   Bhatṛhari: Śatakatraya (1. Nītiśataka, 2. Śṛṅgāraśataka, 3.	BhatR-hari: Śataka-trayaH (1. NIti-Sataka, 2. ŚRFgAra-Sataka, 3.
   Vairāgyaśataka)	VErAgya-Sataka)
   nīti-śatakam	nIti-Satakam
   bhartṛhareḥ	BartR-hareH
   dik-kālādyanavacchinnānanta-cin-mātra-mūrtaye |	dik-kAla-Adi-anavacCinna-ananta--cin--mAtra--mUrtaye |
   svānubhūty-eka-mānāya namaḥ śāntāya tejase || BharSt_1.1 ||	sva-anuBUti--eka-mAnAya namaH SAntAya tejase || BharSt-_1.1 ||
   boddhāro matsara-grastāḥ	bodDAraH matsara--grastAH
   prabhavaḥ smaya-dūṣitāḥ |	praBavaH smaya--dUzitAH |
   abodhopahatāḥ cānye	aboDa-upahatAH ca-anye
   jīrṇam aṅge subhāṣitam || BharSt_1.2 ||	jIrNam aFge suBAzitam || BharSt-_1.2 ||
   ajñaḥ sukham ārādhyaḥ	ajQaH suKam ArADyaH
   sukhataram ārādhyate viśeṣajñaḥ |	suKataram ArADyate viSeza-jQaH |
   jñāna-lava-durvidagdhaṃ	jQAna--lava--durvidagDam
   brahmāpi taṃ naraṃ na rañjayati || BharSt_1.3 ||	brahmA-api tam naram na raQjayati || BharSt-_1.3 ||
   prasahya maṇim uddharen makara-vaktra-daṃṣṭrāntarāt	prasahya maNim udDaret makara--vaktra--daMzwra-antarAt
   samudram api santaret pracalad ūrmi-mālākulam |	samudram api santaret pracalat Urmi--mAlA-Akulam |
   bhujaṅgam api kopitaṃ śirasi puṣpavad dhārayet	BujaFgam api kopitam Sirasi puzpa-vat DArayet-
   na tu pratiniviṣṭa-mūṛkha-jana-cittam ārādhayet || BharSt_1.4 ||	na tu pratinivizwa--mURKa--jana--cittam ArADayet || BharSt-_1.4 ||
   labheta sikatāsu tailam api yatnataḥ pīḍayan	laBeta sikatAsu tElam api yatnatas pIxayan
   pibec ca mṛga-tṛṣṇikāsu salilaṃ pipāsārditaḥ |	pibet ca mRga-tRzNikAsu salilam pipAsA-arditaH |
   kvacid api paryaṭan śaśa-viṣāṇam āsādayet	kvacid api paryawan SaSa-vizANam AsAdayet-
   na tu pratiniviṣṭa-mūrkha-cittam ārādhayet || BharSt_1.5 ||	na tu pratinivizwa--mUrKa--cittam ArADayet || BharSt-_1.5 ||
   vyālaṃ bāla-mṛṇāla-tantubhir asau roddhuṃ samujjṛmbhate	vyAlam bAla--mRNAla-tantuBiH asO rodDum samujjRmBate
   chettuṃ vajra-maṇiṃ śirīṣa-kusuma-prāntena sannahyati |	Cettum vajra-maNim SirIza--kusuma--prAntena sannahyati |
   mādhuryaṃ madhu-bindunā racayituṃ kṣārāmudher īhate	mADuryam maDu-bindunA racayitum kzArAmuDeH Ihate
   netuṃ vāñchanti yaḥ khalān pathi satāṃ sūktaiḥ sudhā-syandibhiḥ ||	netum vAQCanti yaH KalAn paTi satAm sUktEH suDA-syandiBiH ||
   BharSt_1.6 ||	BharSt_1.6 ||
   svāyattam ekānta-guṇaṃ vidhātrā	su-a-Ayattam ekAnta-guNam viDAtrA
   vinirmitaṃ chādanam ajñatāyāḥ |	vinirmitam CAdanam ajQa-tAyAH |
   viśeṣāataḥ sarva-vidāṃ samāje	viSezAatas sarva-vidAm samAje
   vibhūṣaṇaṃ maunam apaṇḍitānām || BharSt_1.7 ||	viBUzaNam mOnam apaNxitAnAm || BharSt-_1.7 ||
   yadā kiñcij-jño 'haṃ dvipa iva madāndhaḥ samabhavaṃ	yadA kiQcij-jQaH aham dvipaH iva mada-anDaH samaBavam
   tadā sarvajño 'smīty abhavad avaliptaṃ mama manaḥ	tadA sarvajQaH asmi-iti aBavat avaliptam mama manaH
   yadā kiñcit kiñcid budhajana-sakāśād avagataṃ	yadA kiQcid kiQcid buDa-jana--sakASAt avagatam
   tadā mūrkho 'smīti jvara iva mado me vyapagataḥ || BharSt_1.8 ||	tadA mUrKaH asmi-iti jvaraH iva madaH me vyapagataH || BharSt-_1.8 ||
   kṛmi-kula-cittaṃ lālā-klinnaṃ vigandhi-jugupsitaṃ	kRmi-kula--cittam lAlA--klinnam viganDi-jugupsitam
   nirupama-rasaṃ prītyā khādan narāsthi nirāmiṣam |	nirupama--rasam prItyA KAdan nara-asTi nirAmizam |
   surapatim api śvā pārśvasthaṃ vilokya na śaṅkate	surapatim api SvA pArSva-sTam vilokya na SaFkate
   na hi gaṇayati kṣudro jantuḥ parigraha-phalgutām || BharSt_1.9 ||	na hi gaNayati kzudraH jantuH parigraha--Palgu-tAm || BharSt-_1.9 ||
   śiraḥ śārvaṃ svargāt paśupati-śirastaḥ kṣitidharaṃ	SiraH SArvam svargAt paSupati--SirastaH kziti-Daram
   mhīdhrād uttuṅgād avanim avaneś cāpi jaladhim |	mhIDrAt uttuFgAt avanim avaneH ca-api jalaDim |
   adho 'dho gaṅgeyaṃ padam upagatā stokam	aDas aDas gaFgA-iyam padam upagatA stokam
   athavāviveka-bhraṣṭānāṃ bhavati vinipātaḥ śatamukhaḥ || BharSt_1.10 ||	aTavA-aviveka--BrazwAnAm Bavati vinipAtaH Sata-muKaH || BharSt-_1.10 ||
   śakyo vārayituṃ jalena hutabhuk cchatreṇa sūryātapo	SakyaH vArayitum jalena hutaBuj cCatreNa sUrya-AtapaH-
   nāgendro niśitāgkuśena samado daṇḍena go-gardabhau |	nAga-indraH niSitAgkuSena sa-madaH daNxena go-gardaBO |
   vyādhir bheṣaja-saṅgrahaiś ca vividhair mantra-prayogair viṣaṃ	vyADiH Bezaja--saFgrahEH ca viviDEH mantra--prayogEH vizam
   sarvasyauṣadham asti śāstra-vihitaṃ mūrkhasya nasty auṣadhim ||	sarvasya-OzaDam asti SAstra--vihitam mUrKasya nasti OzaDim ||
   BharSt_1.11 ||	BharSt_1.11 ||
   sāhitya-saṅgīta-kalā-vihīnaḥ	sAhitya--saFgI-ta-kalA--vihInaH
   sākṣāt paśuḥ puccha-viṣāṇa-hīnaḥ |	sAkzAt paSuH pucCa--vizANa--hInaH |
   tṛṇaṃ na khādann api jīvamānas	tRNam na KAdan api jIvamAnas
   tad bhāga-dheyaṃ paramaṃ paśūnām || BharSt_1.12 ||	tat BAga-Deyam paramam paSUnAm || BharSt-_1.12 ||
   yeṣāṃ na vidyā na tapo na dānaṃ	yezAm na vidyA na tapaH na dAnam
   jñānaṃ na śīlaṃ na guṇo na dharmaḥ |	jQAnam na SIlam na guNaH na DarmaH |
   te martya-loke bhuvi bhāra-bhūtā	te martya--loke Buvi BAra--BUtA
   manuṣya-rūpeṇa mṛgāś caranti || BharSt_1.13 ||	manuzya--rUpeNa mRgAH caranti || BharSt-_1.13 ||
   varaṃ parvata-durgeṣu	varam parvata--durgezu
   bhrāntaṃ vanacaraiḥ saha	BrAntam vana-carEH saha
   na mūrkha-jana-samparkaḥ	na mUrKa--jana--samparkaH
   surendra-bhavaneṣv api || BharSt_1.14 ||	sura-indra--Bavanezu api || BharSt-_1.14 ||
   śāstropaskṛta-śabda-sundara-giraḥ śiṣya-pradeyāgamā	SAstra-upaskRta-Sabda-sundara--giraH Sizya--pradeya-AgamA
   vikhyātāḥ kavayo vasanti viṣaye yasya prabhor nirdhanāḥ |	viKyAtAH kavayaH vasanti vizaye yasya praBoH nirDanAH |
   taj-jāḍyaṃ vasudhādipasya kavayas tv arthaṃ vināpīśvarāḥ	taj-jAxyam vasuDAdipasya kavayaH tu arTam vinA-api-ISvarAH
   kutsyāḥ syuḥ kuparīkṣakā hi maṇayo yair arghataḥ pātitāḥ || BharSt_1.15 ||	kutsyAH syuH ku-parIkzakAH hi maNayaH yEH arGataH pAtitAH || BharSt-_1.15 ||
   hartur yāti na gocaraṃ kim api śaṃ puṣṇāti yat sarvadā 'py	hartuH yAti na gocaram kim api Sam puzNAti yat sarvadA api-
   arthibhyaḥ pratipādyamānam aniśaṃ prāpnoti vṛddhiṃ parām |	arTiByaH pratipAdyamAnam aniSam prApnoti vRdDim parAm |
   kalpānteṣv api na prayāti nidhanaṃ vidyākhyam antardhanaṃ	kalpa-antezu api na prayAti niDanam vidyA-AKyam antarDanam
   yeṣāṃ tān prati mānam ujjhata nṛpāḥ kas taiḥ saha spardhate || BharSt_1.16	yezAm tAn prati mAnam ujJata nRpAH kaH tEH saha sparDate || BharSt-_1.16
   adhigata-paramārthān paṇḍitān māvamaṃsthās	aDigata-parama-arTAn paNxitAn mA-avamaMsTAH-
   tṛṇam iva laghu lakṣmīr naiva tān saṃruṇaddhi |	tRNam iva laGu lakzmIH na-eva tAn saMruNadDi |
   abhinava-mada-lekhā-śyāma-gaṇḍa-sthalānāṃ	aBinava--mada--leKA--SyAma--gaNxa--sTalAnAm
   na bhavati bisatantur vāraṇaṃ vāraṇānām || BharSt_1.17 ||	na Bavati bisa-tantuH vAraNam vAraNAnAm || BharSt-_1.17 ||
   ambhojinī-vana-vihāra-vilāsam eva	amBojinI-vana--vihAra--vilAsam eva
   haṃsasya hanti nitarāṃ kupito vidhātā |	haMsasya hanti nitarAm kupitaH viDAtA |
   na tv asya dugdha-jala-bheda-vidhau prasiddhāṃ	na tu asya dugDa--jala-Beda-viDO prasidDAm
   vaidagdhī-kīrtim apahartum asau samarthaḥ || BharSt_1.18 ||	vEdagDI--kIrtim apahartum asO samarTaH || BharSt-_1.18 ||
   keyūrāṇi na bhūṣayanti puruṣaṃ hārā na candrojjvalā	keyUrANi na BUzayanti puruzam hArAH na candrojjvalA
   na snānaṃ na vilepanaṃ na kusumaṃ nālaṅkṛtā mūrdhajāḥ |	na snAnam na vilepanam na kusumam na-alaFkRtAH mUrDajAH |
   vāṇy ekā samalaṅkaroti puruṣaṃ yā saṃskṛtā dhāryate	vANi ekA samalaFkaroti puruzam yA saMskRtA DAryate
   kṣīyante khalu bhūṣaṇāni satataṃ vāg-bhūṣaṇaṃ bhūṣaṇam || BharSt_1.19 ||	kzIyante Kalu BUzaNAni satatam vAc--BUzaNam BUzaNam || BharSt-_1.19 ||
   vidyā nāma narasya rūpam adhikaṃ pracchanna-guptaṃ dhanaṃ	vidyA nAma narasya rUpam aDikam pracCanna-guptam Danam
   vidyā bhogakarī yaśaḥ-sukhakarī vidyā gurūṇāṃ guruḥ |	vidyA Boga-karI yaSaH--suKa-karI vidyA gurUNAm guruH |
   vidyā bandhujano videśa-gamane vidyā parā devatā	vidyA banDu-janaH videSa--gamane vidyA parA devatA
   vidyā rājasu pūjyate na tu dhanaṃ vidyā-vihīnaḥ paśuḥ || BharSt_1.20 ||	vidyA rAjasu pUjyate na tu Danam vidyA--vihInaH paSuH || BharSt-_1.20 ||
   kṣāntiś cet kavacena kiṃ kim aribhiḥ krodho 'sti ced dehināṃ	kzAntiH ced kavacena kim kim ariBiH kroDaH asti ced dehinAm
   jñātiś ced analena kiṃ yadi suhṛd divyauṣadhaṃ kiṃ phalam |	jQAtiH ced analena kim yadi suhRd divyOzaDam kim Palam |
   kiṃ sarpair yadi durjanāḥ kim u dhanair vidyā 'navadyā yadi	kim sarpEH yadi durjanAH kim u DanEH vidyA anavadyAH yadi
   vrīḍā cet kim u bhūṣaṇaiḥ sukavitā yady asti rājyena kim || BharSt_1.21 ||	vrIxA ced kim u BUzaNEH su-kavitA yadi asti rAjyena kim || BharSt-_1.21 ||
   dākṣiṇyaṃ svajane dayā parijane śāṭhyaṃ sadā durjane	dAkziNyam sva-jane dayA parijane SAWyam sadA durjane
   prītiḥ sādhujane nayo nṛpa-jane vidvaj-jane cārjavam |	prItiH sADu-jane nayaH nRpa-jane vidvaj--jane ca-Arjavam |
   śauryaṃ śatru-jane kṣamā guru-jane kāntā-jane dhṛṣṭatā	SOryam Satru-jane kzamA guru-jane kAntA-a-jane DRzwa-tA
   ye caivaṃ puruṣāḥ kalāsu kuśalās teṣv eva loka-sthitiḥ || BharSt_1.22 ||	ye ca-evam puruzAH kalAsu kuSalAH tezu eva loka--sTitiH || BharSt-_1.22 ||
   jāḍyaṃ dhiyo harati siñcati vāci satyaṃ	jAxyam DiyaH harati siQcati vAci satyam
   mānonnatiṃ diśati pāpam apākaroti |	mAna-unnatim diSati pApam apAkaroti |
   cetaḥ prasādayati dikṣu tanoti kīrtiṃ	cetaH prasAdayati dikzu tanoti kIrtim
   sat-saṅgatiḥ kathaya kiṃ na karoti puṃsām || BharSt_1.23 ||	sat--saFgatiH kaTaya kim na karoti puMsAm || BharSt-_1.23 ||
   jayanti te sukṛtino	jayanti te sukRtinaH-
   rasa-siddhāḥ kavīśvarāḥ |	rasa--sidDAH kavi-ISvarAH |
   nāsti yeṣāṃ yaśaḥkāye	na-asti yezAm yaSaH-kAye
   jarā-maraṇa-jaṃ bhayam || BharSt_1.24 ||	jarA-maraNa-jam Bayam || BharSt-_1.24 ||
   sūnuḥ sac-caritaḥ satī priyatamā svāmī prasādonmukhaḥ	sUnuH sac-caritaH satI priyatamA svAmI prasAda-unmuKaH
   snigdhaṃ mitram avañcakaḥ parijano niḥkleśa-leśaṃ manaḥ |	snigDam mitram avaQcakaH parijanaH niHkleSa--leSam manaH |
   ākāro ruciraḥ sthiraś ca vibhavo vidyāvadātaṃ mukhaṃ	AkAraH ruciraH sTiraH ca viBavaH vidyA-avadAtam muKam
   tuṣṭe viṣṭapa-kaṣṭa-hāriṇi harau samprāpyate dehinā || BharSt_1.25 ||	tuzwe vizwapa--kazwa-hAriNi harO samprApyate dehinA || BharSt-_1.25 ||
   prāṇāghātān nivṛttiḥ para-dhana-haraṇe saṃyamaḥ satya-vākyaṃ	prANa-AGAtAt nivRttiH para-Dana--haraNe saMyamaH satya--vAkyam
   kāle śaktyā pradānaṃ yuvati-jana-kathā-mūka-bhāvaḥ pareṣām |	kAle SaktyA pradAnam yuvati-jana--kaTA-mUka-BAvaH parezAm |
   tṛṣṇā-sroto vibhaṅgo guruṣu ca vinayaḥ sarva-bhūtānukampā	tRzNA--srotaH viBaFgaH guruzu ca vinayaH sarva-BUta-anukampA
   sāmānyaḥ sarva-śāstreṣv anupahata-vidhiḥ śreyasām eṣa panthāḥ ||	sAmAnyaH sarva--SAstrezu anupahata-viDiH SreyasAm eza panTAH ||
   BharSt_1.26 ||	BharSt_1.26 ||
   prārabhyate na khalu vighna-bhayena nīcaiḥ	prAraByate na Kalu viGna-Bayena nIcEs-
   prārabhya vighna-vihatā viramanti madhyāḥ |	prAraBya viGna-vihatAH viramanti maDyAH |
   vighnaiḥ punaḥ punar api pratihanyamānāḥ	viGnEH punar punar api pratihanyamAnAH
   prārabdham uttama-janā na parityajanti || BharSt_1.27 ||	prArabDam uttama--janAH na parityajanti || BharSt-_1.27 ||
   asanto nābhyarthyāḥ suhṛd api na yācyaḥ kṛśa-dhanaḥ	asantaH na-aByarTyAH suhRd api na yAcyaH kRSa-DanaH
   priyā nyāyyā vṛttir malinam asubhaṅge 'py asukaram |	priyA nyAyyA vRttiH malinam asu-BaFge api asukaram |
   vipady uccaiḥ stheyaṃ padam anuvidheyaṃ ca mahatāṃ	vipadi uccEs sTeyam padam anuviDeyam ca mahatAm
   satāṃ kenoddiṣṭaṃ viṣamam asidhārā-vratam idam || BharSt_1.28 ||	satAm kena-uddizwam vizamam asi-DArA--vratam idam || BharSt-_1.28 ||
   kṣut-kṣāmo 'pi jarā-kṛśo 'pi śithila-prāṇo 'pi kaṣṭāṃ daśām	kzut--kzAmaH api jarA-kRSaH api SiTila-prANaH api kazwAm daSAm
   āpanno 'pi vipanna-dīdhitir iti prāṇeṣu naśyatsv api |	ApannaH api vipanna--dIDitiH iti prANezu naSyatsu api |
   mattebhendra-vibhinna-kumbha-piśita-grāsaika-baddha-spṛhaḥ	matta-iBa-indra--viBinna--kumBa--piSita-grAsa-eka---badDa--spRhaH
   kiṃ jīrṇaṃ tṛṇam atti māna-mahatām agresaraḥ kesarī || BharSt_1.29 ||	kim jIrNam tRNam atti mAna--mahatAm agresaraH kesarI || BharSt-_1.29 ||
   svalpa-snāyu-vasāvaśeṣa-malinaṃ nirmāṃsam apy asthi goḥ	su-alpa--snAyu-vasA-vaSeza--malinam nirmAMsam api asTi goH
   śvā labdhvā paritoṣam eti na tu tat tasya kṣudhā-śāntaye |	SvA labDvA paritozam eti na tu tat tasya kzuDA--SAntaye |
   siṃho jambukam aṅkam āgatam api tyaktvā nihanti dvipaṃ	siMhaH jambukam aFkam Agatam api tyaktvA nihanti dvipam
   sarvaḥ kṛcchra-gato 'pi vāñchanti janaḥ sattvānurūpaṃ phalam ||	sarvaH kRcCra-gataH api vAQCanti janaH sattva-anurUpam Palam ||
   BharSt_1.30 ||	BharSt_1.30 ||
   lāṅgūla-cālanam adhaś-caraṇāvapātaṃ	lAFgUla-cAlanam aDaS-caraNa-avapAtam
   bhūmau nipatya vadanodara-darśanaṃ ca |	BUmO nipatya vadana-udara--darSanam ca |
   śvā piṇḍadasya kurute gaja-puṅgavas tu	SvA piNxadasya kurute gaja--puFgavaH tu
   dhīraṃ vilokayati cāṭu-śataiś ca bhuṅkte || BharSt_1.31 ||	DIram vilokayati cAwu-SatEH ca BuFkte || BharSt-_1.31 ||
   parivartini saṃsāre	parivartini saMsAre
   mṛtaḥ ko vā na jāyate |	mRtaH kaH vA na jAyate |
   sa jāto yena jātena	sa jAtaH yena jAtena
   yāti vaṃśaḥ samunnatim || BharSt_1.32 ||	yAti vaMSaH samunnatim || BharSt-_1.32 ||
   kusuma-stavakasyeva	kusuma-stavakasya-iva
   dvayī vṛttir manasvinaḥ |	dvayI vRttiH manasvinaH |
   mūrdhni vā sarva-lokasya	mUrDni vA sarva-lokasya
   śīryate vana eva vā || BharSt_1.33 ||	SIryate vanaH eva vA || BharSt-_1.33 ||
   santy anye 'pi bṛhaspati-prabhṛtayaḥ sambhāvitāḥ pañcaṣās	santi anye api bRhaspati--praBRtayaH samBAvitAH paQcazAs
   tān praty eṣa viśeṣa-vikrama-rucī rāhur na vairāyate |	tAn prati eza viSeza--vikrama--ruciH rAhuH na vErAyate |
   dvāv eva grasate divākara-niśā-prāṇeśvarau bhāskarau	dvO eva grasate divAkara--niSA--prANeSvarO BAskarO
   bhrātaḥ parvaṇi paśya dānava-patiḥ śīrṣāvaśeṣākṛtiḥ || BharSt_1.34 ||	BrAtar parvaNi paSya dAnava-patiH SIrza-avaSeza-AkRtiH || BharSt-_1.34 ||
   vahati bhuvana-śreṇiṃ śeṣaḥ phaṇāphalaka-sthitāṃ	vahati Buvana--SreNim SezaH PaNA-Palaka---sTitAm
   kamaṭha-patinā madhye-pṛṣṭhaṃ sadā sa ca dhāryate |	kamaWa-patinA maDye--pRzWam sadA sa ca DAryate |
   tam api kurute kroḍādhīnaṃ payodhir anādarād	tam api kurute kroxa-aDInam payoDiH anAdarAt-
   ahaha mahatāṃ niḥsīmānaś caritra-vibhūtayaḥ || BharSt_1.35 ||	ahaha mahatAm niHsImAnaH caritra--viBUtayaH || BharSt-_1.35 ||
   varaṃ pakṣa-cchedaḥ samadamaghavan-mukta-kuliśaprahārair	varam pakza-=-CedaH samadam-aGavan-mukta-kuliSa-prahArEH-
   udgacchad-bahula-dahanodgāra-gurubhiḥ |	udgacCat--bahula--dahana-udgAra--guruBiH |
   tuṣārādreḥ sūnor ahaha pitari kleśa-vivaśe	tuzArAdreH sUnoH ahaha pitari kleSa--vivaSe
   na cāsau sampātaḥ payasi payasāṃ patyur ucitaḥ || BharSt_1.36 ||	na ca-asO sampAtaH payasi payasAm patyuH ucitaH || BharSt-_1.36 ||
   siṃhaḥ śiśur api nipatati	siMhaH SiSuH api nipatati
   mada-malina-kapola-bhittiṣu gajeṣu |	mada--malina--kapola-Bittizu gajezu |
   prakṛtir iyaṃ sattvavatāṃ	prakRtiH iyam sattvavatAm
   na khalu vayas tejaso hetuḥ || BharSt_1.37 ||	na Kalu vayaH tejasaH hetuH || BharSt-_1.37 ||
   jātir yātu rasātalaṃ guṇa-gaṇais tatrāpy adho gamyatāṃ	jAtiH yAtu rasAtalam guNa--gaNEH tatra-api aDas gamyatAm
   śīlaṃ śaila-taṭāt patatv abhijanaḥ sandahyatāṃ vahninā |	SIlam SEla--tawAt patatu aBijanaH sandahyatAm vahninA |
   śaurye vairiṇi vajram āśu nipatatv artho 'stu naḥ kevalaṃ	SOrye vEriNi vajram ASu nipatatu arTaH astu naH kevalam
   yenaikena vinā guṇas tṛṇa-lava-prāyāḥ samastā ime || BharSt_1.38 ||	yena-ekena vinA guNaH tRNa--lava--prAyAH samastAH ime || BharSt-_1.38 ||
   dhanam arjaya kākutstha	Danam arjaya kAkutsTa
   dhana-mūlam idaṃ jagat |	Dana--mUlam idam jagat |
   antaraṃ nābhijānāmi	antaram na-aBijAnAmi
   nirdhanasya mṛtasya ca || BharSt_1.39 ||	nirDanasya mRtasya ca || BharSt-_1.39 ||
   tānīndriyāṇy avikalāni tad eva nāma	tAni-indriyANi avikalAni tat eva nAma
   sā buddhir apratihatā vacanaṃ tad eva |	sA budDiH apratihatAH vacanam tat eva |
   arthoṣmaṇā virahitaḥ puruṣaḥ kṣaṇena	arTa-UzmaNA virahitaH puruzaH kzaNena
   so 'py anya eva bhavatīti vicitram etat || BharSt_1.40 ||	saH api anyaH eva Bavati-iti vicitram etat || BharSt-_1.40 ||
   yasyāsti vittaṃ sa naraḥ kulīnaḥ	yasya-asti vittam sa naraH kulInaH
   sa paṇḍitaḥ sa śrutavān guṇajñaḥ |	sa paNxitaH sa SrutavAn guNa-jQaH |
   sa eva vaktā sa ca darśanīyaḥ	saH eva vaktA sa ca darSanIyaH
   sarve guṇāḥ kāñcanam āśrayanti || BharSt_1.41 ||	sarve guNAH kAQcanam ASrayanti || BharSt-_1.41 ||
   daurmantryān nṛpatir vinaśyati yatiḥ saṅgāt suto lālanāt	dOrmantryAt nRpatiH vinaSyati yatiH saFgAt sutaH lAlanAt-
   vipro 'nadhyayanāt kulaṃ kutanayāc chīlaṃ khalopāsanāt |	vipraH anaDyayanAt kulam ku-tanayAt SIlam Kala-upAsanAt |
   hrīr madyād anavekṣaṇād api kṛṣiḥ snehaḥ pravāsāśrayān	hrIH madyAt anavekzaNAt api kRziH snehaH pravAsa-ASrayAn
   maitrī cāpraṇayāt samṛddhir anayāt tyāga-pramādād dhanam || BharSt_1.42 ||	mEtrI ca-apraNayAt samRdDiH anayAt tyAga--pramAdAt Danam || BharSt-_1.42 ||
   dānaṃ bhogo nāśas tisro	dAnam BogaH nASaH tisraH-
   gatayo bhavanti vittasya |	gatayaH Bavanti vittasya |
   yo na dadāti na bhuṅkte	yaH na dadAti na BuFkte
   tasya tṛtīyā gatir bhavati || BharSt_1.43 ||	tasya tRtIyA gatiH Bavati || BharSt-_1.43 ||
   maṇiḥ śāṇollīḍhaḥ samara-vijayī heti-dalito	maNiH SANa-ullIXaH samara-vijayI heti-dalitaH-
   mada-kṣīṇo nāgaḥ śaradi saritaḥ śyāna-pulināḥ |	mada--kzINaH nAgaH Saradi saritaH SyAna--pulinAH |
   kalā-śeṣaś candraḥ surata-mṛditā bāla-vanitā	kalA-SezaH candraH surata--mRditA bAla--vanitA
   tan-nimnā śobhante galita-vibhavāś cārthiṣu narāḥ || BharSt_1.44 ||	tan--nimnA SoBante galita-viBavAH ca-arTizu narAH || BharSt-_1.44 ||
   parikṣīṇaḥ kaścit spṛhayati yavānāṃ prasṛtaye	parikzINaH kaScid spRhayati yavAnAm prasRtaye
   sa paścāt sampūrṇaḥ kalayati dharitrīṃ tṛṇa-samām |	sa paScAt sampUrNaH kalayati DaritrIm tRNa--samAm |
   ataś cānaikāntyād guru-laghutayā 'rtheṣu dhaninām	atas ca-anEkAntyAt guru-laGu-tayA arTezu DaninAm
   avasthā vastūni prathayati ca saṅkocayati ca || BharSt_1.45 ||	avasTA vastUni praTayati ca saFkocayati ca || BharSt-_1.45 ||
   rājan dudhukṣasi yadi kṣiti-dhenum etāṃ	rAjan duDukzasi yadi kziti-Denum etAm
   tenādya vatsam iva lokam amuṃ puṣāṇa	tena-adya vatsam iva lokam amum puzANa
   tasmiṃś ca samyag aniśaṃ paripoṣyamāṇe	tasmin ca samyak aniSam paripozyamANe
   nānā-phalaiḥ phalati kalpalateva bhūmiḥ || BharSt_1.46 ||	nAnA-PalEH Palati kalpalatA-iva BUmiH || BharSt-_1.46 ||
   satyānṛtā ca paruṣā priya-vādinī ca	satya-anRtA ca paruzA priya-vAdinI ca
   hiṃsrā dayālur api cārthaparā vadānyā |	hiMsrA dayAluH api ca-arTa-parA vadAnyA |
   nitya-vyayā pracura-nitya-dhanāgamā ca	nitya--vyayA pracura-nitya--Dana-AgamA ca
   vārāṅganeva nṛpa-nītir aneka-rūpā || BharSt_1.47 ||	vAra-aFganA-iva nRpa-nItiH aneka--rUpAH || BharSt-_1.47 ||
   ājñā kīrtiḥ pālanaṃ brāhmaṇānāṃ	AjQA kIrtiH pAlanam brAhmaNAnAm
   dānaṃ bhogo mitra-saṃrakṣaṇaṃ ca	dAnam BogaH mitra--saMrakzaNam ca
   yeṣām ete ṣaḍguṇā na pravṛttāḥ	yezAm ete zaxguNAH na pravRttAH
   ko 'rthas teṣāṃ pārthivopāśrayeṇa || BharSt_1.48 ||	kaH arTaH tezAm pArTiva-upASrayeNa || BharSt-_1.48 ||
   yad dhātrā nija-bhāla-paṭṭa-likhitaṃ stokaṃ mahad vā dhanaṃ	yat DAtrA nija--BAla--pawwa--liKitam stokam mahat vA Danam
   tat prāpnoti marusthale 'pi nitarāṃ merau tato nādhikam |	tat prApnoti maru-sTale api nitarAm merO tatas na-aDikam |
   tad dhīro bhava vittavatsu kṛpaṇāṃ vṛttiṃ vṛthā sā kṛthāḥ	tat DIraH Bava vittavatsu kRpaNAm vRttim vRTA sA kRTAH
   kūpe paśya payonidhāv api ghaṭo gṛhṇāti tulyaṃ jalam || BharSt_1.49 ||	kUpe paSya payoniDO api GawaH gRhNAti tulyam jalam || BharSt-_1.49 ||
   tvam eva cātakādhāro '	tvam eva cAtaka-ADAraH a
   sīti keṣāṃ na gocaraḥ |	sI-iti kezAm na gocaraH |
   kim ambhoda-varāsmākaṃ	kim amBoda-varA-asmAkam
   kārpaṇyoktaṃ pratīkṣase || BharSt_1.50 ||	kArpaNya-uktam pratIkzase || BharSt-_1.50 ||
   re re cātaka sāvadhāna-manasā mitra kṣaṇaṃ śrūyatām	re re cAtaka sa-avaDAna--manasA mitra kzaNam SrUyatAm
   ambhodā bahavo vasanti gagane sarve 'pi naitādṛśāḥ |	amBodAH bahavaH vasanti gagane sarve api na-etAdRSAH |
   kecid vṛṣṭibhir ārdrayanti vasudhāṃ garjanti kecid vṛthā	kecid vRzwiBiH Ardrayanti vasuDAm garjanti kecid vRTA
   yaṃ yaṃ paśyasi tasya tasya purato mā brūhi dīnaṃ vacaḥ || BharSt_1.51 ||	yam yam paSyasi tasya tasya puratas mA brUhi dInam vacaH || BharSt-_1.51 ||
   akaruṇatvam akāraṇa-vigrahaḥ	akaruNa-tvam akAraNa-vigrahaH
   paradhane parayoṣiti ca spṛhā |	para-Dane para-yoziti ca spRhA |
   sujana-bandhujaneṣv asahiṣṇutā	su-jana-banDu-janezu asahizNu-tA
   prakṛti-siddham idaṃ hi durātmanām || BharSt_1.52 ||	prakRti-sidDam idam hi durAtmanAm || BharSt-_1.52 ||
   durjanaḥ parihartavyo	durjanaH parihartavyaH-
   vidyayā 'lakṛto 'pi san |	vidyayA alakRtaH api san |
   maṇinā bhūṣitaḥ sarpaḥ	maNinA BUzitaH sarpaH
   kim asau na bhayaṅkaraḥ || BharSt_1.53 ||	kim asO na BayaFkaraH || BharSt-_1.53 ||
   jāḍyaṃ hrīmati gaṇyate vrata-rucau dambhaḥ śucau kaitavaṃ	jAxyam hrImati gaNyate vrata-rucO damBaH SucO kEtavam
   śūre nirghṛṇatā munau vimatitā dainyaṃ priyālāpini |	SUre nirGRNa-tA munO vimatitAH dEnyam priya-AlApini |
   tejasviny avaliptatā mukharatā vaktary aśaktiḥ sthire	tejasvini avalipta-tA muKara-tA vaktarI aSaktiH sTire
   tat ko nāma guṇo bhavet sa guṇināṃ yo durjanair nāṅkitaḥ || BharSt_1.54 ||	tat kaH nAma guNaH Bavet sa guNinAm yaH durjanEH na-aFkitaH || BharSt-_1.54 ||
   lobhaś ced aguṇena kiṃ piśunatā yady asti kiṃ pātakaiḥ	loBaH ced aguNena kim piSuna-tA yadi asti kim pAtakEH
   satyaṃ cet tapasā ca kiṃ śuci mano yady asti tīrthena kim |	satyam ced tapasA ca kim Suci manaH yadi asti tIrTena kim |
   saujanyaṃ yadi kiṃ guṇaiḥ sumahimā yady asti kiṃ maṇḍanaiḥ	sOjanyam yadi kim guNEH su-mahimA yadi asti kim maNxanEH
   sad-vidyā yadi kiṃ dhanair apayaśo yady asti kiṃ mṛtyunā || BharSt_1.55 ||	sat--vidyA yadi kim DanEH apayaSaH yadi asti kim mRtyunA || BharSt-_1.55 ||
   śaśī divasa-dhūsaro galita-yauvanā kāminī	SaSI divasa-DUsaraH galita--yOvanA kAminI
   saro vigata-vārijaṃ mukham anakṣaraṃ svākṛteḥ |	saraH vigata-vAri-jam muKam anakzaram svAkRteH |
   prabhur dhana-parāyaṇaḥ satata-durgataḥ sajjano	praBuH Dana--parAyaNaH satata--durgataH sat-janaH-
   nṛpāṅgaṇa-gataḥ khalo manasi sapta śalyāni me || BharSt_1.56 ||	nRpa-aFgaNa--gataH KalaH manasi sapta SalyAni me || BharSt-_1.56 ||
   na kaścic caṇḍa-kopānām	na kaScid caNxa--kopAnAm
   ātmīyo nāma bhūbhujām |	AtmIyaH nAma BUBujAm |
   hotāram api juhvānaṃ	hotAram api juhvAnam
   spṛṣṭo vahati pāvakaḥ || BharSt_1.57 ||	spRzwaH vahati pAvakaH || BharSt-_1.57 ||
   maunomūkaḥ pravacana-paṭur bāṭulo jalpako vā	mOnomUkaH pravacana--pawuH bAwulaH jalpakaH vA
   dhṛṣṭaḥ pārśve vasati ca sadā dūrataś cāpragalbhaḥ |	DRzwaH pArSve vasati ca sadA dUratas ca-apragalBaH |
   kṣāntyā bhīrur yadi na sahate prāyaśo nābhijātaḥ	kzAntyA BIruH yadi na sahate prAyaSas na-aBijAtaH
   sevādharmaḥ parama-gahano yoginām apy agamyaḥ || BharSt_1.58 ||	sevA-DarmaH parama--gahanaH yoginAm api agamyaH || BharSt-_1.58 ||
   udbhāsitākhila-khalasya viśṛṅkhalasya	udBAsita-aKila--Kalasya viSRFKalasya
   prāg-jāta-vistṛta-nijādhama-karma-vṛtteḥ |	prAk--jAta--vistRta--nija-aDama--karma--vRtteH |
   daivād avāpta-vibhavasya guṇa-dviṣo 'sya	dEvAt avApta-viBavasya guNa-dvizaH asya
   nīcasya gocara-gataiḥ sukham āpyate || BharSt_1.59 ||	nIcasya gocara--gatEH suKam Apyate || BharSt-_1.59 ||
   ārambha-gurvī kṣayiṇī krameṇa	AramBa-gurvI kzayiNI krameNa
   laghvī purā vṛddhimatī ca paścāt |	laGvI purA vRdDimatI ca paScAt |
   dinasya pūrvārdha-parārdha-bhinnā	dinasya pUrva-arDa--para-arDa--BinnA
   chāyeva maitrī khala-saj-janānām || BharSt_1.60 ||	CAyA-iva mEtrI Kala--saj--janAnAm || BharSt-_1.60 ||
   mṛga-mīna-sajjanānāṃ tṛṇa-jala-santoṣa-vihita-vṛttīnām |	mRga--mIna--sat-janAnAm tRNa--jala--santoza--vihita--vRttInAm |
   lubdhaka-dhīvara-piśunā niṣkāraṇa-vairiṇo jagati || BharSt_1.61 ||	lubDaka-DI-vara--piSunA nizkAraNa--vEriNaH jagati || BharSt-_1.61 ||
   vāñchā sajjana-saṅgame para-guṇe prītir gurau namratā	vAQCA sat-jana--saFgame para--guNe prItiH gurO namra-tA
   vidyāyāṃ vyasanaṃ sva-yoṣiti ratir lokāpavādād bhayam |	vidyAyAm vyasanam sva-yoziti ratiH loka-apavAdAt Bayam |
   bhaktiḥ śūlini śaktir ātma-damane saṃsarga-muktiḥ khale	BaktiH SUlini SaktiH Atma--damane saMsarga-muktiH Kale
   yeṣv ete nivasanti nirmala-guṇās tebhyo narebhyo namaḥ || BharSt_1.62 ||	yezu ete nivasanti nirmala--guNAH teByaH nareByaH namaH || BharSt-_1.62 ||
   vipadi dhairyam athābhyudaye kṣamā	vipadi DEryam aTa-aByudaye kzamA
   sadasi vākya-paṭutā yudhi vikramaḥ |	sadasi vAkya--pawu-tA yuDi vikramaH |
   yaśasi cābhirucir vyasanaṃ śrutau	yaSasi ca-aBiruciH vyasanam SrutO
   prakṛti-siddham idaṃ hi mahātmanām || BharSt_1.63 ||	prakRti-sidDam idam hi mahAtmanAm || BharSt-_1.63 ||
   pradānaṃ pracchannaṃ gṛham upagate sambhrama-vidhiḥ	pradAnam pracCannam gRham upagate samBrama--viDiH
   priyaṃ kṛtvā maunaṃ sadasi kathanaṃ cāpy upakṛteḥ |	priyam kRtvA mOnam sadasi kaTanam ca-api upakRteH |
   anutseko lakṣmyām anabhibhava-gandhāḥ para-kathāḥ	anutsekaH lakzmyAm anaBiBava--ganDAH para--kaTAH
   satāṃ kenoddiṣṭaṃ viṣamam asidhārā-vratam idam || BharSt_1.64 ||	satAm kena-uddizwam vizamam asi-DArA--vratam idam || BharSt-_1.64 ||
   kare ślāghyas tyāgaḥ śirasi guru-pāda-praṇayitā	kare SlAGyaH tyAgaH Sirasi guru-pAda--praNayitA
   mukhe satyā vāṇī vijayi bhujayor vīryam atulam |	muKe satyA vANI vijayi BujayoH vIryam atulam |
   hṛdi svacchā vṛttiḥ śrutim adhigataṃ ca śravaṇayor	hRdi svacCA vRttiH Srutim aDigatam ca SravaNayoH-
   vināpy aiśvaryeṇa prakṛti-mahatāṃ maṇḍanam idam || BharSt_1.65 ||	vinA-api ESvaryeNa prakRti-mahatAm maNxanam idam || BharSt-_1.65 ||
   sampatsu mahatāṃ cittaṃ	sampatsu mahatAm cittam
   bhavaty utpala-komalam |āpatsu ca mahāśailaśilā-	Bavati utpala--komalam |Apatsu ca mahA-SEla-SilA-
   saṅghāta-karkaśam || BharSt_1.66 ||	saFGAta--karkaSam || BharSt-_1.66 ||
   santaptāyasi saṃsthitasya payaso nāmāpi na jñāyate	santapta-ayasi saMsTitasya payasaH nAma-api na jQAyate
   muktākāratayā tad eva nalinī-patra-sthitaṃ rājate |	mukta-AkAra-tayA tat eva nalinI--patra--sTitam rAjate |
   svātyāṃ sāgara-śukti-madhya-patitaṃ tan-mauktikaṃ jāyate	svAtyAm sAgara--Sukti--maDya-patitam tan-mOktikam jAyate
   prāyeṇādhama-madhyamottama-guṇaḥ saṃsargato jāyate || BharSt_1.67 ||	prAyeNa-aDama--maDyama-uttama--guNaH saMsargataH jAyate || BharSt-_1.67 ||
   prīṇāti yaḥ sucaritaiḥ pitaraṃ sa putro	prINAti yaH su-caritEH pitaram sa putraH-
   yad bhartur eva hitam icchati tat kalatram |	yat BartuH eva hitam icCati tat kalatram |
   tan mitram āpadi sukhe ca sama-kriyaṃ yad	tat mitram Apadi suKe ca sama-kriyam yat-
   etat trayaṃ jagati puṇya-kṛto labhante || BharSt_1.68 ||	etat trayam jagati puNya-kRtaH laBante || BharSt-_1.68 ||
   eko devaḥ keśavo vā śivo vā	ekaH devaH keSavaH vA SivaH vA
   hy ekaṃ mitraṃ bhūpatir vā yatir vā |	hi ekam mitram BUpatiH vA yatiH vA |
   eko vāsaḥ pattane vā vane vā	ekaH vAsaH pattane vA vane vA
   hy ekā bhāryā sundarī vā darī vā || BharSt_1.69 ||	hi ekA BAryA sundarI vA darI vE || BharSt-_1.69 ||
   namratvenonnamantaḥ para-guṇa-kathanaiḥ svān guṇān khyāpayantaḥ	namra-tvena-unnamantaH para--guNa--kaTanEH svAn guNAn KyApayantaH
   svārthān sampādayanto vitata-pṛthutarārambha-yatnāḥ parārthe |	sva-arTAn sampAdayantaH vitata--pRTutara-AramBa-yatnAH para-arTe |
   kṣāntyaivākṣepa-rukṣākṣara-mukhara-mukhān durjanān dūṣayantaḥ	kzAntyA-eva-Akzepa-rukza-akzara--muKara--muKAn durjanAn dUzayantaH
   santaḥ sāścarya-caryā jagati bahu-matāḥ kasya nābhyarcanīyāḥ ||	santaH sa-AScarya-caryA jagati bahu-matAH kasya na-aByarcanIyAH ||
   BharSt_1.70 ||	BharSt_1.70 ||
   bhavanti namrās taravaḥ phalodgamair	Bavanti namrAH taravaH Pala-udgamEH-
   navāmbubhir dūrāvalambino ghanāḥ |	nava-ambuBiH dUra-avalambinaH GanAH |
   anuddhatāḥ sat-puruṣāḥ samṛddhibhiḥ	anudDatAH sat--puruzAH samRdDiBiH
   svabhāva eṣa paropakāriṇām || BharSt_1.71 ||	svaBAvaH eza para-upakAriNAm || BharSt-_1.71 ||
   śrotraṃ śrutenaiva na kuṇḍalena	Srotram Srutena-eva na kuNxalena
   dānena pāṇir na tu kaṅkaṇena |	dAnena pANiH na tu kaFkaNena |
   vibhāti kāyaḥ karuṇa-parāṇāṃ	viBAti kAyaH karuNa--parANAm
   paropakārair na tu candanena || BharSt_1.72 ||	para-upakArEH na tu candanena || BharSt-_1.72 ||
   pāpān nivārayati yojayate hitāya	pApAt nivArayati yojayate hitAya
   guhyaṃ nigūhati guṇān prakaṭīkaroti |	guhyam nigUhati guNAn prakawIkaroti |
   āpad-gataṃ ca na jahāti dadāti kāle	Apad---gatam ca na jahAti dadAti kAle
   san-mitra-lakṣaṇam idaṃ pravadanti santaḥ || BharSt_1.73 ||	san-mitra--lakzaNam idam pravadanti santaH || BharSt-_1.73 ||
   padmākaraṃ dinakaro vikacīkaroti	padma-Akaram dinakaraH vikacIkaroti
   camdrp volāsayati kairava-cakravālam |	camdrp vA-ulAsayati kErava--cakravAlam |
   nābhyarthito jaladharo 'pi jalaṃ dadāti	na-aByarTitaH jalaDaraH api jalam dadAti
   santaḥ svayaṃ parahite vihitābhiyogāḥ || BharSt_1.74 ||	santaH svayam para-hite vihita-aBiyogAH || BharSt-_1.74 ||
   eke sat-puruṣāḥ parārtha-ghaṭakāḥ svārthaṃ parityajanti ye	eke sat--puruzAH para-arTa--GawakAH sva-arTam parityajanti ye
   sāmānyās tu parārtham udyama-bhṛtaḥ svārthāvirodhena ye |	sAmAnyAH tu para-arTam udyama-BRtaH sva-arTa-aviroDena ye |
   te 'mī mānuṣa-rākṣasāḥ parahitaṃ svārthāya nighnanti ye	te amI mAnuza---rAkzasAH para-hitam sva-arTAya niGnanti ye
   ye tu ghnanti nirarthakaṃ parahitaṃ te ke na jānīmahe || BharSt_1.75 ||	ye tu Gnanti nirarTakam para-hitam te ke na jAnImahe || BharSt-_1.75 ||
   kṣīreṇātmagatodakāya hi guṇā dattā purā te 'khilā	kzIreNa-Atma-gata-udakAya hi guNAH dattA purA te aKilA
   kṣīrottāpam avekṣya tena payasā svātmā kṛśānau hutaḥ |	kzIra-uttApam avekzya tena payasA sva-AtmA kRSAnO hutaH |
   gantuṃ pāvakam unmanas tad abhavad dṛṣṭvā tu mitrāpadaṃ	gantum pAvakam unmanaH tat aBavat dRzwvA tu mitra-Apadam
   yuktaṃ tena jalena śāmyati satāṃ maitrī punas tv īdṛśī || BharSt_1.76 ||	yuktam tena jalena SAmyati satAm mEtrI punar tu IdRSI || BharSt-_1.76 ||
   itaḥ svapiti keśavaḥ kulam itas tadīya-dviṣām	itas svapiti keSavaH kulam itas tadIya-dvizAm
   itaś ca śaraṇārthināṃ śikhariṇāṃ gaṇāḥ śerate |	itas ca SaraNa-arTinAm SiKariNAm gaNAH Serate |
   ito 'pi baḍavānalaḥ saha samasta-saṃvartakaiṛ	itas api baxavAnalaH saha samasta--saMvartakER
   aho vitatam ūrjitaṃ bhara-sahaṃ sindhor vapuḥ || BharSt_1.77 ||	aho vitatam Urjitam Bara--saham sinDoH vapuH || BharSt-_1.77 ||
   tṛṣṇāṃ chindhi bhaja kṣamāṃ jahi madaṃ pāpe ratiṃ mā kṛthāḥ	tRzNAm CinDi Baja kzamAm jahi madam pApe ratim mA kRTAH
   satyaṃ brūhy anuyāhi sādhu-padavīṃ sevasva vidvaj-janam |	satyam brUhi anuyAhi sADu--padavIm sevasva vidvaj--janam |
   mānyān mānaya vidviṣo 'py anunaya prakhyāpaya praśrayaṃ	mAnyAn mAnaya vidvizaH api anunaya praKyApaya praSrayam
   kīrtiṃ pālaya duḥkhite kuru dayām etat satāṃ ceṣṭitam || BharSt_1.78 ||	kIrtim pAlaya duHKite kuru dayAm etat satAm cezwitam || BharSt-_1.78 ||
   manasi vacasi kāye puṇya-pīyūṣa-pūrṇās	manasi vacasi kAye puNya-pIyUza--pUrNA-as
   tribhuvanam upakāra-śreṇibhiḥ prīṇayantaḥ |	triBuvanam upakAra--SreNiBiH prINayantaH |
   para-guṇa-paramāṇūn parvatīkṛtya nityaṃ	para--guNa--paramANUn parvatIkRtya nityam
   nija-hṛdi vikasantaḥ santa santaḥ kiyantaḥ || BharSt_1.79 ||	nija--hRdi vikasantaH santa santaH kiyantaH || BharSt-_1.79 ||
   kiṃ tena hema-giriṇā rajatādriṇā vā	kim tena hema-giriNA rajata-adriNA vA
   yatrāśritāś ca taravas taravas ta eva |	yatra-ASritAH ca taravaH taravaH te eva |
   manyāmahe malayam eva yad-āśrayeṇa	manyAmahe malayam eva yat--ASrayeNa
   kaṅkola-nimba-kaṭujā api candanāḥ syuḥ || BharSt_1.80 ||	kaFkola--nimba--kawujAH api candanAH syuH || BharSt-_1.80 ||
   ratnair mahārhais tutuṣur na devā	ratnEH mahArhEH tutuzuH na devAH-
   na bhejire bhīma-viṣeṇa bhītim |	na Bejire BIma-vizeNa BItim |
   sudhāṃ vinā na parayur virāmaṃ	suDAm vinA na parayuH virAmam
   na niścitārthād viramanti dhīrāḥ || BharSt_1.81 ||	na niScita-arTAt viramanti DIrAH || BharSt-_1.81 ||
   kvacit pṛthvīśayyaḥ kvacid api ca paraṅka-śayanaḥ	kvacid pRTvI-SayyaH kvacid api ca paraFka-SayanaH
   kvacic chākāhāraḥ kvacid api ca śālyodana-ruciḥ |	kvacid SAka-AhAraH kvacid api ca SAlyodana-ruciH |
   kvacit kanthādhārī kvacid api ca divyāmbaradharo	kvacid kanTA-DArI kvacid api ca divya-ambara-DaraH-
   manasvī kāryārthī na gaṇayati duḥkhaṃ na ca sukham || BharSt_1.82 ||	manasvI kArya-arTI na gaNayati duHKam na ca suKam || BharSt-_1.82 ||
   aiśvaryasya vibhūṣaṇaṃ sujanatā śauryasya vāk-saṃyamo	ESvaryasya viBUzaNam su-janatA SOryasya vAk-saMyamaH-
   jñānasyopaśamaḥ śrutasya vinayo vittasya pātre vyayaḥ |	jQAnasya-upaSamaH Srutasya vinayaH vittasya pAtre vyayaH |
   akrodhas tapasaḥ kṣamā prabhavitur dharmasya nirvājatā	akroDaH tapasaH kzamA praBavituH Darmasya nirvAja-tA
   sarveṣām api sarva-kāraṇam idaṃ śīlaṃ paraṃ bhūṣaṇam || BharSt_1.83 ||	sarvezAm api sarva-kAraNam idam SIlam param BUzaNam || BharSt-_1.83 ||
   nindantu nīti-nipuṇā yadi vā stuvantu	nindantu nIti--nipuNAH yadi vA stuvantu
   lakṣmīḥ samāviśatu gacchatu vā yatheṣṭham |	lakzmIH samAviSatu gacCatu vA yaTezWam |
   adyaiva vā maraṇam astu yugāntare vā	adya-eva vA maraNam astu yuga-antare vA
   nyāyyāt pathaḥ pravicalanti padaṃ na dhīrāḥ || BharSt_1.84 ||	nyAyyAt paTaH pravicalanti padam na DIrAH || BharSt-_1.84 ||
   bhagnāśasya karaṇḍa-piṇḍita-tanor mlānendriyasya kṣudhā	Bagna-ASasya karaNxa--piNxita---tanoH mlAna-indriyasya kzuDA
   kṛtvākhur vivaraṃ svayaṃ nipatito naktaṃ mukhe bhoginaḥ |	kRtvA-AKuH vivaram svayam nipatitaH naktam muKe BoginaH |
   tṛptas tat-piśitena satvaram asau tenaiva yātaḥ yathā	tRptaH tat--piSitena sa-tvaram asO tena-eva yAtaH yaTA
   lokāḥ paśyata daivam eva hi nṛṇāṃ vṛddhau kṣaye kāraṇam || BharSt_1.85 ||	lokAH paSyata dEvam eva hi nRNAm vRdDO kzaye kAraNam || BharSt-_1.85 ||
   ālasyaṃ hi manuṣyāṇāṃ	Alasyam hi manuzyANAm
   śarīrastho mahān ripuḥ |	SarIra-sTaH mahAn ripuH |
   nāsty udyama-samo bandhuḥ	na-asti udyama--samaH banDuH
   kurvāṇo nāvasīdati || BharSt_1.86 ||	kurvANaH na-avasIdati || BharSt-_1.86 ||
   chinno 'pi rohati tar kṣīṇo 'py upacīyate punaś candraḥ |	CinnaH api rohati tar kzINaH api upacIyate punar candraH |
   iti vimṛśantaḥ santaḥ santapyante na duḥkheṣu || BharSt_1.87 ||	iti vimRSantaH santaH santapyante na duHKezu || BharSt-_1.87 ||
   netā yasya bṛhaspatiḥ praharaṇaṃ vajraṃ surāḥ sainikāḥ	netA yasya bRhaspatiH praharaNam vajram surAH sEnikAH
   svargo durgam anugrahaḥ kila harer airāvato vāraṇaḥ |	svargaH durgam anugrahaH kila hareH ErAvataH vAraNaH |
   ity aiśvarya-balānvito 'pi balabhid bhagnaḥ paraiḥ saṅgare	iti ESvarya--bala-anvitaH api balaBid BagnaH parEH saFgare
   tad vyaktaṃ nanu daivam eva śaraṇaṃ dhig dhig vṛthā pauruṣam ||	tat vyaktam nanu dEvam eva SaraNam Dik Dik vRTA pOruzam ||
   BharSt_1.88 ||	BharSt_1.88 ||
   karmāyattaṃ phalaṃ puṃsāṃ	karma-Ayattam Palam puMsAm
   buddhiḥ karmānusāriṇī |	budDiH karma-anusAriNI |
   tathāpi sudhiyā bhāvyaṃ	taTA-api suDiyA BAvyam
   suvicāryaiva kurvatā || BharSt_1.89 ||	su-vicArya-eva kurvatA || BharSt-_1.89 ||
   khalv āto divaseśvarasya kiraṇaiḥ santāḍito mastake	Kalu AtaH divaseSvarasya kiraNEH santAxitaH mastake
   vāñchan deśam anātapaṃ vidhi-vaśāt tālasya mūlaṃ gataḥ |	vAQCan deSam anAtapam viDi-vaSAt tAlasya mUlam gataH |
   tatrāpy asya mahāphalena patatā bhagnaṃ saśabdaṃ śiraḥ	tatra-api asya mahA-Palena patatA Bagnam sa-Sabdam SiraH
   prāyo gacchati yatra bhāgya-rahitas tatraiva yānty āpadaḥ || BharSt_1.90	prAyas gacCati yatra BAgya--rahitaH tatra-eva yAnti ApadaH || BharSt-_1.90
   ravi-niśākarayor graha-pīḍanaṃ	ravi--niSAkarayoH graha-pIxanam
   gaja-bhujaṅgamayor api bandhanam |	gaja--BujaFgamayoH api banDanam |
   matimatāṃ ca vilokya daridratāṃ	matimatAm ca vilokya daridra-tAm
   vidhir aho balavān iti me matiḥ || BharSt_1.91 ||	viDiH aho balavAn iti me matiH || BharSt-_1.91 ||
   sṛjati tāvad aśeṣa-guṇakaraṃ	sRjati tAvat aSeza-guNa-karam
   puruṣa-ratnam alaṅkaraṇaṃ bhuvaḥ |	puruza--ratnam alaFkaraNam BuvaH |
   tad api tat-kṣaṇa-bhaṅgi karoti	tat api tat-kzaNa-BaFgi karoti
   ced ahaha kaṣṭam apaṇḍitatā vidheḥ || BharSt_1.92 ||	ced ahaha kazwam apaNxita-tA viDeH || BharSt-_1.92 ||
   patraṃ naiva yadā karīra-viṭape doṣo vasantasya kim	patram na-eva yadA karIra--viwape dozaH vasantasya kim
   nolūko 'py avaokate yadi divā sūryasya kiṃ dūṣaṇam |	na-ulUkaH api avaokate yadi divA sUryasya kim dUzaNam |
   dhārā naiva patanti cātaka-mukhe meghasya kiṃ dūṣaṇam	DArAH na-eva patanti cAtaka-muKe meGasya kim dUzaNam
   yat pūrvaṃ vidhinā lalāṭa-likhitaṃ tan mārjituṃ kaḥ kṣamaḥ || BharSt_1.93	yat pUrvam viDinA lalAwa--liKitam tat mArjitum kaH kzamaH || BharSt-_1.93
   namasyāmo devān nanu hatavidhes te 'pi vaśagā	namasyAmaH devAn nanu hata-viDeH te api vaSagA
   vidhir vandyaḥ so 'pi pratiniyata-karmaika-phaladaḥ |	viDiH vandyaH saH api pratiniyata-karma-eka--Pala-daH |
   phalaṃ karmāyattaṃ yadi kim amaraiḥ kiṃ ca vidhinā	Palam karma-Ayattam yadi kim amarEH kim ca viDinA
   namas tat-karmabhyo vidhir api na yebhyaḥ prabhavati || BharSt_1.94 ||	namaH tat-karmaByaH viDiH api na yeByaH praBavati || BharSt-_1.94 ||
   brahmā yena kulālavan niyamito brahmāḍa-bhāṇḍodare	brahmA yena kulAla-vat niyamitaH brahmAxa-BANxa-udare
   viṣṇur yena daśāvatāra-gahane kṣipto mahā-saṅkaṭe |	vizNuH yena daSa-avatAra--gahane kziptaH mahA--saFkawe |
   rudro yena kapāla-pāṇi-puṭake bhikṣāṭanaṃ kāritaḥ	rudraH yena kapAla--pANi--puwake BikzAwanam kAritaH
   sūryo bhrāmyati nityam eva gagane tasmai namaḥ karmaṇe || BharSt_1.95 ||	sUryaH BrAmyati nityam eva gagane tasmE namaH karmaNe || BharSt-_1.95 ||
   naivākṛtiḥ phalati naivaa kulaṃ na śīlaṃ	na-eva-AkRtiH Palati na-evaa kulam na SIlam
   vidyāpi naiva na ca yatna-kṛtāpi sevā |	vidyA-api na-eva na ca yatna-kRtA-api sevA |
   bhāgyāni pūrva-tapasā khalu sañcitāni	BAgyAni pUrva--tapasA Kalu saQcitAni
   kāle phalanti puruṣasya yathaiva vṛkṣāḥ || BharSt_1.96 ||	kAle Palanti puruzasya yaTA-eva vRkzAH || BharSt-_1.96 ||
   vane raṇe śatru-jalāgni-madhye	vane raNe Satru--jala-agni--maDye
   mahārṇave parvata-mastake vā |	mahA-arNave parvata--mastake vA |
   suptaṃ pramattaṃ viṣama-sthitaṃ vā	suptam pramattam vizama--sTitam vA
   rakṣanti puṇyāni purākṛtāni || BharSt_1.97 ||	rakzanti puNyAni purAkRtAni || BharSt-_1.97 ||
   yā sādhūṃś ca khalān karoti viduṣo mūrkhān hitān dveṣiṇaḥ	yA sADUn ca KalAn karoti viduzaH mUrKAn hitAn dveziNaH
   pratyakṣaṃ kurute parīkṣam amṛtaṃ hālāhalaṃ tat-kṣaṇāt |	pratyakzam kurute parIkzam amRtam hAlAhalam tat-kzaNAt |
   tām ārādhaya sat-kriyāṃ bhagavatīṃ bhoktuṃ phalaṃ vāñchitaṃ	tAm ArADaya sat-kriyAm BagavatIm Boktum Palam vAQCitam
   he sādho vyasanair guṇeṣu vipuleṣv āsthāṃ vṛthā mā kṛthāḥ || BharSt_1.98	he sADo vyasanEH guNezu vipulezu AsTAm vRTA mA kRTAH || BharSt-_1.98
   guṇavad aguṇavad vā kurvatā kārya-jātaṃ	guNavat aguNavat vA kurvatA kArya--jAtam
   pariṇatir avadhāryā yatnataḥ paṇḍitena |	pariNatiH avaDAryAH yatnatas paNxitena |
   atirabhasa-kṛtānāṃ karmaṇām āvipatter	ati-raBasa-kRtAnAm karmaNAm AvipatteH-
   bhavati hṛdaya-dāhī śalya-tulyo vipākaḥ || BharSt_1.99 ||	Bavati hRdaya-dAhI Salya--tulyaH vipAkaH || BharSt-_1.99 ||
   sthālyāṃ vaidūryamayyāṃ pacati tilakaṇāṃś candanair indhanaughaiḥ	sTAlyAm vEdUrya-mayyAm pacati tila-kaNAn candanEH inDana-oGEH
   sauvarṇair lāṅgalāgrair vilikhati vasudhām arka-mūlasya hetoḥ |	sOvarNEH lAFgala-agrEH viliKati vasuDAm arka--mUlasya hetoH |
   kṛtvā karpūra-khaṇḍān vṛttim iha kurute kodravāṇāṃ samantāt	kRtvA karpUra-KaNxAn vRttim iha kurute kodravANAm samantAt-
   prāpyemāṃ karm-bhūmiṃ na carati manujo yas topa manda-bhāgyaḥ ||	prApya-imAm karm--BUmim na carati manujaH yaH topa manda--BAgyaH ||
   BharSt_1.100 ||	BharSt_1.100 ||
   majjatv ambhasi yātu meru-śikharaṃ śatruṃ jayatv āhave	majjatu amBasi yAtu meru--SiKaram Satrum jayatu Ahave
   vāṇijyaṃ kṛṣi-sevane ca sakalā vidyāḥ kalāḥ śikṣatām |	vANijyam kRzi-sevane ca sakalAH vidyAH kalAH SikzatAm |
   ākāśaṃ vipulaṃ prayātu khagavat kṛtvā prayatnaṃ paraṃ	AkASam vipulam prayAtu Kaga-vat kRtvA prayatnam param
   nābhāvyaṃ bhavatīha karma-vaśato bhāvyasya nāśaḥ kutaḥ || BharSt_1.101 ||	na-aBAvyam Bavati-iha karma--vaSataH BAvyasya nASaH kutas || BharSt-_1.101 ||
   bhīmaṃ vanaṃ bhavati tasya puraṃ pradhānaṃ	BImam vanam Bavati tasya puram praDAnam
   sarvo janaḥ svajanatām upayāti tasya |	sarvaH janaH sva-jana-tAm upayAti tasya |
   kṛtsnā ca bhūr bhavati sannidhi-ratna-pūrṇā	kRtsnA ca BUH Bavati sanniDi--ratna--pUrNA
   yasyāsti pūrva-sukṛtaṃ vipulaṃ narasya || BharSt_1.102 ||	yasya-asti pUrva--sukRtam vipulam narasya || BharSt-_1.102 ||
   ko lābho guṇisaṅgamaḥ kim asukhaṃ prājñetaraiḥ saṅgatiḥ	kaH lABaH guNi-saFgamaH kim asuKam prAjQa-itarEH saFgatiH
   kā hāniḥ samaya-cyutir nipuṇatā kā dharma-tattve ratiḥ |	kA hAniH samaya-cyutiH nipuNa-tA kA Darma--tattve ratiH |
   kaḥ śūro vijitendriyaḥ priyatamā kā 'nuvratā kiṃ dhanaṃ	kaH SUraH vijita-indriyaH priyatamA kA anuvratA kim Danam
   vidyā kiṃ sukham apravāsa-gamanaṃ rājyaṃ kim ājñā-phalam || BharSt_1.103	vidyA kim suKam apravAsa--gamanam rAjyam kim AjQA--Palam || BharSt-_1.103
   apriya-vacana-daridraiḥ priya-vacana-dhanāḍhyaiḥ sva-dāra-parituṣṭaiḥ |	apriya-vacana--daridrEH priya-vacana--Dana-AXyEH sva-dAra--parituzwEH |
   para-parivāda-nivṛttaiḥ kvacit kvacin maṇḍitā vasudhā || BharSt_1.104 ||	para--parivAda--nivRttEH kvacid kvacid maNxitAH vasuDA || BharSt-_1.104 ||
   kadarthitasyāpi hi dhairya-vṛtter	kadarTitasya-api hi DErya-vRtteH-
   na śakyate dhairya-guṇaḥ pramārṣṭum |	na Sakyate DErya--guNaH pramArzwum |
   adhomukhasyāpi kṛtasya vahner	aDomuKasya-api kRtasya vahneH-
   nādhaḥ śikhā yāti kadācid eva || BharSt_1.105 ||	na-aDas SiKA yAti kadAcid eva || BharSt-_1.105 ||
   kāntākaṭākṣa-viśikhā na lunanti yasya	kAntA-kawAkza--viSiKAH na lunanti yasya
   cittaṃ na nirdahati kipa-kṛśānutāpaḥ |	cittam na nirdahati kipa-kRSa-anutApaH |
   karṣanti bhūri-viṣayāś ca na lobha-pāśair	karzanti BUri-vizayAH ca na loBa--pASEH-
   loka-trayaṃ jayati kṛtsnam idaṃ sa dhīraḥ || BharSt_1.106 ||	loka-trayam jayati kRtsnam idam sa DIraH || BharSt-_1.106 ||
   ekenāpi hi śūreṇa	ekena-api hi SUreNa
   pādākrāntaṃ mahītalam |	pAda-AkrAntam mahI-talam |
   kriyate bhāskareṇaiva	kriyate BAskareNa-eva
   sphāra-sphurita-tejasā || BharSt_1.107 ||	sPAra--sPurita--tejasA || BharSt-_1.107 ||
   vahnis tasya jalāyate jala-nidhiḥ kulyāyate tat-kṣaṇān	vahniH tasya jalAyate jala-niDiH kulyAyate tat-kzaNAn
   meruḥ svalpa-śilāyate mṛgapatiḥ sadyaḥ kuraṅgāyate |	meruH svalpa-SilAyate mRgapatiH sadyas kuraFgAyate |
   vyālo mālya-guṇāyate viṣa-rasaḥ pīyūṣa-varṣāyate	vyAlaH mAlya-guNAyate viza--rasaH pIyUza-varzAyate
   yasyāṅge 'khila-loka-vallabhatamaṃ śīlaṃ samunmīlati || BharSt_1.108 ||	yasya-aFge aKila-loka--vallaBatamam SIlam samunmIlati || BharSt-_1.108 ||
   lajjā-guṇaugha-jananīṃ jananīm iva svām	lajjA-a--guNa-oGa--jananIm jananIm iva svAm
   atyanta-śuddha-hṛdayām anuvartamānām |	atyanta--SudDa--hRdayAm anuvartamAnAm |
   tejasvinaḥ sukham asūn api santyajanati	tejasvinaH suKam asUn api santi-ajanati
   satya-vrata-vyasanino na punaḥ pratijñām || BharSt_1.109 ||	satya--vrata--vyasaninaH na punar pratijQAm || BharSt-_1.109 ||
   śṛṅgāra-śatakam	SRFgAra-Satakam
   bhartṛhareḥ	BartR-hareH
   śambhu-svayambhu-harayo hariṇekṣaṇānāṃ	SamBu--svayamBu--harayaH hariNa-IkzaNAnAm
   yenākriyanta satataṃ gṛha-kumbha-dāsāḥ |	yena-akriyanta satatam gRha--kumBa-dAsAH |
   vācām agocara-caritra-vicitritāya	vAcAm agocara--caritra--vicitritAya
   tasmai namo bhagavate makara-dhvajāya || BharSt_2.1 ||	tasmE namaH Bagavate makara--DvajAya || BharSt-_2.1 ||
   smitena bhāvena ca lajjayā bhiyā	smitena BAvena ca lajjayA BiyA
   parāṇmukhair ardha-kaṭākṣa-vīkṣaṇaiḥ |	parANmuKEH arDa--kawAkza--vIkzaNEH |
   vacobhir īrṣyā-kalahena līlayā	vacoBiH IrzyA--kalahena lIlayA
   samasta-bhāvaiḥ khalu bandhanaṃ striyaḥ || BharSt_2.2 ||	samasta-BAvEH Kalu banDanam striyaH || BharSt-_2.2 ||
   bhrū-cāturyāt kuṣcitākṣāḥ kaṭākṣāḥ	BrU--cAturyAt kuzcita-akzAH kawAkzAH
   snigdhā vāco lajjitāntāś ca hāsāḥ |	snigDAH vAcaH lajjita-antAH ca hAsAH |
   līlā-mandaṃ prasthitaṃ ca sthitaṃ ca	lIlA-mandam prasTitam ca sTitam ca
   strīṇām etad bhūṣaṇaṃ cāyudhaṃ ca || BharSt_2.3 ||	strINAm etat BUzaNam ca-AyuDam ca || BharSt-_2.3 ||
   kvacit sa-bhrū-bhaṅgaiḥ kvacid api ca lajjā-parigataiḥ	kvacid sa-BrU--BaFgEH kvacid api ca lajjA--parigatEH
   kvacid bhūri-trastaiḥ kvacid api ca līlā-vilalitaiḥ |	kvacid BUri-trastEH kvacid api ca lIlA--vilalitEH |
   kumārīṇām etair madana-subhagair netra-valitaiḥ	kumArINAm etEH madana--suBagEH netra-valitEH
   sphuran-nīlābjānāṃ prakara-parikīrṇā iva diśaḥ || BharSt_2.4 ||	sPuran--nIla-abjAnAm prakara--parikIrNAH iva diSaH || BharSt-_2.4 ||
   vaktraṃ candra-vikāsi paṅkaja-parīhāsa-kṣame locane	vaktram candra-vikAsi paFkaja--parIhAsa-kzame locane
   varṇaḥ svarṇam apākariṣṇur alinī-jiṣṇuḥ kacānāṃ cayaḥ |	varNaH svarNam apAkarizNuH alinI--jizNuH kacAnAm cayaH |
   bakṣojāv ibha-kumbha-vibhrama-harau gurvī nitamba-sthalī	bakzojO iBa--kumBa-viBrama--harO gurvI nitamba-sTalI
   vācāṃ hāri ca mārdavaṃ yuvatīṣu svābhāvikaṃ maṇḍanam || BharSt_2.5 ||	vAcAm hAri ca mArdavam yuvatIzu svABAvikam maNxanam || BharSt-_2.5 ||
   smita-kiñcin-mugdhaṃ sarala-taralo dṛṣṭi-vibhavaḥ	smita-kiQcin--mugDam sarala-taralaH dRzwi-viBavaH
   parispando vācām abhinava-vilāsokti-sarasaḥ |	parispandaH vAcAm aBinava--vilAsa-ukti--sarasaH |
   gatānām ārambhaḥ kisalayita-līlā-parikaraḥ	gatAnAm AramBaH kisalayita--lIlA--parikaraH
   spṛśantyās tāruṇyaṃ kim iva na hi ramyaṃ mṛgadṛśaḥ || BharSt_2.6 ||	spRSantyAH tAruNyam kim iva na hi ramyam mRga-dRSaH || BharSt-_2.6 ||
   draṣṭavyeṣu kim uttamaṃ mṛgadṛśaḥ prema-prasannaṃ mukhaṃ	drazwavyezu kim uttamam mRga-dRSaH prema--prasannam muKam
   ghrātaveṣv api kiṃ tad-āsya-pavanaḥ śravyeṣu kiṃ tad-vacaḥ |	GrAtavezu api kim tat--Asya--pavanaH Sravyezu kim tat--vacaH |
   kiṃ svādyeṣu tad-oṣṭha-pallava-rasaḥ spṛśyeṣu kiṃ tad-vapurdhyeyaṃ	kim svAdyezu tad--ozWa--pallava--rasaH spRSyezu kim tad--vapuH-Dyeyam
   kiṃ nava-yauvane sahṛdayaiḥ sarvatra tad-vibhramāḥ || BharSt_2.7 ||	kim nava--yOvane sahRdayEH sarvatra tad--viBramAH || BharSt-_2.7 ||
   etāś calad-valaya-saṃhati-mekhalotthajhaṅkāra-	etAH calat--valaya--saMhati--meKalA-utTa-JaFkAra-
   nūpura-parājita-rāja-haṃsyaḥ |	nUpura-parAjita-rAja--haMsyaH |
   kurvanti kasya na mano vivaśaṃ taruṇyo	kurvanti kasya na manaH vivaSam taruNyaH-
   vitrasta-mugdha-hariṇī-sadṛśaiḥ kaṭākṣaiḥ || BharSt_2.8 ||	vitrasta--mugDa--hariNI--sadRSEH kawAkzEH || BharSt-_2.8 ||
   kuṅkuma-paṅka-kalaṅkita-dehā	kuFkuma--paFka-kalaFkita-dehA
   gaura-payodhara-kampita-hārā |	gOra-payoDara--kampita-hArAH |
   nūpura-haṃsa-raṇat-padmā	nUpura--haMsa--raNat-padmA
   kaṃ na vaśīkurute bhuvi rāmā || BharSt_2.9 ||	kam na vaSIkurute Buvi rAmAH || BharSt-_2.9 ||
   nūnaṃ hi te kavi-varā viparīta-vāco	nUnam hi te kavi--varAH viparIta-vAcaH-
   ye nityam āhur abalā iti kāminīs tāḥ |	ye nityam AhuH abalAH iti kAminIH tAH |
   yābhir vilolitara-tāraka-dṛṣṭi-pātaiḥ	yABiH vilolita-ra-tAraka-dRzwi-pAtEH
   śakrādayo 'pi vijitās tv abalāḥ kathaṃ tāḥ || BharSt_2.10 ||	Sakra-AdayaH api vijitAH tu abalAH kaTam tAH || BharSt-_2.10 ||
   nūnam ājñā-karas tasyāḥ subhruvo makara-dhvajaḥ |	nUnam AjQA-karaH tasyAH suBruvaH makara--DvajaH |
   yatas tan-netra-sañcāra-sūciteṣu pravartate || BharSt_2.11 ||	yatas tan--netra--saQcAra--su-ucitezu pravartate || BharSt-_2.11 ||
   keśāḥ saṃyaminaḥ śruter api paraṃ pāraṃ gate locane	keSAH saMyaminaH SruteH api param pAram gate locane
   antar-vaktram api svabhāva-śuci-bhīḥ kīrṇaṃ dvijānāṃ gaṇaiḥ |	antar-vaktram api svaBAva--Suci-BIH kIrNam dvijAnAm gaNEH |
   muktānāṃ satatādhivāsa-rucirau vakṣoja-kumbhāv imāvitthaṃ	muktAnAm satata-aDivAsa--rucirO vakzaH-ja--kumBO imO=-itTam
   tanvi vapuḥ praśāntam api terāgaṃ karoty eva naḥ || BharSt_2.12 ||	tanvi vapuH praSAntam api terAgam karoti eva naH || BharSt-_2.12 ||
   mugdhe dhānuṣkatā keyam apūrvā tvayi dṛśyate |	mugDe DAnuzka-tA kA-iyam apUrvA tvayi dRSyate |
   yayā vidhyasi cetāṃsi guṇair eva na sāyakaiḥ || BharSt_2.13 ||	yayA viDyasi cetAMsi guNEH eva na sAyakEH || BharSt-_2.13 ||
   sati pradīpe saty agnau satsu tārāravīnduṣu |	sati pradIpe sati agnO satsu tArA-ravi-induzu |
   vinā me mṛga-śāvākṣyā tamo-bhūtam idaṃ jagat || BharSt_2.14 ||	vinA me mRga-SAvAkzyA tamaH--BUtam idam jagat || BharSt-_2.14 ||
   udvṛttaḥ stana-bhāra eṣa tarale netre cale bhrū-late	udvRttaH stana-BAraH eza tarale netre cale BrU-late
   rāgādhiṣṭhitam oṣṭha-pallavam idaṃ kurvantu nāma vyathām |	rAga-aDizWitam ozWa--pallavam idam kurvantu nAma vyaTAm |
   saubhāgyākṣara-mālikeva likhitā puṣpāyudhena svayaṃ	sOBAgya-akzara--mAlikA-iva liKitA puzpa-AyuDena svayam
   madhyasthāpi karoti tāpam adhikaṃ romāvaliḥ kena sā || BharSt_2.15 ||	maDyasTA-api karoti tApam aDikam roma-AvaliH kena sA || BharSt-_2.15 ||
   mukhena candra-kāntena mahānīlaiḥ śiroruhaiḥ |	muKena candra-kAntena mahAnIlEH SiroruhEH |
   karābhyāṃ padmarāgābhyāṃ reje ratnamayīva sā || BharSt_2.16 ||	karAByAm padmarAgAByAm reje ratna-mayI-iva sA || BharSt-_2.16 ||
   guruṇā stana-bhāreṇa mukha-candreṇa bhāsvatā |	guruNA stana--BAreNa muKa-candreNa BAsvatA |
   śanaiś-carābhyāṃ pādābhyāṃ reje grahamayīva sā || BharSt_2.17 ||	Sana-ES-carAByAm pAdAByAm reje graha-mayI-iva sA || BharSt-_2.17 ||
   tasyāḥ stanau yadi ghanau jaghanaṃ ca hāri	tasyAH stanO yadi GanO jaGanam ca hAri
   vaktraṃ ca cāru tava citta kim ākulatvam |	vaktram ca cAru tava citta kim Akula-tvam |
   puṇyaṃ kuruṣva yadi teṣu tavāsti vāñchā	puNyam kuruzva yadi tezu tava-asti vAQCA
   puṇyair vinā na hi bhavanti samīhitārthāḥ || BharSt_2.18 ||	puNyEH vinA na hi Bavanti samIhita-arTAH || BharSt-_2.18 ||
   ime tāruṇya-śrī-nava-parimalāḥ prauḍha-suratapratāpa-	ime tAruNya--SrI-nava--parimalAH prOXa--surata-pratApa-
   prārambhāḥ smara-vijaya-dāna-pratibhuvaḥ |	prAramBAH smara--vijaya--dAna--pratiBuvaH |
   ciraṃ cetaś corā abhinava-vikāraika-guravo	ciram cetaH corAH aBinava--vikAra-eka-guravaH-
   vilāsa-vyāpārāḥ kim api vijayante mṛga-dṛśām || BharSt_2.19 ||	vilAsa--vyApArAH kim api vijayante mRga-dRSAm || BharSt-_2.19 ||
   praṇaya-madhurāḥ premodgārā rasāśrayatāṃ gatāḥ	praNaya--maDurAH prema-udgArAH rasa-ASraya-tAm gatAH
   phaṇiti-madhurā mugdha-prāyāḥ prakāśita-sammadāḥ |	PaNiti--maDurAH mugDa--prAyAH prakASita--sammadAH |
   prakṛti-subhagā visrambhārdrāḥ smarodaya-dāyinī	prakRti-suBagA visramBa-ArdrAH smara-udaya--dAyinI
   rahasi kim api svairālāpā haranti mṛgīdṛśām || BharSt_2.20 ||	rahasi kim api svEH-a-AlApAH haranti mRgI-dRSAm || BharSt-_2.20 ||
   viśramya viśramya vana-drumāṇāṃ	viSramya viSramya vana-drumANAm
   chāyāsu tanvī vicacāra kācit |	CAyAsu tanvI vicacAra kAcid |
   stanottarīyeṇa karoddhṛtena	stana-uttarIyeNa kara-udDRtena
   nivārayantī śaśino mayūkhān || BharSt_2.21 ||	nivArayantI SaSinaH mayUKAn || BharSt-_2.21 ||
   adarśane darśana-mātra-kāmā	adarSane darSana--mAtra--kAmA
   dṛṣṭvā pariṣvaṅga-sukhaika-lolā |	dRzwvA parizvaFga--suKa-eka--lolA |
   āliṅgitāyāṃ punar āyatākṣyāmāśāsmahe	AliFgitAyAm punar Ayata-akzyAma-ASAsmahe
   vigrahayor abhedam || BharSt_2.22 ||	vigrahayoH aBedam || BharSt-_2.22 ||
   mālatī śirasi jṛmbhaṇaṃ mukhe	mAlatI Sirasi jRmBaNam muKe
   candanaṃ vapuṣi kuṅkumāvilam |	candanam vapuzi kuFkuma-Avilam |
   vakṣasi priyatamā madālasā	vakzasi priyatamA mada-alasA
   svarga eṣa pariśiṣṭa āgamaḥ || BharSt_2.23 ||	svargaH eza pariSizwaH AgamaH || BharSt-_2.23 ||
   prāṅ mām eti manāg anāgata-rasaṃ jātābhilāṣāṃ tataḥ	prAk mAm eti manAk anAgata-rasam jAta-aBilAzAm tatas-
   savrīḍaṃ tad anu ślathodyamam atha pradhvasta-dhairyaṃ punaḥ |	sa-vrIxam tat anu SlaTa-udyamam aTa praDvasta-DEryam punar |
   premārdraṃ spṛhaṇīya-nirbhara-rahaḥ krīḍā-pragalbhaṃ tato	prema-Ardram spRhaNIya--nirBara--rahaH krIxA--pragalBam tatas-
   niḥsaṅgāṅga-vikarṣaṇādhika-sukha-ramyaṃ kula-strī-ratam || BharSt_2.24 ||	niHsaFga-aFga--vikarzaNa-aDika--suKa--ramyam kula-strI--ratam || BharSt-_2.24 ||
   urasi nipatitānāṃ srasta-dhammillakānāṃ	urasi nipatitAnAm srasta-DammillakAnAm
   mukulita-nayanānāṃ kiñcid-unmīlitānām |	mukulita-nayanAnAm kiQcid--unmIlitAnAm |
   upari surata-kheda-svinna-gaṇḍa-sthalānāmadhara-	upari surata-Keda--svinna--gaNxa-sTalAnAm-aDara-
   madhu vadhūnāṃ bhāgyavantaḥ pibanti || BharSt_2.25 ||	maDu vaDUnAm BAgyavantaH pibanti || BharSt-_2.25 ||
   āmīlita-nayanānāṃ yaḥ	AmIlita--nayanAnAm yaH
   surataraso 'nu saṃvidaṃ bhāti |	surata-rasaH anu saMvidam BAti |
   mithurair mitho 'vadhāritamavitatham	miTurEH miTas avaDAritam-avitaTam
   idam eva kāma-nirbarhaṇam || BharSt_2.26 ||	idam eva kAma--nirbarhaNam || BharSt-_2.26 ||
   idam anucitam akramaś ca puṃsāṃ	idam anucitam akramaH ca puMsAm
   yad iha jarāsv api manmathā vikārāḥ |	yat iha jarAsu api manmaTAH vikArAH |
   tad api ca na kṛtaṃ nitambinīnāṃ	tat api ca na kRtam nitambinInAm
   stana-patanāvadhi jīvitaṃ rataṃ vā || BharSt_2.27 ||	stana-patana-avaDi jIvitam ratam vA || BharSt-_2.27 ||
   rājas-tṛṣṇāmburāśer na hi jagati gataḥ kaścid evāvasānaṃ	rAjas-tRzNA-amburASeH na hi jagati gataH kaScid eva-avasAnam
   ko vārtho 'rthaiḥ prabhūtaiḥ sva-vapuṣi galite yauvane sānurāge |	kaH vA-arTaH arTEH praBUtEH sva--vapuzi galite yOvane sa-anurAge |
   gacchāmaḥ sadma yāvad vikasita-nayanendīvarālokinīnāmākramyākramya	gacCAmaH sadma yAvat vikasita--nayana-indIvara-AlokinInAm-Akramya-Akramya
   rūpaṃ jhaṭiti na jarayā lupyate preyasīnām || BharSt_2.28 ||	rUpam Jawiti na jarayA lupyate preyasInAm || BharSt-_2.28 ||
   rāgasyāgāram ekaṃ naraka-śata-mahā-duḥkha-samprāpti-heturmohasyotpatti-	rAgasya-AgAram ekam naraka-Sata--mahA--duHKa--samprApti-hetuH-mohasya-utpatti-
   bījaṃ jaladhara-paṭalaṃ jñāna-tārādhipasya |	bIjam jalaDara--pawalam jQAna-tArADipasya |
   kandarpasyaika-mitraṃ prakaṭita-vividha-spaṣṭa-doṣa-prabandhaṃ	kandarpasya-eka-mitram prakawita--viviDa--spazwa--doza--prabanDam
   loke 'smin na hy artha-vraja-kula-bhavana-yauvanād anyad asti ||	loke asmin na hi arTa-vraja--kula--Bavana--yOvanAt anyat asti ||
   BharSt_2.29 ||	BharSt_2.29 ||
   śṛṅgāra-druma-nīrade prasṛmara-krīḍā-rasa-srotasi	SRFgAra-druma--nIrade prasRmara--krIxA-rasa--srotasi
   pradyumna-priya-bāndhave catura-vāṅ-muktā-phalodanvati |	pradyumna--priya--bAnDave catura-vAF-muktA--Pala-udanvati |
   tanvī-netra-cakora-pāvana-vidhau saubhāgya-lakṣmī-nidhau	tanvI--netra--cakora--pAvana-viDO sOBAgya--lakzmI--niDO
   dhanyaḥ ko 'pi na vikriyāṃ kalayati prāpte nave yauvane || BharSt_2.30 ||	DanyaH kaH api na vikriyAm kalayati prApte nave yOvane || BharSt-_2.30 ||
   saṃsāre 'sminn asāre kunṛpati-bhavana-dvāra-sevā-kalaṅkavyāsaṅga-	saMsAre asmin asAre ku-nRpati--Bavana-dvAra--sevA--kalaFka-vyAsaFga-
   vyasta-dhairyaṃ katham amala-dhiyo mānasaṃ saṃvidadhyuḥ |	vyasta--DEryam kaTam amala-DiyaH mAnasam saMvidaDyuH |
   yady etāḥ prodyad-indu-dyuti-nicaya-bhṛto na syur ambhoja-netrāḥ	yadi etAH prodyat--indu-dyuti--nicaya-BRtaH na syuH amBoja--netrAH
   preṅkhat-kāñcī-kalāpāḥ stana-bhara-vinaman-madhya-bhājas taruṇyaḥ ||	preFKat--kAQcI--kalApAH stana--Bara--vinaman--maDya-BAjaH taruNyaH ||
   BharSt_2.31 ||	BharSt_2.31 ||
   siddhādhyāsita-kandare hara-vṛṣa-skandhāvarugṇa-drume	sidDa-aDyAsita--kandare hara--vRza--skanDa-avarugNa-drume
   gaṅgā-dhauta-śilā-tale himavataḥ sthāne sthite śreyasi |	gaFgA-DOta--SilA--tale himavataH sTAne sTite Sreyasi |
   kaḥ kurvīta śiraḥ praṇāma-malinaṃ mlānaṃ manasvī jano	kaH kurvIta SiraH praNAma--malinam mlAnam manasvI jano
   yad-vitrasta-kuraṅga-śāva-nayanā na syuḥ smarāstraṃ striyaḥ || BharSt_2.32	yat--vitrasta-kuraFga-SAva--nayanAH na syuH smara-astram striyaH || BharSt-_2.32
   saṃsāra tava paryanta-padavī na davīyasī |	saMsAra tava paryanta--padavI na davIyasI |
   antarā dustarā na syur yadi te madirekṣaṇām || BharSt_2.33 ||	antarA dustarAH na syuH yadi te madirA-IkzaNAm || BharSt-_2.33 ||
   diśa vana-hariṇībhyo vaṃśa-kāṇḍa-cchavīnāṃ	diSa vana--hariNIByaH vaMSa-kANxa-=-CavInAm
   kavalam upala-koṭi-cchinna-mūlaṃ kuśānām |	kavalam upala-kowi-=-Cinna--mUlam kuSAnAm |
   śaka-yuvati-kapolāpāṇḍutāmbūla-vallīdalam	Saka-yuvati--kapola-ApANxu-tAmbUla-vallI-dalam
   aruṇa-nakhāgraiḥ pāṭitaṃ vā vadhūbhyaḥ || BharSt_2.34 ||	aruNa-naKa-agrEH pAwitam vA vaDUByaH || BharSt-_2.34 ||
   asārāḥ sarve te virati-virasāḥ pāpa-viṣayā	asArAH sarve te virati--virasAH pApa-vizayA
   jugupsyantāṃ yad vā nanu sakala-doṣāspadam iti |	jugupsyantAm yat vA nanu sakala-doza-Aspadam iti |
   tathāpy etad-bhūmau nahi para-hitāt puṇyam adhikaṃ	taTA-api etat--BUmO nahi para-hitAt puNyam aDikam
   na cāsmin saṃsāre kuvalaya-dṛśo ramyam aparam || BharSt_2.35 ||	na ca-asmin saMsAre kuvalaya--dRSaH ramyam aparam || BharSt-_2.35 ||
   etat-kāma-phalo loke yad dvayor eka-cittatā |	etat-kAma-PalaH loke yat dvayoH eka--citta-tA |
   anya-citta-kṛte kāme śavayor iva saṅgamaḥ || BharSt_2.35*1 ||	anya-citta-kRte kAme SavayoH iva saFgamaH || BharSt-_2.35*1 ||
   mātsaryam utsārya vicārya kāryamāryāḥ	mAtsaryam utsArya vicArya kAryam-AryAH
   samaryādam idaṃ vadantu |	sa-maryAdam idam vadantu |
   sevyā nitambāḥ kim u bhūdharāṇāmata	sevyAH nitambAH kim u BUDarANAm-ata
   smara-smera-vilāsinīnām || BharSt_2.36 ||	smara--smera--vilAsinInAm || BharSt-_2.36 ||
   saṃsāre svapna-sāre pariṇati-tarale dve gatī paṇḍitānāṃ	saMsAre svapna---sAre pariNati-tarale dve gatI paNxitAnAm
   tattva-jñānāmṛtāmbhaḥ-plava-lalita-dhiyāṃ yātu kālaḥ kathañcit |	tattva--jQAna-amRta-amBaH--plava--lalita--DiyAm yAtu kAlaH kaTaQcid |
   no cen mugdhāṅganānāṃ stana-jaghana-ghanābhoga-sambhoginīnāṃ	no ced mugDa-aFganAnAm stana--jaGana--Gana-ABoga--samBoginInAm
   sthūlopastha-sthalīṣu sthagita-karatala-sparśa-līlodyamānām || BharSt_2.37	sTUla-upasTa--sTalIzu sTagita-kara-tala--sparSa--lIlA-udyamAnAm || BharSt-_2.37
   āvāsaḥ kriyatāṃ gaṅge pāpa-hāriṇi vāriṇi |	AvAsaH kriyatAm gaFge pApa--hAriNi vAriNi |
   stana-dvaye taruṇyā vā manohāriṇi hāriṇi || BharSt_2.38 ||	stana--dvaye taruNyAH vA manohAriNi hAriNi || BharSt-_2.38 ||
   kim iha bahubhir uktair yukti-śūnyaiḥ pralāpairdvayam	kim iha bahuBiH uktEH yukti--SUnyEH pralApEH-dvayam
   iha puruṣāṇāṃ sarvadā sevanīyam |	iha puruzANAm sarvadA sevanIyam |
   abhinava-mada-līlā-lālasaṃ sundarīṇāṃ	aBinava--mada--lIlA--lAlasam sundarINAm
   stana-bhara-parikhinnaṃ yauvanaṃ vā vanaṃ vā || BharSt_2.39 ||	stana--Bara--pariKinnam yOvanam vA vanam vA || BharSt-_2.39 ||
   satyaṃ janā vacmi na pakṣa-pātāl	satyam janAH vacmi na pakza-pAtAl
   lokeṣu saptasv api tathyam etat |	lokezu saptasu api taTyam etat |
   nānyan manohāri nitambinībhyo	na-anyat manohAri nitambinIByaH-
   duḥkhaika-hetur na ca kaścid anyaḥ || BharSt_2.40 ||	duHKa-eka-hetuH na ca kaScid anyaH || BharSt-_2.40 ||
   kāntety utpala-locaneti vipula-śroṇī-bharety unnamatpīnottuṅga-	kAntA-iti utpala--locanA-iti vipula--SroNI--Bara-iti unnamat-pIna-uttuFga-
   payodhareti samukhāmbhojeti subhrūr iti |	payoDarA-iti samuKa-amBojA-iti suBrUH iti |
   dṛṣṭvā mādyati modate 'bhiramate prastauti vidvān api	dRzwvA mAdyati modate aBiramate prastOti vidvAn api
   pratyakṣāśuci-bhastrikāṃ striyam aho mohasya duśceṣṭitam || BharSt_2.41 ||	pratyakza-aSuci-BastrikAm striyam aho mohasya duScezwitam || BharSt-_2.41 ||
   smṛtā bhavati tāpāya dṛṣṭā conmāda-kāriṇī |	smRtA Bavati tApAya dRzwA ca-unmAda--kAriNI |
   spṛṣṭā bhavati mohāya sā nāma dayitā katham || BharSt_2.42 ||	spRzwA Bavati mohAya sA nAma dayitA kaTam || BharSt-_2.42 ||
   tāvad evāmṛtamayī yāval locana-gocarā |	tAvat eva-amRta-mayI yAvat locana--gocarAH |
   cakṣuṣ-pathād atītā tu viṣād apy atiricyate || BharSt_2.43 ||	cakzuz--paTAt atItA tu vizAt api atiricyate || BharSt-_2.43 ||
   nāmṛtaṃ na viṣaṃ kiñcid etāṃ muktvā nitambinīm |	na-amRtam na vizam kiQcid etAm muktvA nitambinIm |
   saivāmṛta-latā raktā viraktā viṣa-vallarī || BharSt_2.44 ||	sA-eva-amRta-latA raktA viraktA viza-vallarI || BharSt-_2.44 ||
   āvartaḥ saṃśayānām avinaya-bhuvanaṃ paṭṭaṇaṃ sāhasānāṃ	AvartaH saMSayAnAm avinaya--Buvanam pawwaNam sAhasAnAm
   doṣāṇāṃ sannidhānaṃ kapaṭa-śata-mayaṃ kṣetram apratyayānām |	dozANAm sanniDAnam kapawa-Sata-mayam kzetram apratyayAnAm |
   svarga-dvārasya vighno naraka-pura-mukha sarvamāyākaraṇḍaṃ	svarga-dvArasya viGnaH naraka-pura-muKa sarva-mAyA-karaNxam
   strī-yantraṃ kena sṛṣṭaṃ viṣam amṛtamayaṃ prāṇi-lokasya pāśaḥ ||	strI-yantram kena sRzwam vizam amRta-mayam prANi-lokasya pASaH ||
   BharSt_2.45 ||	BharSt_2.45 ||
   no satyena mṛgāṅka eṣa vadanī-bhūto na cendīvaradvandvaṃ	no satyena mRgAFkaH eza vadanI--BUtaH na ca-indIvara-dvandvam
   locanatāṃ gata na kanakair apy aṅga-yaṣṭiḥ kṛtā |	locana-tAm gata na kanakEH api aFga-yazwiH kRtA |
   kintv evaṃ kavibhiḥ pratārita-manās tattvaṃ vijānann api	kintu evam kaviBiH pratArita-manAH tattvam vijAnan api
   tvaṅ-māṃsāsthi-mayaṃ vapur mṛga-dṛśāṃ mando janaḥ sevate || BharSt_2.46 ||	tvaF-mAMsa-asTi--mayam vapuH mRga-dRSAm mandaH janaH sevate || BharSt-_2.46 ||
   līlāvatīnāṃ sahajā vilāsāsta	lIlAvatInAm sahajAH vilAsAH-te-
   eva mūḍhasya hṛdi sphuranti |	eva mUXasya hRdi sPuranti |
   rāgo nalinyā hi nisarga-siddhastatra	rAgaH nalinyAH hi nisarga--sidDaH-tatra
   bhramty eva vṛthā ṣaḍ-aṅghriḥ || BharSt_2.47 ||	Bramti eva vRTA zaz--aFGriH || BharSt-_2.47 ||
   saṃmohayanti madayanti viḍambayanti	saMmohayanti madayanti vixambayanti
   nirbhartsyanti ramayanti viṣādayanti |	nirBartsyanti ramayanti vizAdayanti |
   etāḥ praviśya sadayaṃ hṛdayaṃ narāṇāṃ	etAH praviSya sa-dayam hRdayam narANAm
   kiṃ nāma vāma-nayanā na samācaranti || BharSt_2.47*1 ||	kim nAma vAma--nayanAH na samAcaranti || BharSt-_2.47*1 ||
   yad etat pūrṇendu-dyuti-haram udārākṛti paraṃ	yat etat pUrNa-indu--dyuti--haram udAra-AkRti param
   mukhābjaṃ tanvaṅgyāḥ kila vasati yatrādhara-madhu |	muKa-abjam tanu-aFgyAH kila vasati yatra-aDara--maDu |
   idaṃ tat kiṃ pāka-druma-phalam idānīm atirasavyatīte 'smin	idam tat kim pAka-druma--Palam idAnIm ati-rasa-vyatIte asmin
   kāle viṣam iva bhaviṣyty asukhadam || BharSt_2.48 ||	kAle vizam iva Bavizyti asuKa-dam || BharSt-_2.48 ||
   unmīlat-trivalī-taraṅga-nilayā prottuṅga-pīna-stanadvandvenodgata-	unmIlat--trivalI--taraFga-nilayA prottuFga---pIna--stana-dvandvena-udgata-
   cakravāka-yugalā vaktrāmbujodbhāsinī |	cakravAka-yugalA vaktra-ambuja-udBAsinI |
   kāntākāra-dharā nadīyam abhitaḥ krūrātra nāpekṣate	kAnta-AkAra--DarA nadIyam aBitas krUra-atra na-apekzate
   saṃsārārṇava-majjanaṃ yadi tadā dūreṇa santyajyatām || BharSt_2.49 ||	saMsAra-arNava--majjanam yadi tadA dUreNa santyajyatAm || BharSt-_2.49 ||
   jalpanti sārdham anyena paśyanty anyaṃ savibhramāḥ |	jalpanti sArDam anyena paSyanti anyam sa-viBramAH |
   hṛd-gataṃ cintayanty anyaṃ priyaḥ ko nāma yoṣitām || BharSt_2.50 ||	hRd--gatam cintayanti anyam priyaH kaH nAma yozitAm || BharSt-_2.50 ||
   madhu tiṣṭhati vāci yoṣitāṃ hṛdi hālāhalam eva kevalam |	maDu tizWati vAci yozitAm hRdi hAlAhalam eva kevalam |
   ataeva nipīyate 'dharo hṛdayaṃ muṣṭibhir eva tāḍyate || BharSt_2.51 ||	ataeva nipIyate aDaraH hRdayam muzwiBiH eva tAxyate || BharSt-_2.51 ||
   apasara sakhe dūrād asmāt kaṭākṣa-viṣānalāt	apasara saKe dUrAt asmAt kawAkza-viza-analAt
   prakṛti-viṣamād yoṣit-sarpād vilāsa-phaṇābhṛtaḥ |	prakRti-vizamAt yozit--sarpAt vilAsa--PaNA-BRtaH |
   itara-phaṇinā daṣṭaḥ śakyaś cikitsitum auṣadhaiścatur-	itara--PaNinA dazwaH SakyaH cikitsitum OzaDEH-catur-
   vanitābhogi-grastaṃ hi mantriṇaḥ || BharSt_2.52 ||	vanitA-Bogi-grastam hi mantriNaH || BharSt-_2.52 ||
   vistāritaṃ makara-ketana-dhīvareṇa	vistAritam makara-ketana--DIvareNa
   strī-saṃjñitaṃ baḍiśam atra bhavāmbu-rāśau |	strI--saMjQitam baxiSam atra Bava-ambu-rASO |
   yenācirāt tad-adharāmiṣa-lola-martya-	yena-acirAt tad--aDara-Amiza--lola--martya-
   matsyān vikṛṣya vipacaty anurāga-vahnau || BharSt_2.53 ||	matsyAn vikRzya vipacati anurAga--vahnO || BharSt-_2.53 ||
   kāminī-kāya-kāntāre kuca-parvata-durgame |	kAminI--kAya--kAntAre kuca-parvata-durgame |
   mā saṃcara manaḥ pāntha tatrāste smara-taskaraḥ || BharSt_2.54 ||	mA saMcara manaH pAnTa tatra-Aste smara-taskaraH || BharSt-_2.54 ||
   vyādīrgheṇa calena vaktra-gatinā tejasvinā bhoginā	vyAdIrGeNa calena vaktra-gatinA tejasvinA BoginA
   nīlābja-dyutināhinā param ahaṃ dṛṣṭo na tac-cakṣuṣā |	nIla-abja--dyutinA-ahinA param aham dRzwaH na tac-cakzuzA |
   dṛṣṭe santi cikitsakā diśi diśi prāyeṇa darmārthino	dRzwe santi cikitsakAH diSi diSi prAyeNa darma-arTinaH-
   mugdhākṣkṣaṇa-vīkṣitasya na hi me vaidyo na cāpy auṣadham || BharSt_2.55	mugDa-akzkzaNa--vIkzitasya na hi me vEdyaH na ca-api OzaDam || BharSt-_2.55
   iha hi madhura-gītaṃ nṛtyam etad-raso 'yaṃ	iha hi maDura--gItam nRtyam etat--rasaH ayam
   sphurati parimalo 'sau sparśa eṣa stanānām |	sPurati parimalaH asO sparSaH eza stanAnAm |
   iti hata-paramārthair indriyair bhrāmyamāṇaḥ	iti hata-parama-arTEH indriyEH BrAmyamANaH
   sva-hita-karaṇa-dhūrtaiḥ pañcabhir vañcito 'smi || BharSt_2.56 ||	sva--hita-karaNa--DUrtEH paQcaBiH vaQcitaH asmi || BharSt-_2.56 ||
   na gamyo mantrāṇāṃ na ca bhavati bhaiṣajya-viṣayo	na gamyaH mantrANAm na ca Bavati BEzajya--vizayaH-
   na cāpi pradhvaṃsaṃ vrajati vividhaiḥ śāntika-śataiḥ |	na ca-api praDvaMsam vrajati viviDEH SAnti-ka-SatEH |
   bhramāveśād aṅge kam api vidadhad bhaṅgam asakṛt	Brama-AveSAt aFge kam api vidaDat BaFgam asakRt-
   smarāpasmāro 'yaṃ bhramayati dṛśaṃ ghūrṇayati ca || BharSt_2.57 ||	smara-apasmAraH ayam Bramayati dRSam GUrNayati ca || BharSt-_2.57 ||
   jāty-andhāya ca durmukhāya ca jarājīrṇā khilāṅgāya ca	jAti--anDAya ca durmuKAya ca jarA-jIrNA Kila-aFgAya ca
   grāmīṇāya ca duṣkulāya ca galat-kuṣṭhābhibhūtāya ca |	grAmINAya ca duzkulAya ca galat--kuzWa-aBiBUtAya ca |
   yacchantīṣu manoharaṃ nija-vapu-lakṣmī-lava-śraddhayā	yacCantIzu manoharam nija-vapu--lakzmI-lava--SradDayA
   paṇya-strīṣu viveka-kalpa-latikāśa-strīṣu rājyeta kaḥ || BharSt_2.58 ||	paNya--strIzu viveka--kalpa--latikA-Sa--strIzu rAjyeta kaH || BharSt-_2.58 ||
   veśyāsau madana-jvālā	veSyA-asO madana--jvAlA
   rūpe 'ndhana-vivardhitā |	rUpe anDana--vivarDitA |
   kāmibhir yatra hūyante	kAmiBiH yatra hUyante
   yauvanāni dhanāni ca || BharSt_2.59 ||	yOvanAni DanAni ca || BharSt-_2.59 ||
   kaś cumbati kula-puruṣo veśyādhara-pallavaṃ manojñam api |	kaH cumbati kula--puruzaH veSyA-Dara--pallavam manojQam api |
   cārabhaṭa-cora-ceṭaka-naṭa-viṭa-niṣṭhīvana-śarāvam || BharSt_2.60 ||	cAra-Bawa--cora--cewaka--nawa--viwa--nizWIvana--SarAvam || BharSt-_2.60 ||
   dhanyās ta eva dhavalāyata-locanānāṃ	DanyAH te eva Davala-Ayata--locanAnAm
   tāruṇya-darpa-ghana-pīna-payodharāṇām |	tAruNya-darpa--Gana--pIna--payoDarANAm |
   kṣāmodaropari lasat-trivalī-latānāṃ	kzAmodara-upari lasat--trivalI--latAnAm
   dṛṣṭvākṛtiṃ vikṛtim eti mano na yeṣām || BharSt_2.61 ||	dRzwvA-AkRtim vikRtim eti manaH na yezAm || BharSt-_2.61 ||
   bāle līlā-mukulitam amī mantharā dṛṣṭi-pātāḥ	bAle lIlA--mukulitam amI manTarAH dRzwi-pAtAH
   kiṃ kṣipyante virama-virama vyartha eṣa śramas te |	kim kzipyante virama--virama vyarTaH eza SramaH te |
   sampraty anye vayam uparataṃ bālyam āsthā vanānte	samprati anye vayam uparatam bAlyam AsTA vanAnte
   kṣīṇo mohas tṛṇam iva jagaj-jālam ālokayāmaḥ || BharSt_2.62 ||	kzINaH mohaH tRNam iva jagaj--jAlam AlokayAmaH || BharSt-_2.62 ||
   iyaṃ bālā māṃ praty anavaratam indīvara-dalaprabhā	iyam bAlA mAm prati anavaratam indIvara--dala-praBA
   cīraṃ cakṣuḥ kṣipati kim abhipretam anayā |	cIram cakzuH kzipati kim aBipretam anayA |
   gato moho 'smākaṃ smara-śabara-bāṇa-vyatikarajvara-	gataH mohaH asmAkam smara--Sabara--bANa--vyatikara-jvara-
   jvālā śāntā tad api na varākī viramati || BharSt_2.63 ||	jvAlA SAntA tat api na varAkI viramati || BharSt-_2.63 ||
   kiṃ kandarpa karaṃ kadarthayasi re kodaṇḍa-ṭaṅkāritaṃ	kim kandarpa karam kadarTayasi re kodaNxa--waFka-aritam
   re re kokila komalaṃ kala-ravaṃ kiṃ vā vṛthā jalpasi |	re re kokila komalam kala-ravam kim vA vRTA jalpasi |
   mugdhe snigdha-vidagdha-cāru-madhurair lolaiḥ kaṭākṣair alaṃ	mugDe snigDa--vidagDa--cAru--maDurEH lolEH kawAkzEH alam
   cetaś cumbita-candra-cūḍa-caraṇa-dhyānāmṛtaṃ vartate || BharSt_2.64 ||	cetaH cumbita--candra-cUxa--caraNa--DyAna-amRtam vartate || BharSt-_2.64 ||
   virahe 'pi saṅgamaḥ khalu	virahe api saFgamaH Kalu
   parasparaṃ saṅgataṃ mano yeṣām |	parasparam saFgatam manaH yezAm |
   hṛdayam api vighaṭṭitaṃ cet	hRdayam api viGawwitam ced-
   saṅgī virahaṃ viśeṣayati || BharSt_2.65 ||	saFgI viraham viSezayati || BharSt-_2.65 ||
   kiṃ gatena yadi sā na jīvati	kim gatena yadi sA na jIvati
   prāṇiti priyatamā tathāpi kim |	prANiti priyatamA taTA-api kim |
   ity udīkṣya nava-megha-mālikāṃ	iti udIkzya nava--meGa-mAlikAm
   na prayāti pathikaḥ sva-mandiram || BharSt_2.66 ||	na prayAti paTikaH sva--mandiram || BharSt-_2.66 ||
   viramata budhā yoṣit-saṅgāt sukhāt kṣaṇa-bhaṅgurāt	viramata buDAH yozit--saFgAt suKAt kzaNa-BaFgurAt-
   kuruta karuṇā-maitrī-prajñā-vadhū-jana-saṅgamam |	kuruta karuNA--mEtrI--prajQA-a--vaDU--jana--saFgamam |
   na khalu narake hārākrāntaṃ ghana-stana-maṇḍalaṃ	na Kalu narake hAra-AkrAntam Gana--stana--maNxalam
   śaraṇam athavā śroṇī-bimbaṃ raṇan-maṇi-mekhalam || BharSt_2.67 ||	SaraNam aTavA SroNI--bimbam raNan-maNi--meKalam || BharSt-_2.67 ||
   yadā yogābhyāsa-vyasana-kṛśayor ātma-manasoravicchinnā	yadA yoga-aByAsa--vyasana--kRSayoH Atma-manasoH-avicCinnA
   maitrī sphurati kṛtinas tasya kim u taiḥ |	mEtrI sPurati kRtinaH tasya kim u tEH |
   priyāṇām ālāpair adhara-madhubhir vaktra-vidhubhiḥ	priyANAm AlApEH aDara-maDuBiH vaktra-viDuBiH
   saniśvāsāmodaiḥ sakuca-kalaśāśleṣa-surataiḥ || BharSt_2.68 ||	sa-niSvAsa-AmodEH sa-kuca--kalaSa-ASleza--suratEH || BharSt-_2.68 ||
   yadāsīd ajñānaṃ smara-timira-sañcāra-janitaṃ	yadA-AsIt ajQAnam smara--timira--saQcAra--janitam
   tadā dṛṣṭa-nārī-mayam idam aśeṣaṃ jagad iti |	tadA dRzwa--nArI--mayam idam aSezam jagat iti |
   idānīm asmākaṃ paṭutara-vivekāñjana-juṣāṃ	idAnIm asmAkam pawutara--viveka-aQjana--juzAm
   samībhūtā dṛṣṭis tribhuvanam api brahma manute || BharSt_2.69 ||	samIBUtA dRzwiH triBuvanam api brahma manute || BharSt-_2.69 ||
   tāvad eva kṛtinām api sphuratyeṣa	tAvat eva kRtinAm api sPurati-eza
   nirmala-viveka-dīpakaḥ |	nirmala-viveka-dIpakaH |
   yāvad eva na kuraṅga-cakṣuṣāṃ	yAvat eva na kuraFga--cakzuzAm
   tāḍyate caṭula-locanāñcalaiḥ || BharSt_2.70 ||	tAxyate cawula--locana-aQcalEH || BharSt-_2.70 ||
   vacasi bhavati saṅga-tyāgam uddiśya vārtā	vacasi Bavati saFga-tyAgam uddiSya vArtA
   śruti-mukhara-mukhānāṃ kevalaṃ paṇḍitānām |	Sruti-muKara--muKAnAm kevalam paNxitAnAm |
   jaghanam aruṇa-ratna-granthi-kāñcī-kalāpaṃ	jaGanam aruNa--ratna--granTi--kAQcI--kalApam
   kuvalaya-nayanānāṃ ko vihātuṃ samarthaḥ || BharSt_2.71 ||	kuvalaya--nayanAnAm kaH vihAtum samarTaH || BharSt-_2.71 ||
   sva-para-pratārako 'sau	sva-para--pratArakaH asO
   nindati yo 'līka-paṇḍito yuvatīḥ |	nindati yaH alIka-paNxitaH yuvatIH |
   yasmāt tapaso 'pi phalaṃ	yasmAt tapasaH api Palam
   svargaḥ svarge 'pi cāpsarasaḥ || BharSt_2.72 ||	svargaH svarge api ca-apsarasaH || BharSt-_2.72 ||
   mattebha-kumbha-dalane bhuvi santi dhīrāḥ	matta-iBa--kumBa-dalane Buvi santi DIrAH
   kecit pracaṇḍa-mṛga-rāja-vadhe 'pi dakṣāḥ |	kecid pracaNxa--mRga--rAja--vaDe api dakzAH |
   kintu bravīmi balināṃ purataḥ prasahya	kintu bravImi balinAm puratas prasahya
   kandarpa-darpa-dalane viralā manuṣyāḥ || BharSt_2.73 ||	kandarpa--darpa--dalane viralAH manuzyAH || BharSt-_2.73 ||
   san-mārge tāvad āste prabhavati ca naras tāvad evendriyāṇāṃ	san--mArge tAvat Aste praBavati ca naraH tAvat eva-indriyANAm
   lajjāṃ tāvad vidhatte vinayam api samālambate tāvad eva |	lajjAm tAvat viDatte vinayam api samAlambate tAvat eva |
   bhrū-cāpākṛṣṭa-muktāḥ śravaṇa-patha-gatā nīla-pakṣmāṇa ete	BrU-cApAkRzwa-muktAH SravaNa--paTa--gatAH nIla--pakzmANaH ete
   yāval līlāvatīnāṃ hṛdi na dhṛtimuṣo dṛṣṭi-bāṇāḥ patanti || BharSt_2.74 ||	yAvat lIlAvatInAm hRdi na DRti-muzaH dRzwi--bANAH patanti || BharSt-_2.74 ||
   unmatta-prema-saṃrambhād	unmatta--prema--saMramBAt-
   ārabhante yad-aṅganāḥ |	AraBante yat--aFganAH |
   tatra pratyūham ādhātuṃ	tatra pratyUham ADAtum
   brahmāpi khalu kātaraḥ || BharSt_2.75 ||	brahmA-api Kalu kAtaraH || BharSt-_2.75 ||
   tāvan mahattvaṃ pāṇḍityaṃ	tAvat mahat-tvam pANxityam
   kulīnatvaṃ vivekitā |	kulIna-tvam viveki-tAH |
   yāvaj jvalati nāṅgeṣu	yAvat jvalati na-aFgezu
   hataḥ pañceṣu-pāvakaḥ || BharSt_2.76 ||	hataH paQca-izu--pAvakaH || BharSt-_2.76 ||
   śāstrajño 'pi praguṇi-tanayo 'tyānta-bādhāpi bāḍhaṃ	SAstra-jQaH api praguNi-tanayaH atyAnta-bADA-api bAXam
   saṃsāre 'smin bhavati viralo bhājanaṃ sad-gatīnām |	saMsAre asmin Bavati viralaH BAjanam sad-gatInAm |
   yenaitasmin niraya-nagara-dvāram udghāṭayantī	yena-etasmin niraya-nagara-dvAram udGAwayantI
   vāmākṣīṇāṃ bhavati kuṭilā bhrū-latā kuñcikeva || BharSt_2.77 ||	vAma-akzINAm Bavati kuwilA BrU-latA kuQcikA-iva || BharSt-_2.77 ||
   kṛśaḥ kāṇaḥ khañjaḥ śravaṇa-rahitaḥ puccha-vikalo	kRSaH kANaH KaQjaH SravaNa--rahitaH pucCa--vikalaH-
   vraṇī pūya-klinnaḥ kṛmi-kula-śatair āvṛta-tanuḥ |	vraNI pUya--klinnaH kRmi-kula--SatEH AvRta--tanuH |
   kṣudhā kṣāmo jīrṇaḥ piṭharaka-kapālārpita-galaḥ	kzuDA kzAmaH jIrNaH piWara-ka-kapAla-arpita--galaH
   śunīm anveti śvā hatam api ca hanty eva madanaḥ || BharSt_2.78 ||	SunIm anveti SvA hatam api ca hanti eva madanaH || BharSt-_2.78 ||
   strī-mudrāṃ kusumāyudhasya jayinīṃ sarvārtha-sampat-karīṃ	strI-mudrAm kusumAyuDasya jayinIm sarva-arTa--sampat-karIm
   ye mūḍhāḥ pravihāya yānti kudhiyo mithyā-phalānveṣiṇaḥ |	ye mUXAH pravihAya yAnti kuDiyaH miTyA-Pala-anveziNaH |
   te tenaiva nihatya nirdayataraṃ nagnīkṛtā muṇḍitāḥ	te tena-eva nihatya nirdayataram nagnIkRtAH muNxitAH
   kecit pañca-śikhī-kṛtāś ca jaṭilāḥ kāpālikāś cāpare || BharSt_2.79 ||	kecid paQca--SiKI-kRtAH ca jawilAH kApAlikAH ca-apare || BharSt-_2.79 ||
   viśvāmitra-parāśara-prabhṛtayo vātāmbu-parṇāśanāste 'pi	viSvAmitra--parASara--praBRtayaH vAta-ambu-parNa-aSanAH-te api
   strī-mukha-paṅkajaṃ sulalitaṃ dṛṣṭvaiva mohaṃ gatāḥ |	strI--muKa--paFkajam su-lalitam dRzwvA-eva moham gatAH |
   śālyannaṃ sa-ghṛtaṃ payo-dadhi-yutaṃ ye bhuñjate mānavāsteṣām	SAli-annam sa-GRtam payo-daDi--yutam ye BuQjate mAnavAH-tezAm
   indriya-nigraho yadi bhaved vindhyaḥ plavet sāgare || BharSt_2.80 ||	indriya-nigrahaH yadi Bavet vinDyaH plavet sAgare || BharSt-_2.80 ||
   parimala-bhṛto vātāḥ śākhā navāṅkura-koṭayo	parimala-BRtaH vAtAH SAKAH nava-aFkura--kowayaH-
   madhura-vidhurotkaṇṭhā-bhājaḥ priyā pika-pakṣiṇām |	maDura--viDura-utkaNWA--BAjaH priyA pika-pakziNAm |
   virala-virasa-svedodgārā vadhū-vadanendavaḥ	virala-virasa--sveda-udgArAH vaDU-vadana-indavaH
   prasarati madhau dhātryāṃ jāto na kasya guṇodayaḥ || BharSt_2.81 ||	prasarati maDO DAtryAm jAtaH na kasya guNa-udayaH || BharSt-_2.81 ||
   madhur ayaṃ madhurair api kokilā	maDuH ayam maDurEH api kokilA
   kala-ravair malayasya ca vāyubhiḥ |	kala-ravEH malayasya ca vAyuBiH |
   virahiṇaḥ prahiṇasti śarīriṇo	virahiNaH prahiNasti SarIriNaH-
   vipadi hanta sudhāpi viṣāyate || BharSt_2.82 ||	vipadi hanta suDA-api vizAyate || BharSt-_2.82 ||
   āvāsaḥ kila-kiñcitasya dayitā-pārśve vilāsālasāḥ	AvAsaH kila--kiQcitasya dayitA--pArSve vilAsa-alasAH
   karṇe kokila-kāminī-kala-ravaḥ smero latā-maṇḍapaḥ |	karNe kokila--kAminI--kala-ravaH smeraH latA-maNxapaH |
   goṣṭhī sat-kavibhiḥ samaṃ katipayair mugdhāḥ sudhāṃśoḥ karāḥ	gozWI sat-kaviBiH samam katipayEH mugDAH suDAMSoH karAH
   keṣāṃcit sukhayanti cātra hṛdayaṃ caitre vicitrāḥ kṣapāḥ || BharSt_2.83 ||	kezAMcid suKayanti ca-atra hRdayam cEtre vicitrAH kzapAH || BharSt-_2.83 ||
   pāntha strī-virahānalāhuti-kalām ātanvatī mañjarīmākandeṣu	pAnTa strI--viraha-anala-Ahuti-kalAm AtanvatI maQjarI-mAkandezu
   pikāṅganābhir adhunā sotkaṇṭham ālokyate |	pikA-aFganABiH aDunA sa-utkaNWam Alokyate |
   apy ete nava-pāṭalā-parimala-prāg-bhāra-pāṭac-carā	api ete nava-pAwalA--parimala--prAg-BAra--pAwa-c-carA
   vānti-klānti-vitāna-tānava-kṛtaḥ śrīkhaṇḍa-śailānilāḥ || BharSt_2.84 ||	vAnti-klAnti--vitAna--tAnava--kRtaH SrIKaNxa--SEla-anilAH || BharSt-_2.84 ||
   prathitaḥ praṇayavatīnāṃ	praTitaH praNayavatInAm
   tāvat padam ātanotu hṛdi mānaḥ |	tAvat padam Atanotu hRdi mAnaH |
   bhavati na yāvac candanataru-	Bavati na yAvat candana-taru-
   surabhir malaya-pavamānaḥ || BharSt_2.85 ||	suraBiH malaya-pavamAnaH || BharSt-_2.85 ||
   sahakāra-kusuma-kesaranikara-	sahakAra--kusuma--kesara-nikara-
   bharāmoda-mūrcchita-dig-ante |	Bara-Amoda--mUrcCita-diS--ante |
   madhura-madhura-vidhura-madhupe	maDura--maDura--viDura--maDupe
   madhau bhavet kasya notkaṇṭhā || BharSt_2.86 ||	maDO Bavet kasya na-utkaNWAH || BharSt-_2.86 ||
   acchāccha-candana-rasārdratarā mṛgākṣyo	acCa-acCa--candana--rasa-ArdratarA mRga-akzyaH-
   dhārā-gṛhāṇi kusumāni ca kaumudī ca |	DArA--gRhANi kusumAni ca kOmudI ca |
   mando marut sumanasaḥ śuci harmya-pṛṣṭhaṃ	mandaH marut sumanasaH Suci harmya--pRzWam
   grīṣme madaṃ ca madanaṃ ca vivardhayanti || BharSt_2.87 ||	grIzme madam ca madanam ca vivarDayanti || BharSt-_2.87 ||
   srajo hṛdy āmodā vyajana-pavanaś candra-kiraṇāḥ	srajaH hRdi AmodAH vyajana--pavanaH candra-kiraNAH
   parāgaḥ kāsāro malayaja-rajaḥ śīdhu viśadam |	parAgaH kAsAraH malayaja--rajaH SIDu viSadam |
   śuciḥ saudhotsaṅgaḥ pratanu vasanaṃ paṅkaja-dṛśo	SuciH sODa-utsaFgaH pratanu vasanam paFkaja--dRSaH-
   nidāgha-rtāv etad vilasati labhante sukṛtinaḥ || BharSt_2.88 ||	nidAGa--rtO etat vilasati laBante sukRtinaH || BharSt-_2.88 ||
   sudhā-śubhraṃ dhāma sphurad-amala-raśmiḥ śaśadharaḥ	suDA--SuBram DAma sPurat--amala--raSmiH SaSaDaraH
   priyā-vaktrāmbhojaṃ malayaja-rajaś cātisurabhiḥ |	priyA--vaktra-amBojam malayaja--rajaH ca-ati-suraBiH |
   srajo hṛdyāmodās tad idam akhilaṃ rāgiṇi jane	srajaH hRdi-AmodAH tat idam aKilam rAgiNi jane
   karoty antaḥ kṣobhaṃ na tu viṣaya-saṃsarga-vimukhe || BharSt_2.89 ||	karoti antar kzoBam na tu vizaya--saMsarga--vimuKe || BharSt-_2.89 ||
   taruṇī-veṣoddīpita-kāmā	taruNI--veza-uddIpita-kAmA
   vikasaj-jātī-puṣpa-sugandhiḥ |	vikasa-j-jAtI--puzpa--suganDiH |
   unnata-pīna-payodhara-bhārā	unnata--pIna--payoDara--BArA
   prāvṛṭ tanute kasya na harṣam || BharSt_2.90 ||	prAvRz tanute kasya na harzam || BharSt-_2.90 ||
   viyad-upacita-meghaṃ bhūmayaḥ kandalinyo	viyat--upacita--meGam BUmayaH kandalinyaH-
   nava-kuṭaja-kadambāmodino gandhavāhāḥ |	nava-kuwaja--kadamba-AmodinaH ganDavAhAH |
   śikhi-kula-kala-kekārāvaramyā vanāntāḥ	SiKi--kula-kala-kekArAvaramyAH vanAntAH
   sukhinam asukhinaṃ vā sarvam utkaṇṭhayanti || BharSt_2.91 ||	suKinam asuKinam vA sarvam utkaNWayanti || BharSt-_2.91 ||
   upari ghanaṃ ghana-paṭalaṃ	upari Ganam Gana-pawalam
   tiryag girayo 'pi nartita-mayūrāḥ |	tiryak girayaH api nartita--mayUrAH |
   kṣitir api kandala-dhavalā	kzitiH api kandala-DavalA
   dṛṣṭiṃ pathikaḥ kva pātayati || BharSt_2.92 ||	dRzwim paTikaH kva pAtayati || BharSt-_2.92 ||
   ito vidyud-vallī-vilasitam itaḥ ketaki-taroḥ	itas vidyut--vallI--vilasitam itas ketaki-taroH
   sphuran gandhaḥ prodyaj-jalada-ninada-sphūrjitam itaḥ |	sPuran ganDaH prodyaj--jalada--ninada--sPUrjitam itas |
   itaḥ keki-krīḍā-kala-kala-ravaḥ pakṣmala-dṛśāṃ	itas keki--krIxA-kala--kala--ravaH pakzmala-dRSAm
   kathaṃ yāsyanty ete viraha-divasāḥ sambhṛta-rasāḥ || BharSt_2.93 ||	kaTam yAsyanti ete viraha--divasAH samBRta-rasAH || BharSt-_2.93 ||
   asūci-sañcāre tamasi nabhasi prauḍha-jaladadhvani-	asUci--saQcAre tamasi naBasi prOXa--jalada-Dvani-
   prājñaṃmanye patati pṛṣatānāṃ ca nicaye |	prAjQaMmanye patati pRzatAnAm ca nicaye |
   idaṃ saudāminyāḥ kanaka-kamanīyaṃ vilasitaṃ	idam sOdAminyAH kanaka-kamanIyam vilasitam
   mudaṃ ca mlāniṃ ca prathayati pathi svaira-sudṛśām || BharSt_2.94 ||	mudam ca mlAnim ca praTayati paTi svEra-su-dRSAm || BharSt-_2.94 ||
   āsāreṇa na harmyataḥ priyatamair yātuṃ bahiḥ śakyate	AsAreNa na harmyataH priyatamEH yAtum bahis Sakyate
   śītotkampa-nimittam āyata-dṛśā gāḍhaṃ samāliṅgyate |	SIta-utkampa--nimittam Ayata-dRSA gAXam samAliFgyate |
   jātāḥ śīkara-śītalāś ca marutor atyanta-kheda-cchido	jAtAH SIkara--SItalAH ca marutoH atyanta--Keda-=-CidaH-
   dhanyānāṃ bata durdinaṃ sudinatāṃ yāti priyā-saṅgame || BharSt_2.95 ||	DanyAnAm bata durdinam su-dina-tAm yAti priyA--saFgame || BharSt-_2.95 ||
   ardhaṃ suptvā niśāyāḥ sarabhasa-suratāyāsa-sanna-ślathāṅgaprodbhūtāsahya-	arDam suptvA niSAyAH saraBasa--surata-AyAsa--sanna--SlaTAFga-prodBUta-asahya-
   tṛṣṇo madhu-mada-nirato harmya-pṛṣṭhe vivikte |	tRzNaH maDu-mada--nirataH harmya--pRzWe vivikte |
   sambhoga-klānta-kāntā-śithila-bhuja-latā-varjitaṃ karkarīto	samBoga-klAnta--kAntA--SiTila-Buja--latA---varjitam karkarItaH-
   jyotsnābhinnāccha-dhāraṃ pibati na salilaṃ śāradaṃ manda-puṇyaḥ ||	jyotsnA-Binna-acCa-DAram pibati na salilam SAradam manda--puNyaH ||
   BharSt_2.96 ||	BharSt_2.96 ||
   hemante dadhi-dugdha-sarpir aśanā māñjiṣṭha-vāso-bhṛtaḥ	hemante daDi-dugDa--sarpiH aSanAH mAQjizWa-vAsa-u-BRtaH
   kāśmīra-drava-sāndra-digdha-vapuṣaś chinnā vicitrai rataiḥ |	kASmIra-drava--sAndra-digDa--vapuzaH CinnAH vicitrEH ratEH |
   vṛttoru-stana-kāminojana-kṛtāśleṣā gṛhābhyantare	vRtta-Uru--stana--kAminaH-jana-kRta-ASlezAH gRha-aByantare
   tāmbūlī-dala-pūga-pūrita-mukhā dhanyāḥ sukhaṃ śerate || BharSt_2.97 ||	tAmbUlI-dala--pUga--pUrita-muKAH DanyAH suKam Serate || BharSt-_2.97 ||
   praduyat-prauḍha-priyaṅgu-dyuti-bhṛti vikasat-kunda-mādyad-dvirephe	praduyat--prOXa--priyaFgu--dyuti-BRti vikasat--kunda-mAt-yad-dvirePe
   kāle prāleya-vāta-pracala-vilasitodāra-mandāra-dhāmni |	kAle prAleya-vAta--pracala--vilasita-udAra--mandAra--DAmni |
   yeṣāṃ no kaṇṭha-lagnā kṣaṇam api tuhina-kṣoda-dakṣā mṛgākṣī	yezAm no kaNWa--lagnA kzaNam api tuhina-kzoda-dakzA mRgAkzI
   tesām āyāma-yāmā yama-sadana-samā yāminī yāti yūnām || BharSt_2.98 ||	tesAm AyAma-yAmA yama--sadana--samA yAminI yAti yUnAm || BharSt-_2.98 ||
   cumbanto gaṇḍa-bhittīr alakavati mukhe sītkṛtāny ādadhānā	cumbantaH gaNxa-BittIH alakavati muKe sItkRtAni AdaDAnA
   vakṣaḥ-sūtkañcukeṣu stana-bhara-pulakodbhedam āpādayantaḥ |	vakzaH-su-utkaQcukezu stana--Bara--pulaka-udBedam ApAdayantaH |
   ūrū-nākampayantaḥ pṛthu-jaghana-taṭāt sraṃsayanto 'ṃśukāni	UrU-na-akampayantaH pRTu--jaGana--tawAt sraMsayantaH aMSukAni
   vyaktaṃ kāntā-janānāṃ viṭa-carita-bhṛtaḥ śaiśirā vānti vātāḥ ||	vyaktam kAntA-a-janAnAm viwa--carita-BRtaH SESirAH vAnti vAtAH ||
   BharSt_2.99 ||	BharSt_2.99 ||
   keśānākulayan dṛśo mukulayan vāso balād ākṣipannātanvan	keSAn-Akulayan dRSaH mukulayan vAsaH balAt Akzipan=-Atanvan
   pulakodgamaṃ prakaṭayann āvega-kampaṃ śanaiḥ |	pulaka-udgamam prakawayan Avega--kampam SanEs |
   bāraṃ bāram udāra-sītkṛta-kṛto danta-cchadān pīḍayan	bAram bAram udAra-sItkRta-kRtaH danta--cCadAn pIxayan
   prāyaḥ śaiśira eṣa samprati marut kāntāsu kāntāyate || BharSt_2.100 ||	prAyas SESiraH eza samprati marut kAntAsu kAntAyate || BharSt-_2.100 ||
   yady asya nāsti ruciraṃ tasmiṃs tasya spṛhā manojñe 'pi |	yadi asya na-asti ruciram tasmin tasya spRhA manojQe api |
   ramaṇīye 'pi sudhāṃśau na manaḥ-kāmaḥ sarojinyāḥ || BharSt_2.101 ||	ramaNIye api suDAMSO na manaH--kAmaH sa-rojinyAH || BharSt-_2.101 ||
   vairāgye saṃcaraty eko nītau bhramati cāparaḥ |	vErAgye saMcarati ekaH nItO Bramati ca-aparaH |
   śṛṅgāre ramate kaścid bhuvi bhedāḥ parasparam || BharSt_2.102 ||	SRFgAre ramate kaScid Buvi BedAH parasparam || BharSt-_2.102 ||
   iti śubhaṃ bhūyāt |	iti SuBam BUyAt |
   vairāgya-śatakam	vErAgya--Satakam
   bhartṛhareḥ	BartR-hareH
   cūḍottaṃsita-candra-cāru-kalikā-cañcac-chikhā-bhāsvaro	cUxa-uttaMsita-candra--cAru--kalikA--caQcac--SiKA-BAsvaraH-
   līlā-dagdha-vilola-kāma-śalabhaḥ śreyo-daśāgre sphuran |	lIlA--dagDa--vilola--kAma-SalaBaH SreyaH--daSa-agre sPuran |
   antaḥ-sphūrjad-apāra-moha-timira-prāg-bhāram uccāṭayan	antaH--sPUrjad-a-pAra--moha--timira--prAg-BAram uccAwayan
   śvetaḥ-sadmani yogināṃ vijayate jñāna-pradīpo haraḥ || BharSt_3.1 ||	SvetaH--sadmani yoginAm vijayate jQAna--pradIpaH haraH || BharSt-_3.1 ||
   bhrāntaṃ deśam aneka-durga-viṣamaṃ prāptaṃ na kiñcit phalaṃ	BrAntam deSam aneka--durga--vizamam prAptam na kiQcid Palam
   tyaktvā jāti-kulābhimānam ucitaṃ sevā kṛtā niṣphalā |	tyaktvA jAti--kula-aBimAnam ucitam sevA kRtA nizPalAH |
   bhuktaṃ māna-vivarjitaṃ para-gṛheṣv āśaṅkayā kākavat	Buktam mAna--vivarjitam para-gRhezu ASaFkayA kAka-vat-
   tṛṣṇe jṛmbhasi pāpa-karma-piśune nādyāpi santuṣyasi || BharSt_3.2 ||	tRzNe jRmBasi pApa-karma--piSune na-adya-api santuzyasi || BharSt-_3.2 ||
   utkhātaṃ nidhi-śaṅkayā kṣiti-talaṃ dhmātā girer dhātavo	utKAtam niDi-SaFkayA kziti-talam DmAtA gireH DAtavaH-
   nistīrṇaḥ saritāṃ patir nṛpatayo yatnena santoṣitāḥ |	nistIrNaH saritAm patiH nRpatayaH yatnena santozitAH |
   mantrārādhana-tat-pareṇa manasā nītāḥ śmaśāne niśāḥ	mantra-ArADana--tat--pareNa manasA nItAH SmaSAne niSAH
   prāptaḥ kāṇa-varāṭako 'pi na mayā tṛṣṇe sakāmā bhava || BharSt_3.3 ||	prAptaH kANa-varAwakaH api na mayA tRzNe sa-kAmA Bava || BharSt-_3.3 ||
   khalālāpāḥ sauḍhāḥ katham api tad-ārādhana-parairnigṛhyāntar-	Kala-AlApAH sOXAH kaTam api tad--ArADana--parEH-nigRhya-antar-
   bāṣpaṃ hasitam api śūnyena manasā |	bAzpam hasitam api SUnyena manasA |
   kṛto vitta-stambha-pratihata-dhiyām añjalir api	kRtaH vitta--stamBa--pratihata--DiyAm aQjaliH api
   tvam āśe moghāśe kima aparam ato nartayasi mām || BharSt_3.4 ||	tvam ASe moGa-ASe kima aparam atas nartayasi mAm || BharSt-_3.4 ||
   amīṣāṃ prāṇānāṃ tulita-visinī-patra-payasāṃ	amIzAm prANAnAm tulita-visinI--patra--payasAm
   kṛte kiṃ nāsmābhir vigalita-vivekair vyavasitam |	kRte kim na-asmABiH vigalita-vivekEH vyavasitam |
   yad-āḍhyānām agre draviṇa-mada-niḥsaṃjña-manasāṃ	yad-a-AXyAnAm agre draviNa-mada--niHsaMjQa--manasAm
   kṛtaṃ māva-vrīḍair nija-guṇa-kathā-pātakam api || BharSt_3.5 ||	kRtam mA-ava--vrIxEH nija--guNa--kaTA-a-pAtakam api || BharSt-_3.5 ||
   kṣāntaṃ na kṣamayā gṛhocita-sukhaṃ tyaktaṃ na santoṣataḥ	kzAntam na kzamayA gRha-ucita--suKam tyaktam na santozataH
   soḍho duḥsaha-śīta-tāpa-pavana-kleśo na taptaṃ tapaḥ |	soXaH duHsaha--SIta-tApa-pavana--kleSaH na taptam tapaH |
   dhyātaṃ vittam ahar-niśaṃ nityamita-prāṇair na śambhoḥ padaṃ	DyAtam vittam ahar-niSam nitya-mita--prANEH na SamBoH padam
   tat-tat-karma kṛtaṃ yad eva munibhis tais taiḥ phalair vañcitāḥ ||	tat-tat--karma kRtam yat eva muniBiH tEH tEH PalEH vaQcitAH ||
   BharSt_3.6 ||	BharSt_3.6 ||
   bhogā na bhuktā vayam eva bhuktās	BogAH na BuktA vayam eva Bukta-as
   tapo na taptaṃ vayam eva taptāḥ |	tapaH na taptam vayam eva taptAH |
   kālo na yāto vayam eva yātāstṛṣṇā	kAlaH na yAtaH vayam eva yAtAH-tRzNA
   na jīrṇā vayam eva jīrṇāḥ || BharSt_3.7 ||	na jIrNAH vayam eva jIrNAH || BharSt-_3.7 ||
   balibhir mukham ākrāntaṃ palitenāṅkitaṃ śiraḥ |	baliBiH muKam AkrAntam palitena-aFkitam SiraH |
   gātrāṇi śithilāyante tṛṣṇaikā taruṇāyate || BharSt_3.8 ||	gAtrANi SiTilAyante tRzNA-ekA taruNAyate || BharSt-_3.8 ||
   viveka-vyākośe vidadhati same śāmyati tṛṣā	viveka--vyAkoSe vidaDati same SAmyati tRzA
   pariṣvaṅge tuṅge prasaratitarāṃ sā pariṇatā |	parizvaFge tuFge prasaratitarAm sA pariNatA |
   jarājīrṇaiśvarya-grasana-gahanākṣepa-kṛpaṇastṛṣāpātraṃ	jarA-jIrNa-ESvarya--grasana--gahana-Akzepa--kRpaNaH-tRzA-pAtram
   yasyāṃ bhavati marutām apy adhipatiḥ || BharSt_3.8*1 ||	yasyAm Bavati marutAm api aDipatiH || BharSt-_3.8*1 ||
   nivṛttā bhogecchā puruṣa-bahu-māno 'pi galitaḥ	nivRttA Boga-icCA puruza--bahu-mAnaH api galitaH
   samānāḥ svar-yātāḥ sapadi suhṛdo jīvita-samāḥ |	samAnAH svar-yAtAH sapadi suhRdaH jIvita--samAH |
   śanair yaṣṭy utthānaṃ ghana-timira-ruddhe ca nayane	SanEs yazwi utTAnam Gana--timira-rudDe ca nayane
   aho mūḍhaḥ kāyas tad api maraṇāpāya-cakitaḥ || BharSt_3.9 ||	aho mUXaH kAyaH tat api maraNa-apAya--cakitaH || BharSt-_3.9 ||
   āśā nāma nadī manoratha-jalā tṛṣṇā-taraṅgākulā	ASA nAma nadI manoraTa--jalA tRzNA-a-taraFga-AkulA
   rāga-grāhavatī vitarka-vihagā dhairya-druma-dhvaṃsinī |	rAga--grAhavatI vitarka--vihagA DErya--dru-ma--DvaMsinI |
   mohāvarta-sudustarātigahanā prottuṅga-cintā-taṭī	moha-Avarta--su-dustarA-ati-gahanA prottuFga-cintA--tawI
   tasyāḥ para-gatā viśuddham alaso nandanti yogīśvarāḥ || BharSt_3.10 ||	tasyAH para-gatAH viSudDam alasaH nandanti yogi-ISvarAH || BharSt-_3.10 ||
   na saṃsārotpannaṃ caritam anupaśyāmi kuśalaṃ	na saMsAra-utpannam caritam anupaSyAmi kuSalam
   vipākaḥ puṇyānāṃ janayati bhayaṃ me vimṛśataḥ |	vipAkaH puNyAnAm janayati Bayam me vimRSataH |
   mahadbhiḥ puṇyaughaiś cira-parigṛhītāś ca viṣayā	mahadBiH puNya-oGEH cira--parigRhItAH ca vizayA
   mahānto jāyante vyasanam iva dātuṃ viṣayiṇām || BharSt_3.11 ||	mahAntaH jAyante vyasanam iva dAtum vizayiNAm || BharSt-_3.11 ||
   avaśyaṃ yātāraś cirataram uṣitvāpi viṣayā	avaSyam yAtAraH cirataram uzitvA-api vizayA
   viyoge ko bhedas tyajati na jano yat svayam amūn |	viyoge kaH BedaH tyajati na janaH yat svayam amUn |
   vrajantaḥ svātantryād atula-paritāpāya manasaḥ	vrajantaH svAtantryAt atula--paritApAya manasaH
   svayaṃ tyaktā hy ete śama-sukham anantaṃ vidadhati || BharSt_3.12 ||	svayam tyaktAH hi ete Sama--suKam anantam vidaDati || BharSt-_3.12 ||
   brahma-jñāna-viveka-nirmala-dhiyaḥ kurvanty aho duṣkaraṃ	brahma--jQAna--viveka--nirmala-DiyaH kurvanti aho duzkaram
   yan muñcanty upabhoga-bhāñjy api dhanāny ekāntato niḥspṛhāḥ |	yat muQcanti upaBoga--BAQji api DanAni ekAntataH niHspRhAH |
   samprātān na purā na samprati na ca prāptau dṛḍha-pratyayān	samprAtAt na purA na samprati na ca prAptO dRXa--pratyayAn
   vāñchā-mātra-parigrahān api paraṃ tyaktuṃ na śaktā vayam || BharSt_3.13 ||	vAQCA--mAtra--parigrahAn api param tyaktum na SaktAH vayam || BharSt-_3.13 ||
   dhanyānāṃ giri-kandareṣu vasatāṃ jyotiḥ paraṃ dhyāyatāmānandāśru-	DanyAnAm giri--kandarezu vasatAm jyotiH param DyAyatAm-Ananda-aSru-
   jalaṃ pibanti śakunā niḥśaṅkam aṅkeśayāḥ |	jalam pibanti SakunAH niHSaFkam aFkeSayAH |
   asmākaṃ tu manorathoparacita-prāsāda-vāpī-taṭakrīḍā-	asmAkam tu manoraTa-uparacita--prAsAda-vApI--tawa-krIxA-
   kānana-keli-kautuka-juṣām āyuḥ paraṃ kṣīyate || BharSt_3.14 ||	kAnana--keli--kOtuka-juzAm AyuH param kzIyate || BharSt-_3.14 ||
   bhikṣā-śataṃ tad api nīrasam eka-bāraṃ	BikzA-a--Satam tat api nIrasam eka-bAram
   śayyā ca bhūḥ parijano nija-deha-mātram |	SayyA ca BUH parijanaH nija--deha--mAtram |
   vastraṃ viśīrṇa-śata-khaṇḍa-mayī ca kanthā	vastram viSIrNa-Sata-KaNxa--mayI ca kanTA
   hā hā tathāpi viṣayā na parityajanti || BharSt_3.15 ||	hA hA taTA-api vizayAH na parityajanti || BharSt-_3.15 ||
   stanau māṃsa-granthī kanaka-kalaśāv ity upamitī	stanO mAMsa-granTI kanaka-kalaSO iti upamitI
   mukhaṃ śleṣmāgāraṃ tad api ca śaśāṅkena tulitam |	muKam Slezma-AgAram tat api ca SaSAFkena tulitam |
   sravan-mūtra-klinnaṃ kari-vara-śira-spardhi jaghanaṃ	sravan--mUtra--klinnam kari--vara--Sira--sparDi jaGanam
   muhur nindyaṃ rūpaṃ kavi-jana-viśeṣair guru-kṛtam || BharSt_3.16 ||	muhur nindyam rUpam kavi--jana--viSezEH guru-kRtam || BharSt-_3.16 ||
   eko rāgiṣu rājate priyatamā-dehārdha-hārī haro	ekaH rAgizu rAjate priyatamA--deha-arDa--hArI haraH-
   nīrāgeṣu jano vimukta-lalanāsaṅgo na yasmāt paraḥ |	nIrAgezu janaH vimukta---lalanA-saFgaH na yasmAt paraH |
   durvāra-smara-bāṇa-pannaga-viṣa-vyābiddha-mugdho janaḥ	durvAra-smara--bANa--pannaga--viza--vyAbidDa-mugDaH janaH
   śeṣaḥ kāma-viḍambitān na viṣayān bhoktuṃ na moktuṃ kṣamaḥ || BharSt_3.17	SezaH kAma--vixambitAn na vizayAn Boktum na moktum kzamaH || BharSt-_3.17
   ajānan dāhātmyaṃ patatu śalabhas tīvra-dahane	ajAnan dAhAtmyam patatu SalaBaH tIvra--dahane
   sa mīno 'py ajñānād baḍiśa-yutam aśnātu piśitam |	sa mInaH api ajQAnAt baxiSa--yutam aSnAtu piSitam |
   vijānanto 'py ete vayam iha viyaj jāla-jaṭilān	vijAnantaH api ete vayam iha viyat jAla--jawilAn
   na muñcāmaḥ kānām ahaha gahano moha-mahimā || BharSt_3.18 ||	na muQcAmaH kAnAm ahaha gahanaH moha--mahimA || BharSt-_3.18 ||
   tṛṣā śuṣyaty āsye pibati salilaṃ śīta-madhuraṃ	tRzA Suzyati Asye pibati salilam SIta--maDuram
   kṣudhārtaḥ śālyannaṃ kavalayati māṃsādi-kalitam |	kzuDA-ArtaH SAli-annam kavalayati mAMsa-Adi--kalitam |
   pradīpte kāmāgnau sudṛḍhataram āliṅgati vadhūṃ	pradIpte kAma-agnO su-dRXataram AliFgati vaDUm
   pratīkāraṃ vyādhaḥ sukham iti viparyasyati janaḥ || BharSt_3.19 ||	pratIkAram vyADaH suKam iti viparyasyati janaH || BharSt-_3.19 ||
   tuṅgaṃ veśma sutāḥ satām abhimatāḥ saṅkhyātigāḥ sampadaḥ	tuFgam veSma sutAH satAm aBimatAH saFKyA-atigAH sampadaH
   kalyāṇī dayitā vayaś ca navam ity ajñāna-mūḍho janaḥ |	kalyANI dayitA vayaH ca navam iti ajQAna-mUXaH janaH |
   matvā viśvam anaśvaraṃ niviśate saṃsāra-kārā-gṛhe	matvA viSvam anaSvaram niviSate saMsAra--kArA--gRhe
   saṃdṛśya kṣaṇa-bhaṅguraṃ tad akhilaṃ dhanyas tu sannyasyati || BharSt_3.20	saMdRSya kzaNa-BaFguram tat aKilam DanyaH tu sannyasyati || BharSt-_3.20
   dīnā dīna-mukhaiḥ sadaiva śiśukairākṛṣṭa-jīrṇāmbarā	dInA dIna--muKEH sadA-eva SiSukEH-AkRzwa--jIrNa-ambarA
   krośadbhiḥ kṣudhitair niranna-vidhurā dṛśyā na ced gehinī |	kroSadBiH kzuDitEH niranna--viDurA dRSyA na ced gehinI |
   yācñā-bhaṅga-bhayena gadgada-gala-truṭyad-vilīnākṣaraṃ	yAcQA-BaFga--Bayena gadgada-gala-truwi-ad--vilIna-akzaram
   ko dehīti vadet sva-dagdha-jaṭharasyārthe manasvī pumān || BharSt_3.21 ||	kaH dehi-iti vadet sva--dagDa---jaWarasya-arTe manasvI pumAn || BharSt-_3.21 ||
   abhimata-mahāmāna-granthi-prabheda-paṭīyasī	aBimata-mahAmAna--granTi--praBeda--pawIyasI
   gurutara-guṇa-grāmābhoja-sphuṭojjvala-candrikā |	gurutara--guNa--grAmA-Boja--sPuwa-ujjvala--candrikA |
   vipula-vilal-lajjā-vallī-vitāna-kuṭhārikā	vipula--vilal-lajjA-vallI--vitAna-kuWArikA
   jaṭhara-piṭharī duspureyaṃ karoti viḍambanam || BharSt_3.22 ||	jaWara--piWarI duspurA-iyam karoti vixambanam || BharSt-_3.22 ||
   puṇye grāme vane vā mahati sita-paṭac-channa-pālī kapāliṃ	puNye grAme vane vA mahati sita-pawac-Canna-pAlI kapAlim
   hy ādāya nyāya-garbha-dvija-huta-huta-bhug dhūma-dhūmropakaṇṭhe |	hi AdAya nyAya-garBa-dvija-huta--huta-Buj DUma-DUmra-upakaNWe |
   dvāraṃ dvāraṃ praviṣṭo varam udara-darī-pūraṇāya kṣudhārto	dvAram dvAram pravizwaH varam udara-darI--pUraNAya kzuDA-ArtaH-
   mānī prāṇaiḥ sanātho na punar anudinaṃ tulya-kulyesu dīnaḥ || BharSt_3.23	mAnI prANEH sanATaH na punar anudinam tulya--kulyesu dInaH || BharSt-_3.23
   gaṅgā-taraṅga-kaṇa-śīkara-śītalāni	gaFgA-taraFga--kaNa--SIkara--SItalAni
   vidyādharādhyuṣita-cāru-śilā-talāni |	vidyADara-aDyuzita--cAru-SilA--talAni |
   sthānāni kiṃ himavataḥ pralayaṃ gatāni	sTAnAni kim himavataH pralayam gatAni
   yat sāvamāna-para-piṇḍa-ratā manuṣyāḥ || BharSt_3.24 ||	yat sa-avamAna---para-piNxa--ratAH manuzyAH || BharSt-_3.24 ||
   kiṃ kandāḥ kandarebhyaḥ pralayam upagatā nirjharā vā giribhyaḥ	kim kandAH kandareByaH pralayam upagatAH nirJarAH vA giriByaH
   pradhvastā vā tarubhyaḥ sarasa-gala-bhṛto valkalinyaś ca śākhāḥ |	praDvastAH vA taruByaH sarasa--gala-BRtaH valkalinyaH ca SAKAH |
   vīkṣyante yan mukhāni prasabham apagata-praśrayāṇāṃ khalānāṃ	vIkzyante yat muKAni prasaBam apagata--praSrayANAm KalAnAm
   duḥkhāpta-svalpa-vitta-smaya-pavana-vaśānartita-bhrū-latāni || BharSt_3.25	duHKa-Apta-su-alpa--vid-ta--smaya--pavana--vaSA-nartita--BrU--latAni || BharSt-_3.25
   puṇyair mūla-phalais tathā praṇayinīṃ vṛttiṃ kuruṣvādhunā	puNyEH mUla-PalEH taTA praNayinIm vRttim kuruzva-aDunA
   bhū-śayyāṃ nava-pallavair akṛpaṇair uttiṣṭha yāvo vanam |	BU-SayyAm nava--pallavEH akRpaNEH uttizWa yAvaH vanam |
   kṣudrāṇām aviveka-mūḍha-manasāṃ yatreśvarāṇāṃ sadā	kzudrANAm aviveka-mUXa--manasAm yatra-ISvarANAm sadA
   vitta-vyādhi-vikāra-vihvala-girāṃ nāmāpi na śrūyate || BharSt_3.26 ||	vitta--vyADi--vikAra-vihvala--girAm nAma-api na SrUyate || BharSt-_3.26 ||
   phalaṃ svecchā-labhyaṃ prativanam akhedaṃ kṣitiruhāṃ	Palam sva-icCA-a-laByam prativanam aKedam kzitiruhAm
   payaḥ sthāne sthāne śiśira-madhuraṃ puṇya-saritām |	payaH sTAne sTAne SiSira--maDuram puNya--saritAm |
   mṛdu-sparśā śayyā sulalita-latā-pallava-mayī	mRdu-sparSA SayyA su-lalita--latA--pallava--mayI
   sahante santāpaṃ tad api dhanināṃ dvāri kṛpaṇāḥ || BharSt_3.27 ||	sahante santApam tat api DaninAm dvAri kRpaNAH || BharSt-_3.27 ||
   ye vartante dhana-pati-puraḥ prārthanā-duḥkha-bhājo	ye vartante Dana-pati-puraH prArTanA--duHKa-BAjaH-
   ye cālpatvaṃ dadhati viṣayākṣepa-paryāpta-buddheḥ |	ye ca-alpa-tvam daDati vizaya-Akzepa--paryApta-budDeH |
   teṣām antaḥ-sphurita-hasitaṃ vāsarāṇi smareyaṃ	tezAm antar---sPurita--hasitam vAsarANi smareyam
   dhyāna-cchede śikhari-kuhara-grāva-śayyā-niṣaṇṇaḥ || BharSt_3.28 ||	DyAna--cCede SiKari-kuhara--grAva-SayyA--nizaNNaH || BharSt-_3.28 ||
   ye santoṣa-nirantara-pramuditas teṣāṃ na bhinnā mudo	ye santoza--nirantara--pramuditaH tezAm na BinnA mudaH-
   ye tv anye dhana-lubdha-saṅkala-dhiyas tesāṃ na tṛṣṇāhatā |	ye tu anye Dana-lubDa--saFkala--DiyaH tesAm na tRzNA-AhatA |
   itthaṃ kasya kṛte kutaḥ sa vidhinā kīdṛk-padaṃ sampadāṃ	itTam kasya kRte kutas sa viDinA kIdRS---padam sampadAm
   svātmany eva samāpta-hema-mahimā merur na me rocate || BharSt_3.29 ||	sva-Atmani eva samApta--hema--mahimA meruH na me rocate || BharSt-_3.29 ||
   bhikṣāhāram adainyam apratisukhaṃ bhīticchidaṃ sarvato	BikzA-AhAram adEnyam apratisuKam BIti=-Cidam sarvatas-
   durmātsarya-madābhimāna-mathanaṃ duḥkhaugha-vidhvaṃsanam |	durmAtsarya--mada-aBimAna-maTanam duHKa-oGa--viDvaMsanam |
   sarvatrānvaham aprayatna-sulabhaṃ sādhu-priyaṃ pāvanaṃ	sarvatra-anvaham aprayatna--sulaBam sADu--priyam pAvanam
   śambhoḥ satram avāyam akṣaya-nidhiṃ śaṃsanti yogīśvarāḥ || BharSt_3.30 ||	SamBoH satram avAyam akzaya-niDim SaMsanti yogi-ISvarAH || BharSt-_3.30 ||
   bhoge rogamayaṃ kule cyuti-bhayaṃ vitte nṛpālād bhayaṃ	Boge roga-mayam kule cyuti-Bayam vitte nRpAlAt Bayam
   māne dhainya-bhayaṃ bale ripu-bhayaṃ rūpe jarāya bhayam |	mAne DEnya--Bayam bale ripu--Bayam rUpe jarAya Bayam |
   śāstre vādibhayaṃ guṇe khala-bhayaṃ kāye kṛtāntād bhayaṃ	SAstre vAdi-Bayam guNe Kala-Bayam kAye kRtAntAt Bayam
   sarvaṃ vastu bhayānvitaṃ bhuvi nṝṇāṃ vairāgyam evābhayam || BharSt_3.31 ||	sarvam vastu Baya-anvitam Buvi nLNAm vErAgyam eva-aBayam || BharSt-_3.31 ||
   ākrāntaṃ maraṇena janma jarasā cātyujjvalaṃ yauvanaṃ	AkrAntam maraNena janma jarasA ca-ati-ujjvalam yOvanam
   santoṣo dhana-lipsayā śama-mukhaṃ prauḍhāṅganā-vibhramaiḥ |	santozaH Dana--lipsayA Sama-muKam prOXa-aFganA--viBramEH |
   lokair matsaribhir guṇā vana-bhuvo vyālair nṛpā durjanair	lokEH matsariBiH guNAH vana-BuvaH vyAlEH nRpAH durjanEH-
   asthairyeṇa vibhūtayo 'py apahatā grastaṃ na kiṃ kena vā || BharSt_3.32 ||	asTEryeNa viBUtayaH api apahatAH grastam na kim kena vA || BharSt-_3.32 ||
   ādhi-vyādhi-śatair janasya vividhair ārogyam unmūlyate	ADi--vyADi--SatEH janasya viviDEH Arogyam unmUlyate
   lakṣmīr yatra patanti tatra vivṛta-dvārā iva vyāpadaḥ |	lakzmIH yatra patanti tatra vivRta--dvArAH iva vyApadaH |
   jātaṃ jātam avaśyam āśu vivaśaṃ mṛtyuḥ karoty ātmasāt	jAtam jAtam avaSyam ASu vivaSam mRtyuH karoti AtmasAt-
   tat kiṃ tena niraṅkuśena vidhinā yan nirmitaṃ susthiram || BharSt_3.33 ||	tat kim tena niraFkuSena viDinA yat nirmitam susTiram || BharSt-_3.33 ||
   bhogās tuṅgataraṅga-bhaṅga-taralāḥ prāṇāḥ kṣaṇa-dhvaṃsinaḥ	BogAH tuFga-taraFga--BaFga--taralAH prANAH kzaNa--DvaMsinaH
   stokāny eva dināni yauvana-sukhaṃ sphūrtiḥ priyāsu sthitā |	stokAni eva dinAni yOvana--suKam sPUrtiH priyAsu sTitA |
   tat-saṃsāram asāram eva nikhilaṃ buddhvā budhā bodhakā	tat-saMsAram asAram eva niKilam budDvA buDA boDakA
   lokānugraha-peśalena manasā yatnaḥ samādhīyatām || BharSt_3.34 ||	loka-anugraha-peSalena manasA yatnaH samADIyatAm || BharSt-_3.34 ||
   bhogā megha-vitāna-madhya-vilasat-saudāminī-cañcalā	BogA meGa-vitAna--maDya--vilasat--sOdAminI--caQcalA
   āyur vāyu-vighaṭṭitābja-paṭalī-līnāmbuvad bhaṅguram |	AyuH vAyu--viGawwita-abja--pawalI--lIna-ambu-vat BaFguram |
   līlā yauvana-lālasās tanubhṛtām ity ākalayya drutaṃ	lIlAH yOvana-lAlasAH tanuBRtAm iti Akalayya drutam
   yoge dhairya-samādhi-siddhi-sulabhe buddhiṃ vidadhvaṃ budhāḥ ||	yoge DErya--samADi--sidDi--sulaBe budDim vidaDvam buDAH ||
   BharSt_3.35 ||	BharSt_3.35 ||
   āyuḥ kallola-lolaṃ katipaya-divasa-sthāyinī yauvana-śrīr	AyuH kallola--lolam katipaya--divasa---sTAyinI yOvana--SrIH-
   arthāḥ saṅkalpa-kalpā ghana-samaya-taḍid-vibhramā bhoga-pūgāḥ |	arTAH saFkalpa--kalpAH Gana--samaya--taxid--viBramAH Boga--pUgAH |
   kaṇṭhāśleṣopagūḍha tad api ca na ciraṃ yat priyābhaḥ praṇītaṃ	kaNWa-ASleza-upagUXa tat api ca na ciram yat priya-ABaH praNItam
   brahmaṇy āsakta-cittā bhavata bhavamayāmbhodhi-pāraṃ tarītum ||	brahmaNi Asakta--cittA Bavata Bava-maya-amBoDi--pAram tarItum ||
   BharSt_3.36 ||	BharSt_3.36 ||
   kṛcchreṇāmedhya-madhye niyamita-tanubhiḥ sthīyate garbha-vāse	kRcCreNa-ameDya--maDye niyamita--tanuBiH sTIyate garBa--vAse
   kāntā-viśleṣa-duḥkha-vyatikara-viṣamo yauvane copabhogaḥ |	kAntA--viSleza--duHKa--vyatikara--vizamaH yOvane ca-upaBogaH |
   vāmākṣīṇām avajñā-vihasita-vasatir vṛddha-bhāvo 'nyasādhuḥ	vAma-akzINAm avajQA--vihasita--vasatiH vRdDa-BAvaH anya-sADuH
   saṃsāre re manuṣyā vadata yadi sukhaṃ svalpam apy asti kiñcit ||	saMsAre re manuzyAH vadata yadi suKam su-alpam api asti kiQcid ||
   BharSt_3.37 ||	BharSt_3.37 ||
   vyāghrīva tiṣṭhati jarā paritarjayantī	vyAGrI-iva tizWati jarA paritarjayantI
   rogāś ca śatrava iva praharanti deham |	rogAH ca SatravaH iva praharanti deham |
   āyuḥ parisravanti bhinna-ghaṭā-divāmbho	AyuH parisravanti Binna--GawA-divA-amBaH-
   lokas tathāpy ahitam ācaratīti citram || BharSt_3.38 ||	lokaH taTA-api ahitam Acarati-iti citram || BharSt-_3.38 ||
   bhogā bhaṅgura-vṛttayo bahuvidhās tair eva cāyaṃ bhavastat	BogAH BaFgura--vRttayaH bahuviDAH tEH eva ca-ayam BavaH-tat-
   kasyeha kṛte paribhramata re lokāḥ kṛtaṃ ceṣṭataiḥ |	kasya-iha kRte pariBramata re lokAH kRtam cezwatEH |
   āśā-pāśa-śatāpaśānti-viśadaṃ cetaḥ-samādhīyatāṃ	ASA--pASa-Sata-apaSAnti-viSadam cetaH-samADIyatAm
   kāmotpatti-vaśāt svadhāmani yadi śraddeyam asmad-vacaḥ || BharSt_3.39 ||	kAma-utpatti-vaSAt sva-DAmani yadi Sraddeyam asmat--vacaH || BharSt-_3.39 ||
   sakhe dhanyāḥ kecit truṭita-bhava-bandha-vyatikarā	saKe DanyAH kecid truwita-Bava--banDa--vyatikarA
   vanānte cittāntar-viṣam aviṣayāśīt-viṣa-gatāḥ |	vanAnte citta-antar--vizam avizaya-aSIt--viza--gatAH |
   śarac-candra-jyotsnādhavala-gaganābhoga-subhagāṃ	Sarac-candra--jyotsnA-Davala--gagana-ABoga-suBagAm
   nayante ye rātriṃ sukṛta-caya-cintaika-śaraṇāḥ || BharSt_3.39*1 ||	nayante ye rAtrim su-kRta--caya--cintA-eka-SaraNAH || BharSt-_3.39*1 ||
   brahmendrādi-marud-gaṇāṃs tṛṇa-kaṇān yatra sthito manyate	brahma-indra-Adi--marut---gaNAn tRNa--kaNAn yatra sTitaH manyate
   yat-svādād virasā bhavanti vibhavās trailokya-rājyādayaḥ |	yat--svAdAt virasAH Bavanti viBavAH trElokya--rAjya-AdayaH |
   bhogaḥ ko 'pi sa eva eka paramo nityodito jṛmbhate	BogaH kaH api saH eva eka paramaH nityoditaH jRmBate
   bhoḥ sādho kṣaṇa-bhaṅgure tad itare bhoge ratiṃ mā kṛthāḥ || BharSt_3.40	BoH sADo kzaNa-BaFgure tat itare Boge ratim mA kRTAH || BharSt-_3.40
   sā ramyā nagarī mahān sa nṛpatiḥ sāmanta-cakraṃ ca tat	sA ramyA nagarI mahAn sa nRpatiH sAmanta--cakram ca tat-
   pārśve tasya ca sā vidagdha-pariṣat tāś candra-bimbānanāḥ |	pArSve tasya ca sA vidagDa--parizad tAH candra--bimba-AnanAH |
   udvṛttaḥ sa rāja-putra-nivahas te vandinas tāḥ kathāḥ	udvRttaH sa rAja--putra--nivahaH te vandinaH tAH kaTAH
   sarvaṃ yasya vaśād agāt smṛti-pathaṃ kālāya tasmai namaḥ || BharSt_3.41 ||	sarvam yasya vaSAt agAt smRti--paTam kAlAya tasmE namaH || BharSt-_3.41 ||
   yatrānekaḥ kvacid api gṛhe tatra tiṣṭhaty athaiko	yatra-anekaH kvacid api gRhe tatra tizWati aTa-eko
   yatrāpy ekas tad anu bahavas tatra naiko 'pi cānte |	yatra-api ekaH tat anu bahavaH tatra na-ekaH api ca-ante |
   itthaṃ nayau rajani-divasau lolayan dvāv ivākṣau	itTam nayO raja-ni-di-vasO lolayan dvO iva-akzO
   kālaḥ kalyo bhuvana-phalake kraḍati prāṇi-śāraiḥ || BharSt_3.42 ||	kAlaH kalyaH Buvana-Palake kraxati prANi--SArEH || BharSt-_3.42 ||
   ādityasya gatāgatair aharahaḥ saṃkṣīyate jīvitaṃ	Adityasya gatAgatEH aharahar saMkzIyate jIvitam
   vyāpārair bahu-kārya-bhāra-gurubhiḥ kālo 'pi na jñāyate |	vyApArEH bahu--kArya--BAra-guruBiH kAlaH api na jQAyate |
   dṛṣṭvā janma-jarā-vipatti-maraṇaṃ trāsaś ca notpadyate	dRzwvA janma---jarA--vipatti-maraNam trAsaH ca na-utpadyate
   pītvā mohamayīṃ pramāda-madirām unmatta-bhūtaṃ jagat || BharSt_3.43 ||	pItvA moha-mayIm pramAda--madirAm unmatta-BUtam jagat || BharSt-_3.43 ||
   rātriḥ saiva punaḥ sa eva divaso matvā mudhā jantavo	rAtriH sA-eva punar saH eva divasaH matvA muDA jantavaH-
   dhāvanty udyaminas tathaiva nibhṛta-prārabdha-tat-tat-kriyāḥ |	DAvanti udyaminaH taTA-eva niBRta-prArabDa---tat-tat--kriyAH |
   vyāpāraiḥ punar-ukta-bhūta-viṣayair itthaṃ vidhenāmunā	vyApArEH punar--ukta-BUta--vizayEH itTam viDena-amunA
   saṃsāreṇa kadarthitā vayam aho mohān na lajjāmahe || BharSt_3.44 ||	saMsAreNa kadarTitAH vayam aho mohAt na lajjAmahe || BharSt-_3.44 ||
   na dhyānaṃ padam īśvarasya vidhivat saṃsāra-vicchittaye	na DyAnam padam ISvarasya viDivat saMsAra--vicCittaye
   svarga-dvāra-kapāṭa-pāṭana-paṭur dharmo 'pi nopārjitaḥ |	svarga-dvAra--kapAwa--pAwana--pawuH DarmaH api na-upArjitaH |
   nārī-pīna-payodharoru-yugalaṃ svapne 'pi nāliṅgitaṃ	nArI--pIna--payoDara-Uru--yugalam svapne api na-AliFgitam
   mātuḥ kevalam eva yauvana-vana-cchede kuṭhārā vayam || BharSt_3.45 ||	mAtuH kevalam eva yOvana-vana-=-Cede kuWArAH vayam || BharSt-_3.45 ||
   nābhyastā prativādi-vṛnda-damanī vidyā vinītocitā	na-aByastA prativAdi--vRnda-damanI vidyA vinIta-ucitA
   khaḍgāgraiḥ kari-kumbha-pīṭha-dalanair nākaṃ na nītaṃ yaśaḥ |	Kaxga-agrEH kari-kumBa--pIWa--dalanEH nAkam na nItam yaSaH |
   kāntākomala-pallavādhara-rasaḥ pīto na candrodaye	kAntA-komala--pallava-aDara--rasaH pItaH na candra-udaye
   tāruṇyaṃ gatam eva niṣphalam aho śūnyālaye dīpavat || BharSt_3.46 ||	tAruNyam gatam eva nizPalam aho SUnya-Alaye dIpa-vat || BharSt-_3.46 ||
   vidyā nādhigatā kalaṅka-rahitā vittaṃ ca nopārjitaṃ	vidyA na-aDigatA kalaFka--rahitA vittam ca na-upArjitam
   śuśrūṣāpi samāhitena manasā pitror na sampāditā |	SuSrUzA-api samAhitena manasA pitroH na sampAditA |
   ālolāyata-locanāḥ priyatamāḥ svapne 'pi nāliṅgitāḥ	Alola-Ayata--locanAH priyatamAH svapne api na-AliFgitAH
   kālo 'yaṃ para-piṇḍa-lolupatayā kākair iva preryate || BharSt_3.47 ||	kAlaH ayam para--piNxa--lolupa-tayA kAkEH iva preryate || BharSt-_3.47 ||
   vayaṃ yebhyo jātāś cira-parigatā eva khalu te	vayam yeByaH jAtAH cira--parigatAH eva Kalu te
   samaṃ yaiḥ saṃvṛddhāḥ smṛti-viṣayatāṃ te 'pi gamitāḥ |	samam yEH saMvRdDAH smRti-vizaya-tAm te api gamitAH |
   idānīm ete smaḥ pratidivasam āsanna-patanā	idAnIm ete smaH pratidivasam Asanna-patanA
   gatās tulyāvasthāṃ sikatilanadī-tīra-tarubhiḥ || BharSt_3.48 ||	gatAH tulya-avasTAm sika-tila-nadI--tIra-taruBiH || BharSt-_3.48 ||
   āyur varṣa-śataṃ nṝṇāṃ parimitaṃ rātrau tad-ardhaṃ gataṃ	AyuH varza--Satam nLNAm parimitam rAtrO tad--arDam gatam
   tasyārdhasya parasya cārdham aparaṃ bālatva-vṛddhatvayoḥ |	tasya-arDasya parasya ca-arDam aparam bAla-tva--vRdDa-tvayoH |
   śeṣaṃ vyādhi-viyoga-duḥkha-sahitaṃ sevādibhir nīyate	Sezam vyADi--viyoga--duHKa--sahitam sevA-AdiBiH nIyate
   jīve vārita-raṅga-cañcalatare saukhyaṃ kutaḥ prāṇinām || BharSt_3.49 ||	jIve vArita-raFga--caQcalatare sOKyam kutas prANinAm || BharSt-_3.49 ||
   kṣaṇaṃ bālo bhūtvā kṣaṇam pai yuvā kāma-rasikaḥ	kzaNam bAlaH BUtvA kzaNam pE yuvA kAma-rasikaH
   kṣaṇaṃ vittair hīnaḥ kṣaṇam api ca sampūrṇa-vibhavaḥ |	kzaNam vittEH hInaH kzaNam api ca sampUrNa--viBavaH |
   jarā-jīrṇair aṅgair naṭa iva balī-maṇḍita-tanūr	jarA-a--jIrNEH aFgEH nawaH iva balI--maNxita--tanUH-
   naraḥ saṃsārānte viśati yamadhānīya-vanikām || BharSt_3.50 ||	naraH saMsAra-ante viSati yama-DAnIya-vanikAm || BharSt-_3.50 ||
   tvaṃ rājā vayam apy upāsita-guru-prajñābhimānonnatāḥ	tvam rAjA vayam api upAsita--guru--prajQA-aBimAna-unnatAH
   khyātas tvaṃ vibhavair yaśāṃsi kavayo dikṣu pratanvanti naḥ |	KyAtaH tvam viBavEH yaSAMsi kavayaH dikzu pratanvanti naH |
   itthaṃ māna-dhanāti-dūram ubhayor apy āvayor antaraṃ	itTam mAna-DanAti-dUram uBayoH api AvayoH antaram
   yady asmāsu parāṅmukho 'si vayam apy ekāntato niḥspṛhā || BharSt_3.51 ||	yadi asmAsu parAFmuKaH asi vayam api ekAntataH niHspRhAH || BharSt-_3.51 ||
   arthānām īśiṣe tvaṃ vayam api ca girām īśmahe yāvad arthaṃ	arTAnAm ISize tvam vayam api ca girAm ISmahe yAvat arTam
   śūras tvaṃ vādi-darpa-vyupaśamana-vidhāva-kṣayaṃ pāṭavaṃ naḥ |	SUraH tvam vAdi-darpa--vyupaSamana--viDO=-a-kzayam pAwavam naH |
   sevante tvāṃ dhanāḍhyā matimalahatayemām api śrotu-kāmāmayy	sevante tvAm Dana-AXyAH mati-mala-hatayA-imAm api Srotu-kAma-AmayI-
   apy āsthā na te cet tvayi mama nitarām eva rājann anāsthā || BharSt_3.52	api AsTA na te ced tvayi mama nitarAm eva rAjan anAsTA || BharSt-_3.52
   vayam iha parituṣṭā valkalais tvaṃ dukūlaiḥ	vayam iha parituzwAH valkalEH tvam dukUlEH
   sama iha paritoṣo nirviśeṣo viśeṣaḥ |	samaH iha paritozaH nirviSezaH viSezaH |
   sa tu bhavatu daridro yasya tṛṣṇā viśālā	sa tu Bavatu daridraH yasya tRzNA viSAlA
   manasi ca parituṣṭe ko 'rthavān ko daridraḥ || BharSt_3.53 ||	manasi ca parituzwe kaH arTavAn kaH daridraH || BharSt-_3.53 ||
   phalam alam aśanāya svādu pānāya toyaṃ	Palam alam aSanAya svAdu pAnAya toyam
   kṣitir api śayanārthaṃ vāsase valkalaṃ ca |	kzitiH api Sayana-arTam vAsase valkalam ca |
   nava-ghana-madhupāna-bhrānta-sarvendriyāṇāmavinayam	nava--Gana--maDu-pAna-BrAnta--sarva-indriyANAm-avinayam
   anumantuṃ notsahe durjanānām || BharSt_3.54 ||	anumantum na-utsahe durjanAnAm || BharSt-_3.54 ||
   aśnīmahi vayaṃ bhikṣām āśāvāso vasīmahi |	aSnImahi vayam BikzAm ASAvAsaH vasImahi |
   śayīmahi mahī-pṛṣṭhe kurvīmahi kim īśvaraiḥ || BharSt_3.55 ||	SayImahi mahI--pRzWe kurvImahi kim ISvarEH || BharSt-_3.55 ||
   na naṭā nā viṭā na gāyakā na ca sabhyetara-vāda-cuñcavaḥ |	na nawA nA viwAH na gAyakAH na ca saByetara-vAda--cuQcavaH |
   nṛpam īkṣitum atra ke vayaṃ stana-bhārān amitā na yoṣitaḥ || BharSt_3.56	nRpam Ikzitum atra ke vayam stana--BArAn amitA na yozitaH || BharSt-_3.56
   vipula-hṛdayair īśair etaj jagaj janitaṃ purā	vipula--hRdayEH ISEH etat jagat janitam purA
   vidhṛtam aparair dattaṃ cānyair vijitya tṛṇaṃ yathā |	viDRtam aparEH dattam ca-anyEH vijitya tRNam yaTA |
   iha hi bhuvanāny anyair dhīrāś caturdaśa bhuñjate	iha hi BuvanAni anyEH DIrAH caturdaSa BuQjate
   katipaya-pura-svāmye puṃsāṃ ka eṣa mada-jvaraḥ || BharSt_3.57 ||	katipaya-pura--svAmye puMsAm kaH eza mada-jvaraH || BharSt-_3.57 ||
   abhuktāyāṃ yasyāṃ kṣaṇam api na yātaṃ nṛpa-śatair	aBuktAyAm yasyAm kzaNam api na yAtam nRpa--SatEH-
   dhuvas tasyā lābhe ka iva bahumānaḥ kṣiti-bhṛtām |	DuvaH tasyAH lABe kaH iva bahu-mAnaH kziti-BRtAm |
   tad-aṃśasyāpy aṃśe tad-avaya-leśe 'pi patayo	tad--aMSasya-api aMSe tad--avaya-leSe api patayaH-
   viṣāde kartavye vidadhati jaḍāḥ pratyuta mudam || BharSt_3.58 ||	vizAde kartavye vidaDati jaxAH pratyuta mudam || BharSt-_3.58 ||
   mṛt-piṇḍo jala-rekhayā bala-yatiḥ sarvo 'py ayaṃ nanv aṇuḥ	mRt-piNxaH jala-reKayA bala-yatiH sarvaH api ayam nanu aNuH
   svāṃśīkṛtya sa eva saṅgara-śatai rājñāṃ gaṇā bhuñjate |	svAMSIkRtya saH eva saFga-ra--SatEH rAjQAm gaNAH BuQjate |
   ye dadyur dadato 'thavā kim aparaṃ kṣudrā daridraṃ bhṛśaṃ	ye dadyuH dadataH aTavA kim aparam kzudrA daridram BRSam
   dhig dhik tān puruṣādhamān dhanakaṇān vāñchanti tebhyo 'pi ye ||	Dik Dik tAn puruza-aDamAn Dana-kaNAn vAQCanti teByaH api ye ||
   BharSt_3.59 ||	BharSt_3.59 ||
   sa jātaḥ ko 'py āsīn madana-ripuṇā mūrdhni dhavalaṃ	sa jAtaH kaH api AsIt madana-ripuNA mUrDni Davalam
   kapālaṃ yasyoccair vinihitam alaṅkāra-vidhaye |	kapAlam yasya-uccEs vinihitam alaFkAra--viDaye |
   nṛbhiḥ prāṇa-trāṇa-pravaṇa-matibhiḥ kaiścid adhunā	nRBiH prANa-trANa--pravaNa-matiBiH kEScid aDunA
   namadbhiḥ kaḥ puṃsām ayam atula-darpa-jvara-bharaḥ || BharSt_3.60 ||	namadBiH kaH puMsAm ayam atula--darpa--jvara--BaraH || BharSt-_3.60 ||
   pareṣāṃ cetāṃsi pratidivasam ārādhya bahudhā	parezAm cetAMsi pratidivasam ArADya bahuDA
   prasādaṃ kiṃ netuṃ viśasi hṛdaya kleśa-kalitam |	prasAdam kim netum viSasi hRdaya kleSa--kalitam |
   prasanne tvayy antaḥ-savayamudita-cintāmaṇi-gaṇo	prasanne tvayi antaH--savaya-m-udita--cintAmaNi--gaNaH-
   viviktaḥ saṅkalpaḥ kim abhilaṣitaṃ puṣyati na te || BharSt_3.61 ||	viviktaH saFkalpaH kim aBilazitam puzyati na te || BharSt-_3.61 ||
   satyām eva trilokī-sariti hara-śiraś cumbinīvac chaṭāyāṃ	satyAm eva trilokI--sariti hara-SiraH cumbinI-vat SawAyAm
   sad-vṛttiṃ kalpayantyāṃ baṭa-viṭapa-bhavair valkalaiḥ sat-phalaiś ca |	sat--vRttim kalpayantyAm bawa--viwa-pa-BavEH valkalEH sat-PalEH ca |
   ko 'yaṃ vidvān vipatti-jvara-janita-rujātīva-duḥkhāsikānāṃ	kaH ayam vidvAn vipatti-jvara-janita-rujA-atIva--duHKAsikAnAm
   vaktraṃ vīkṣeta duḥsthe yadi hi na vibhṛyāt sve kuṭumbe 'nukampām ||	vaktram vIkzeta duHsTe yadi hi na viBRyAt sve kuwumbe anukampAm ||
   BharSt_3.61*1 ||	BharSt_3.61*1 ||
   paribhramasi kiṃ mudhā kvacana citta viśrāmyatāṃ	pariBramasi kim muDA kvacana citta viSrAmyatAm
   svayaṃ bhavati yad yathā bhavati tat tathā nānyathā |	svayam Bavati yat yaTA Bavati tat taTA na-anyaTA |
   atītam ananusmarann api ca bhāvya-saṅkalpayannatarkita-	atItam ananusmaran api ca BAvya--saFkalpayan=-atarkita-
   samāgamānubhavāmi bhoganāham || BharSt_3.62 ||	samAgama-anuBavAmi BoganAham || BharSt-_3.62 ||
   etasmād viramendriyārtha-gahanādāyāsakād āśrayaśreyo-	etasmAt virama-indriya-arTa--gahanAt-AyAsakAt ASraya-SreyaH--
   mārgam aśeṣa-duḥkha-śamana-vyāpāra-dakṣaṃ kṣaṇāt |	mArgam aSeza--duHKa--Samana--vyApAra--dakzam kzaNAt |
   svātmībhāvam upaihi santyaja nijāṃ kallola-lolaṃ gatiṃ	sva-AtmIBAvam upEhi santyaja nijAm kallola--lolam gatim
   mā bhūyo bhaja bhaṅgurāṃ bhava-ratiṃ cetaḥ prasīdādhunā || BharSt_3.63 ||	mA BUyas Baja BaFgurAm Bava--ratim cetaH prasIda-aDunA || BharSt-_3.63 ||
   mohaṃ mārjaya tām upārjaya ratiṃ candrārdha-cūḍāmaṇau	moham mArjaya tAm upArjaya ratim candra-arDa-cUxAmaNO
   cetaḥ svarga-taraṅgiṇī-taṭa-bhuvām āsaṅgam aṅgīkuru |	cetaH svarga--taraFgiNI--tawa--BuvAm AsaFgam aFgIkuru |
   ko vā vīciṣu budbudeṣu ca taḍil-lekhāsu ca śrīṣu ca	kaH vA vIcizu budbudezu ca taxil-leKAsu ca SrIzu ca
   jvālāgreṣu ca pannageṣu sarid-vegeṣu ca ca-pratyayaḥ || BharSt_3.64 ||	jvAlA-agrezu ca pannagezu sarit--vegezu ca ca--pratyayaH || BharSt-_3.64 ||
   cetaś cintaya mā ramāṃ sakṛd imām asthāyinīm āsthayā	cetaH cintaya mA ramAm sakRt imAm asTAyinIm AsTayA
   bhūpāla-bhrukuṭī-kuṭī-viharaṇa-vyāpāra-paṇyāṅganām |	BUpAla--Bru-kuwI--kuwI--viharaNa--vyApAra--paNya-aFganAm |
   kanthā-kañcukinaḥ praviśya bhavana-dvārāṇi vārāṇasīrathyā-	kanTA--kaQcukinaH praviSya Bavana-dvArANi vArANasI-raTyA-
   paṅktiṣu pāṇi-pātra-patitāṃ bhikṣām apekṣāmahe || BharSt_3.65 ||	paFktizu pANi--pAtra--patitAm BikzAm apekzAmahe || BharSt-_3.65 ||
   agre gītaṃ sarasa-kavayaḥ pārśvayor dākṣiṇātyāḥ	agre gItam sarasa-ka-vayaH pArSvayoH dAkziNAtyAH
   paścāl līlāvalaya-raṇitaṃ cāmara-grāhiṇīnām |	paScAt lIlA-valaya--raNitam cAmara--grAhiNInAm |
   yady asty evaṃ kuru bhava-rasāsvādane lampaṭatvaṃ	yadi asti evam kuru Bava--rasa-AsvAdane lampawa-tvam
   no cec cetaḥ praviśa sahasā nirvikalpe samādhau || BharSt_3.66 ||	no ced cetaH praviSa sahasA nirvikalpe samADO || BharSt-_3.66 ||
   prāptāḥ śriyaḥ sakala-kāma-dudhās tataḥ kiṃ	prAptAH SriyaH sakala--kAma-duDAH tatas kim
   nyastaṃ padaṃ śirasi vidviṣatāṃ tataḥ kim |	nyastam padam Sirasi vidvizatAm tatas kim |
   sampāditāḥ praṇayino vibhavais tataḥ kiṃ	sampAditAH praNayinaH viBavEH tatas kim
   kalpaṃ sthitās tanubhṛtāṃ tanavas tataḥ kim || BharSt_3.67 ||	kalpam sTitAH tanuBRtAm tanavaH tatas kim || BharSt-_3.67 ||
   bhaktir bhave maraṇa-janma-bhayaṃ hṛdi-sthaṃ	BaktiH Bave maraNa--janma--Bayam hRdi-sTam
   sneho na bandhuṣu na manmathajā vikārāḥ |	snehaH na banDuzu na manmaTa-jAH vikArAH |
   saṃsarja doṣa-rahitā vijayā vanāntā	saMsarja doza--rahitA vijayA vanAntA
   vairāgyam asti kim itaḥ paramarthanīyam || BharSt_3.68 ||	vErAgyam asti kim itas param-arTanIyam || BharSt-_3.68 ||
   tasmād anantam ajaraṃ paramaṃ vikāsi	tasmAt anantam ajaram paramam vikAsi
   tad brahma cintaya kim ebhir asad-vikalpaiḥ |	tat brahma cintaya kim eBiH asat--vikalpEH |
   yasyānuṣaṅgiṇa ime bhuvanādhipatyabhogādayaḥ	yasya-anuzaFgiNaH ime Buvana-ADipatya-Boga-AdayaH
   kṛpaṇa-loka-matā bhavanti || BharSt_3.69 ||	kRpaNa-loka--matAH Bavanti || BharSt-_3.69 ||
   pātālam āviśasi yāsi nabho vilaṅghya	pAtAlam AviSasi yAsi naBaH vilaFGya
   diṅ-maṇḍalaṃ bhramasi mānasa cāpalena |	diF--maNxalam Bramasi mAnasa cApalena |
   bhrāntyāpi jātu vimalaṃ katham ātmanīnaṃ	BrAntyA-api jAtu vimalam kaTam AtmanInam
   na brahma saṃsarasi virvṛtimm eṣi yena || BharSt_3.70 ||	na brahma saMsarasi virvRtimm ezi yena || BharSt-_3.70 ||
   kiṃ vedaiḥ smṛtibhiḥ purāṇa-paṭhanaiḥ śāstrair mahā-vistaraiḥ	kim vedEH smRtiBiH purANa--paWanEH SAstrEH mahA--vistarEH
   svarga-grāma-kuṭī-nivāsa-phaladaiḥ karma-kriyā-vibhramaiḥ |	svarga--grAma--kuwI--nivAsa--Pala-dEH karma-kriyA--viBramEH |
   muktvaikaṃ bhava-duḥkha-bhāra-racanā-vidhvaṃsa-kālānalaṃ	muktvA-ekam Bava--duHKa--BAra--racanA--viDvaMsa--kAla-analam
   svātmānanda-pada-praveśa-kalanaṃ śesair vāṇig-vṛttibhiḥ || BharSt_3.71 ||	sva-Atma-Ananda-pada--praveSa--kalanam SesEH vANig-vRttiBiH || BharSt-_3.71 ||
   nāyaṃ te samayo rahasyam adhunā nidrāti nātho yadi	na-ayam te samayaH rahasyam aDunA nidrAti nATaH yadi
   sthitvā drakṣyati kupyati prabhur iti dvāreṣu yeṣāṃ vacaḥ |	sTitvA drakzyati kupyati praBuH iti dvArezu yezAm vacaH |
   cetas tān apahāya yāhi bhavanaṃ devasya viśveśitur	cetaH tAn apahAya yAhi Bavanam devasya viSva-ISituH-
   nirdauvārika-nirdayokty-aparuṣaṃ niḥsoma-śarma-pradam || BharSt_3.71*1 ||	nirdOvArika--nirdaya-ukty-aparuzam niHsoma--Sarma--pradam || BharSt-_3.71*1 ||
   yato meruḥ śrīmān nipatati yugāntāgni-valitaḥ	yatas meruH SrImAn nipatati yugAnta-agni--valitaH
   samudrāḥ śuṣyanti pracura-makara-grāha-nilayāḥ |	samudrAH Suzyanti pracura--makara--grAha--nilayAH |
   dharā gacchaty antaṃ dharaṇi-dhara-pādair api dhṛtā	DarA gacCati antam DaraNi-Dara--pAdEH api DRtA
   śarīre kā vārtā karikalabha-karṇāgra-capale || BharSt_3.72 ||	SarIre kA vArtA kari-kalaBa-karNa-agra---capale || BharSt-_3.72 ||
   gātraṃ saṅkucitaṃ gatir vigalitā bhraṣṭā ca dantāvalir	gAtram saFkucitam gatiH vigalitA BrazwA ca danta-AvaliH-
   dṛṣṭir nakṣyati vardhate vadhiratā vaktraṃ ca lālāyate |	dRzwiH nakzyati varDate vaDiratA vaktram ca lAlAyate |
   vākyaṃ nādriyate ca bāndhava-jano bhāryā na śuśrūṣate	vAkyam na-Adriyate ca bAnDava-janaH BAryA na SuSrUzate
   hā kaṣṭaṃ puruṣasya jīrṇa-vayasaḥ putro 'py amitrāyate || BharSt_3.73 ||	hA kazwam puruzasya jIrNa-vayasaH putraH api amitrAyate || BharSt-_3.73 ||
   varṇaṃ sitaṃ śirasi vīkṣya śiroruhāṇāṃ	varNam sitam Sirasi vIkzya SiroruhANAm
   sthānaṃ jarā-paribhavasya tadā pumāṃsam |	sTAnam jarA--pariBavasya tadA pumAMsam |
   āropitāṃsthi-śatakaṃ parihṛtya yānti	AropitAMsTi-Satakam parihRtya yAnti
   caṇḍāla-kūpam iva dūrataraṃ taruṇyaḥ || BharSt_3.74 ||	caNxAla-kUpam iva dUrataram taruNyaH || BharSt-_3.74 ||
   yāvat svastham idaṃ śarīram arujaṃ yāvac ca dūre jarā	yAvat svasTam idam SarIram arujam yAvat ca dUre jarA
   yāvac cendriya-śaktir apratihatā yāvat kṣayo nāyuṣaḥ |	yAvat ca-indriya--SaktiH apratihatAH yAvat kzayaH na-AyuzaH |
   ātma-śreyasi tāvad eva viduṣā kāryaḥ prayatno mahān	Atma--Sreyasi tAvat eva viduzA kAryaH prayatnaH mahAn
   sandīpte bhavane tu kūpa-khananaṃ pratyudyamaḥ kīdṛśaḥ || BharSt_3.75 ||	sandIpte Bavane tu kUpa--Kananam pratyudyamaH kIdRSaH || BharSt-_3.75 ||
   tapasyantaḥ santaḥ kim adhinivasāmaḥ sura-nadīṃ	tapasyantaH santaH kim aDinivasAmaH sura--nadIm
   guṇodārān dārān uta paricarāmaḥ savinayam |	guNa-udArAn dArAn uta paricarAmaH sa-vinayam |
   pibāmaḥ śāstraughānuta-vividha-kāvyāmṛta-rasān	pibAmaH SAstra-oGa-anuta--viviDa-kAvya-amRta-rasAn
   na vidmaḥ kiṃ kurmaḥ katipaya-nimeṣāyuṣi jane || BharSt_3.76 ||	na vidmaH kim kurmaH katipaya--nimeza-Ayuzi jane || BharSt-_3.76 ||
   durārādhyāś cāmī turaga-cala-cittāḥ kṣitibhujo	durArADyAH ca-amI turaga--cala--cittAH kzitiBujaH-
   vayaṃ tu sthūlecchāḥ sumahati phale baddha-manasaḥ |	vayam tu sTUla-icCAH su-mahati Pale badDa--manasaH |
   jarā dehaṃ mṛtyur harati dayitaṃ jīvitam idaṃ	jarA deham mRtyuH harati dayitam jIvitam idam
   sakhe nānyac chreyo jagati viduṣe 'nyatra tapasaḥ || BharSt_3.77 ||	saKe na-anyat SreyaH jagati viduze anyatra tapasaH || BharSt-_3.77 ||
   māne mlāyini khaṇḍite ca vasuni vyarthe prayāte 'rthini	mAne mlAyini KaNxite ca vasuni vyarTe prayAte arTini
   kṣīṇe bandhu-jane gate parijane naṣṭe śanair yauvane |	kzINe banDu--jane gate parijane nazwe SanEs yOvane |
   yuktaṃ kevalam etad eva sudhiyāṃ yaj jahnu-kanyā-payaḥpūtāgrāva-	yuktam kevalam etat eva suDiyAm yat jahnu-kanyA--payaH-pUtA-grAva-
   girīndra-kandara-taṭī-kuñje nivāsaḥ kvacit || BharSt_3.78 ||	giri-indra--kandara--tawI--kuQje nivAsaH kvacid || BharSt-_3.78 ||
   ramyāś candra-marīcayas tṛṇavatī ramyā vanānta-sthalī	ramyAH candra-marIcayaH tRNavatI ramyA vanAnta-sTalI
   ramyaṃ sādhu-samāgamāgata-sukhaṃ kāvyeṣu ramyāḥ kathāḥ |	ramyam sADu--samAgama-Agata--suKam kAvyezu ramyAH kaTAH |
   kopopāhita-bāṣpa-bindu-taralaṃ ramyaṃ priyāyā mukhaṃ	kopa-upAhita---bAzpa--bindu--taralam ramyam priyAyAH muKam
   sarvaṃ ramyam anityatām upagate citte na kiñcit punaḥ || BharSt_3.79 ||	sarvam ramyam anitya-tAm upagate citte na kiQcid punar || BharSt-_3.79 ||
   ramyaṃ harmya-talaṃ na kiṃ vasataye śravyaṃ na geyādikaṃ	ramyam harmya--talam na kim vasataye Sravyam na geya-Adikam
   kiṃ vā prāṇa-samāsamāgama-sukhaṃ naivādhika-prītaye |	kim vA prANa--samAsamAgama--suKam na-eva-aDika--prItaye |
   kintu bhrānta-pataṅga-kṣapavanavyālola-dīpāṅkuracchāyā-	kintu BrAnta--pataFga--kzapa-vana-vyAlola--dIpa-aFkura=-CAyA-
   cañcalam ākalayya sakalaṃ santo vanāntaṃ gatāḥ || BharSt_3.80 ||	caQcalam Akalayya sakalam santaH vanAntam gatAH || BharSt-_3.80 ||
   ā saṃsārāt tribhuvanam idaṃ cinvatāṃ tāt tādṛṅnaivāsmākaṃ	A saMsArAt triBuvanam idam cinvatAm tAt tAdRS-na-eva-asmAkam
   nayana-padavīṃ śrotra-mārgaṃ gato vā |	nayana-padavIm Srotra--mArgam gataH vA |
   yo 'yaṃ dhatte viṣaya-kariṇo gāḍha-gūḍhābhimānakṣīvasyāntaḥ-	yaH ayam Datte vizaya-kariNaH gAXa--gUXa-aBimAna-kzIvasya-antaH-
   karaṇa-kariṇaḥ saṃyamālāna-līlām || BharSt_3.81 ||	karaNa-kariNaH saMyama-AlAna--lIlAm || BharSt-_3.81 ||
   yad etat svacchandaṃ viharaṇam akārpaṇyam aśanaṃ	yat etat svacCandam viharaNam akArpaNyam aSanam
   sahāryaiḥ saṃvāsaḥ śrutam upaśamaika-vrata-phalam |	saha-AryEH saMvAsaH Srutam upaSama-eka-vrata-Palam |
   mano manda-spandaṃ bahir api cirasyāpi vimṛśanna	manaH manda--spandam bahis api cirasya-api vimRSan=-a
   jāne kasyaiṣā pariṇatir udārasya tapasaḥ || BharSt_3.82 ||	jAne kasya-ezA pariNatiH udArasya tapasaH || BharSt-_3.82 ||
   jīrṇā eva manorathāś ca hṛdaye yātaṃ ca tad yauvanaṃ	jIrNAH eva manoraTAH ca hRdaye yAtam ca tat yOvanam
   hantāṅgeṣu guṇāś bandhya-phalatāṃ yātā guṇajñair vinā |	hanta-aFgezu guNAH banDya-Pala-tAm yAtA guNa-jQEH vinA |
   kiṃ yuktaṃ sahasābhyupaiti balavān kālaḥ kṛtānto 'kṣamī	kim yuktam sahasA-aByupEti balavAn kAlaH kRtAntaH akzamI
   hā jñātaṃ madanāntakāṅghri-yugalaṃ muktvāsti nānyo gatiḥ || BharSt_3.83 ||	hA jQAtam madana-antaka-aFGri--yugalam muktvA-asti na-anyaH gatiH || BharSt-_3.83 ||
   maheśvare vā jagatām adhīśvare	maheSvare vA jagatAm aDISvare
   janārdane vā jagad-antarātmani |	janArdane vA jagat--antarAtmani |
   na vastu-bheda-pratipattir asti me	na vastu-Beda--pratipattiH asti me
   tathāpi bhaktis taruṇendu-śekhare || BharSt_3.84 ||	taTA-api BaktiH taruNa-indu--SeKare || BharSt-_3.84 ||
   sphurat-sphāra-jyotsnādhavalita-tale kvāpi puline	sPurat--sPAra--jyotsnA-Davalita--tale kvApi puline
   sukhāsīnāḥ śānta-dhvantisu rajanīṣu dyu-saritaḥ |	suKa-AsInAH SAnta-Dvantisu rajanIzu dyu--saritaH |
   bhavābhogodvignāḥ śiva śiva śivety uccavacasaḥ	Bava-aBoga-udvignAH Siva Siva Siva-iti ucca-vacasaH
   kadā yāsyāmo 'targata-bahula-bāṣpākula-daśām || BharSt_3.85 ||	kadA yAsyAmaH atargata--bahula--bAzpa-Akula-daSAm || BharSt-_3.85 ||
   mahādevo devaḥ sarid api ca saiṣā sura-saridguhā	mahAdevaH devaH sarit api ca sA-ezA sura--sarit-guhA
   evāgāraṃ vasanam api tā eva haritaḥ |	eva-AgAram vasanam api tAH eva haritaH |
   suhṛdā kālo 'yaṃ vratm idam adainya-vratam idaṃ	suhRdA kAlaH ayam vratm idam adEnya-vratam idam
   kiyad vā vakṣyāmo vaṭa-viṭapa evāstu dayitā || BharSt_3.- ||	kiyat vA vakzyAmaH vawa--viwapaH eva-astu dayitA || BharSt-_3. ||
   vitīrṇe sarvasve taruṇa-karuṇā-pūrṇa-hṛdayāḥ	vitIrNe sarva-sve taruNa---karuNA--pUrNa--hRdayAH
   smarantaḥ saṃsāre viguṇa-pariṇāmāṃ vidhi-gatim |	smarantaH saMsAre viguNa--pariNAmAm viDi--gatim |
   vayaṃ puṇyāraṇye pariṇata-śarac-candra-kiraṇās	vayam puNya-araNye pariNata--Sarac-candra-kiraNAH-
   triyāmā nesyāmo hara-caraṇa-cintaika-śaraṇāḥ || BharSt_3.86 ||	triyAmA nesyAmaH hara--caraNa--cintA-eka-SaraNAH || BharSt-_3.86 ||
   kadā vārāṇasyām amara-taṭinī-rodhasi vasan	kadA vArANasyAm amara--tawinI--roDasi vasan
   vasānaḥ kaupīnaṃ śirasi nidadhāno 'ñjali-puṭam |	vasAnaH kOpInam Sirasi nidaDAnaH aQjali-puwam |
   aye gaurīnātha tripurahara śambho trinayana	aye gOrInATa tripura-hara SamBo trinayana
   prasīdetyākrośan nimiṣam iva neṣyāmi divasān || BharSt_3.87 ||	prasIda-iti-AkroSan nimizam iva nezyAmi divasAn || BharSt-_3.87 ||
   udyāneṣu vicitra-bhojana-vidhis tīvrātitīvraṃ tapaḥ	udyAnezu vicitra--Bojana--viDiH tIvra-ati-tIvram tapaH
   kaupīnāvaraṇaṃ suvastram amitaṃ bhikṣāṭanaṃ maṇḍanam |	kOpIna-AvaraNam su-vastram amitam BikzAwanam maNxanam |
   āsannaṃ maraṇaṃ ca maṅgala-samaṃ yasyāṃ samutpadyate	Asannam maraNam ca maFgala--samam yasyAm samutpadyate
   tāṃ kāśīṃ parihṛtya hanta vibudhair anyatra kiṃ sthīyate || BharSt_3.- ||	tAm kASIm parihRtya hanta vibuDEH anyatra kim sTIyate || BharSt-_3. ||
   snātvā gāṅgaiḥ payobhiḥ śuci-kusuma-phalair arcayitvā vibho tvā	snAtvA gAFgEH payoBiH Suci--kusuma--PalEH arcayitvA viBo tvA
   dhyeye dhyānaṃ niveśya kṣiti-dhara-kuhara-grāva-paryaṅka-mūle |	Dyeye DyAnam niveSya kziti-Dara-kuhara--grAva--paryaFka--mUle |
   ātmārāmaḥ phalāśī guru-vacana-ratas tvat-prasādāt smarāre	Atma-ArAmaH Pala-ASI guru--vacana--rataH tvat--prasAdAt smara-are
   duḥkhaṃ mokṣye kadāhaṃ sama-kara-caraṇe puṃsi sevāsamuttham || BharSt_3.88	duHKam mokzye kadA-aham sama-kara--caraNe puMsi sevA-samutTam || BharSt-_3.88
   ekākī niḥspṛhaḥ śāntaḥ pāṇipātro digambaraḥ |	ekAkI niHspRhaH SAntaH pANi-pAtraH digambaraH |
   kadā śambho bhaviṣyāmi karma-nirmūlana-kṣamaḥ || BharSt_3.89 ||	kadA SamBo BavizyAmi karma--nirmUlana--kzamaH || BharSt-_3.89 ||
   pāṇiṃ pātrayatāṃ nisarga-śucinā bhaikṣeṇa santuṣyatāṃ	pANim pAtrayatAm nisarga--SucinA BEkzeNa santuzyatAm
   yatra kvāpi niṣīdatāṃ bahu-tṛṇaṃ viśvaṃ muhuḥ paśyatām |	yatra kvApi nizIdatAm bahu-tRNam viSvam muhur paSyatAm |
   atyāge 'pi tanor akhaṇḍa-paramānandāvabodha-spṛśā	atyAge api tanoH aKaNxa-parama-Ananda-avaboDa--spRSA
   madhvā ko 'pi śiva-prasāda-sulabhaḥ sampatsyate yoginām || BharSt_3.90 ||	maDvA kaH api Siva-prasAda--sulaBaH sampatsyate yoginAm || BharSt-_3.90 ||
   kaupīnaṃ śata-khaṇḍa-jarjarataraṃ kanthā punas tādṛśī	kOpInam Sata-KaNxa--jarjarataram kanTA punar tAdRSI
   naiścintyaṃ nirapekṣa-bhaikṣyam aśanaṃ nidrā śmaśāne vane |	nEScintyam nirapekza--BEkzyam aSanam nidrA SmaSAne vane |
   svātantryeṇa niraṅkuśaṃ viharaṇaṃ svāntaṃ praśāntaṃ sadā	svAtantryeNa niraFkuSam viharaNam sva-antam praSAntam sadA
   sthairyaṃ yoga-mahotsave 'pi ca yadi trailokya-rājyena kim || BharSt_3.91	sTEryam yoga--mahA-utsave api ca yadi trElokya---rAjyena kim || BharSt-_3.91
   brahmāṇḍaṃ maṇḍalī-mātraṃ kiṃ lobhāya manasvinaḥ |	brahmANxam maNxalI--mAtram kim loBAya manasvinaH |
   śapharī-sphurtenābdhiḥ kṣubdho na khalu jāyate || BharSt_3.92 ||	SaParI--sPurtena-abDiH kzubDaH na Kalu jAyate || BharSt-_3.92 ||
   mātar lakṣmi bhajasva kañcid aparaṃ mat-kāṅkṣiṇī mā sma bhūr	mAtar lakzmi Bajasva kaQcid aparam mat--kAFkziNI mA sma BUr
   bhogeṣu spṛhayālavas tava vaśe kā niḥspṛhāṇām asi |	Bogezu spRhayAlavaH tava vaSe kA niHspRhANAm asi |
   sadyaḥ syūta-palāśa-patra-puṭikā-pātraiḥ pavitrī-kṛtair	sadyas syUta--palASa-patra--puwikA--pAtrEH pavitrI-kRtEH-
   bhikṣā-vastubhir eva samprati vayaṃ vṛttiṃ samīhāmahe || BharSt_3.93 ||	BikzA--vastuBiH eva samprati vayam vRttim samIhAmahe || BharSt-_3.93 ||
   mahā-śayyā pṛthvī vipulam upadhānaṃ bhuja-latāṃ	mahA-SayyA pRTvI vipulam upaDAnam Buja-latAm
   vitānaṃ cākāśaṃ vyajanam anukūlo 'yam anilaḥ |	vitAnam ca-AkASam vyajanam anukUlaH ayam anilaH |
   śarac-candro dīpo virati-vanitā-saṅga-muditaḥ	Sarac-candraH dIpaH virati--vanitA--saFga-muditaH
   sukhī śāntaḥ śete munir atanu-bhūtir nṛpa iva || BharSt_3.94 ||	suKI SAntaH Sete muniH atanu-BUtiH nRpaH iva || BharSt-_3.94 ||
   bhikṣāsī jana-madhya-saṅga-rahitaḥ svāyatta-ceṣṭaḥ sadā	BikzAsI jana--maDya--saFga--rahitaH su-a-Ayatta--cezwaH sadA
   hānā-dāna-virakta-mārga-nirataḥ kaścit tapasvī sthitaḥ |	hAnA--dAna--virakta--mArga--nirataH kaScid tapasvI sTitaH |
   rathyākīrṇa-viśīrṇa-jīrṇa-vasanaḥ samprāpta-kanthāsano	raTyA-AkIrNa--viSIrNa--jIrNa-vasanaH samprApta-kanTAsanaH-
   nirmāno nirahaṅkṛtiḥ śama-sukhābhogaika-baddha-spṛhaḥ || BharSt_3.95 ||	nirmAnaH nirahaFkRtiH Sama--suKa-ABoga-eka--badDa-spRhaH || BharSt-_3.95 ||
   caṇḍālaḥ kim ayaṃ dvijātir athavā śūdro 'tha kiṃ tāpasaḥ	caNxAlaH kim ayam dvijAtiH aTavA SUdraH aTa kim tApasaH
   kiṃ vā tattva-viveka-peśala-matir yogīśvaraḥ ko 'pi kim |	kim vA tattva--viveka--peSala-matiH yogi-ISvaraH kaH api kim |
   ity utpanna-vikalpa-jalpa-mukharair ābhāṣyamāṇā janair	iti utpanna--vikalpa--jalpa--muKarEH ABAzyamANA janEH-
   na kruddhāḥ pathi naiva tuṣṭa-manaso yānti svayaṃ yoginaḥ || BharSt_3.96	na krudDAH paTi na-eva tuzwa-manasaH yAnti svayam yoginaH || BharSt-_3.96
   hiṃsā-śūnyam ayatna-labhyam aśanaṃ dhātrā marut-kalpitaṃ	hiMsA--SUnyam ayatna-laByam aSanam DAtrA marut--kalpitam
   vyālānaṃ paśavas tṛṇāṅkura-bhujas tuṣṭāḥ sthalī-śāyinaḥ |	vyAlAnam paSavaH tRNa-aFkura-BujaH tuzwAH sTalI--SAyinaH |
   saṃsārārṇava-laṅghana-kṣama-dhiyāṃ vṛttiḥ kṛtā sā nṛṇāṃ	saMsAra-arNava--laFGana--kzama-DiyAm vRttiH kRtA sA nRNAm
   tām anveṣayatāṃ prayānti satataṃ sarvaṃ samāptiṃ guṇāḥ || BharSt_3.97 ||	tAm anvezayatAm prayAnti satatam sarvam samAptim guNAH || BharSt-_3.97 ||
   gaṅgā-tīre hima-giri-śilā-baddha-padmāsanasya	gaFgA--tIre hima--giri-SilA---badDa--padmAsanasya
   brahma-dhyānābhyasana-vidhinā yoga-nidrāṃ gatasya |	brahma-DyAna-aByasana--viDinA yoga-nidrAm gatasya |
   kiṃ tair bhāvyaṃ mama sudivasair yatra te nirviśaṅkāḥ	kim tEH BAvyam mama su-divasEH yatra te nirviSaFkAH
   kaṇḍūyante jaraṭha-hariṇāḥ svāṅgam aṅge madīye || BharSt_3.98 ||	kaNxUyante jaraWa--hariNAH sva-aFgam aFge madIye || BharSt-_3.98 ||
   jīrṇāḥ kanthā tataḥ kiṃ sitam amala-paṭaṃ paṭṭa-sūtraṃ tataḥ kiṃ	jIrNAH kanTA tatas kim sitam amala-pawam pawwa--sUtram tatas kim
   ekā bhāryā tataḥ kiṃ haya-kari-sugaṇair āvṛto vā tataḥ kim |	ekA BAryA tatas kim haya--kari--su-gaNEH AvRtaH vA tatas kim |
   bhaktaṃ bhuktaṃ tataḥ kiṃ kadaśanam athavā vāsarānte tataḥ kiṃ	Baktam Buktam tatas kim kadaSanam aTavA vAsara-ante tatas kim
   vyakta-jyotir na vāntarmathita-bhava-bhayaṃ vaibhavaṃ vā tataḥ kim ||	vyakta-jyotiH na vA-antar-maTita--Bava--Bayam vEBavam vA tatas kim ||
   BharSt_3.- ||	BharSt_3. ||
   pāṇiḥ pātraṃ pavitraṃ bhramaṇa-parigataṃ bhaikṣyam akṣayyam annaṃ	pANiH pAtram pavitram BramaNa--parigatam BEkzyam akzayyam annam
   vistīrṇaṃ vastram āśā-daśakam acapalaṃ talpam asvalpam urvīm |	vistIrNam vastram ASA-daSakam acapalam talpam asvalpam urvIm |
   yeṣāṃ niḥsaṅgatāṅgī-karaṇa-pariṇata-svānta-santoṣiṇas te	yezAm niHsaFga-tAFgI-karaNa--pariNata--sva-anta--santoziNaH te
   dhanyāḥ saṃnyasta-dainya-vyatikara-nikarāḥ karma nirmūlayanti ||	DanyAH saMnyasta--dEnya--vyatikara--nikarAH karma nirmUlayanti ||
   BharSt_3.99 ||	BharSt_3.99 ||
   trailokyādhipatitvam eva virasaṃ yasmin mahāśāsane	trElokya-aDipati-tvam eva virasam yasmin mahA-SAsane
   tal labdhvāsana-vastra-māna-ghaṭane bhoge ratiṃ mā kṛthāḥ |	tat labDvA-Asana-vastra-mAna--Gawane Boge ratim mA kRTAH |
   bhogaḥ ko 'pi sa eka eva paramo nityoditā jṛmbhane	BogaH kaH api saH ekaH eva paramaH nitya-uditA jRmBane
   yat-svādād virasā bhavanti visayās trailokya-rājyādayaḥ || BharSt_3.99*1	yat--svAdAt virasAH Bavanti visayAH trElokya--rAjya-AdayaH || BharSt-_3.99*1
   mātar medini tāta māruti sakhe tejaḥ subandho jala	mAtar medini tAta mAruti saKe tejaH subanDaH jala
   bhrātar vyoma nibaddha eṣa bhavatām antyaḥ praṇāmāñjaliḥ |	BrAtar vyoma nibadDaH eza BavatAm antyaH praNAma-aQjaliH |
   yuṣmat-saṅga-vaśopajāta-sukṛta-sphāra-sphuran-nirmalajñānāpāsta-	yuzmat--saFga--vaSa-upajAta--su-kRta--sPAra--sPuran--nirmala-jQAna-apAsta-
   samasta-moha-mahimā līne para-brahmaṇi || BharSt_3.100 ||	samasta-moha--mahimA lIne para-brahmaNi || BharSt-_3.100 ||
   śayyā śaila-śilā-gṛhaṃ giri-guhā vastraṃ taruṇāṃ tvacaḥ	SayyA SEla-SilA-gRham giri-guhA vastram taruNAm tvacaH
   sāraṅgāḥ suhṛdo nanu kṣiti-ruhāṃ vṛttiḥ phalaiḥ komalaiḥ |	sAraFgAH suhRdaH nanu kziti-ruhAm vRttiH PalEH komalEH |
   yesāṃ nirjharam ambu-pānam ucitaṃ ratyai tu vidyāṅganā	yesAm nirJaram ambu--pAnam ucitam ratyE tu vidyA-aFganA
   manye te parameśvarāḥ śirasi yari baddho na sevāñjaliḥ || BharSt_3.100*1	manye te parameSvarAH Sirasi yari badDaH na sevA-aQjaliH || BharSt-_3.100*1
   dhairyaṃ yasya pitā kṣamā ca jananī śāntiś ciraṃ gehinī	DEryam yasya pitA kzamA ca jananI SAntiH ciram gehinI
   satyaṃ mitram idaṃ dayā ca bhaginī bhrātā manaḥ-saṃyamaḥ |	satyam mitram idam dayA ca BaginI BrAtA manaH--saMyamaH |
   śayyā bhūmi-talaṃ diśo 'pi vasanaṃ jñānāmṛtaṃ bhojanaṃ	SayyA BUmi-talam diSaH api vasanam jQAna-amRtam Bojanam
   hy ete yasya kuṭumbino vada sakhe kasmād bhayaṃ yoginaḥ || BharSt_3.100*2	hi ete yasya kuwumbinaH vada saKe kasmAt Bayam yoginaH || BharSt-_3.100*2
   aho vā hāre vā balavati ripau vā suhṛdi vā	aho vA hAre vA balavati ripO vA suhRdi vA
   maṇau vā loṣṭhe vā kusuma-śayane vā dṛṣadi vā |	maNO vA lozWe vA kusuma--Sayane vA dRzadi vA |
   tṛṇe vā straiṇe vā mama sama-dṛśo yānti divasāḥ	tRNe vA strENe vA mama sama-dRSaH yAnti divasAH
   kvacit puṇyāraṇye śiva śiva śiveti pralapataḥ || BharSt_3.100*3 ||	kvacid puNya-araNye Siva Siva SivA-iti pralapataH || BharSt-_3.100*3 ||
