   BhG 5.1	Bhu 5.1
   arjuna uvāca	arjunaH uvAca
   saṃnyāsaṃ karmaṇāṃ kṛṣṇa punar yogaṃ ca śaṃsasi |	saMnyAsam karmaNAm kRzNa punar yogam ca SaMsasi |
   yac chreya etayor ekaṃ tan me brūhi suniścitam ||1||	yat SreyaH etayoH ekam tat me brUhi su-niScitam ||1||
   śrīdharaḥ :	SrIDaraH :
   nivārya saṃśayaṃ jiṣṇoḥ karma-saṃnyāsa-yogayoḥ |	nivArya saMSayam jizNoH karma--saMnyAsa--yogayoH |
   jitendriyasya ca yateḥ pañcame muktim abravīt ||	jita-indriyasya ca yateH paQcame muktim abravIt ||
   ajñāna-sambhūtaṃ saṃśayaṃ jñānāsinā chittvā karma-yogam ātiṣṭha ity uktam	ajQAna--samBUtam saMSayam jQAna-asinA CittvA karma--yogam AtizWaH iti uktam
   | tatra pūrvāpara-virodhaṃ manvāno 'rjuna uvāca saṃnyāsam iti | yas tv	| tatra pUrva-apara--viroDam manvAnaH arjunaH uvAca saMnyAsam iti | yaH tu-
   ātma-ratir eva syād ity ādinā sarvaṃ karmākhilaṃ pārtha ity ādinā ca	Atma--ratiH eva syAt iti AdinA sarvam karma-aKilam pArTaH iti AdinA ca
   karma-saṃnyāsaṃ kathayasi | jñānāsinā saṃśayaṃ chittvā yogam ātiṣṭha iti	karma-saMnyAsam kaTayasi | jQAna-asinA saMSayam CittvA yogam AtizWaH iti
   punar yogaṃ ca kathayasi | na ca karma-saṃnyāsaḥ karma-yogaś ca ekasyaiva	punar yogam ca kaTayasi | na ca karma-saMnyAsaH karma-yogaH ca ekasya-eva
   ekadaiva sambhavataḥ viruddha-svarūpatvāt | tasmād etayor madhya ekasminn	ekadA-eva samBavataH virudDa--svarUpa-tvAt | tasmAt etayoH maDye ekasmin=-
   anuṣṭhātavye sati mama yac chreyaḥ suniścitam tad ekaṃ brūhi ||1||	anuzWAtavye sati mama yat SreyaH su-niScitam tat ekam brUhi ||1||
   madhusūdanaḥ :	maDusUdanaH :
   adhyāyābhyāṃ kṛto dvābhyāṃ nirṇayaḥ karma-bodhayoḥ |	aDyAyAByAm kRtaH dvAByAm nirNayaH karma--boDayoH |
   karma-tat-tyāgayor dvābhyāṃ nirṇayaḥ kriyate 'dhunā ||	karma--tat--tyAgayoH dvAByAm nirNayaH kriyate aDunA ||
   tṛtīye 'dhyāye jyāyasī cet karmaṇas te ity ādinārjunena pṛṣṭo bhagavān	tRtIye aDyAye jyAyasI ced karmaNaH te iti Adina-arjunena pRzwaH BagavAn
   jñāna-karmaṇor vikalpa-samuccayāsambhavenādhikāri-bheda-vyavasthayā loke	jQAna-karmaNoH vikalpa--samuccaya-asamBavena-aDika-ari-Beda--vyavasTayA loke
   'smin dvividhā niṣṭhā purā proktā mayānagha ity ādinā nirṇayaṃ kṛtavān |	asmin dviviDA nizWA purA proktAH mayA-anaGaH iti AdinA nirNayam kRtavAn |
   tathā cājñādhikārikaṃ karma na jñānena saha samuccīyate tejas-timirayor	taTA ca-AjQADi-kArikam karma na jQAnena saha samuccIyate tejas--timirayoH-
   iva yugapad asambhavāt karmādhikāra-hetu-bheda-buddhy-apanodakatvena	iva yugapad asamBavAt karma-aDikAra--hetu-Beda--budDi--apana-udaka-tvena
   jñānasya tad-virodhitvāt | nāpi vikalpyate ekārthatvābhāvāt |	jQAnasya tad--viroDi-tvAt | na-api vikalpyate eka-arTa-tva-aBAvAt |
   jñāna-kāryasyājñāna-nāśasya karmaṇā kartum aśakyatvāt tam eva viditvāpi	jQAna--kAryasya-ajQAna-nASasya karmaNA kartum aSakya-tvAt tam eva viditvA-api
   mṛtyum eti nānyaḥ panthā vidyate 'nāyanāya iti śruteḥ |	mRtyum eti na-anyaH panTAH vidyate anAyanAya iti SruteH |
   jñāne jāte tu karma-kāryaṃ nāpekṣyata evety uktaṃ yāvān artha udapāne ity	jQAne jAte tu karma--kAryam na-apekzyate eva-iti uktam yAvAn arTaH udapAne iti-
   atra | tathā ca jñāninaḥ karmānadhikāre niścite prārabdha-karma-vaśād	atra | taTA ca jQAninaH karma-anaDikAre niScite prArabDa--karma--vaSAd
   vṛthā-ceṣṭā-rūpeṇa tad-anuṣṭhānaṃ vā sarva-karma-saṃnyāso veti nirvivādaṃ	vRTA--cezwA--rUpeNa tat--anuzWAnam vA sarva-karma--saMnyAsaH vA-iti nirvivAdam
   caturthe nirṇītam | ajñena tv antaḥ-karaṇa-śuddhi-dvārā jñānotpattaye	caturTe nirNItam | ajQena tu antaH-karaNa--SudDi--dvArAH jQAna-utpattaye
   karmāṇy anuṣṭheyāni tam etaṃ vedānuvacanena brāhmaṇā vividiṣanti yajñena	karmANi anuzWeyAni tam etam veda-anuvacanena brAhmaNAH vividizanti yajQena
   dānena tapasānāśakena iti śruteḥ | sarvaṃ karmākhilaṃ pārtha jñāne	dAnena tapasA-anASakena iti SruteH | sarvam karma-aKilam pArTa jQAne
   parisamāpyate iti bhagavad-vacanāc ca | evaṃ sarva-karmāṇi jñānārthāni |	parisamApyate iti Bagavat--vacanAt ca | evam sarva-karmANi jQAna-arTAni |
   tathā sarva-karma-saṃnyāso 'pi jñānārthaḥ śrūyate etam eva pravrājino	taTA sarva-karma--saMnyAsaH api jQAna-arTaH SrUyate etam eva pravrAjinaH-
   lokam icchantaḥ pravrajanti, śānto dānta uparatas titikṣuḥ samāhito	lokam icCantaH pravrajanti, SAntaH dAntaH uparataH titikzuH samAhitaH-
   bhūtvātmany evātmānaṃ paśyet, tyajataiva hi taj jñeyaṃ tyuktuḥ pratyak	BUtvA-Atmani eva-AtmAnam paSyet, tyajata-eva hi tat jQeyam tyuktuH pratyak
   paraṃ padam, satyānṛte sukha-duḥkhe vedān imaṃ lokam amuṃ ca	param padam, satya-anRte suKa--duHKe vedAn imam lokam amum ca
   parityajyātmānam anvicchet ity ādau |	parityajya-AtmAnam anvicCet iti AdO |
   tatra karma tat-tyāgayor ārād upakāraka-saṃnipatyopakārakayoḥ	tatra karma tat-tyAgayoH ArAt upakAraka--saMnipatya-upakArakayoH
   prayājāvaghātayor iva na samuccayaḥ sambhavati viruddhatvena	prayAja-avaGAtayoH iva na samuccayaH samBavati virudDa-tvena
   yaugapadyābhāvāt | nāpi karma-tat-tyāgayor	yOgapadya-aBAvAt | na-api karma--tat--tyAgayoH-
   ātma-jñāna-mātra-phalatvenaikārthatvād atirātrayoḥ	Atma--jQAna--mAtra--Pala-tvena-eka-arTa-tvAt atirAtrayoH
   ṣoḍaśi-grahaṇāgrahaṇayor iva vikalpaḥ syāt | dvāra-bhedenaikārthatvābhāvāt	zoxaSi--grahaNa-agrahaNayoH iva vikalpaH syAt | dvAra-Bedena-eka-arTa-tva-aBAvAt-
   | karmaṇo hi pāpa-kṣaya-rūpam adṛṣṭam eva dvāraṃ, saṃnyāsasya tu	| karmaNaH hi pApa--kzaya--rUpam adRzwam eva dvAraM, saMnyAsasya tu
   sarva-vikṣepābhāvena vicārāvasara-dāna-rūpaṃ dṛṣṭam eva dvāram |	sarva--vikzepa-aBAvena vicAra-avasara-dAna--rUpam dRzwam eva dvAram |
   niyamāpūrvaṃ tu dṛṣṭa-samavāyitvād avaghātādāv iva na prayojakam | tathā	niyama-apUrvam tu dRzwa--samavAyi-tvAt avaGAta-AdO iva na prayojakam | taTA
   cādṛṣṭārtha-dṛṣṭārthayor ārād upakāraka-saṃnipātyopakārakayor	ca-adRzwa-arTa--dRzwa-arTayoH ArAt upakAraka--saMnipAtya-upakArakayoH-
   eka-pradhānārthatve 'pi vikalpo nāsty eva | prayājāvaghātādīnām api	eka--praDAna-arTa-tve api vikalpaH na-asti eva | prayAja-avaGAta-AdInAm api
   tat-prasaṅgāt | tasmāt krameṇobhayam apy anṣṭheyam | tatrāpi	tat--prasaFgAt | tasmAt krameNa-uBayam api anzWeyam | tatra-api
   saṃnyāsānantaraṃ karmānuṣṭhānaṃ cet tadā	saMnyAsa-anantaram karma-anuzWAnam ced tadA
   parityakta-pūrvāśrama-svīkāreṇārūḍha-patitatvāt karmānadhikāritvaṃ	parityakta--pUrva-ASrama--svIkAreNa-ArUXa-patita-tvAt karma-anaDikAri-tvam
   prāktana-saṃnyāsa-vaiyarthyaṃ ca tasyādṛṣṭārthatvābhāvāt |	prAktana--saMnyAsa--vEyarTyam ca tasya-adRzwa-arTa-tva-aBAvAt |
   prathama-kṛta-saṃnyāsenaiva jñānādhikāra-lābhe tad-uttara-kāle	praTama--kRta-saMnyAsena-eva jQAna-aDikAra-lABe tad--uttara--kAle
   karmānuṣṭhāna-vaiyarthyaṃ ca | tasmād ādau bhagavad-arpaṇa-buddhyā	karma-anuzWAna--vEyarTyam ca | tasmAt AdO Bagavat--arpaNa-budDyA
   niṣkāma-karmānuṣṭhānād antaḥ-karaṇa-śuddhau tīvreṇa vairāgyeṇa vividiṣāyāṃ	nizkAma--karma-anuzWAnAt antaH-karaNa--SudDO tIvreNa vErAgyeNa vividizAyAm
   dṛḍhāyāṃ sarva-karma-saṃnyāsaḥ	dRXAyAm sarva-karma--saMnyAsaH
   śravaṇa-mananādi-rūpa-vedānta-vākya-vicārāya kartavya iti bhagavato matam	SravaNa-manana-Adi---rUpa-veda-anta--vAkya--vicArAya kartavyaH iti BagavataH matam
   | tathā coktam - na karmaṇām anārambhān naiṣkarmyaṃ puruṣo 'śnute iti |	| taTA ca-uktam  na karmaNAm anAramBAt nEzkarmyam puruzaH aSnute iti |
   vakṣyate ca -	vakzyate ca -
   ārurukṣor muner yogaṃ karma kāraṇam ucyate |	ArurukzoH muneH yogam karma kAraNam ucyate |
   yogārūḍhasya tasyaiva śamaḥ kāraṇam ucyate || [Gītā 6.3] iti |	yoga-ArUXasya tasya-eva SamaH kAraNam ucyate || [GItAH 6.3] iti |
   yogo 'tra tīvra-vairāgya-pūrvikā vividiṣā | tad uktaṃ vārtika-kāraiḥ -	yogaH atra tIvra-vErAgya--pUrvikA vividizA | tat uktam vArtika-kArEH -
   pratyag vividiṣāsiddhyai vedānuvacanādayaḥ |	pratyak vividizA-sidDyE veda-anuvacana-AdayaH |
   brahmāvāptyai tu tat-tyāga īpsantīti śruter balāt || iti |	brahma-avAptyE tu tat-tyAgaH Ipsanti-iti SruteH balAt || iti |
   smṛtiś ca -	smRtiH ca -
   kaṣāya-paṅktiḥ karmāṇi jñānaṃ tu paramā gatiḥ |	kazAya--paFktiH karmANi jQAnam tu paramA gatiH |
   kaṣāye karmabhiḥ pakve tato jñānaṃ pravartate || iti |	kazAye karmaBiH pakve tatas jQAnam pravartate || iti |
   mokṣa-dharme -	mokza--Darme -
   kaṣāyaṃ pācayitvā ca śreṇī-sthāneṣu ca triṣu |	kazAyam pAcayitvA ca SreNI--sTAnezu ca trizu |
   pravrajec ca paraṃ sthānaṃ pārivrājyam anuttamam ||	pravrajet ca param sTAnam pArivrAjyam anuttamam ||
   bhāvinaḥ karaṇaiś cāyaṃ bahu-saṃsāra-yoniṣu |	BAvinaH karaNEH ca-ayam bahu--saMsAra--yonizu |
   āsādayati śuddhātmā mokṣaṃ vai prathamāśrame ||	AsAdayati SudDa-AtmA mokzam vE praTama-ASrame ||
   tam āsādya tu muktasya dṛṣṭārthasya vipaścitaḥ |	tam AsAdya tu muktasya dRzwa-arTasya vipaScitaH |
   triṣv āśrameṣu ko nv artho bhavet paramābhīpsitaḥ || iti |	trizu ASramezu kaH nu arTaH Bavet parama-aBIpsitaH || iti |
   mokṣaṃ vairāgyam | etena kramākrama-saṃnyāso dvāv api darśinau | tathā ca	mokzam vErAgyam | etena kramAkrama--saMnyAsaH dvO api darSinO | taTA ca
   śrutiḥ - brahmacaryaṃ samāpya gṛhī bhaved gṛhād vanī bhūtvā pravrajed yadi	SrutiH  brahmacaryam samApya gRhI Bavet gRhAt vanI BUtvA pravrajet yadi
   vetarathā brahmacaryād eva pravrajed gṛhād vā vanād vā yad ahar eva	vetaraTAH brahmacaryAt eva pravrajet gRhAt vA vanAt vA yat ahar eva
   virajet tad ahar eva pravrajet iti |	virajet tat ahar eva pravrajet iti |
   tasmād ajñasyāviraktatā-daśāyāṃ karmānuṣṭhānam eva | tasyaiva	tasmAt ajQasya-avirakta-tA-daSAyAm karma-anuzWAnam eva | tasya-eva
   viraktatā-daśāyāṃ saṃnyāsaḥ śravaṇādy-avasara-dānena jñānārthaṃ iti	virakta-tA-daSAyAm saMnyAsaH SravaNa-Adi--a-vasara--dAnena jQAna-arTam iti
   daśā-bhedenājñam adhikṛtyaiva karma-tat-tyāgau vyākhyātuṃ pañcama-ṣaṣṭhāv	daSA-Bedena-AjQam aDikRtya-eva karma--tat--tyAgO vyAKyAtum paQcama--zazWO=-
   adhyāyāv ārabhyete | vidvat-saṃnyāsas tu jñāna-balād artha-siddha eveti	aDyAyO AraByete | vidvat--saMnyAsaH tu jQAna-balAt arTa-sidDaH eva-iti
   sandehābhāvān na vicāryate |	sandeha-aBAvAt na vicAryate |
   tatraikam eva jijñāsum ajñaṃ prati jñānārthatvena karma-tat-tyāgayor	tatra-ekam eva jijQAsum ajQam prati jQAna-arTa-tvena karma--tat--tyAgayoH-
   vigdhānāt tayoś ca viruddhayor yugapad anuṣṭhānāsambhavān mayā jijñāsunā	vigDAnAt tayoH ca virudDayoH yugapad anuzWAna-asamBavAn mayA jijQAsunA
   kim idānīm anuṣṭheyam iti sandihāno 'rjuna uvāca saṃnyāsam iti |	kim idAnIm anuzWeyam iti sandihAnaH arjunaH uvAca saMnyAsam iti |
   he kṛṣṇa ! sadānanda-rūpa bhakta-duḥkha-karṣaṇeti vā | karmaṇāṃ	he kRzNaH ! sadAnanda--rUpa Bakta--duHKa-karzaNa-iti vA | karmaNAm
   yāvaj-jīvādi-śruti-vihitānāṃ nityānāṃ naimittikānāṃ ca saṃnyāsaṃ tyāgaṃ	yAvat--jIva-Adi--Sruti--vihitAnAm nityAnAm nEmittikAnAm ca saMnyAsam tyAgam
   jijñāsum ajñaṃ prati kathayasi veda-mukhena punas tad-viruddhaṃ yogaṃ ca	jijQAsum ajQam prati kaTayasi veda--muKena punar tat--virudDam yogam ca
   karmānuṣṭhāna-rūpaṃ śaṃsasi | etam eva pravrājino lokam icchantaḥ	karma-anuzWAna--rUpam SaMsasi | etam eva pravrAjinaH lokam icCantaH
   pravrajanti, tam etaṃ vedānuvacanena brāhmaṇā vividiṣanti yajñena ity	pravrajanti, tam etam veda-anuvacanena brAhmaNAH vividizanti yajQena iti-
   ādi-vākya-dvayena -	Adi-vAkya--dvayena -
   nirāśīr yata-cittātmā tyakta-sarva-parigrahaḥ |	nirASIH yata-citta-AtmA tyakta--sarva--parigrahaH |
   śārīraṃ kevalaṃ karma kurvann āpnoti kilbiṣam || [Gītā 4.21]	SArIram kevalam karma kurvan Apnoti kilbizam || [GItAH 4.21]
   chittvainaṃ saṃśayaṃ yogam ātiṣṭhottiṣṭha bhārata iti gītā-vākya-dvayena	CittvA-enam saMSayam yogam AtizWa-uttizWa BArataH iti gItA--vAkya--dvayena
   vā | tatraikam ajñaṃ prati karma-tat-tyāgayor vidhānād yugapad	vA | tatra-ekam ajQam prati karma--tat--tyAgayoH viDAnAt yugapad-
   ubhayānuṣṭhānasambhavād etayoḥ karma-tat-tyāgayor madhye yad ekaṃ śreyaḥ	uBaya-anuzWAna-samBavAt etayoH karma--tat--tyAgayoH maDye yat ekam SreyaH
   praśasyataraṃ manyase karma vā tat-tyāgaṃ vā tan me brūhi suniścitaṃ tava	praSasyataram manyase karma vA tat-tyAgam vA tat me brUhi su-niScitam tava
   matam anuṣṭhānāya ||1||	matam anuzWAnAya ||1||
   viśvanāthaḥ :	viSvanATaH :
   proktaṃ jñānād api śreṣṭhaṃ karma tad-dāṛḍhya-siddhaye |	proktam jQAnAt api SrezWam karma tad--dARXya--sidDaye |
   tat-padārthasya ca jñānaṃ sāmyād yā api pañcame ||	tat-padArTasya ca jQAnam sAmyAt yAH api paQcame ||
   pūrvādhyāyānte śrutena vākya-dvāreṇa virodham āśaṅkamānaḥ pṛcchati	pUrva-aDyAya-ante Srutena vAkya-dvAreNa viroDam ASaFkamAnaH pRcCati
   sannyāsam iti |	sannyAsam iti |
   yoga-saṃnyasta-karmāṇaṃ jñāna-saṃchinna-saṃśayam |	yoga--saMnyasta-karmANam jQAna--saMCinna--saMSayam |
   ātmavantaṃ na karmāṇi nibadhnanti dhanaṃjaya || [Gītā 4.41]	Atmavantam na karmANi nibaDnanti DanaMjayaH || [GItAH 4.41]
   iti vākyena tvaṃ karma-yogenotpanna-jñānasya karma-saṃnyāsaṃ brūṣe |	iti vAkyena tvam karma--yogena-utpanna--jQAnasya karma-saMnyAsam brUze |
   tasmād ajñāna-saṃbhūtaṃ hṛt-sthaṃ jñānāsinātmanaḥ |	tasmAt ajQAna--saMBUtam hRt--sTam jQAna-asinA-AtmanaH |
   chittvainaṃ saṃśayaṃ yogam ātiṣṭhottiṣṭha bhārata || [Gītā 4.42]	CittvA-enam saMSayam yogam AtizWa-uttizWa BArata || [GItAH 4.42]
   ity anena punas tasyaiva karma-yogaṃ ca brūṣe | na ca karma-saṃnyāsaḥ	iti anena punar tasya-eva karma--yogam ca brUze | na ca karma-saMnyAsaH
   karma-yogaś ca ekasyaiva ekadaiva sambhavataḥ, sthiti-gativat	karma-yogaH ca ekasya-eva ekadA-eva samBavataH, sTiti--gati-vat-
   viruddha-svarūpatvāt | tasmāj jñānī karma-saṃnyāsaṃ kuryāt, karma-yogaṃ vā	virudDa--svarUpa-tvAt | tasmAt jQAnI karma-saMnyAsam kuryAt, karma---yogam vA
   kuryād iti tvad-abhiprāyam anavagato |haṃ pṛcchāmi etayor madhye yad ekaṃ	kuryAt iti tvad--aBiprAyam anavagataH |ham pRcCAmi etayoH maDye yat ekam
   śreyas tvayā suniścitam tan me brūhi ||1||	SreyaH tvayA su-niScitam tat me brUhi ||1||
   baladevaḥ :	baladevaH :
   jñānataḥ karmaṇaḥ śraiṣṭhyaṃ sukaratvādinā hariḥ |	jQAnataH karmaNaH SrEzWyam sukara-tva-AdinA hariH |
   śuddhasya tad-akartṛtvaṃ tvety ādi prāha pañcame ||	SudDasya tat--akartR-tvam tvA-iti Adi prAha paQcame ||
   dvitīye mumukṣuṃ praty ātma-vijñānaṃ mocakam abhidhāya tad-upāyayā	dvitIye mumukzum prati Atma-vijQAnam mocakam aBiDAya tad--upAyayA
   niṣkāmaṃ karma kartavyam abhyadhāt | labdha-vijñānasya na kiṃcit	nizkAmam karma kartavyam aByaDAt | labDa-vijQAnasya na kiMcid-
   karmāstīti yas tv ātma-ratir eva syāt iti tṛtīye, sarvaṃ karmākhilaṃ	karma-asti-iti yaH tu Atma--ratiH eva syAt iti tRtIye, sarvam karma-aKilam
   pārtha iti caturthe cāvādīt | ante tu tasmād ajñāna-saṃbhūtaṃ [Gītā 4.42]	pArTaH iti caturTe ca-avAdIt | ante tu tasmAt ajQAna--saMBUtam [GItAH 4.42]
   ity ādinā tasyaiva punaḥ karma-yogaṃ prāvocat | tatrārjunaḥ pṛcchati	iti AdinA tasya-eva punar karma--yogam prAvocat | tatra-arjunaH pRcCati
   saṃnyāsam iti | he kṛṣṇa ! karmaṇāṃ sannyāsaṃ	saMnyAsam iti | he kRzNaH ! karmaNAm sannyAsam
   sarvendriya-vyāpāra-virati-rūpaṃ jñāna-yogam ity arthaḥ | punar yogaṃ	sarva-indriya--vyApAra--virati--rUpam jQAna--yogam iti arTaH | punar yogam
   karmānuṣṭhānaṃ ca sarvendriya-vyāpāra-rūpaṃ śaṃsasi | na caikasya yugapat	karma-anuzWAnam ca sarva-indriya--vyApAra--rUpam SaMsasi | na ca-ekasya yugapad-
   tau sambhavetāṃ, sthiti-gativat tamas-tejovac ca viruddha-svarūpatvāt |	tO samBavetAM, sTiti--gati-vat tamas--tejaH-vat ca virudDa--svarUpa-tvAt |
   tasmāl labdha-jñānaḥ karma sannyased anutiṣṭhed veti bhavad-abhimataṃ	tasmAt labDa--jQAnaH karma sannyaset anutizWet vA-iti Bavat--aBimatam
   vettum aśakto 'haṃ pṛcchāmi | etayoḥ karma-sannyāsa-karmānuṣṭhānayor yad	vettum aSaktaH aham pRcCAmi | etayoH karma--sannyAsa--karma-anuzWAnayoH yat-
   ekaṃ śreyas tvayā suniścitaṃ tattvaṃ me brūhīti ||1||	ekam SreyaH tvayA su-niScitam tattvam me brUhi-iti ||1||
   BhG 5.2	Bhu 5.2
   śrī-bhagavān uvāca	SrI--BagavAn uvAca
   saṃnyāsaḥ karma-yogaś ca niḥśreyasa-karāv ubhau |	saMnyAsaH karma--yogaH ca niHSreyasa-karO uBO |
   tayos tu karma-saṃnyāsāt karma-yogo viśiṣyate ||2||	tayoH tu karma--saMnyAsAt karma--yogaH viSizyate ||2||
   śrīdharaḥ : atrottaraṃ śrī-bhagavān uvāca saṃnyāsa iti | ayaṃ bhāvaḥ - na	SrIDaraH : atra-uttaram SrI--BagavAn uvAca saMnyAsaH iti | ayam BAvaH  na
   hi vedānta-vedyātma-tattvajñaṃ prati karma-yogam ahaṃ bravīmi | yataḥ	hi vedAnta-vedya-Atma--tattva-jQam prati karma---yogam aham bravImi | yatas-
   pūrvoktena saṃnyāsena virodhaḥ syāt | api tu dehātmābhimāninaṃ tvāṃ	pUrva-uktena saMnyAsena viroDaH syAt | api tu deha-AtmA-aBimAninam tvAm
   bandhu-vadhādi-nimitta-śoka-mohādi-kṛtam enaṃ saṃśayaṃ	banDu--vaDa-Adi--nimitta--Soka--moha-Adi--kRtam enam saMSayam
   dehātma-viveka-jñānāsinā chittvā paramātma-jñānopāya-bhūtaṃ karma-yogam	deha-Atma--viveka--jQAna-asinA CittvA paramAtma--jQAna-upAya-BUtam karma---yogam
   ātiṣṭheti bravīmi | karma-yogena śuddha-cittasyātma-tattva-jñāne jāte sati	AtizWA-iti bravImi | karma--yogena SudDa--cittasya-Atma--tattva--jQAne jAte sati
   tat-paripākārthaṃ jñāna-niṣṭhāṅgatvena saṃnyāsaḥ pūrvam uktaḥ | evaṃ saty	tat--paripAka-arTam jQAna--nizWA-aFga-tvena saMnyAsaH pUrvam uktaH | evam sati-
   aṅga-pradhānayor vikalpa-yogāt saṃnyāsaḥ karma-yogaś cety etāv ubhāv api	aFga--praDAnayoH vikalpa--yogAt saMnyAsaH karma--yogaH ca-iti etO uBO api
   bhūmikā-bhedena samuccitāv eva niḥśreyasaṃ sādhayataḥ | tathāpi tu tayor	BUmikA--Bedena samuccitO eva niHSreyasam sADayataH | taTA-api tu tayoH-
   madhye tu karma-saṃnyāsāt sakāśāt karma-yogo viśiṣṭo bhavatīti ||2||	maDye tu karma--saMnyAsAt sakASAt karma--yogaH viSizwaH Bavati-iti ||2||
   madhusūdanaḥ : evam arjunasya praśne tad-uttaram śrī-bhagavān uvāca	maDusUdanaH : evam arjunasya praSne tad--uttaram SrI--BagavAn uvAca
   saṃnyāsa iti | niḥśreyasa-karau jñānotpatti-hetutvena mokṣopayoginau |	saMnyAsaH iti | niHSreyasa-karO jQAna-utpatti-hetu-tvena mokza-upayoginO |
   tayos tu karma-saṃnyāsād anadhikāri-kṛtāt karma-yogo viśiṣyate śreyān	tayoH tu karma-saMnyAsAt anaDikAri-kRtAt karma--yogaH viSizyate SreyAn
   adhikāra-sampādakatvena ||2||	aDikAra--sampAdaka-tvena ||2||
   viśvanāthaḥ : karma-yogo viśiṣyata iti jñāninaḥ karma-karaṇe na ko 'pi	viSvanATaH : karma--yogaH viSizyate iti jQAninaH karma--karaNe na kaH api
   doṣaḥ | pratyuta niṣkāma-karmaṇā citta-śuddhi-dārḍhyāj jñāna-dārḍhyam eva	dozaH | pratyuta nizkAma-karmaNA citta--SudDi--dArXyAt jQAna--dArXyam eva
   syāt | saṃnyāsinas tu kadācit citta-vaiguṇye sati tad-upaśamanārthaṃ kiṃ	syAt | saMnyAsinaH tu kadAcid citta--vEguNye sati tad--upaSamana-arTam kim
   karma niṣiddham ? jñānābhyāsa-pratibandhakaṃ tu citta-vaiguṇyam eva |	karma nizidDam ? jQAna-aByAsa--pratibanDakam tu citta--vEguNyam eva |
   viṣaya-grahaṇe tu vāntāśitvam eva syād iti bhāvaḥ ||2||	vizaya-grahaNe tu vAntASi-tvam eva syAt iti BAvaH ||2||
   baladevaḥ : evaṃ pṛṣṭo śrī-bhagavān uvāca saṃnyāsa iti | niḥśreyasa-karau	baladevaH : evam pRzwaH SrI--BagavAn uvAca saMnyAsaH iti | niHSreyasa-karO
   mukti-hetū | karma-saṃnyāsāj jñāna-yogād viśiṣyate śreṣṭho bhavati | ayaṃ	mukti-hetU | karma-saMnyAsAt jQAna--yogAt viSizyate SrezWaH Bavati | ayam
   bhāvaḥ - na khalu labdha-jñānasyāpi karma-yogo doṣāvahaḥ | kintu	BAvaH  na Kalu labDa--jQAnasya-api karma--yogaH doza-AvahaH | kintu
   jñāna-garbhatvāj jñāna-dārḍhya-kṛd eva | jñāna-niṣṭhatayā	jQAna--garBa-tvAt jQAna--dArXya--kRt eva | jQAna--nizWatayA
   karma-sannyāsinas tu citta-doṣe sati tad-doṣa-vināśāya karmānuṣṭheyaṃ	karma-sannyAsinaH tu citta-doze sati tad--doza--vinASAya karma-anuzWeyam
   pratiṣedhaka-śāstrāt | karma-tyāga-vākyāni tv ātmani ratau satyāṃ karmāṇi	pratizeDa-ka-SAstrAt | karma--tyAga--vAkyAni tu Atmani ratO satyAm karmANi
   taṃ svayaṃ tjayantīty āhuḥ | tasmāt sukaratvād apramādatvāj	tam svayam tjayanti-iti AhuH | tasmAt sukara-tvAt apramAdatvAt-
   jñāna-garbhatvāc ca karma-yogaḥ śreyān iti ||2||	jQAna-garBa-tvAt ca karma-yogaH SreyAn iti ||2||
   BhG 5.3	Bhu 5.3
   jñeyaḥ sa nitya-saṃnyāsī yo na dveṣṭi na kāṅkṣati |	jQeyaH sa nitya--saMnyAsI yaH na dvezwi na kAFkzati |
   nirdvandvo hi mahā-bāho sukhaṃ bandhāt pramucyate ||3||	nirdvandvaH hi mahA-bAho suKam banDAt pramucyate ||3||
   śrīdharaḥ : kuta ity apekṣāyāṃ saṃnyāsitvena karma-yoginaṃ stuvaṃs tasya	SrIDaraH : kutas iti apekzAyAm saMnyAsi-tvena karma--yoginam stuvan tasya
   śreṣṭhatvaṃ darśayati jñeya iti | rāga-dveṣādi-rāhityena parameśvarārthaṃ	SrezWa-tvam darSayati jQeyaH iti | rAga--dveza-Adi--rAhityena parameSvara-arTam
   karmāṇi yo 'nutiṣṭhati sa nityaṃ karmānuṣṭhāna-kāle 'pi saṃnyāsīty evaṃ	karmANi yaH anutizWati sa nityam karma-anuzWAna--kAle api saMnyAsi-iti evam
   jñeyaḥ | tatra hetuḥ nirdvandvo rāga-dveṣādi-dvandva-śūnyo hi śuddha-citto	jQeyaH | tatra hetuH nirdvandvaH rAga--dveza-Adi-dvan-dva--SUnyaH hi SudDa-cittaH-
   jñāna-dvārā sukham anāyāsenaiva bandhāt saṃsārāt pramucyate ||3||	jQAna-dvArA suKam anAyAsena-eva banDAt saMsArAt pramucyate ||3||
   madhusūdanaḥ : tam eva karma-yogaṃ stauti jñeya iti tribhiḥ | sa karmaṇi	maDusUdanaH : tam eva karma--yogam stOti jQeyaH iti triBiH | sa karmaNi
   pravṛtto 'pi nityaṃ saṃnyāsīti jñeyaḥ | ko 'sau ? yo na dveṣṭi	pravRttaH api nityam saMnyAsi-iti jQeyaH | kaH asO ? yaH na dvezwi
   bhagavad-arpaṇa-buddhyā kriyamāṇaṃ karma niṣphalatva-śaṅkayā | na kāṅkṣati	Bagavat--arpaNa-budDyA kriyamANam karma nizPala-tva--SaFkayA | na kAFkzati
   svargādikam | nirdvandvo rāga-dveṣa-rahito hi yasmāt sukham anāyāsena he	svarga-Adikam | nirdvandvaH rAga--dveza--rahitaH hi yasmAt suKam anAyAsena he
   mahābāho bandhād antaḥkaraṇāśuddhi-rūpāj jñāna-pratibandhāt pramucyate	mahA-bAho banDAt antaHkaraNa-aSudDi--rUpAt jQAna-pratibanDAt pramucyate
   nityānitya-vastu-vivekādi-prakarṣeṇa mukto bhavati ||3||	nitya-aniti-a--vastu--viveka-Adi-prakarzeNa muktaH Bavati ||3||
   viśvanāthaḥ : na ca sannyāsa-prāpyo mokṣo 'kṛta-saṃnyāsenaiva tena na	viSvanATaH : na ca sannyAsa--prApyaH mokzaH akRta-saMnyAsena-eva tena na
   prāpya iti vācyam ity āha jñeya iti | sa tu śuddha-cittaḥ karmī	prApya iti vAcyam iti Aha jQeyaH iti | sa tu SudDa-cittaH karmI
   nitya-saṃnyāsī eva jñeyaḥ | he mahābāho iti mukti-nagarīṃ jetuṃ sa eva	nitya--saMnyAsI eva jQeyaH | he mahA-bAho iti mukti-nagarIm jetum saH eva
   mahāvīra iti bhāvaḥ ||3||	mahAvIraH iti BAvaH ||3||
   baladevaḥ : kuto viśiṣyate tatrāha jñeya iti | sa viśuddha-cittaḥ	baladevaH : kutas viSizyate tatra-Aha jQeyaH iti | sa viSudDa-cittaH
   karma-yogī nitya-saṃnyāsī | sa sarvadā jñāna-yoga-niṣṭho jñeyaḥ | yaḥ	karma--yogI nitya--saMnyAsI | sa sarvadA jQAna--yoga-nizWaH jQeyaH | yaH
   karmāntargatātmānubhavānanda-paritṛptas tato 'nyat kiṃcit na kāṅkṣati na	karma-antargata-Atma-anuBava-Ananda--paritRptaH tatas anyat kiMcid na kAFkzati na
   ca dveṣṭi | nirdvandvo dvandva-sahiṣṇuḥ sukham anāyāsena	ca dvezwi | nirdvandvaH dvandva--sahizNuH suKam anAyAsena
   sukara-karma-niṣṭhayety arthaḥ ||3||	sukara-karma--nizWayA-iti arTaH ||3||
   BhG 5.4	Bhu 5.4
   sāṃkhya-yogau pṛthag bālāḥ pravadanti na paṇḍitāḥ |	sAMKya--yogO pRTak bAlAH pravadanti na paNxitAH |
   ekam apy āsthitaḥ samyag ubhayor vindate phalam ||4||	ekam api AsTitaH samyak uBayoH vindate Palam ||4||
   śrīdharaḥ : yasmād evam aṅga-pradhānatvenobhayor avasthā-bhedena	SrIDaraH : yasmAt evam aFga--praDAna-tvena-uBayoH avasTA-Bedena
   krama-samuccayaḥ | ato vikalpam aṅgīkṛtyobhayoḥ kaḥ śreṣṭha iti praśno	krama-samuccayaH | atas vikalpam aFgIkRtya-uBayoH kaH SrezWaH iti praSnaH-
   'jñāninām evocitaḥ | na vivekinām ity āha sāṅkhya-yogāv iti |	ajQAninAm eva-ucitaH | na vivekinAm iti Aha sAFKya--yogO iti |
   sāṅkhya-śabdena jñāna-niṣṭhā-vācinā tad-aṅgaṃ saṃnyāsaṃ lakṣayati |	sAFKya--Sabdena jQAna--nizWA--vAcinA tad--aFgam saMnyAsam lakzayati |
   saṃnyāsa-karma-yogau eka-phalau santau pṛthak svatantrāv iti bālā ajñā eva	saMnyAsa--karma--yogO eka-PalO santO pRTak svatantrO iti bAlAH ajQAH eva
   pravadanti na tu paṇḍitāḥ | tatra hetuḥ - anayor ekam apy samyag āsthita	pravadanti na tu paNxitAH | tatra hetuH  anayoH ekam api samyak AsTita
   āśritavān ubhayor api phalam āpnoti | tathā hi karma-yogaṃ samyag	ASritavAn uBayoH api Palam Apnoti | taTA hi karma--yogam samyak-
   anutiṣṭhan śuddha-cittaḥ san jñāna-dvārā yad ubhayoḥ phalaṃ kaivalyaṃ tad	anutizWan SudDa-cittaH san jQAna-dvArAH yat uBayoH Palam kEvalyam tat-
   vindati | saṃnyāsaṃ samyag āsthito 'pi pūrvam anuṣṭhitasya karma-yogasyāpi	vindati | saMnyAsam samyak AsTitaH api pUrvam anuzWitasya karma--yogasya-api
   paramparayā jñāna-dvārā yad ubhayoḥ phalaṃ kaivalyaṃ tad vindatīti na	paramparayA jQAna-dvArA yat uBayoH Palam kEvalyam tat vindati-iti na
   pṛthak phalatvam anayor ity arthaḥ ||4||	pRTak Pala-tvam anayoH iti arTaH ||4||
   madhusūdanaḥ : nanu yaḥ karmaṇi pravṛttaḥ sa kathaṃ saṃnyāsīti jñātavyaḥ	maDusUdanaH : nanu yaH karmaNi pravRttaH sa kaTam saMnyAsi-iti jQAtavyaH
   karma-tat-tyāgayoḥ svarūpa-virodhāt phalaikyāt tatheti cet, na | svarūpato	karma-tat--tyAgayoH svarUpa-viroDAt Pala-EkyAt taTA-iti cet, na | svarUpataH-
   viruddhayoḥ phale 'pi virodhasyaucityāt | tathā ca niḥśreyasa-karāv ubhāv	virudDayoH Pale api viroDasya-OcityAt | taTA ca niHSreyasa-karO uBO=-
   ity anupapannam ity āśaṅkyāha sāṃkhya-yogāv iti | saṃkhyā samyag	iti anupapannam iti ASaFkya-Aha sAMKya--yogO iti | saMKyA samyak-
   ātma-buddhis tāṃ vahatīti jñānāntaraṅga-sādhanatayā sāṅkhyaḥ saṃnyāsaḥ |	Atma-budDiH tAm vahati-iti jQAna-antaraFga--sADana-tayA sAFKyaH saMnyAsaH |
   yogaḥ pūrvokta-karma-yogaḥ | tau pṛthag viruddha-phalau bālāḥ	yogaH pUrva-ukta-karma-yogaH | tO pRTak virudDa--PalO bAlAH
   śāstrārtha-viveka-jñāna-śūnyāḥ pravadanti, na paṇḍitāḥ | kiṃ tarhi	SAstra-arTa-viveka--jQAna--SUnyAH pravadanti, na paNxitAH | kim tarhi
   paṇḍitānāṃ matam ? ucyate - ekam apy saṃnyāsa-karmaṇor madhye samyag	paNxitAnAm matam ? ucyate  ekam api saMnyAsa--karmaNoH maDye samyak-
   āsthitaḥ svādhikārānurūpeṇa samyag yathā-śāstraṃ kṛtavān sann ubhayor	AsTitaH sva-aDikAra-anurUpeNa samyak yaTA-SAstram kRtavAn san uBayoH-
   vindate phalam jñānotpatti-dvāreṇa niḥśreyasam ekam eva ||4||	vindate Palam jQAna-utpatti-dvAreNa niHSreyasam ekam eva ||4||
   viśvanāthaḥ : tasmād yac chreya evaitayor iti tvad-uktam api vastuto na	viSvanATaH : tasmAt yat SreyaH eva-etayoH iti tvad--uktam api vastutas na
   ghaṭate | vivekibhir ubhayoḥ pārthakyābhāvasya dṛṣṭatvād ity āha	Gawate | vivekiBiH uBayoH pArTakyA-BAvasya dRzwa-tvAt iti Aha
   sāṃkhya-yogāv iti | sāṃkhya-śabdena jñāna-niṣṭhā-vācinā tad-aṅgaḥ saṃnyāso	sAMKya--yogO iti | sAMKya--Sabdena jQAna--nizWA--vAcinA tad--aFgaH saMnyAsaH-
   lakṣyate | saṃnyāsa-karma-yogau pṛthak svatantrāv iti bālāḥ vadanti, na tu	lakzyate | saMnyAsa--karma--yogO pRTak svatantrO iti bAlAH vadanti, na tu
   vijñāḥ jñeyaḥ sa nitya-saṃnyāsī iti pūrvokteḥ | ata ekam apīty ādi ||4||	vijQAH jQeyaH sa nitya--saMnyAsI iti pUrva-ukteH | atas ekam api-iti Adi ||4||
   baladevaḥ : yaḥ śreya etayor ekam iti tvad-vākyaṃ ca na ghaṭata ity āha	baladevaH : yaH SreyaH etayoH ekam iti tvad--vAkyam ca na GawataH iti Aha
   sāṃkhyeti | jñāna-yoga-karma-yogau phala-bhedāt pṛthag-bhūtāv iti bālāḥ	sAMKya-iti | jQAna--yoga--karma--yogO Pala-BedAt pRTak--BUtO iti bAlAH
   pravadanti, na tu paṇḍitāḥ | ataeva ekam ity ādi phalam	pravadanti, na tu paNxitAH | ataeva ekam iti Adi Palam
   ātmāvaloka-lakṣaṇam ||4||	Atma-avaloka--lakzaNam ||4||
   BhG 5.5	Bhu 5.5
   yat sāṃkhyaiḥ prāpyate sthānaṃ tad yogair api gamyate |	yat sAMKyEH prApyate sTAnam tat yogEH api gamyate |
   ekaṃ sāṃkhyaṃ ca yogaṃ ca yaḥ paśyati sa paśyati ||5||	ekam sAMKyam ca yogam ca yaH paSyati sa paSyati ||5||
   śrīdharaḥ : etad eva sphuṭayati yat sāṃkhyair iti | sāṃkhyair	SrIDaraH : etat eva sPuwayati yat sAMKyEH iti | sAMKyEH-
   jñāna-niṣṭhaiḥ saṃnyāsibhir yat sthānaṃ mokṣākhyaṃ prakarṣeṇa sākṣād	jQAna--nizWEH saMnyAsiBiH yat sTAnam mokza-AKyam prakarzeNa sAkzAt-
   avāpyate, yogair ity ārśa āditvān matv-arthīyo 'c-pratyayo draṣṭavyaḥ |	avApyate, yogEH iti ArSaH Adi-tvAt matv-arTIyaH ac-pratyayaH drazwavyaH |
   tena karma-yogibhir api tad eva jñāna-dvāreṇa gamyate 'vāpyate | ataḥ	tena karma---yogiBiH api tat eva jQAna-dvAreNa gamyate avApyate | atas-
   sāṃkhyaṃ ca yogaṃ ca ekaphalatvena ekaṃ yaḥ paśyati sa eva samyak paśyati	sAMKyam ca yogam ca eka-Pala-tvena ekam yaH paSyati saH eva samyak paSyati
   madhusūdanaḥ : ekasyānuṣṭhānāt katham ubhayoḥ phalaṃ vindate tathāha yat	maDusUdanaH : ekasya-anuzWAnAt kaTam uBayoH Palam vindate taTA-Aha yat-
   sāṃkhyair iti | sāṅkhyair jñāna-niṣṭhaiḥ saṃnyāsibhir	sAMKyEH iti | sAFKyEH jQAna--nizWEH saMnyAsiBiH-
   aihika-karmānuṣṭhāna-śūnyatve 'pi prāg-bhavīya-karmabhir eva	Ehika-karma-anuzWAna--SUnya-tve api prAc--BavIya--karmaBiH eva
   saṃskṛtāntaḥ-karaṇaiḥ śravaṇādi-pūrvikayā jñāna-niṣṭhayā yat prasiddhaṃ	saMskRta-antaH--karaNEH SravaNa-Adi-pUrvikayA jQAna--nizWayA yat prasidDam
   sthānaṃ tiṣṭhaty evāsmin na tu kadāpi cyavata iti vyutpattyā mokṣākhyaṃ	sTAnam tizWati eva-asmin na tu kadApi cyavataH iti vyutpattyA mokza-AKyam
   prāpyata āvaraṇābhāva-mātreṇa labhyata iva nitya-prāptatvāt, yogair api	prApyate AvaraNa-aBAva--mAtreNa laByate iva nitya--prApta-tvAt, yogEH api
   bhagavad-arpaṇa-buddhyā phalābhisandhi-rāhityena kṛtāni karmāṇi śāstrīyāṇi	Bagavat--arpaNa-budDyA Pala-aBisanDi--rAhityena kRtAni karmANi SAstrIyANi
   yogās te yeṣāṃ santi te 'pi yogāḥ | arśa-āditvān matv-arthīyo 'c-pratyayaḥ	yogAH te yezAm santi te api yogAH | arSa-Adi-tvAt matv-arTIyaH ac-pratyayaH
   | tair yogibhir api sattva-śuddhyā saṃhyāsa-pūrvaka-śravaṇādi-puraḥ-sarayā	| tEH yogiBiH api sattva--SudDyA saMhya-asa--pUrva-ka--SravaNa-Adi-puraH-sarayA
   jñāna-niṣṭhayā vartamāne bhaviṣyati vā janmani sampatsyamānayā tat sthānaṃ	jQAna--nizWayA vartamAne Bavizyati vA janmani sampatsyamAnayA tat sTAnam
   gamyate | ata eka-phalatvād ekaṃ sāṃkhyaṃ ca yogaṃ ca yaḥ paśyati sa eva	gamyate | atas eka-Pala-tvAt ekam sAMKyam ca yogam ca yaH paSyati saH eva
   samyak paśyati nānyaḥ |	samyak paSyati na-anyaH |
   ayaṃ bhāvaḥ yeṣāṃ saṃnyāsa-pūrvikā jñāna-niṣṭhā dṛśyate teṣāṃ tayaiva	ayam BAvaH yezAm saMnyAsa--pUrvikA jQAna--nizWA dRSyate tezAm tayA-eva
   liṅgena prāg-janmasu bhagavad-arpita-karma-niṣṭhānumīyate | kāraṇam	liFgena prAk--janmasu Bagavat--arpita-karma--nizWA-anumIyate | kAraNam
   antareṇa kāryotpatty-ayogāt | tad uktam -	antareNa kArya-utpatti--ayogAt | tat uktam -
   yāny ato 'nyāni janmāni teṣu nūnaṃ kṛtaṃ bhavet |	yAni atas anyAni janmAni tezu nUnam kRtam Bavet |
   yat kṛtyaṃ puruṣeṇeha nānyathā brahmaṇi sthitiḥ || iti |	yat kRtyam puruzeNa-iha na-anyaTA brahmaNi sTitiH || iti |
   evaṃ yeṣāṃ bhagavad-arpita-karma-niṣṭhā dṛśyate teṣāṃ tayaiva liṅgena	evam yezAm Bagavat--arpita--karma--nizWA dRSyate tezAm tayA-eva liFgena
   bhāvinī saṃnyāsa-pūrvajñāna-niṣṭhānumīyate sāmagryāḥ kāryāvyabhicāritvāt |	BAvinI saMnyAsa--pUrva-jQAna---nizWA-anumIyate sAmagryAH kArya-avI-aBicAri-tvAt |
   tasmād ajñena mumukṣuṇāntaḥkaraṇa-śuddhaye prathamaṃ karma-yogo 'nuṣṭheyo	tasmAt ajQena mumukzuNA-antaHkaraNa--SudDaye praTamam karma-yogaH anuzWeyaH-
   na tu saṃnyāsaḥ | sa tu vairāgya-tīvratāyāṃ svayam eva bhaviṣyatīti ||5||	na tu saMnyAsaH | sa tu vErAgya--tIvra-tAyAm svayam eva Bavizyati-iti ||5||
   viśvanāthaḥ : etad eva spaṣṭayati yad iti | sāṃkhyaiḥ sannyāsena yogair	viSvanATaH : etat eva spazwayati yat iti | sAMKyEH sannyAsena yogEH-
   niṣkāma-karmaṇā | bahu-vacanaṃ gauraveṇa | ataeva tad dvayaṃ pṛthag-bhūtam	nizkAma--karmaNA | bahu-vacanam gOraveNa | ataeva tat dvayam pRTak--BUtam
   api yo vivekenaikam eva paśyati sa paśyati, cakṣuṣmān paṇḍita ity arthaḥ	api yaH vivekena-ekam eva paSyati sa paSyati, cakzuzmAn paNxitaH iti arTaH
   baladevaḥ : etad viśadayati yad iti | sāṃkhyair jñāna-yogibhir yogaiḥ	baladevaH : etat viSadayati yat iti | sAMKyEH jQAna--yogiBiH yogEH
   niṣkāma-karmabhiḥ | arśa ādy ac | sthānaṃ ātmāvaloka-lakṣaṇam | ataeva tad	nizkAma--karmaBiH | arSe Adi at | sTAnam Atma-avaloka--lakzaNam | ataeva tat-
   dvayaṃ nivṛtti-pravṛtti-rūpatayā bhinna-rūpam api phalaikyād ekaṃ yaḥ	dvayam nivRtti--pravRtti--rUpa-tayA Binna--rUpam api Pala-EkyAt ekam yaH
   paśyati vetti, sa paśyati sa cakṣuṣmān paṇḍita ity arthaḥ ||5||	paSyati vetti, sa paSyati sa cakzuzmAn paNxitaH iti arTaH ||5||
   BhG 5.6	Bhu 5.6
   saṃnyāsas tu mahābāho duḥkham āptum ayogataḥ |	saMnyAsaH tu mahA-bAho duHKam Aptum ayogataH |
   yoga-yukto munir brahma nacireṇādhigacchati ||6||	yoga-yuktaH muniH brahma nacireNa-aDigacCati ||6||
   śrīdharaḥ : yadi karma-yogino 'py antataḥ saṃnyāsenaiva jñāna-nisṭhā tarhy	SrIDaraH : yadi karma--yoginaH api antatas saMnyAsena-eva jQAna--nisWA tarhi-
   ādita eva saṃnyāsaḥ kartuṃ yukta iti manvānaṃ praty āha saṃnyāsa iti |	Aditas eva saMnyAsaH kartum yuktaH iti manvAnam prati Aha saMnyAsaH iti |
   ayogataḥ karma-yogaṃ vinā saṃnyāso duḥkham āptum duḥkha-hetuḥ | aśakya ity	ayogataH karma--yogam vinA saMnyAsaH duHKam Aptum duHKa--hetuH | aSakyaH iti-
   arthaḥ | citta-śuddhy-abhāvena jñāna-niṣṭhāyā asambhavāt | yoga-yuktas tu	arTaH | citta--SudDi--a-BAvena jQAna-nizWAyAH asamBavAt | yoga--yuktaH tu
   śuddha-cittatayā muniḥ saṃnyāsī bhūtvācireṇaiva brahmādhigacchati |	SudDa-citta-tayA muniH saMnyAsI BUtvA-acireNa-eva brahma-aDigacCati |
   aparokṣaṃ jānāti | ataś citta-śuddheḥ prāk karma-yoga eva saṃnyāsād	aparokzam jAnAti | atas citta--SudDeH prAk karma-yogaH eva saMnyAsAt-
   viśiṣyata iti pūrvoktaṃ siddham | tad uktaṃ vārttika-kṛdbhiḥ -	viSizyate iti pUrva-uktam sidDam | tat uktam vArttika-kRdBiH -
   pramādino bahiś cittāḥ piśunāḥ kalahotsukāḥ |	pramAdinaH bahis cittAH piSunAH kalaha-utsukAH |
   sannyāsino 'pi dṛśyante daiva-sandūṣitāśrayāḥ || iti ||6||	san=-yAsinaH api dRSyante dEva--sandUzita-ASrayAH || iti ||6||
   madhusūdanaḥ : aśuddhāntaḥkaraṇenāpi saṃnyāsa eva prathamaṃ kuto na	maDusUdanaH : aSudDa-antaHkaraNena-api saMnyAsaH eva praTamam kutas na
   kriyate jñāna-niṣṭhā-hetutvena tasyāvaśakatvād iti cet tatrāha saṃnyāsa	kriyate jQAna--nizWA--hetutvena tasya-avaSaka-tvAt iti ced tatra-Aha saMnyAsa
   iti | ayogato yogam antaḥ-karaṇa-śodhakaṃ śāstrīyaṃ karmāntareṇa haṭhād	iti | ayogataH yogam antaH-karaNa--SoDakam SAstrIyam karma-antareNa haWAt-
   eva yaḥ kṛtaḥ saṃnyāsaḥ sa tu duḥkham āptum eva bhavati,	eva yaH kRtaH saMnyAsaH sa tu duHKam Aptum eva Bavati,
   aśuddhāntaḥkaraṇatvena tat-phalasya jñāna-nisṭhāyā asambhavāt | śodhake ca	aSudDa-antaHkaraNa-tvena tat-Palasya jQAna-nisWAyAH asamBavAt | SoDake ca
   karmaṇy anadhikārāt karma-brahmobhaya-bhraṣṭatvena parama-saṅkaṭāpatteḥ |	karmaNi anaDikArAt karma--brahma-uBaya--Brazwa-tvena parama-saFkawa-ApatteH |
   karma-yoga-yuktas tu śuddhāntaḥkaraṇatvān munir manana-śīlaḥ saṃnyāsī	karma--yoga--yuktaH tu SudDa-antaHkaraNa-tvAt muniH manana--SIlaH saMnyAsI
   bhūtvā brahma satya-jñānādi-lakṣaṇam ātmānaṃ na cireṇa śīghram	BUtvA brahma satya--jQAna-Adi--lakzaNam AtmAnam na cireNa SIGram
   evādhigacchati sākṣātkaroti pratibandhakābhāvāt | etac coktaṃ prāg eva -	eva-aDigacCati sAkzAtkaroti pratibanDaka-aBAvAt | etat ca-uktam prAk eva -
   na karmaṇām anārambhān naiṣkarmyaṃ puruṣo 'śnute |	na karmaNAm anAramBAt nEzkarmyam puruzaH aSnute |
   na ca saṃnyasanād eva siddhiṃ samadhigacchati || [Gītā 3.4] iti |	na ca saMnyasanAt eva sidDim samaDigacCati || [GItAH 3.4] iti |
   ata eka-phalatve 'pi karma-saṃnyāsāt karma-yogo viśiṣyata iti yat prāg	atas eka-Pala-tve api karma--saMnyAsAt karma--yogaH viSizyate iti yat prAk-
   uktaṃ tad upapannam ||6||	uktam tat upapannam ||6||
   viśvanāthaḥ : kintu samyak-citta-śuddhim anirdhārayato jñāninaḥ saṃnyāso	viSvanATaH : kintu samyak-citta--SudDim anirDArayataH jQAninaH saMnyAsaH-
   duḥkhadaḥ karma-yogas tu sukhada eveti pūrva-vyañjitam arthaṃ spaṣṭam	duHKa-daH karma-yogaH tu suKa-daH eva-iti pUrva--vyaQjitam arTam spazwam
   evāha saṃnyāsas tv iti | citta-vaiguṇye satīti śeṣaḥ | ayogataḥ	eva-Aha saMnyAsaH tu iti | citta--vEguNye sati-iti SezaH | ayogataH
   karma-yogābhāvāc citta-vaiguṇya-praśāmaka-karma-yogasya saṃnyāsiny abhāvāt	karma---yoga-aBAvAt citta-vEguNya--praSAma-ka-karma--yogasya saMnyAsini aBAvAt-
   tatra anadhikārād ity arthaḥ | saṃnyāso duḥkham eva prāptuṃ bhavati | tad	tatra anaDikArAt iti arTaH | saMnyAsaH duHKam eva prAptum Bavati | tat-
   uktaṃ vārttika-kṛdbhiḥ -	uktam vArttika-kRdBiH -
   pramādino bahiś cittāḥ piśunāḥ kalahotsukāḥ |	pramAdinaH bahis cittAH piSunAH kalaha-utsukAH |
   sannyāsino 'pi dṛśyante daiva-sandūṣitāśrayāḥ || iti |	san=-yAsinaH api dRSyante dEva--sandUzita-ASrayAH || iti |
   śrutir api -yadi na samuddharanti yatayo hṛdi kāma-jaṭā iti | bhagavatāpi	SrutiH api -yadi na samudDaranti yatayaH hRdi kAma-jawAH iti | BagavatA-api
   yas tva saṃyata-ṣaḍ-vargaḥ [BhP 11.18.40] ity ādy uktam | tasmād	yaH tva saMyata--zaz--vargaH [Bhj 11.18.40] iti Adi uktam | tasmAt-
   yoga-yuktaḥ niṣkāma-karmavān munir jñānī san brahma śīghraṃ prāpnoti ||6||	yoga--yuktaH nizkAma-karmavAn muniH jQAnI san brahma SIGram prApnoti ||6||
   baladevaḥ : jñāna-yogasya duṣkaratvāt sukara-karma-yogaḥ śreyān ity āha	baladevaH : jQAna--yogasya duzkara-tvAt sukara--karma-yogaH SreyAn iti Aha
   saṃnyāsas tv iti | saṃnyāsaḥ sarvendriya-vyāpāra-vinivṛtti-rūpo	saMnyAsaH tu iti | saMnyAsaH sarva-indriya-vyApAra--vinivRtti--rUpaH-
   jñāna-yogaḥ | ayogataḥ karma-yogaṃ vinā duḥkhaṃ prāptum bhavati |	jQAna--yogaH | ayogataH karma--yogam vinA duHKam prAptum Bavati |
   duṣkaratvāt sapramādatvāc ca duḥkha-hetur eva syād ity arthaḥ |	duzkara-tvAt sa-pramAda-tvAt ca duHKa-hetuH eva syAt iti arTaH |
   yoga-yukta-niṣkāma-karmī tu munir ātma-manana-śīlaḥ sann acireṇa śīghram	yoga--yukta--nizkAma--karmI tu muniH Atma-manana--SIlaH san acireNa SIGram
   eva brahmādhigacchati ||6||	eva brahma-aDigacCati ||6||
   BhG 5.7	Bhu 5.7
   yoga-yukto viśuddhātmā vijitātmā jitendriyaḥ |	yoga--yuktaH viSudDa-AtmA vijita-AtmA jita-indriyaH |
   sarva-bhūtātma-bhūtātmā kurvann api na lipyate ||7||	sarva-BUta-Atma--BUta-AtmA kurvan api na lipyate ||7||
   śrīdharaḥ : karma-yogādi-krameṇa brahmādhigame saty api tad-uparitanena	SrIDaraH : karma--yoga-Adi--krameNa brahma-aDigame sati api tad--u-paritanena
   karmaṇā bandhaḥ syād evety āśaṅkyāha yoga-yukta iti | yogena yuktaḥ |	karmaNA banDaH syAt eva-iti ASaFkya-Aha yoga--yuktaH iti | yogena yuktaH |
   ataeva viśuddha ātmā cittaṃ yasya saḥ | ataeva vijita ātmā śarīraṃ yena |	ataeva viSudDaH AtmA cittam yasya saH | ataeva vijitaH AtmA SarIram yena |
   ataeva jitānīndriyāṇi yena | tataś ca sarveṣāṃ bhūtānām ātma-bhūta ātmā	ataeva jitAni-indriyANi yena | tatas ca sarvezAm BUtAnAm Atma-BUtaH AtmA
   yasya sa loka-saṅgrahārthaṃ svābhāvikaṃ vā karma kurvann api na lipyate	yasya sa loka-saFgraha-arTam svABAvikam vA karma kurvan api na lipyate
   madhusūdanaḥ : nanu karmaṇo bandha-hetutvād yoga-yukto munir	maDusUdanaH : nanu karmaNaH banDa--hetu-tvAt yoga--yuktaH muniH-
   brahmādhigacchatīty anupapannam ity ata āha yoga-yukta iti |	brahma-aDigacCati-iti anupapannam iti atas Aha yoga--yuktaH iti |
   bhagavad-arpaṇa-phalābhisandhi-rāhityādi-guṇa-yuktaṃ śāstrīyaṃ karma yoga	Bagavat--arpaNa-Pala-aBisanDi--rAhityAdi-guNa-yuktam SAstrI-iyam karma yoga
   ity ucyate | tena yogena yuktaḥ puruṣaḥ prathamaṃ viśuddhātmā viśuddho	iti ucyate | tena yogena yuktaH puruzaH praTamam viSudDa-AtmA viSudDaH-
   rajas-tamo-bhyām akaluṣita ātmāntaḥkaraṇa-rūpaṃ sattvaṃ yasya sa tathā |	rajas-tamo-ByAm akaluzitaH Atma-antaHkaraNa--rUpam sattvam yasya sa taTA |
   nirmalāntaḥ-karaṇaḥ san vijitātmā sva-vaśīkṛta-dehaḥ | tato jitendriyaḥ	nirmala-antaH-karaNaH san vijita-AtmA sva--vaSIkRta-dehaH | tatas jita-indriyaH
   sva-vaśīkṛta-sarva-bāhyendriyaḥ | etena manūktas tridaṇḍī kathitaḥ -	sva--vaSIkRta--sarva--bAhya-indriyaH | etena manu-uktaH tridaNxI kaTitaH -
   vāg-daṇḍo 'tha mano-daṇḍaḥ kāya-daṇḍas tathaiva ca |	vAc--daNxaH aTa mano-daNxaH kAya-daNxaH taTA-eva ca |
   yasyaite nityatā daṇḍāḥ sa tridaṇḍīti kathyata || iti |	yasya-ete nityatA daNxAH sa tridaNxI-iti kaTyate || iti |
   vāg iti bāhyendriyopalakṣaṇam | etādṛśasya tattva-jñānam avaśyaṃ bhavatīty	vAc iti bAhya-indriya-upalakzaNam | etAdRSasya tattva--jQAnam avaSyam Bavati-iti-
   āha sarva-bhūtātma-bhūtātmā sarva-bhūta ātma-bhūtaś cātmā svarūpaṃ yasya	Aha sarva-BUta-Atma--BUta-AtmA sarva-BUtaH Atma-BUtaH ca-AtmA svarUpam yasya
   sa tathā | jaḍājaḍātmakaṃ sarva ātma-mātraṃ paśyann ity arthaḥ | sarveṣāṃ	sa taTA | jaxa-ajaxa-Atmakam sarve Atma--mAtram paSyan iti arTaH | sarvezAm
   bhūtānām ātma-bhūta ātmā yasyeti vyākhyāne tu sarva-bhūtātmety	BUtAnAm Atma-BUtaH AtmA yasya-iti vyAKyAne tu sarva-BUta-AtmA-iti-
   etāvataivārtah-lābhād ātma-bhūtety adhikaṃ syāt | sarvātma-padayor	etAvatA-eva-Arta-h-lABAt Atma-BUtA-iti aDikam syAt | sarva-Atma--padayoH-
   jaḍājaḍa-paratve tu samañjasam | etādṛśaḥ paramārtha-darśī kurvann api	jaxa-ajaxa---paratve tu samaQjasam | etAdRSaH parama-arTa--darSI kurvan api
   karmāṇi para-dṛṣṭyā na lipyate taiḥ karmabhiḥ sva-dṛṣṭyā tad-abhāvād ity	karmANi para-dRzwyA na lipyate tEH karmaBiH sva--dRzwyA tad--aBAvAt iti-
   arthaḥ ||7||	arTaH ||7||
   viśvanāthaḥ : kṛtenāpi karmaṇā jñāninas tasya na lepa ity āha yogeti |	viSvanATaH : kRtena-api karmaNA jQAninaH tasya na lepaH iti Aha yoga-iti |
   yoga-yukto jñānī trividhaḥ - viśuddhātmā vijita-buddhir ekaḥ | vijitātmā	yoga-yuktaH jQAnI triviDaH  viSudDa-AtmA vijita-budDiH ekaH | vijita-AtmA
   viśuddha-citto dvitīyaḥ | jitendriyas tṛtīya iti | pūrva-pūrveṣāṃ	viSudDa--cittaH dvitIyaH | jita-indriyaH tRtIyaH iti | pUrva--pUrvezAm
   sādhana-tāratamyād utkarṣaḥ | etādṛśe gṛhasthe tu sarve 'pi jīvā	sADana-tAratamyAt utkarzaH | etAdRSe gRhasTe tu sarve api jIvA
   anurajyantīty āha sarveṣām api bhūtānām ātma-bhūtaḥ premāspadībhūta ātmā	anurajyanti-iti Aha sarvezAm api BUtAnAm Atma-BUtaH prema-AspadIBUtaH AtmA
   deho yasya saḥ ||7||	dehaH yasya saH ||7||
   baladevaḥ : īdṛśī mumukṣuḥ sarveṣāṃ preyān ity āha yogeti | yoge niṣkāme	baladevaH : IdRSI mumukzuH sarvezAm preyAn iti Aha yoga-iti | yoge nizkAme
   karmaṇi yukto nirataḥ | ataeva viśuddhātmā nirmala-buddhiḥ | ataeva	karmaNi yuktaH nirataH | ataeva viSudDa-AtmA nirmala--budDiH | ataeva
   vijitātmā vaśīkṛta-manāḥ | ataeva jitendriyaḥ śabdādi-viṣaya-rāga-śūnyaḥ |	vijita-AtmA vaSIkRta--manAH | ataeva jita-indriyaH Sabda-Adi--vizaya--rAga--SUnyaH |
   ataeva sarveṣāṃ bhūtānāṃ jīvānām ātma-bhūtaḥ premāspadatām gata ātmā deho	ataeva sarvezAm BUtAnAm jIvAnAm Atma-BUtaH prema-Aspada-tAm gataH AtmA dehaH-
   yasya saḥ | na cātra pārtha-sārathinā sarvātmaikyam abhimatam - na tv	yasya saH | na ca-atra pArTa-sAraTinA sarva-Atma-Ekyam aBimatam  na tu-
   evāham ity ādinā sarvātmanāṃ mitho bhedasya tenābhidhānāt | tad-vādināpi	eva-aham iti AdinA sarva-AtmanAm miTas Bedasya tena-aBiDAnAt | tad--vAdinA-api
   vijñājñābhedasya vaktum aśaktyatvāc ca | evambhūtaḥ kurvann api	vijQA-AjQA-Bedasya vaktum aSaktyatvAt ca | evamBUtaH kurvan api
   viviktātmānusandhānād anātmany ātmābhimānena na lipyate acireṇātmānam	vivikta-Atma-anusanDAnAt anAtmani Atma-aBimAnena na lipyate acireNa-AtmAnam
   adhigacchati | ataḥ karma-yogaḥ śreyān ||7||	aDigacCati | atas karma-yogaH SreyAn ||7||
   BhG 5.8	Bhu 5.8
   naiva kiṃ cit karomīti yukto manyeta tattva-vit |	na-eva kim cit karomi-iti yuktaH manyeta tattva--vid |
   paśyañ śṛṇvan spṛśañ jighrann aśnan gacchan svapañ śvasan ||8||	paSyan SRNvan spRSan jiGran aSnan gacCan svapan Svasan ||8||
   pralapan visṛjan gṛhṇann unmiṣan nimiṣann api |	pralapan visRjan gRhNan unmizan nimizan api |
   indriyāṇīndriyārtheṣu vartanta iti dhārayan ||9||	indriyANi-indriya-arTezu vartante iti DArayan ||9||
   śrīdharaḥ : karma kurvann api na lipyata ity etad viruddham ity āśaṅkya	SrIDaraH : karma kurvan api na lipyate iti etat virudDam iti ASaFkya
   kartṛtvābhimānābhāvān na viruddham ity āha naiveti dvābhyām | karma-yogena	kartR-tva-aBimAna-aBAvAt na virudDam iti Aha na-eva-iti dvAByAm | karma--yogena
   yuktaḥ krameṇa tattvavid bhūtvā darśana-śravaṇādīni kurvann	yuktaH krameNa tattva-vid BUtvA darSana--SravaNa-AdIni kurvan=-
   apīndriyāṇīndriyārtheṣu vartanta iti dhārayan buddhyā niścinvan kiṃcid apy	api-indriyANi-indriya-arTezu vartante iti DArayan budDyA niScinvan kiMcid api-
   ahaṃ na karomīti manyeta manyate | tatra	aham na karomi-iti manyeta manyate | tatra
   darśana-śravaṇa-sparśanāghrānāśanāni cakṣur-ādi-jñānendriya-vyāpārāḥ |	darSana--SravaNa--sparSana-AGrAnASanAni cakzuH--Adi-jQAna-indriya--vyApArAH |
   gatiḥ pādayoḥ | svāpo buddheḥ | śvāsaḥ prāṇasya | pralapanaṃ	gatiH pAdayoH | svApaH budDeH | SvAsaH prANasya | pralapanam
   vāg-indriyasya | visargaḥ pāyūpasthayoḥ | grahaṇaṃ hastayoḥ |	vAc--indriyasya | visargaH pAyu-upasTayoH | grahaNam hastayoH |
   unmeṣaṇa-nimeṣaṇe kūrmākhya-prāṇasyeti vivekaḥ | etāni karmāṇi kurvann api	unmezaNa--nimezaNe kUrma-AKya-prANasya-iti vivekaH | etAni karmANi kurvan api
   abhimānābhāvād brahma-vin na lipyate | tathā ca parāmarṣaṃ sūtram -	aBimAna-aBAvAt brahma-vid na lipyate | taTA ca parAmarzam sUtram -
   tad-adhigama uttara-pūrvāghayor aśleṣa-vināśau tad-vyapadeśād iti ||8-9||	tad--aDigamaH uttara--pUrva-aGayoH aSleza--vinASO tat--vyapadeSAt iti ||8-9||
   madhusūdanaḥ : etad eva vivṛṇoti naiveti dvābhyām |	maDusUdanaH : etat eva vivRNoti na-eva-iti dvAByAm |
   cakṣur-ādi-jñānendriyair vāg-ādi-karmendriyaiḥ prāṇā̆di-vāyu-bhedair	cakzuH--Adi--jQAna-indriyEH vAc--a-Adi-karma-indriyEH prANĂdi-vAyu--BedEH-
   antaḥ-karaṇa-catuṣṭayena ca tat-tac-ceṣṭāsu kriyamāṇāsu	antaH-karaNa--catuzwayena ca tat--tat---cezwAsu kriyamANAsu
   indriyāṇīndriyādīny evendriyārtheṣu sva-sva-viṣayeṣu vartante pravartante	indriyANi-indriya-AdIni eva-indriya-arTezu sva--sva--vizayezu vartante pravartante
   na tv aham iti dhārayann avadhārayann naiva kiṃcit karomīti manyeta	na tu aham iti DArayan avaDArayan na-eva kiMcid karomi-iti manyeta
   manyate tattvavit paramārtha-darśī yuktaḥ samāhita-cittaḥ | athavādau	manyate tattva-vid parama-arTa--darSI yuktaH samAhita-cittaH | aTavA-AdO
   yuktaḥ karma-yogena paścād antaḥkaraṇa-śuddhi-dvāreṇa tattvavid bhūtvā	yuktaH karma--yogena paScAt antaHkaraNa--SudDi--dvAreNa tattva-vid BUtvA
   naiva kiṃcit karomīti manyata iti sambandhaḥ |	na-eva kiMcid karomi-iti manyate iti sambanDaH |
   tatra darśana-śravaṇa-sparśana-ghrāṇāśanāni	tatra darSana--SravaNa--sparSana--GrANa-aSanAni
   cakṣuḥ-śrotra-tvag-ghrāṇa-rasanānāṃ pañca-jñānendriyāṇāṃ vyāpārāḥ paśyan	cakzuH-Srotra--tu-ac--GrANa--rasanAnAm paQca--jQAna-indriyANAm vyApArAH paSyan
   śṛṇvan spṛśañ jighrann aśnann ity uktāḥ | gatiḥ pādayoḥ | pralāpo vācaḥ |	SRNvan spRSan jiGran aSnan iti uktAH | gatiH pAdayoH | pralApaH vAcaH |
   visargaḥ pāyūpasthayoḥ | grahaṇaṃ hastayor iti pañca karmendriya-vyāpārā	visargaH pAyu-upasTayoH | grahaNam hastayoH iti paQca karmendriya--vyApArA
   gacchan pralapan visṛjan gṛhṇann ity uktāḥ | śvasann iti	gacCan pralapan visRjan gRhNan iti uktAH | Svasan iti
   prāṇādi-pañcakasya vyāpāropalakṣaṇam | unmiṣan nimiṣann iti	prANa-Adi-paQcakasya vyApAra-upalakzaNam | unmizan nimizan iti
   nāga-kūrmādi-pañcakasya | svapann ity antaḥ-karaṇa-catuṣṭayasya |	nAga-kUrma-Adi-paQcakasya | svapan iti antaH-karaNa--catuzwayasya |
   artha-krama-vaśāt pāṭha-kramaṃ bhaṅktvā vyākhyātāv imau ślokau | yasmāt	arTa-krama--vaSAt pAWa-kramam BaFktvA vyAKyAtO imO SlokO | yasmAt-
   sarva-vyāpāreṣv apy ātmano 'kartṛtvam eva paśyati | ataḥ kurvann api na	sarva--vyApArezu api AtmanaH akartR-tvam eva paSyati | atas kurvan api na
   lipyata iti yuktam evoktam iti bhāvaḥ ||8-9||	lipyate iti yuktam eva-uktam iti BAvaH ||8-9||
   viśvanāthaḥ : yena karmaṇālepas taṃ prakāraṃ śikṣayati naiveti | yuktaḥ	viSvanATaH : yena karmaNA-AlepaH tam prakAram Sikzayati na-eva-iti | yuktaH
   karma-yogī darśanādīni kurvann apīndriyāṇīndriyārtheṣu vartanta iti	karma-yogI darSana-AdIni kurvan api-indriyANi-indriya-arTezu vartante iti
   dhārayan buddhyā niścinvan nirabhimānaḥ kiṃcid apy ahaṃ naiva karomīti	DArayan budDyA niScinvan niraBimAnaH kiMcid api aham na-eva karomi-iti
   manyate ||8-9||	manyate ||8-9||
   baladevaḥ : śuddhasyātmano 'dhiṣṭhānādi-pañcāpekṣita-karma-kartṛtvaṃ	baladevaH : SudDasya-AtmanaH aDizWAna-Adi-paQca-apekzita--karma-kartR-tvam
   nāstīty upadiśati naiveti | yukto niṣkāma-karmī	na-asti-iti upadiSati na-eva-iti | yuktaH nizkAma--karmI
   prādhānika-dehendriyādi-saṃsargād darśanādīni karmāṇi kurvann api	prADAnika-deha-indriya-Adi--saMsargAt darSana-AdIni karmANi kurvan api
   tattva-vit viviktam ātma-tattvam anubhavan indriyārtheṣu rūpādiṣu	tattva--vid viviktam Atma--tattvam anuBavan indriya-arTezu rUpa-Adizu
   indriyāṇi cakṣur-ādīni mad-vāsanānuguṇa-paramātma-preritāni vartanta iti	indriyANi cakzuH--AdIni mad--vAsanA-anuguNa--paramAtma--preritAni vartante iti
   dhārayan niścinvann ahaṃ kiṃcid api na karomīti manyate | paśyañ śṛṇvan	DArayat niScinvan aham kiMcid api na karomi-iti manyate | paSyan SRNvan
   spṛśañ jighrann aśnann iti cakṣuḥ-śrotra-tvag-ghrāṇa-rasanānāṃ	spRSan jiGran aSnan iti cakzuH-Srotra--tu-ac--GrANa--rasanAnAm
   jñānendriyāṇāṃ darśana-śravaṇa-sparśanāghrānāśanāni vyāpārāḥ | tatra	jQAna-indriyANAm darSana--SravaNa--sparSana-AGrAnASanAni vyApArAH | tatra
   gamanaṃ pādayoḥ | pralāpo vācaḥ | visargānandaḥ pāyūpasthayoḥ | grahaṇaṃ	gamanam pAdayoH | pralApaH vAcaH | visarga-AnandaH pAyu-upasTayoH | grahaNam
   hastayor iti bodhyam | śvasann iti prāṇādīnām unmiṣan nimiṣann iti	hastayoH iti boDyam | Svasan iti prANa-AdInAm unmizan nimizan iti
   nāgādīnāṃ prāṇa-bhedānām | svapann ity antaḥkaraṇānām ity arthaḥ kramād	nAga-AdInAm prANa-BedAnAm | svapan iti antaHkaraNAnAm iti arTaH kramAt-
   vyākhyeyam | vijñāna-sukhaika-rasasya	vyAKyeyam | vijQAna--suKa-eka-rasasya
   mamānādi-vāsanā-hetuka-prādhānika-dehādi-sambandha-nimittaṃ	mama-anAdi--vAsanA--hetuka--prADAnika--deha-Adi-sambanDa--nimittam
   tadīdṛśa-karma-kartṛtvam, na tu svarūpaika-nimittam iti manyata ity arthaḥ	tad-IdRSa--karma-kartR-tvam, na tu svarUpa-eka--nimittam iti manyate iti arTaH
   | na svarūpa-prayuktam ātmanaḥ kartṛtvaṃ kiṃcid api nāstīti śakyam	| na svarUpa--prayuktam AtmanaH kartR-tvam kiMcid api na-asti-iti Sakyam
   abhidhātuṃ nirdhāraṇe manane ca tasyābhidhānāt | tat tac ca jñānam eva tac	aBiDAtum nirDAraNe manane ca tasya-aBiDAnAt | tat tat ca jQAnam eva tat-
   cātmano nityam | na hi vijñātur vijñāter viparilāpo vidyate iti śruteḥ |	ca-AtmanaH nityam | na hi vijQAtuH vijQAteH viparilApaH vidyate iti SruteH |
   tat-siddhiś ca hariṇā dharma-bhūtena jñānena ca ity āhuḥ ||8-9||	tat-sidDiH ca hariNA Darma-BUtena jQAnena ca iti AhuH ||8-9||
   BhG 5.10	Bhu 5.10
   brahmaṇy ādhāya karmāṇi saṅgaṃ tyaktvā karoti yaḥ |	brahmaNi ADAya karmANi saFgam tyaktvA karoti yaH |
   lipyate na sa pāpena padma-patram ivāmbhasā ||10||	lipyate na sa pApena padma--patram iva-amBasA ||10||
   śrīdharaḥ : tarhi yasya karomīti abhimāno 'sti tasya karma-lepo durvāraḥ |	SrIDaraH : tarhi yasya karomi-iti aBimAnaH asti tasya karma-lepaH durvAraH |
   tathāviśuddha-cittatvāt saṃnyāso 'pi nāsti iti mahat saṅkaṭam āpannam ity	taTA-aviSudDa--citta-tvAt saMnyAsaH api na-asti iti mahat saFkawam Apannam iti-
   āśaṅkyāha brahmaṇīti | brahmaṇy ādhāya parameśvare samarpya | tat-phale ca	ASaFkya-Aha brahmaNi-iti | brahmaNi ADAya parameSvare samarpya | tat-Pale ca
   saṅgaṃ tyaktvā | yaḥ karmāṇi karoti asau pāpena bandhu-hetutayā pāpiṣṭhena	saFgam tyaktvA | yaH karmANi karoti asO pApena banDu--hetu-tayA pApizWena
   puṇya-pāpātmakena karmaṇā na lipyate yathā padma-patram ambhasi sthitam	puNya--pApa-Atmakena karmaNA na lipyate yaTA padma--patram amBasi sTitam
   api tenāmbhasā na lipyate tadvat ||10||	api tena-amBasA na lipyate tadvat ||10||
   madhusūdanaḥ : tarhy avidvān kartṛtvābhimānāl lipyetaiva tathā ca karthaṃ	maDusUdanaH : tarhi avidvAn kartR-tva-aBimAnAt lipyeta-eva taTA ca karTam
   tasya saṃnyāsa-pūrvikā jñāna-niṣṭhā syād iti tatrāha brahmaṇīti | brahmaṇi	tasya saMnyAsa--pUrvikA jQAna--nizWA syAt iti tatra-Aha brahmaNi-iti | brahmaNi
   parameśvara ādhāya samarpya saṅgaṃ phalābhilāṣaṃ tyaktveśvarārthaṃ bhṛtya	parameSvaraH ADAya samarpya saFgam Pala-aBilAzam tyaktvA-ISvara-arTam BRtya
   iva svāmy-arthaṃ sva-phala-nirapekṣatayā karomīty abhiprāyeṇa karmāṇi	iva svAmI--arTam sva--Pala--nirapekza-tayA karomi-iti aBiprAyeNa karmANi
   laukikāni vaidikāni ca karoti yo lipyate na sa pāpena pāpa-puṇyātmakena	lOkikAni vEdikAni ca karoti yaH lipyate na sa pApena pApa--puNya-Atmakena
   karmaṇeti yāvat | yathā padma-patram upari prakṣiptenāmbhasā na lipyate	karmaNA-iti yAvat | yaTA padma--patram upari prakziptena-amBasA na lipyate
   tadvat | bhagavad-arpaṇa-buddhyānuṣṭhitaṃ karma buddhi-śuddhi-phalam eva	tadvat | Bagavat--arpaNa-budDyA-anuzWitam karma budDi--SudDi-Palam eva
   syāt ||10||	syAt ||10||
   viśvanāthaḥ : kiṃ ca brahmaṇi parameśvare mayi samarpya saṅgaṃ tyaktvā	viSvanATaH : kim ca brahmaNi parameSvare mayi samarpya saFgam tyaktvA
   sābhimāno 'pi karmāsaktiṃ vihāya yaḥ karmāṇi karoti | pāpenety upalakṣaṇam	sa-aBimAnaH api karma-Asaktim vihAya yaH karmANi karoti | pApena-iti upalakzaNam
   | so 'pi karma-mātreṇaiva na lipyate ||10||	| saH api karma--mAtreNa-eva na lipyate ||10||
   baladevaḥ : uktaṃ viśadayann āha brahmaṇīti | brahma-śabdenātra	baladevaH : uktam viSadayan Aha brahmaNi-iti | brahma--Sabdena-atra
   triguṇāvasthaṃ pradhānam uktam | tasmād etad brahma-nāma-rūpam annaṃ ca	triguNa-avasTam praDAnam uktam | tasmAt etat brahma-nAma-rUpam annam ca
   jñāyata iti śravaṇāt | mama yonir mahad brahma iti vakṣyamāṇāc ca |	jQAyate iti SravaNAt | mama yoniH mahat brahma iti vakzyamANAt ca |
   dehendriyādīni pradhāna-pariṇāma-viśeṣāṇi bhavanti tad-rūpatayā pariṇate	deha-indriya-AdIni praDAna--pariNAma--viSezANi Bavanti tad--rUpa-tayA pariNate
   pradhāne darśanādīni karmāṇy ādhāya tasyaivaitāni | na tu tad-viviktasya	praDAne darSana-AdIni karmANi ADAya tasya-eva-etAni | na tu tad--viviktasya
   śuddhasya mameti nirdhāryety arthaḥ | saṅgaṃ tat-phalābhilāṣaṃ	SudDasya mama-iti nirDArya-iti arTaH | saFgam tat-Pala-aBilAzam
   tat-kartṛtvābhiniveśaṃ ca tyaktvā | yas tāni karoti sa tādṛg dehādimattayā	tat-kartR-tva-aBiniveSam ca tyaktvA | yaH tAni karoti sa tAdRS deha-Adi-mattayA
   sann api dehādy-ātmābhimānena pāpena na lipyate |	san api deha-At-y-a-Atma-aBimAnena pApena na lipyate |
   tathoparinikṣiptenāmbhasā spṛṣṭam api padma-patraṃ tadvat | na ca mayi	taTA-upari-nikziptena-amBasA spRzwam api padma--patram tadvat | na ca mayi
   saṃnyasya karmāṇi iti pūrva-svārasyād brahmaṇi paramātmanīti vyākhyeyam |	saMnyasya karmANi iti pUrva-svArasyAt brahmaNi paramAtmani-iti vyAKyeyam |
   prādhānika-dehādi-saṃsṛṣṭasyaiva jīvasya darśanādi-karma-kartṛtvaṃ, na tu	prADAnika--deha-Adi-saMsRzwasya-eva jIvasya darSana-Adi--karma-kartR-tvaM, na tu
   tad-viviktasyety arthasya prakṛtatvāt ||10||	tad--viviktasya-iti arTasya prakRta-tvAt ||10||
   BhG 5.11	Bhu 5.11
   kāyena manasā buddhyā kevalair indriyair api |	kAyena manasA budDyA kevalEH indriyEH api |
   yoginaḥ karma kurvanti saṅgaṃ tyaktvātma-śuddhaye ||11||	yoginaH karma kurvanti saFgam tyaktvA-Atma--SudDaye ||11||
   śrīdharaḥ : kevalaṃ sattva-śuddhi-mātra-phalam eva tasya karmaṇaḥ syāt	SrIDaraH : kevalam sattva--SudDi--mAtra--Palam eva tasya karmaNaH syAt-
   yasmāt kāyeneti | kāyena dehena manasā buddhyā ca | yoginaḥ saṅgaṃ tyaktvā	yasmAt kAyena-iti | kAyena dehena manasA budDyA ca | yoginaH saFgam tyaktvA
   kāyena manasā buddhyā kevalair indriyair api | kevala-śabdaḥ kāyādibhir	kAyena manasA budDyA kevalEH indriyEH api | kevala--SabdaH kAya-AdiBiH-
   api pratyekaṃ sambadhyate | sarva-vyāpāreṣu mamatā-varjanāya yoginaḥ	api pratyekam sambaDyate | sarva-vyApArezu mamatA--varjanAya yoginaH
   karmiṇaḥ karma kurvanti | saṅgaṃ tyaktvā phala-viṣayam | ātma-śuddhaye	karmiNaH karma kurvanti | saFgam tyaktvA Pala--vizayam | Atma--SudDaye
   sattva-śuddhaya ity arthaḥ | tasmāt tatraiva tavādhikāra iti ||11||	sattva--SudDayaH iti arTaH | tasmAt tatra-eva tava-aDikAraH iti ||11||
   madhusūdanaḥ : tad eva vivṛṇoti kāyeneti | kāyena manasā buddhyendriyair	maDusUdanaH : tat eva vivRNoti kAyena-iti | kAyena manasA budDyA-indriyEH-
   api yoginaḥ karmiṇaḥ phala-saṅgaṃ tyaktvā karma kurvanti kāyādīnāṃ	api yoginaH karmiNaH Pala-saFgam tyaktvA karma kurvanti kAya-AdInAm
   sarveṣāṃ viśeṣaṇaṃ kevalair iti | īśvarāyaiva karomi na mama phalāyeti	sarvezAm viSezaNam kevalEH iti | ISvarAya-eva karomi na mama PalAya-iti
   mamatā-śūnyair ity arthaḥ | ātma-śuddhaye citta-śuddhy-artham ||11||	mamatA--SUnyEH iti arTaH | Atma--SudDaye citta--SudDi--arTam ||11||
   viśvanāthaḥ : kevalair indriyair iti | indrāya svāhā ity ādinā	viSvanATaH : kevalEH indriyEH iti | indrAya svAhA iti AdinA
   havir-ādy-arpaṇa-kāle yadyapi manaḥ kvāpy anyatra tad apīty arthaḥ |	haviH--Adi--arpaNa--kAle yadi-api manaH kvApi anyatra tat api-iti arTaH |
   ātma-viśuddhaye manaḥ-śuddhy-artham ||11||	Atma--viSudDaye manaH--SudDi--arTam ||11||
   baladevaḥ : sad-ācāraṃ pramāṇayann etad vivṛṇoti kāyeneti | kāyādibhiḥ	baladevaH : sat--AcAram pramANayan etat vivRNoti kAyena-iti | kAya-AdiBiH
   sādhyaṃ karma kāyādy-ahaṃbhāva-śūnyā yoginaḥ kurvanti | kevalair	sADyam karma kAya-Adi--ahaMBAva--SUnyAH yoginaH kurvanti | kevalEH-
   viśuddhaiḥ | saṅgaṃ tyaktveti prāgvad ātma-śuddhaye	viSudDEH | saFgam tyaktvA-iti prAgvat Atma--SudDaye
   anādi-dehātmābhimāna-nivṛttaye ||11||	anAdi-deha-AtmA-aBimAna--nivRttaye ||11||
   BhG 5.12	Bhu 5.12
   yuktaḥ karma-phalaṃ tyaktvā śāntim āpnoti naiṣṭhikīm |	yuktaH karma-Palam tyaktvA SAntim Apnoti nEzWikIm |
   ayuktaḥ kāma-kāreṇa phale sakto nibadhyate ||12||	ayuktaH kAma-kAreNa Pale saktaH nibaDyate ||12||
   śrīdharaḥ : nanu kathaṃ tenaiva karmaṇā kaścin mucyate kaścid badhyate iti	SrIDaraH : nanu kaTam tena-eva karmaNA kaScid mucyate kaScid baDyate iti
   vyavasthā ? ata āha yukta iti | yuktaḥ parameśvaraika-niṣṭhaḥ san karmaṇaḥ	vyavasTA ? atas Aha yuktaH iti | yuktaH parameSvara-eka--nizWaH san karmaNaH
   phalaṃ tyaktvā karmaṇi kurvann ātyantikīṃ śāntiṃ mokṣaṃ prāpnoti | ayuktas	Palam tyaktvA karmaNi kurvan AtyantikIm SAntim mokzam prApnoti | ayukta-s
   tu bahirmukhaḥ kāma-kāreṇa kāmataḥ pravṛttyā phala āsakto nitarāṃ bandhaṃ	tu bahirmuKaH kAma-kAreNa kAmataH pravRttyA PalaH AsaktaH nitarAm banDam
   prāpnoti ||12||	prApnoti ||12||
   madhusūdanaḥ : kartṛtvābhimāna-sāmye 'pi tenaiva karmaṇā kaścin mucyate	maDusUdanaH : kartR-tva-aBimAna--sAmye api tena-eva karmaNA kaScid mucyate
   kaścit tu badhyata iti vaiṣamye ko hetur iti tatrāha yukta iti | yukta	kaScid tu baDyate iti vEzamye kaH hetuH iti tatra-Aha yuktaH iti | yukta
   īśvarāyaivaitāni karmāṇi na mama phalāyety evam abhiprāyavān karma-phalaṃ	ISvarAya-eva-etAni karmANi na mama PalAya-iti evam aBiprAyavAn karma--Palam
   tyaktvā karmāṇi kurvan śāntim mokṣākhyām āpnoti naiṣṭhikīṃ	tyaktvA karmANi kurvan SAntim mokza-AKyAm Apnoti nEzWikIm
   sattva-śuddhi-nitya-vastu-viveka-saṃnyāsa-jñāna-niṣṭhā-krameṇa jātām iti	sattva--SudDi--nitya-vastu--viveka--saMnyAsa--jQAna-nizWA--krameNa jAtAm iti
   yāvat | yas tu punar ayukta īśvarāyaivaitāni karmāṇi na mama phalāyety	yAvat | yaH tu punar ayuktaH ISvarAya-eva-etAni karmANi na mama PalAya-iti-
   abhiprāya-śūnyaḥ sa kāma-kāreṇa kāmataḥ pravṛttyā mama phalāyaivedaṃ karma	aBiprAya--SUnyaH sa kAma-kAreNa kAmataH pravRttyA mama PalAya-eva-idam karma
   karomīti phale sakto nibadhyate karmabhir nitarāṃ saṃsāra-bandhaṃ prāpnoti	karomi-iti Pale saktaH nibaDyate karmaBiH nitarAm saMsAra--banDam prApnoti
   | yasmād evaṃ tasmāt tvam api yuktaḥ san karmāṇi kurv iti vākya-śeṣaḥ	| yasmAt evam tasmAt tvam api yuktaH san karmANi kuru iti vAkya-SezaH
   viśvanāthaḥ : karma-karaṇe anāsakty-āsaktī eva mokṣa-bandha-hetū ity āha	viSvanATaH : karma--karaNe anAsakti--AsaktI eva mokza--banDa--hetU iti Aha
   yukto yogī niṣkāma-karmītity arthaḥ | naiṣṭhikīm niṣṭhā-prāptāṃ śāntiṃ	yuktaH yogI nizkAma--karmi-ititi arTaH | nEzWikIm nizWA--prAptAm SAntim
   mokṣam ity arthaḥ | ayuktaḥ sa-kāma-karmīty arthaḥ | kāma-kāreṇa	mokzam iti arTaH | ayuktaH sa-kAma--karmi-iti arTaH | kAma--kAreNa
   kāma-pravṛttyā ||12||	kAma--pravRttyA ||12||
   baladevaḥ : yukta ātmārpita-manāḥ karma-phalaṃ tyaktvā kurvann naiṣṭhikīm	baladevaH : yuktaH Atma-arpita--manAH karma-Palam tyaktvA kurvan nEzWikIm
   sthirāṃ śāntim ātmāvaloka-lakṣaṇām āpnoti | ayukta ātmānarpita-manāḥ	sTirAm SAntim Atma-avaloka--lakzaNAm Apnoti | ayuktaH AtmAnarpita--manAH
   karma-phale saktaḥ kāma-kāreṇa kāmataḥ karmaṇi pravṛttyā nibadhyate	karma-Pale saktaH kAma-kAreNa kAmataH karmaNi pravRttyA nibaDyate
   saṃsarati ||12||	saMsarati ||12||
   BhG 5.13	Bhu 5.13
   sarva-karmāṇi manasā saṃnyasyāste sukhaṃ vaśī |	sarva-karmANi manasA saMnyasya-AH-te suKam vaSI |
   nava-dvāre pure dehī naiva kurvan na kārayan ||13||	nava-dvAre pure dehI na-eva kurvan na kArayan ||13||
   śrīdharaḥ : evaṃ tāvac citta-śuddhi-śūnyasya saṃnyāsāt karma-yogo	SrIDaraH : evam tAvat citta--SudDi--SUnyasya saMnyAsAt karma-yogaH-
   viśiṣyate ity etat prapañcitam | idānīṃ śuddha-cittasya saṃnyāsaḥ śreṣṭha	viSizyate iti etat prapaQcitam | idAnIm SudDa--cittasya saMnyAsaH SrezWa
   ity āha sarva-karmāṇīti | vaśī yata-cittaḥ | sarvāṇi karmāṇi vikṣepakāni	iti Aha sarva-karmANi-iti | vaSI yata-cittaH | sarvANi karmANi vikzepakAni
   manasā viveka-yuktena saṃnyasya sukhaṃ yathā bhavaty evaṃ jñāna-niṣṭhaḥ	manasA viveka--yuktena saMnyasya suKam yaTA Bavati evam jQAna--nizWaH
   sann āste | kvāsta iti ? ata āha nava-dvāra iti | netre nāsike karṇau	san Aste | kva-aste iti ? atas Aha nava-dvAraH iti | netre nAsike karNO
   mukhaṃ ceti sapta śiro-gatāni | adhogate dve pāyūpastha-rūpe iti | evaṃ	muKam ca-iti sapta Siro--gatAni | aDas-gate dve pAyu-upasTa--rUpe iti | evam
   nava-dvārāṇi yasmiṃs tasmin pure puravad ahaṅkāra-śūnye dehe dehy	nava-dvArANi yasmin tasmin pure pura-vat ahaFkAra--SUnye dehe dehi-
   avatiṣṭhate | ahaṅkārābhāvād eva svyaṃ tena dehena naiva kurvan	avatizWate | ahaFkAra-aBAvAt eva svyam tena dehena na-eva kurvan
   mama-kārābhāvāc ca na kārayan ity aviśuddha-cittād vyavṛttir uktā |	mama-kAra-aBAvAt ca na kArayan iti aviSudDa-cittAt vyavRttiH uktA |
   aśuddha-citto hi saṃnyasya punaḥ karoti kārayati ca | na tv ayaṃ tathā |	aSudDa-cittaH hi saMnyasya punar karoti kArayati ca | na tu ayam taTA |
   antaḥ sukhaṃ āsta ity arthaḥ ||13||	antar suKam Aste iti arTaH ||13||
   madhusūdanaḥ : aśuddha-cittasya kevalāt saṃnyāsāt karma-yogaḥ śreyān iti	maDusUdanaH : aSudDa--cittasya kevalAt saMnyAsAt karma-yogaH SreyAn iti
   pūrvoktaṃ prapañcyādhunā śuddha-cittasya sarva-karma-saṃnyāsa eva śreyān	pUrva-uktam prapaQcyA-aDunA SudDa--cittasya sarva-karma--saMnyAsaH eva SreyAn
   ity āha sarva-karmāṇīti | nityaṃ naimittikaṃ kāmyaṃ pratiṣiddhaṃ ceti	iti Aha sarva-karmANi-iti | nityam nEmittikam kAmyam pratizidDam ca-iti
   sarvāṇi karmāṇi manasā karmaṇy akarma yaḥ paśyed ity	sarvANi karmANi manasA karmaNi akarma yaH paSyet iti-
   atroktenākartrātma-svarūpa-samyag-darśanena saṃnyasya parityajya	atra-uktena-akartR-Atma--svarUpa--samyak--darSanena saMnyasya parityajya
   prārabdha-karma-vaśād āste tiṣṭhaty eva | kiṃ duḥkhena nety āha sukham	prArabDa--karma--vaSAt Aste tizWati eva | kim duHKena na-iti Aha suKam
   anāyāsena | āyāsa-hetu-kāya-vāṅ-mano-vyāpāra-śūnyatvāt | kāya-vāṅ-manāṃsi	anAyAsena | AyAsa--hetu-kAya-vAF-mano--vyApAra--SUnya-tvAt | kAya--vAF-manAMsi
   svacchandāni kuto na vyāpriyante tatrāha vaśī	svacCandAni kutas na vyApriyante tatra-Aha vaSI
   sva-vaśīkṛta-kārya-karaṇa-saṅghātaḥ | kvāste ? nava-dvāre pure dve śrotre	sva---vaSIkRta-kArya--karaNa--saFGAtaH | kva-Aste ? nava-dvAre pure dve Srotre
   dve cakṣuṣī dve nāsike vāg eketi śirasi sapta | dve pāyūpasthākhye adha	dve cakzuzI dve nAsike vAc ekA-iti Sirasi sapta | dve pAyu-upasTa-AKye aDa
   iti nava-dvāra-viśiṣṭe dehe | dehī deha-bhinnātma-darśī pravāsīva	iti nava--dvAra--viSizwe dehe | dehI deha-Binna-Atma-darSI pravAsI-iva
   para-gehe tat-pūjā-paribhavādibhir aprahṛṣyann aviṣīdann	para-gehe tat--pUjA--pariBava-AdiBiH aprahRzyan avizIdat-=-
   ahaṅkāra-mamakāra-śūnyas tiṣṭhati | ajño hi dehatādātmyābhimānād deha eva	ahaFkAra--mamakAra--SUnyaH tizWati | ajQaH hi deha-tAdAtmya-aBimAnAt dehaH eva
   na tu dehī | sa ca dehādhikaraṇam evātmano 'dhikaraṇaṃ manyamāno gṛhe	na tu dehI | sa ca deha-aDikaraNam eva-AtmanaH aDikaraNam manyamAnaH gRhe
   bhūmāvasāne vāham āsa ity abhimanyate na tu dehe 'ham āsa iti	BUma-avasAne vA-aham AsaH iti aBimanyate na tu dehe aham AsaH iti
   bheda-darśanābhāvāt | saṃghāta-vyatiriktātma-darśī tu sarva-karma-saṃnyāsī	Beda--darSana-aBAvAt | saMGAta--vyatirikta-Atma-darSI tu sarva-karma--saMnyAsI
   bheda-darśanād dehe 'ham āsa iti pratipadyate | ataeva dehādi-vyāpārāṇām	Beda--darSanAt dehe aham AsaH iti pratipadyate | ataeva deha-Adi--vyApArANAm
   avidyayātmany akriye samāropitānāṃ vidyayā bādha eva sarva-karma-saṃnyāsa	avidyayA-Atmani akriye samAropitAnAm vidyayA bADaH eva sarva-karma--saMnyAsa
   ity ucyate | etasmād evājña-vailakṣaṇyādy-uktaṃ viśeṣaṇaṃ nava-dvāre pure	iti ucyate | etasmAt eva-ajQa--vElakzaNyAt-i--uktam viSezaNam nava-dvAre pure
   āsta iti |	Aste iti |
   nanu dehādi-vyāpārāṇām ātmany āropitānāṃ nau-vyāpārāṇāṃ tīrastha-vṛkṣa iva	nanu deha-Adi--vyApArANAm Atmani AropitAnAm nO-vyApArANAm tIra-sTa-vRkzaH iva
   vidyayā bādhe 'pi sva-vyāpāreṇātmanaḥ kartṛtvaṃ dehādi-vyāpāreṣu	vidyayA bADe api sva--vyApAreNa-AtmanaH kartR-tvam deha-Adi-vyApArezu
   kārayitṛtvaṃ ca syād iti nety āha naiva kurvan na kārayan | āsta iti	kArayitR-tvam ca syAt iti na-iti Aha na-eva kurvan na kArayan | Aste iti
   sambandhaḥ ||13||	sambanDaH ||13||
   viśvanāthaḥ : ato 'nāsaktaḥ karmāṇi kurvann api jñeyaḥ sa nitya-saṃnyāsī	viSvanATaH : atas anAsaktaH karmANi kurvan api jQeyaH sa nitya--saMnyAsI
   iti pūrvoktavad vastutaḥ saṃnyāsī evocyate tatrāha sarva-karmāṇi manasā	iti pUrva-ukta-vat vastutas saMnyAsI eva-ucyate tatra-Aha sarva-karmANi manasA
   saṃnyasya kāyādi-vyāpāreṇa bahiḥ kurvann api vaśī jitendriyaḥ sukham āste	saMnyasya kAya-Adi--vyApAreNa bahis kurvan api vaSI jita-indriyaH suKam Aste
   | kutra ? nava-dvāre pure ahaṃ-bhāva-śūnye dehe dehy utpanna-jñāno jīvo	| kutra ? nava-dvAre pure ahaM-BAva--SUnye dehe dehi utpanna--jQAnaH jIvaH-
   naiva kurvann iti karma-sukhasya vastutaḥ kartṛtvaṃ naivāstīti jānan, na	na-eva kurvan iti karma--suKasya vastutas kartR-tvam na-eva-asti-iti jAnan, na
   kārayann iti nāpi teṣu prayojana-kartṛtvam ity api jānann ity arthaḥ	kArayan iti na-api tezu prayojana-kartR-tvam iti api jAnan iti arTaH
   baladevaḥ : sarveti | vivekatā manasā tādṛśi pradhāne sarva-karmāṇi	baladevaH : sarva-iti | viveka-tA manasA tAdRSi praDAne sarva-karmANi
   saṃnyasyārpayitvā dehādinā bahis tāni kurvann api vaśī jitendriyaḥ sukhaṃ	saMnyasya-arpayitvA deha-AdinA bahis tAni kurvan api vaSI jita-indriyaH suKam
   āste | nava-dvāre pure puravad ahaṃ-bhāva-varjite dehe dve netre dve	Aste | nava-dvAre pure pura-vat ahaM-BAva--varjite dehe dve netre dve
   nāsike dve śrotre mukhaṃ ceti śirasi sapta dvārāṇi adhastāt tu	nAsike dve Srotre muKam ca-iti Sirasi sapta dvArANi aDastAt tu
   pāyūpasthākhye dve iti nava-dvārāṇi dehī labdha-jñānojīvaḥ | naiveti	pAyu-upasTa-AKye dve iti nava-dvArANi dehI labDa--jQAnojIvaH | na-eva-iti
   dehādi-viviktasyātmanaḥ karmasu kartṛtvaṃ kārayitṛtvaṃ ca nāstīti vijānann	deha-Adi--viviktasya-AtmanaH karmasu kartR-tvam kArayitR-tvam ca na-asti-iti vijAnan=-
   ity arthaḥ ||13||	iti arTaH ||13||
   BhG 5.14	Bhu 5.14
   na kartṛtvaṃ na karmāṇi lokasya sṛjati prabhuḥ |	na kartR-tvam na karmANi lokasya sRjati praBuH |
   na karma-phala-saṃyogaṃ svabhāvas tu pravartate ||14||	na karma--Pala--saMyogam svaBAvaH tu pravartate ||14||
   śrīdharaḥ : nanu eṣa hy evainaṃ sādhu karma kārayati taṃ yam ebhyo	SrIDaraH : nanu eza hi eva-enam sADu karma kArayati tam yam eByaH-
   lokebhya unninīṣate | eṣa asādhu karma kārayati taṃ yam adho ninīṣate	lokeByaH unninIzate | eza asADu karma kArayati tam yam aDas ninIzate
   ity-ādi-śruteḥ parameśvareṇaiva śubhāśubha-phaleṣu karmasu kartṛtvena	iti--Adi-SruteH parameSvareNa-eva SuBa-aSuBa--Palezu karmasu kartR-tvena
   prayujyamāno 'svatantraḥ puruṣaḥ kathaṃ tāni karmāṇi tyajet ? īśvareṇaiva	prayujyamAnaH asvatantraH puruzaH kaTam tAni karmANi tyajet ? ISvareNa-eva
   jñāna-mārge prayujyamāṇaḥ śubhāśubhani ca tyakṣyatīti cet ? evaṃ sati	jQAna--mArge prayujyamANaH SuBa-aSuBani ca tyakzyati-iti ced ? evam sati
   vaiṣamya-nairghṛṇyābhyām īśvarasyāpi prayojaka-kartṛtvāt	vEzamya-nErGRNyAByAm ISvarasya-api prayojaka--kartR-tvAt
   puṇya-pāpa-sambandhaḥ syād ity āśaṅkyāha na kartṛtvam iti dvābhyām |	puNya-pApa--sambanDaH syAt iti ASaFkya-Aha na kartR-tvam iti dvAByAm |
   prabhur īśvaro jīva-lokasya kartṛtvādikaṃ na sṛjati, kintu jīvasya	praBuH ISvaraH jIva--lokasya kartR-tva-Adikam na sRjati, kintu jIvasya
   svabhāvo 'vidyaiva kartṛtvādi-rūpeṇa pravartate | anādy-avidyā-kāma-vaśāt	svaBAvaH avidyA-eva kartR-tva-Adi--rUpeNa pravartate | anAdy-a-vidyA--kAma--vaSAt
   pravṛtti-svabhāvaṃ jīva-lokam īśvaraḥ karmasu niyuṅkte | na tu svayam eva	pravRtti--svaBAvam jIva--lokam ISvaraH karmasu niyuFkte | na tu svayam eva
   kartṛtvādikam utpādayatīty arthaḥ ||14||	kartR-tva-Adikam utpAdayati-iti arTaH ||14||
   madhusūdanaḥ : devadattasya svagataiva gatir yathā sthitau satyāṃ na	maDusUdanaH : devadattasya sva-gatA-eva gatiH yaTA sTitO satyAm na
   bhavati evam ātmano 'pi kartṛtvaṃ kārayitṛtvam na svagatam eva	Bavati evam AtmanaH api kartR-tvam kArayitR-tvam na sva-gatam eva
   sat-saṃnyāse sati na bhavati, athavā nabhasi tala-malinatādivad	sat--saMnyAse sati na Bavati, aTavA naBasi tala-mali-na-tA-Adi-vat-
   vastu-vṛttyā tatra nāsty eveti sandehāpohāyāha na kartṛtvam iti | lokasya	vastu-vRttyA tatra na-asti eva-iti sandeha-apohAya-Aha na kartR-tvam iti | lokasya
   dehādeḥ kartṛtvaṃ prabhur ātmā svāmī na sṛjati tvaṃ kurv iti niyogena	deha-AdeH kartR-tvam praBuH AtmA svAmI na sRjati tvam kuru iti niyogena
   tasya kārayitā na bhavatīty arthaḥ | nāpi lokasya karmāṇīpsitatamāni	tasya kArayitA na Bavati-iti arTaH | na-api lokasya karmANi-IpsitatamAni
   ghaṭādīni svayaṃ sṛjati kartāpi na bhavatīty arthaḥ | nāpi lokasya karma	Gawa-AdIni svayam sRjati kartA-api na Bavati-iti arTaH | na-api lokasya karma
   kṛtavatas tat-phala-sambandhaṃ sṛjati bhojayitāpi bhoktāpi na bhavatīty	kRtavataH tat-Pala--sambanDam sRjati BojayitA-api BoktA-api na Bavati-iti-
   arthaḥ | na samānaḥ sann ubhau lokāv anusaṃcarati dhyāyatīva lelāyatīva	arTaH | na samAnaH san uBO lokO anusaMcarati DyAyati-iva lelAyati-iva
   sadhīḥ ity ādi śruteḥ | atrāpi śarīrastho 'pi kaunteya na karoti na	saDIH iti Adi SruteH | atra-api SarIra-sTaH api kOnteya na karoti na
   lipyate [Gītā 13.31] ity ukteḥ |	lipyate [GItA 13.31] iti ukteH |
   yadi kiṃcid api svato na kārayati na karoti cātmā kas tarhi kārayan	yadi kiMcid api svatas na kArayati na karoti ca-AtmA kaH tarhi kArayan
   kurvaṃś ca pravartata iti tatrāha svabhāvas tv iti | ajñānātmikā daivī	kurvan ca pravartate iti tatra-Aha svaBAvaH tu iti | ajQAna-AtmikA dEvI
   māyā prakṛtiḥ pravartate ||14||	mAyA prakRtiH pravartate ||14||
   viśvanāthaḥ : nanu ca yadi jīvasya vastutaḥ kartṛtvādikaṃ naivāsti, tarhi	viSvanATaH : nanu ca yadi jIvasya vastutas kartR-tva-Adikam na-eva-asti, tarhi
   parameśvara-sṛṣṭe jagati sarvatra jīvasya kartṛtva-bhokṛtvādi-darśanān	parameSvara--sRzwe jagati sarvatra jIvasya kartR-tva-BokR-tva-Adi-darSanAn
   manye parameśareṇaiva balāt tasya kartṛtvādikaṃ sṛṣṭam | tathā sati tasmin	manye parameSareNa-eva balAt tasya kartR-tva-Adikam sRzwam | taTA sati tasmin
   vaiṣamya-nairghṛṇye prasakte, tatra na hi nahīty āha na kartṛtvam iti |	vEzamya-nErGRNye prasakte, tatra na hi na-hi-iti Aha na kartR-tvam iti |
   nāpi tat-kartṛtvena karmāṇy api, na ca karma-phalair bhogaiḥ saṃyogam api,	na-api tat-kartR-tvena karmANi api, na ca karma-PalEH BogEH saMyogam api,
   kintu jīvasya svabhāvo 'nādy-avidyaiva pravartate | taṃ jīvaṃ	kintu jIvasya svaBAvaH anAdy-avidyA-eva pravartate | tam jIvam
   kartṛtvādy-abhimānam ārohayitum iti bhāvaḥ ||14||	kartR-tva-Adi--aBimAnam Arohayitum iti BAvaH ||14||
   baladevaḥ : etad dvayaṃ śuddhasya nāstīti viśadayati neti | prabhur	baladevaH : etat dvayam SudDasya na-asti-iti viSadayati na-iti | praBuH-
   dehendriyādīnāṃ svāmī jīvo lokasya janasya kartṛtvaṃ na sṛjatīti tvaṃ kurv	deha-indriya-AdInAm svAmI jIvaH lokasya janasya kartR-tvam na sRjati-iti tvam kurv
   iti kārayitā na bhavati | nāpi tasyepsitatamāni karmāṇi mālyāmbarādīni	iti kArayitA na Bavati | na-api tasya-IpsitatamAni karmANi mAlya-ambara-AdIni
   sṛjatīti svayaṃ kartāpi na bhavati | na ca karma-phalena sukhena duḥkhena	sRjati-iti svayam kartA-api na Bavati | na ca karma--Palena suKena duHKena
   ca saṃyogaṃ sambandhaṃ sṛjatīti bhojayitā bhoktā ca na bhavatīty arthaḥ |	ca saMyogam sambanDam sRjati-iti BojayitA BoktA ca na Bavati-iti arTaH |
   yady evaṃ, tarhi kaḥ kārayan kurvaṃś ca pratīyate ? tatrāha svabhāvas tv	yadi evaM, tarhi kaH kArayan kurvan ca pratIyate ? tatra-Aha svaBAvaH tu-
   iti | anādi-pravṛttā pradhāna-vāsanātra	iti | anAdi--pravRttA praDAna--vAsanA-atra
   svabhāva-śabdenokta-prādhānika-dehādimān jīvaḥ kārayitā kartā ceti na	svaBAva--Sabdena-ukta--prADAnika--deha-AdimAn jIvaH kArayitA kartA ca-iti na
   viviktasya tattvam iti | śuddhe 'pi kiṃcit kartṛtvam asty eva pūrvatra	viviktasya tattvam iti | SudDe api kiMcid kartR-tvam asti eva pUrvatra
   sukhāsane tattvasyokteḥ bhānādāv ivaitad bodhyaṃ, dhātv-arthaḥ khalu	suKa-Asane tattvasya-ukteH BAnAdO iva-etat boDyaM, DAtu--arTaH Kalu
   kriyā, tan-mukhyatvaṃ hi kartṛtvam uktam ||14||	kriyA, tan--muKya-tvam hi kartR-tvam uktam ||14||
   BhG 5.15	Bhu 5.15
   nādatte kasya cit pāpaṃ na caiva sukṛtaṃ vibhuḥ |	na-Adatte kasya cit pApam na ca-eva sukRtam viBuH |
   ajñānenāvṛtaṃ jñānaṃ tena muhyanti jantavaḥ ||15||	ajQAnena-AvRtam jQAnam tena muhyanti jantavaH ||15||
   śrīdharaḥ : yasmād evaṃ tasmāt nādatta iti | prayojako 'pi san prabhuḥ	SrIDaraH : yasmAt evam tasmAt na-adattaH iti | prayojakaH api san praBuH
   kasyacit pāpaṃ sukṛtaṃ ca naivādatte na bhajate | tatra hetuḥ - vibhuḥ	kasyacid pApam sukRtam ca na-eva-Adatte na Bajate | tatra hetuH  viBuH
   paripūrṇaḥ | āpta-kāma ity arthaḥ | yadi hi svārtha-kāmanayā kārayet tarhi	paripUrNaH | Apta-kAmaH iti arTaH | yadi hi sva-arTa-kAmanayA kArayet tarhi
   tathā syāt | na tv etad asti | āpta-kāmasyaivācintya-nija-māyayā	taTA syAt | na tu etat asti | Apta-kAmasya-eva-acintya-nija--mAyayA
   tat-tat-pūrva-karmānusāreṇa pravartakatvāt |	tat-tat--pUrva--karma-anusAreNa pravartaka-tvAt |
   nanu bhaktān anugṛhṇato 'bhaktān nigṛhṇataś ca vaiṣamyopalambhāt katham	nanu BaktAn anugRhNataH aBaktAt nigRhNataH ca vEzamya-upalamBAt kaTam
   āpta-kāmatvam iti ? ata āha ajñāneneti | nigraho 'pi daṇḍa-rūpo 'nugraha	Apta-kAma-tvam iti ? atas Aha ajQAnena-iti | nigrahaH api daNxa--rUpaH anugraha
   eveti | evam ajñānena sarvatra samaḥ parameśvara ity evaṃbhūtaṃ jñānam	eva-iti | evam ajQAnena sarvatra samaH parameSvaraH iti evaMBUtam jQAnam
   āvṛtam | tena hetunā jantavo jīvā muhyanti | bhagavati vaiṣamyaṃ manyanta	AvRtam | tena hetunA jantavaH jIvAH muhyanti | Bagavati vEzamyam manyanta
   ity arthaḥ ||15||	iti arTaH ||15||
   madhusūdanaḥ : nanv īśvaraḥ kārayitā jīvaḥ kartā, tathā ca śrutiḥ - eṣa u	maDusUdanaH : nanu ISvaraH kArayitA jIvaH kartA, taTA ca SrutiH  ezaH u
   hy eva sādhu karma kārayati taṃ yam unninīyate | eṣa u evāsādhu karma	hi eva sADu karma kArayati tam yam unninIyate | ezaH u eva-asADu karma
   kārayati taṃ yam adho ninīṣate ity ādiḥ | smṛtiś ca -	kArayati tam yam aDas ninIzate iti AdiH | smRtiH ca -
   ajño jantur anīśo 'yam ātmanaḥ sukha-duḥkhayoḥ |	ajQaH jantuH anISaH ayam AtmanaH suKa--duHKayoH |
   īśvara-prerito gacchet svargaṃ vāśvabhram eva ca || iti |	ISvara--preritaH gacCet svargam vA-aSvaBram eva ca || iti |
   tathā ca jīveśvarayoḥ kartṛtva-kārayitṛtvābhyāṃ	taTA ca jIveSvarayoH kartR-tva--kArayitR-tvAByAm
   bhoktṛtva-bhojayitṛtvābhyāṃ ca pāpa-puṇya-lepa-sambhavāt katham uktaṃ	BoktR-tva-BojayitR-tvAByAm ca pApa--puNya--lepa--samBavAt kaTam uktam
   svabhāvas tu pravartata iti tatrāha nādatta iti | paramārthataḥ vibhuḥ	svaBAvaH tu pravartate iti tatra-Aha na-adattaH iti | paramArTataH viBuH
   parameśvaraḥ kasyacit jīvasya pāpaṃ sukṛtaṃ ca naivādatte paramārthato	parameSvaraH kasyacid jIvasya pApam sukRtam ca na-eva-Adatte paramArTa-taH-
   jīvasya kartṛtvābhāvāt parameśvarasya ca kārayitṛtvābhāvāt | kathaṃ tarhi	jIvasya kartR-tva-aBAvAt parameSvarasya ca kArayitR-tva-aBAvAt | kaTam tarhi
   śrutiḥ smṛtir loka-vyavahāraś ca tatrāha ajñānenāvaraṇa-vikṣepā-śaktimatā	SrutiH smRtiH loka-vyavahAraH ca tatra-Aha ajQAnena-AvaraNa--vikzepA--SaktimatA
   māyākhyenānṛtena tamasāvṛtam ācchāditaṃ jñānaṃ	mAyA-AKyena-anRtena tamasA-AvRtam AcCAditam jQAnam
   jīveśvara-jagad-bheda-bhramādhiṣṭhāna-bhūtaṃ nityaṃ sva-prakāśaṃ	jIva-ISvara--jagat--Beda--Brama-aDizWAna--BUtam nityam sva--prakASam
   sac-cid-ānanda-rūpam advitīyaṃ paramārtha-satyaṃ, tena svarūpāvaraṇena	sac-cit--A-Ananda--rUpam advitIyam parama-arTa--satyan, tena sva-rUpa-AvaraNena
   muhyanti	muhyanti
   pramātṛ-prameya-pramāṇa-kartṛ-karma-karaṇa-bhoktṛ-bhogya-bhogākhya-nava-vidha-saṃsāra-rūpaṃ	pramAtR-prameya--pramANa-kartR--karma-karaNa--BoktR-Bogya-Boga-AKya-nava-viDa--saMsAra-rUpam
   moham atasmiṃs tad-avabhāsa-rūpaṃ vikṣepaṃ gacchanti jantavo janana-śīlāḥ	moham atasmin tad--avaBAsa-rUpam vikzepam gacCanti jantavaH janana--SIlAH
   saṃsāriṇo vastu-svarūpādarśinaḥ |	saMsAriNaH vastu--svarUpa-adarSinaH |
   akartr-abhoktṛ-paramānandādvitīyātma-svarūpādarśana-nibandhano 'yaṃ	akartr-a-BoktR--parama-AnandA-dvitIya-Atma--svarUpa-adarSana--nibanDanaH ayam
   jīveśvara-jagad-bheda-bhramaḥ pratīyamāno vartate mūḍhānām | tasyāṃ	jIveSvara--jagat--Beda--BramaH pratIyamAnaH vartate mUXAnAm | tasyAm
   cāvasthāyāṃ mūḍha-pratyayānuvādinyāv ete śruti-smṛtī	ca-avasTAyAm mUXa--pratyaya-anuvAdinyO ete Sruti-smRtI
   vāstavādvaita-bodhi-vākya-śeṣa-bhūte iti na doṣaḥ ||15||	vAstavAt-vEta--boDi--vAkya--Seza-BUte iti na dozaH ||15||
   viśvanāthaḥ : yasmād asādhu-sādhu-karmaṇām īśvaro na kārayitā, tasmād eva	viSvanATaH : yasmAt asADu--sADu--karmaNAm ISvaraH na kArayitA, tasmAt eva
   na tasya pāpa-puṇya-bhāgitvam ity āha nādatta iti | nādatte na gṛhṇāti |	na tasya pApa--puNya-BAgi-tvam iti Aha na-adattaH iti | na-Adatte na gRhNAti |
   kintu tadīyā khalu yā śaktir avidyā saiva jīva-jñānam āvṛṇoti ity āha	kintu tadIyA Kalu yA SaktiH avidyA sA-eva jIva--jQAnam AvRNoti iti Aha
   ajñānenāvidyayā | jñānaṃ jīvasya svābhāvikam | tena hetunā ||15||	ajQAnena-avidyayA | jQAnam jIvasya svABAvikam | tena hetunA ||15||
   baladevaḥ : nanu yadi viśuddhasya jīvasya tādṛśa-karma-kartṛtvādi nāstīti	baladevaH : nanu yadi viSudDasya jIvasya tAdRSa--karma-kartR-tva-Adi na-asti-iti
   brūṣe, tarhi kautukākrāntaḥ paramātmā pradhānaṃ tad-gale nipātya	brUze, tarhi kOtuka-AkrAntaH paramAtmA praDAnam tat--gale nipAtya
   tat-pariṇāma-dehendriyādi-matas tasya tad-racitavān ity āpadyate | yuktaṃ	tat--pariNAma--deha-indriya-Adi--mataH tasya tad--racitavAn iti Apadyate | yuktam
   caitat | anyathā eṣa u hy eva sādhu karma kārayati taṃ yam ebhyo lokebhya	ca-etat | anyaTA ezaH u hi eva sADu karma kArayati tam yam eByaH lokeBya
   unninīṣate | eṣa u evāsādhu karma kārayati taṃ yam adho ninīṣate iti	unninIzate | ezaH u eva-asADu karma kArayati tam yam aDas ninIzate iti
   śrutiḥ |	SrutiH |
   ajño jantur anīśo 'yam ātmanaḥ sukha-duḥkhayoḥ |	ajQaH jantuH anISaH ayam AtmanaH suKa--duHKayoH |
   īśvara-prerito gacchet svargaṃ vāśv abhram eva ca ||	ISvara--preritaH gacCet svargam vA-ASu aBram eva ca ||
   iti smṛtiś ca vyākupyet | tathā ca pāpa-puṇya-mayīm avasthāṃ nayati |	iti smRtiH ca vyAkupyet | taTA ca pApa--puNya--mayIm avasTAm nayati |
   prayojake tasmin vaiṣamyādikaṃ pāpādi-bhāgitvaṃ ca syād iti cet tatrāha	prayojake tasmin vEzamya-Adikam pApa-Adi-BAgi-tvam ca syAt iti ced tatra-Aha
   nādatta iti |	na-adattaH iti |
   vibhur aparimita-vijñānānando 'nanta-śakti-pūrṇaḥ svānandaika-rasikas tato	viBuH aparimita-vijQAna-AnandaH ananta--Sakti--pUrNaH sva-Ananda-eka-rasikaH tatas-
   'nyatrodāsīnaḥ paramātmānādi-pradhāna-vāsanā-nibandhaṃ bubhukṣuṃ	anyatra-udAsInaH paramAtmA-anAdi-praDAna--vAsanA--nibanDam buBukzum
   sva-sannidhi-mātra-pariṇata-pradhāna-maya-dehādimantaṃ jīvaṃ	sva--sanniDi--mAtra--pariNata--praDAna-maya--deha-Adi-mantam jIvam
   tad-vāsanānusāreṇa karmāṇi kārayan kasyacij jīvasya pāpaṃ sukṛtaṃ ca	tad--vAsana-anusAreNa karmANi kArayan kasyacid jIvasya pApam sukRtam ca
   nādatte na gṛhṇāti | evam uktaṃ śrī-vaiṣṇave -	na-Adatte na gRhNAti | evam uktam SrI--vEzNave -
   yathā sannidhi-mātreṇa gandhaḥ kṣobhāya jāyate |	yaTA sanniDi--mAtreNa ganDaH kzoBAya jAyate |
   manaso nopakartṛtvāt tathāsau parameśvaraḥ ||	manasaH na-upakartR-tvAt taTA-asO parameSvaraH ||
   sannidhānād yathākāśa-kālādyāḥ kāraṇaṃ taroḥ |	sanniDAnAt yaTA-AkASa--kAla-AdyAH kAraNam taroH |
   tathaivāpariṇāmena viśvasya bhagavān hariḥ || [ViP 1.2.30-1] iti |	taTA-eva-apariNAmena viSvasya BagavAn hariH || [ViS 1.2.30-1] iti |
   audāsīnya-mātre 'yaṃ gandhādi-dṛṣṭānto na tv icchāyā abhāve tasyāḥ | so	OdAsInya--mAtre ayam ganDa-Adi-dRzwAntaH na tu icCAyAH aBAve tasyAH | saH-
   'kāmayata iti śrutatvāt | tarhi jīvās taṃ viṣamaṃ kuto vadanti, tatrāha	akAmayatas iti Sruta-tvAt | tarhi jIvAH tam vizamam kutas vadanti, tatra-Aha
   ajñāneneti | anādi-tad-vaimukhyenājñānena jīvānāṃ nityam api jñānam āvṛtaṃ	ajQAnena-iti | anAdi-tad--vEmuKyena-ajQAnena jIvAnAm nityam api jQAnam AvRtam
   tirohitam | tena hetunā jantavo jīvā muhyanti | samam api taṃ vimūḍhā	tirohitam | tena hetunA jantavaH jIvAH muhyanti | samam api tam vimUXA
   viṣamaṃ vadanti na vijñā ity arthaḥ | āha caivaṃ sūtrakāraḥ -	vizamam vadanti na vijQAH iti arTaH | Aha ca-evam sUtrakAraH -
   vaiṣamya-nairghṛṇye na sāpekṣatvāt tathā hi darśayati [Vs 2.1.35], na	vEzamya-nErGRNye na sa-apekza-tvAt taTA hi darSayati [VH 2.1.35], na
   karmāvibhāgād iti cen nānāditvāt [Vs 2.1.36] iti ||15||	karma-aviBAgAt iti ced nAnA-Adi-tvAt [VH 2.1.36] iti ||15||
   BhG 5.16	Bhu 5.16
   jñānena tu tad ajñānaṃ yeṣāṃ nāśitam ātmanaḥ |	jQAnena tu tat ajQAnam yezAm nASitam AtmanaH |
   teṣām ādityavaj jñānaṃ prakāśayati tatparam ||16||	tezAm Aditya-vat jQAnam prakASayati tad-param ||16||
   śrīdharaḥ : jñāninas tu na muhyantīty āha jñāneneti | bhagavato jñānena	SrIDaraH : jQAninaH tu na muhyanti-iti Aha jQAnena-iti | BagavataH jQAnena
   yeṣāṃ tad-vaiṣamyopalambhakam ajñānaṃ nāśitam taj jñānaṃ teṣām ajñānaṃ	yezAm tat--vEzamya-upalamBakam ajQAnam nASitam tat jQAnam tezAm ajQAnam
   nāśayitvā tat paraṃ paripūrṇam īśvara-svarūpaṃ prakāśayati | yathādityas	nASayitvA tat param paripUrNam ISvara--svarUpam prakASayati | yaTA-Aditya-s
   tamo nirasya samastaṃ vastu-jātaṃ prakāśayati tadvat ||16||	tamaH nirasya samastam vastu-jAtam prakASayati tadvat ||16||
   madhusūdanaḥ : tarhi sarveṣām andādy-ajñānāvṛtatvāt kathaṃ	maDusUdanaH : tarhi sarvezAm anda-Ady-a-jQAna-AvRta-tvAt kaTam
   saṃsāra-nivṛttiḥ syād ? ata āha jñāneneti |	saMsAra-nivRttiH syAt ? atas Aha jQAnena-iti |
   tad-āvaraṇa-vikṣepa-śakti-madanādy-anirvācyam anṛtam anarthavāta-mūlam	tad--AvaraNa--vikzepa--Sakti--madana-Ady-a-nirvAcyam anRtam anarTa-vAta--mUlam
   ajñānam ātmāśraya-viṣayam avidyā-māyādi-śabda-vācyam ātmano jñānena	ajQAnam Atma-ASraya--vizayam avidyA-mAyA-Adi--Sabda--vAcyam AtmanaH jQAnena
   gurūpadiṣṭa-vedānta-mahā-vākya-janyena	guru-upadizwa--veda-anta--mahA-vAkya--janyena
   śravana-manana-nididhyāsana-paripāka-nirmalāntaḥkaraṇa-vṛtti-rūpeṇa	Srava-na-manana--nidiDi-Asana--paripAka--nirmala-antaHkaraNa--vRtti--rUpeNa
   nirvikalpaka-sākṣātkāreṇa	nirvikalpaka-sAkzAtkAreNa
   śodhita-tat-tvaṃ-padārthābheda-rūpa-śuddha-sac-cid-ānandākhaṇḍaika-rasa-vastu-mātra-viṣayeṇa	SoDita---tat--tvaM-padArTa-aBeda--rUpa--SudDa--sac-cit--a-AnandA-KaNxa-eka-rasa-vastu--mAtra--vizayeNa
   nāśitaṃ bādhitaṃ kāla-traye 'py asad evāsattayā jñātam	nASitam bADitam kAla-traye api asat eva-asat-tayA jQAtam
   adhiṣṭhāna-caitanya-mātratāṃ prāpitaṃ śuktāv iva rajataṃ śukti-jñānena	aDizWAna--cEtanya--mAtra-tAm prApitam SuktO iva rajatam Sukti--jQAnena
   śravana-manana-nididhyāsanādi-sādhana-sampannānāṃ bhagavad-anugṛhītānāṃ	Srava-na-manana--nidiDi-Asana-Adi-sADana--sampannAnAm Bagavat--anugRhItAnAm
   mumukṣūṇāṃ teṣāṃ taj jñānaṃ kartṛ | ādityavad yathādityaḥ	mumukzUNAm tezAm tat jQAnam kartR | Aditya-vat yaTA-AdityaH
   svodaya-mātreṇaiva tamo niravaśeṣaṃ nivartayati na tu kaṃcit sahāyam	sva-udaya--mAtreNa-eva tamaH niravaSezam nivartayati na tu kaMcid sahAyam
   apekṣate tathā brahma-jñānam api śuddha-sattva-pariṇāmatvād	apekzate taTA brahma-jQAnam api SudDa--sattva--pariNAma-tvAt-
   vyāpaka-prakāśa-rūpaṃ svotpatti-mātreṇaiva sahakāryantara-nirapekṣatayā	vyApaka--prakASa--rUpam sva-utpatti--mAtreNa-eva sahakAri-antara--nirapekza-tayA
   sa-kāryam ajñānaṃ nivartayat param satya-jñānaānantānanda-rūpam ekam	sa-kAryam ajQAnam nivartayat param satya--jQAnaa-anantA-nanda--rUpam ekam
   evādvitīyaṃ paramātma-tattvaṃ prakāśayati praticchāyā-grahaṇa-mātreṇaiva	eva-advitIyam paramAtma--tattvam prakASayati praticCAyA-grahaNa--mAtreNa-eva
   karmatām antareṇābhivyanakti |	karmatAm antareNa-aBivyanakti |
   atrājñānenāvṛtaṃ jñānena nāśitam ity	atra-ajQAnena-AvRtam jQAnena nASitam iti-
   ajñānansyāvaraṇatva-jñāna-nāśyatvābhyāṃ jñānābhāva-rūpatvaṃ vyāvartitam |	ajQAnan-syAvaraNa-tva--jQAna--nASya-tvAByAm jQAna-aBAva--rUpa-tvam vyAvartitam |
   nahy abhāvaḥ kiṃcid āvṛṇoti na vā jñānābhāvo jñānena nāśyate svabhāvato	nahi aBAvaH kiMcid AvRNoti na vA jQAna-aBAvaH jQAnena nASyate svaBAvataH-
   nāśa-rūpatvāt tasya | tasmād aham ajño mām anyaṃ ca na jānāmīty	nASa--rUpa-tvAt tasya | tasmAt aham ajQaH mAm anyam ca na jAnAmi-iti-
   ādi-sākṣi-pratyakṣa-siddhaṃ bhāva-rūpam evājñānam iti bhagavato matam |	Adi-sa-akzi--pratyakza--sidDam BAva--rUpam eva-ajQAnam iti BagavataH matam |
   vistaras tv advaita-siddhau draṣṭavyaḥ |	vistaraH tu advEta--sidDO drazwavyaH |
   yeṣām iti bahu-vacanenāniyamo darśitaḥ | tathā ca śrutiḥ - tad yo yo	yezAm iti bahu--vacanena-aniyamaH darSitaH | taTA ca SrutiH  tat yaH yaH-
   devānāṃ pratyabudhyata sa eva tad abhavat tatha rṣīṇāṃ tathā manuṣyāṇāṃ	devAnAm pratyabuDyata saH eva tat aBavat taTa rzINAm taTA manuzyANAm
   tad idam apy etarhi ya evaṃ vedāhaṃ brahmāsmīti sa idaṃ sarvaṃ bhavati ity	tat idam api etarhi yaH evam veda-aham brahma-asmi-iti saH idam sarvam Bavati iti-
   ādir yad viṣayaṃ yad-āśrayam ajñānaṃ tad-viṣaya-tad-āśraya-pramāṇa-jñānāt	AdiH yat vizayam yat--ASrayam ajQAnam tad--vizaya--tad-ASraya--pramANa--jQAnAt
   tan-nivṛttir iti nyāya-prāptam aniyamaṃ darśayati | tatrājñāna-gatam	tan--nivRttiH iti nyAya--prAptam aniyamam darSayati | tatra-ajQAna--gatam
   āvaraṇaṃ dvividham - ekaṃ sato 'py asattvāpādakam anyat tu bhāto 'py	AvaraNam dviviDam  ekam sataH api asattva-ApAdakam anyat tu BAtaH api-
   abhānāpādakam | tatrādyaṃ parokṣāparokṣa-sādhāraṇa-pramāṇa-jñāna-mātrān	aBAna-ApAdakam | tatra-Adyam parokza-aparokza--sADAraNa--pramANa--jQAna--mAtrAn
   nivartate | anumite 'pi vahny-ādau parvate vahnir nāstīty	nivartate | anumite api vahni--AdO parvate vahniH na-asti-iti-
   ādi-bhramādarśanāt | tathā satyaṃ jñānam anantaṃ brahmāsti iti vākyāt	Adi-Brama-adarSanAt | taTA satyam jQAnam anantam brahma-asti iti vAkyAt-
   parokṣa-niścaye 'pi brahma nāstīti bhramo nivartata eva | asty eva brahma	parokza--niScaye api brahma na-asti-iti BramaH nivartate eva | asti eva brahma
   kintu mama na bhātīty ekaṃ bhrama-janakaṃ dvitīyam abhānāvaraṇaṃ	kintu mama na BAti-iti ekam Brama--janakam dvitIyam aBAna-AvaraNam
   sākṣātkārād eva nivartate | sa ca sākṣātkāro vedānta-vākyenaiva janyate	sAkzAtkArAt eva nivartate | sa ca sAkzAtkAraH vedAnta--vAkyena-eva janyate
   nirvikalpaka ity ādy advaita-siddhāv anusandheyam ||16||	nirvikalpakaH iti Adi advEta--sidDO anusanDeyam ||16||
   viśvanāthaḥ : yathāvidyā tasya jñānam āvṛṇoti, tathaivāparā tasya	viSvanATaH : yaTAvidyA tasya jQAnam AvRNoti, taTA-eva-aparA tasya
   vidyā-śaktir avidyāṃ vināśya jñānaṃ prakāśayatīty arthaḥ | jñānena	vidyA--SaktiH avidyAm vinASya jQAnam prakASayati-iti arTaH | jQAnena
   vidyā-śaktyā | ajñānam avidyām | teṣāṃ jīvānāṃ jñānam eva kartṛ ādityavad	vidyA--SaktyA | ajQAnam avidyAm | tezAm jIvAnAm jQAnam eva kartR Aditya-vat-
   ity-āditya-prabhā yathāndhakāraṃ vināśya ghaṭa-paṭādikaṃ prakāśayati,	iti--Aditya--praBA yaTA-anDakAram vinASya Gawa-pawa-Adikam prakASayati,
   tathaiva vidyayaivāvidyāṃ vināśya taj-jīva-niṣṭhaṃ jñānaṃ param aprākṛtaṃ	taTA-eva vidyayA-eva-avidyAm vinASya taj-jIva--nizWam jQAnam param aprAkRtam
   prakāśayati | tena parameśvaro na kam api badhnāti, nāpi kam api mocayati	prakASayati | tena parameSvaraH na kam api baDnAti, na-api kam api mocayati
   | kintv ajñāna-jñāne prakṛter eva dharmaḥ krameṇa badhnāti mocayati ca |	| kintu ajQAna--jQAne prakRteH eva DarmaH krameNa baDnAti mocayati ca |
   kartṛtva-bhoktṛtva-tat-prayojakatvādayor bandhakāḥ | anāsakti-śāntyādayo	kartR-tva--BoktR-tva--tat--prayojaka-tva-AdayoH banDakAH | anAsakti-SAntyAdayaH-
   mocakāś ca prakṛter eva dharmāḥ | kintu parameśvarasyāntaryāmitva eva	mocakAH ca prakRteH eva DarmAH | kintu parameSvarasya-antar-yAmitvaH eva
   prakṛtes te te dharmā udbudhyanta ity etad-aṃśenaiva tasya prayojakatvam	prakRteH te te DarmAH udbuDyante iti etat--aMSena-eva tasya prayojaka-tvam
   iti na tasya vaiṣamya-nairghṛṇye ||16||	iti na tasya vEzamya-nErGRNye ||16||
   baladevaḥ : vijñā na muhyantīty etad āha jñāneneti | sarvaṃ	baladevaH : vijQAH na muhyanti-iti etat Aha jQAnena-iti | sarvam
   jñāna-plavenaiva [Gītā 4.36] iti | jñānāgniḥ sarva-karmāṇi [Gītā 4.37], na	jQAna--plavena-eva [GItA 4.36] iti | jQAna-agniH sarva-karmANi [GItAH 4.37], na
   hi jñānena sadṛśaṃ [Gītā 4.38] iti cokta-mahimnā sad-guru-prasāda-labdhena	hi jQAnena sadRSam [GItA 4.38] iti ca-ukta--mahimnA sat--guru--prasAda--labDena
   sva-parātma-viṣayakena jñānena yeṣāṃ sat-prasaṅgināṃ tad-vaimukhyam	sva-para-Atma--vizayakena jQAnena yezAm sat--prasaFginAm tat--vEmuKyam
   ajñānaṃ nāśitaṃ pradhvaṃsitaṃ teṣāṃ taj-jñānaṃ kartṛ paraṃ prakāśayati |	ajQAnam nASitam praDvaMsitam tezAm taj-jQAnam kartR param prakASayati |
   dehādeḥ paraṃ jīvaṃ vaiṣamyādi-doṣāt param īśvaraṃ ca bodhayati |	deha-AdeH param jIvam vEzamya-Adi-dozAt param ISvaram ca boDayati |
   ādityavat yathā ravir udita eva tamo nirasyan yathāvad vastu pradarśayati,	Aditya-vat yaTA raviH uditaH eva tamaH nirasyan yaTAvat vastu pradarSayati,
   tathā sad-gurūpadeśa-labdham ātma-jñānaṃ yathāvad ātma-vastv iti | atra	taTA sad-gu-ru-upadeSa--labDam Atma--jQAnam yaTAvat Atma-vastu iti | atra
   vinaṣṭājñānānāṃ jīvānāṃ bahutvaṃ nigadatā pārtha-sārathinā mokṣe teṣāṃ	vinazwa-ajQAnAnAm jIvAnAm bahu-tvam nigadatA pArTa-sAraTinA mokze tezAm
   tad-darśitaṃ aupādhikatvaṃ tasya praty uktaṃ neme janādhipāḥ ity	tat--darSitam OpADika-tvam tasya prati uktam na-ime janADipAH iti-
   upakramoktaṃ ca tat sopapattikam abhūt ||16||	upakrama-uktam ca tat sa-upapattikam aBUt ||16||
   BhG 5.17	Bhu 5.17
   tad-buddhayas tad-ātmānas tan-niṣṭhās tat-parāyaṇāḥ |	tad--budDayaH tat--AtmAnaH tan--nizWAH tat--parAyaNAH |
   gacchanty apunar-āvṛttiṃ jñāna-nirdhūta-kalmaṣāḥ ||17||	gacCanti apunar--AvRttim jQAna--nirDUta--kalmazAH ||17||
   śrīdharaḥ : evaṃbhūteśvaropāsakānāṃ phalam āha tad-buddhaya iti | tasminn	SrIDaraH : evaMBUta-ISvara-upAsakAnAm Palam Aha tad--budDayaH iti | tasmin=-
   eva buddhir niścayātmikā yeṣām | tasminn etātmā mano yeṣām | tasminn eva	eva budDiH niScaya-AtmikAH yezAm | tasmin eta-AtmA manaH yezAm | tasmin eva
   niṣṭhā tātparyaṃ yeṣām | tad eva param ayamam āśrayo yeṣām | tataś ca	nizWA tAtparyam yezAm | tat eva param ayamam ASrayaH yezAm | tatas ca
   tat-prasāda-labdhenātma-jñānena nirdhūtaṃ nirastaṃ kalmaṣaṃ yeṣām | te	tat--prasAda--labDena-Atma--jQAnena nirDUtam nirastam kalmazam yezAm | te
   'punar-āvṛttiṃ muktiṃ yānti ||17||	apunar-AvRttim muktim yAnti ||17||
   madhusūdanaḥ : jñānena paramātma-tattva-prakāśe sati tad-buddhaya iti |	maDusUdanaH : jQAnena paramAtma--tattva--prakASe sati tad--budDayaH iti |
   tasmin jñāna-prakāśite paramātma-tattve sac-cid-ānanda-ghana eva	tasmin jQAna--prakASite paramAtma--tattve sac-cit--A-Ananda-GanaH eva
   bāhya-sarva-viṣaya-parityāgena sādhana-paripākāt paryavasitā buddhir	bAhya--sarva--vizaya--parityAgena sADana--paripAkAt paryavasitA budDiH-
   antaḥkaraṇa-vṛttiḥ sākṣātkāra-lakṣaṇā yeṣāṃ te tad-buddhayaḥ sarvadā	antaHkaraNa-vRttiH sAkzAtkAra--lakzaNAH yezAm te tad--budDayaH sarvadA
   nirbīja-samādhi-bhāja ity arthaḥ | tat kiṃ boddhāro jīvā boddhavyaṃ	nirbIja--samADi--BAjaH iti arTaH | tat kim bodDAraH jIvAH bodDavyam
   brahma-tattvam iti boddhṛ-boddhavya-bhāvo hi māyā-vijṛmbhito na	brahma-tattvam iti bodDR-bodDavya-BAvaH hi mAyA--vijRmBitaH na
   vāstavābheda-virodhīti bhāvaḥ |	vAstava-aBeda--viroDi-iti BAvaH |
   nanu tad-ātmāna iti viśeṣaṇaṃ vyartham | avidvad-vyavartakaṃ hi	nanu tat--AtmAnaH iti viSezaNam vyarTam | avidvat--vyavartakam hi
   vidvad-viśeṣaṇam | ajñā api hi vastu-gatyā tad-ātmāna iti kathaṃ	vidvat---viSezaNam | ajQAH api hi vastu-gatyA tat--AtmAnaH iti kaTam
   tad-vyāvṛttir iti cet, na | itarātmatva-vyāvṛttau tātparyāt | ajñā hi	tat--vyAvRttiH iti cet, na | itara-Atma-tva--vyAvRttO tAtparyAt | ajQAH hi
   anātma-bhūte dehādāv ātmābhimānina iti na tad-ātmāna iti vyapadiśyante |	anAtma-BUte deha-AdO Atma-aBimAninaH iti na tat--AtmAnaH iti vyapadiSyante |
   vijñās tu nivṛtta-dehādy-abhimānā iti virodhi-nivṛttyā tad-ātmāna iti	vijQAH tu nivRtta--deha-Adi--a-BimAnAH iti viroDi--nivRttyA tat--AtmAnaH iti
   vyapadiśyanta iti yuktaṃ viśeṣaṇam |	vyapadiSyante iti yuktam viSezaNam |
   nanu karmānuṣṭhāna-vikṣepe sati kathaṃ dehādy-abhimāna-nivṛttir iti	nanu karma-anuzWAna--vikzepe sati kaTam deha-Adi--aBimAna--nivRttiH iti
   tatrāha tan-niṣṭhā iti | tasminn eva brahmaṇi	tatra-Aha tan--nizWAH iti | tasmin eva brahmaNi
   sarva-karmānuṣṭhāna-vikṣepa-nivṛttyā niṣṭhā sthitir yeṣāṃ te tan-niṣṭhāḥ |	sarva-karma-anuzWAna--vikzepa--nivRttyA nizWA sTitiH yezAm te tan--nizWAH |
   sarva-karma-saṃnyāsena tad-eka-vicāra-parā ity arthaḥ | phala-rāge sati	sarva-karma--saMnyAsena tad--eka--vicAra--parAH iti arTaH | Pala-rAge sati
   kathaṃ tat-sādhana-bhūta-karma-tyāga iti tatrāha tat-parāyaṇāḥ | tad eva	kaTam tat-sADana--BUta--karma--tyAgaH iti tatra-Aha tat--parAyaNAH | tat eva
   param ayanaṃ prāptavyaṃ yeṣāṃ te tat-parāyaṇāḥ | sarvato viraktā ity	param ayanam prAptavyam yezAm te tat--parAyaNAH | sarvatas viraktAH iti-
   arthaḥ |	arTaH |
   atra tad-buddhaya ity anena sākṣātkāra uktaḥ | tad-ātmāna ity	atra tad--budDayaH iti anena sAkzAtkAraH uktaH | tat--AtmAnaH iti-
   anātmābhimā-rūpa-viparīta-bhāva-nivṛtti-phalako vedānta-vicāraḥ	anAtma-aBimA--ru-upa-viparIta--BAva--nivRtti-PalakaH vedAnta--vicAraH
   śravaṇa-manana-paripāka-rūpaḥ | tat-parāyaṇā ity anena vairāgya-prakarṣaṃ	SravaNa-manana--paripAka-rUpaH | tat--parAyaNAH iti anena vErAgya--prakarzam
   ity uttarottarasya pūrva-pūrva-hetutvaṃ draṣṭavyam | ukta-viśeṣaṇā yatayo	iti uttarottarasya pUrva--pUrva--hetu-tvam drazwavyam | ukta--viSezaNA yatayaH-
   gacchanty apunar-āvṛttiṃ punar-deha-sambandhābhāva-rūpāṃ muktiṃ	gacCanti apunar--AvRttim punar--deha--sambanDa-aBAva--rUpAm muktim
   prāpnuvanti | sakṛn muktānām api punar deha-sambandhaḥ kuto na syād iti	prApnuvanti | sakRt muktAnAm api punar deha--sambanDaH kutas na syAt iti
   tatrāha jñāna-nirdhūta-kalmaṣāḥ jñānena nirdhūtaṃ samūlam unmūlitaṃ	tatra-Aha jQAna--nirDUta--kalmazAH jQAnena nirDUtam sa-mUlam unmUlitam
   punar-deha-sambandha-kāraṇaṃ kalmaṣaṃ puṇya-pāpātmakaṃ karma yeṣāṃ te	punar--deha--sambanDa--kAraNam kalmazam puNya--pApa-Atmakam karma yezAm te
   tathā | jñānenānādy-ajñāna-nivṛttyā tat-kārya-karma-kṣaye tan-mūlakaṃ	taTA | jQAnena-anAdy-a-jQAna--nivRttyA tat-kArya--karma--kzaye tan-mUlakam
   punar deha-grahaṇaṃ kathaṃ bhaved iti bhāvaḥ ||17||	punar deha-grahaNam kaTam Bavet iti BAvaH ||17||
   viśvanāthaḥ : kintu vidyā jīvātma-jñānam eva prakāśayati, na tu	viSvanATaH : kintu vidyA jIvAtma--jQAnam eva prakASayati, na tu
   paramātma-jñānaṃ bhaktyāham ekayā grāhyaḥ iti bhagavad-ukteḥ | tasmāt	paramAtma--jQAnam BaktyA-aham ekayA grAhyaH iti Bagavat--ukteH | tasmAt-
   paramātma-jñānārthaṃ jñānibhir api punar viśeṣato bhaktiḥ kāryā ity ata	paramAtma--jQAna-arTam jQAniBiH api punar viSezataH BaktiH kAryA iti ata
   āha tad-buddhaya iti | tat-padena pūrvam upakrānto vibhuḥ parāmṛśyate |	Aha tad--budDayaH iti | tat-padena pUrvam upakrAntaH viBuH parAmRSyate |
   tasmin parameśvara eva buddhir yeṣām te tam-manana-parā ity arthaḥ |	tasmin parameSvaraH eva budDiH yezAm te tam-manana--parAH iti arTaH |
   tad-ātmānas tan-manaskās tam eva dhyāyanta ity arthaḥ | tan-niṣṭhāḥ jñānaṃ	tat--AtmAnaH tan--manaskAH tam eva DyAyante iti arTaH | tan--nizWAH jQAnam
   mayi saṃnyaset iti bhagavad-ukteḥ | dehādy-atiriktātmma-jñāne 'pi sāttvike	mayi saMnyaset iti Bagavat--ukteH | deha-Adi--atirikta-Atmma--jQAne api sAttvike
   niṣṭhāṃ parityajya tad-eka-niṣṭhāḥ | tat-parāyaṇās	nizWAm parityajya tad--eka--nizWAH | tat-parAyaNa-as
   tadīya-śravaṇa-kīrtana-parāḥ | yad vakṣyate -	tadIya--SravaNa-kIrtana--parAH | yat vakzyate -
   bhaktyā mām abhijānāti yāvān yaś cāsmi tattvataḥ |	BaktyA mAm aBijAnAti yAvAn yaH ca-asmi tattvataH |
   tato māṃ tattvato jñātvā viśate tad-anantaram || [Gītā 18.55] iti |	tatas mAm tattvataH jQAtvA viSate tad--anantaram || [GItAH 18.55] iti |
   jñāna-nirdhūta-kalmaṣā jñānena vidyāyaiva pūrvam eva dhvasta-samastāvidyāḥ	jQAna--nirDUta--kalmazAH jQAnena vidyAya-eva pUrvam eva Dvasta--samasta-avidyAH
   baladevaḥ : paramātmany avaiṣamyādi-dhyāyatāṃ phalam āha tad iti | tasmiṃs	baladevaH : paramAtmani avEzamya-Adi-DyAyatAm Palam Aha tat iti | tasmin=-
   tad-avaiṣamyādike guṇa-gaṇe buddhir niścayātmikā yeṣāṃ te | tad-ātmānas	tat--avEzamyAdike guNa--gaNe budDiH niScaya-AtmikAH yezAm te | tat--AtmAnaH-
   tasmin niviṣṭa-manasaḥ tan-niṣṭhās tat-tātparyavantas tat-parāyaṇās	tasmin nivizwa--manasaH tan--nizWAH tat-tAt-paryavantaH tat--parAyaNa-as
   tat-samāśrayāḥ | evam abhyastena tad-vaiṣamyādi-guṇa-jñānena	tat-samASrayAH | evam aByastena tat--vEzamya-Adi-guNa--jQAnena
   nirdhūta-kalmaṣā vinaṣṭa-tad-vaimukhyāḥ santa apunar-āvṛttiṃ muktiṃ	nirDUta--kalmazA vinazwa---tad-vEmuKyAH santaH apunar--AvRttim muktim
   gacchantīti ||17||	gacCanti-iti ||17||
   BhG 5.18	Bhu 5.18
   vidyā-vinaya-saṃpanne brāhmaṇe gavi hastini |	vidyA--vinaya--saMpanne brAhmaNe gavi hastini |
   śuni caiva śvapāke ca paṇḍitāḥ sama-darśinaḥ ||18||	Suni ca-eva SvapAke ca paNxitAH sama-darSinaH ||18||
   śrīdharaḥ : kīdṛśās te jñānino ye 'punar-āvṛttiṃ gacchantīty apekṣāyām āha	SrIDaraH : kIdRSAH te jQAninaH ye apunar-AvRttim gacCanti-iti apekzAyAm Aha
   vidyā-vinaya-saṃpanna iti | viṣameṣv api samaṃ brahmaiva draṣṭuṃ śīlaṃ	vidyA--vinaya--saMpannaH iti | vizamezu api samam brahma-eva drazwum SIlam
   yeṣāṃ te paṇḍitāḥ | jñānina ity arthaḥ | atra vidyā-vinayābhyāṃ yukte	yezAm te paNxitAH | jQAninaH iti arTaH | atra vidyA--vinayAByAm yukte
   brāhmaṇe ca | śuno yaḥ pacati tasmin śvapāke ca iti karmaṇā vaiṣamyam |	brAhmaNe ca | SunaH yaH pacati tasmin SvapAke ca iti karmaNA vEzamyam |
   gavi hastini śuni ceti jātito vaiṣamyaṃ darśitam ||18||	gavi hastini Suni ca-iti jAtitaH vEzamyam darSitam ||18||
   madhusūdanaḥ : deha-pātād ūrdhvaṃ videha-kaivalya-rūpaṃ jñāna-phalam uktvā	maDusUdanaH : deha--pAtAt UrDvam videha--kEvalya--rUpam jQAna-Palam uktvA
   prārabdha-karma-vaśāt saty api dehe jīvan-mukti-rūpaṃ tat-phalam āha	prArabDa--karma--vaSAt sati api dehe jIvan-mukti--rUpam tat-Palam Aha
   vidyeti | vidyā vedārtha-parijñānaṃ brahma-vidyā vā | vinayo	vidyA-iti | vidyA veda-arTa--parijQAnam brahma--vidyA vA | vinayaH-
   nirahaṅkāratvam anauddhatyam iti yāvat | tābhyāṃ saṃpanne brahma-vidi	nirahaFkAra-tvam anOdDatyam iti yAvat | tAByAm saMpanne brahma--vidi
   vinīte ca brāhmaṇe sāttvike sarvottame | tathā gavi saṃskāra-hīnāyāṃ	vinIte ca brAhmaNe sAttvike sarva-uttame | taTA gavi saMskAra--hInAyAm
   rājasyāṃ madhyamāyāṃ | tathā hastini śuni śvapāke cātyanta tāmase	rAjasyAm maDyamAyAm | taTA hastini Suni SvapAke ca-atyanta tAmase
   sarvādhame 'pi | sattvādi-guṇais taj-jaiś ca saṃskārair aspṛṣṭam eva samaṃ	sarva-aDame api | sattva-Adi--guNEH taj-jEH ca saMskArEH aspRzwam eva samam
   brahma draṣṭuṃ śīlaṃ yeṣāṃ te sama-darśinaḥ | paṇḍitā jñāninaḥ | yathā	brahma drazwum SIlam yezAm te sama-darSinaH | paNxitAH jQAninaH | yaTA
   gaṅgā-toye taḍāge surāyāṃ mūtre vā pratibimbitasyādityasya na	gaFgA-a-toye taxAge surAyAm mUtre vA pratibimbitasya-Adityasya na
   tad-guṇa-doṣa-sambandhas tathā brahmaṇo 'pi cid-ābhāsa-dvārā	tad--guNa--doza-sambanDaH taTA brahmaNaH api cit--a-ABAsa--dvArA
   pratibimbitasya nopādhi-gata-guṇa-doṣa-sambandha iti pratisandadhānāḥ	pratibimbitasya na-upADi--gata-guNa--doza--sambanDaH iti pratisandaDAnAH
   sarvatra sama-dṛṣṭyaiva rāga-dveṣa-rāhityena paramānanda-sphūrtyā	sarvatra sama-dRzwyA-eva rAga--dveza--rAhityena parama-Ananda-sPUrtyA
   jīvan-muktim anubhavantīty arthaḥ ||18||	jIvan-muktim anuBavanti-iti arTaH ||18||
   viśvanāthaḥ : tataś ca guṇātītānāṃ teṣāṃ guṇa-maye vastu-mātra eva	viSvanATaH : tatas ca guNa-atItAnAm tezAm guNa-maye vastu--mAtraH eva
   tāratamya-mayaṃ viśeṣam ajighṛkṣūṇāṃ sama-buddhir eva syād ity āha vidyeti	tAratamya--mayam viSezam ajiGRkzUNAm sama-budDiH eva syAt iti Aha vidyA-iti
   | brāhmaṇe gavīti sāttvika-jātitvāt | hastini madhyame | śuni ca śvapāke	| brAhmaNe gavIti sAttvika-jAti-tvAt | hastini maDyame | Suni ca SvapAke
   ceti tāmas-jātitvād adhame 'pi tat-tad-viśeṣāgrahaṇāt sama-darśinaḥ	ca-iti tAmas-jAti-tvAt aDame api tat--tad--viSeza-agrahaNAt sama-darSinaH
   paṇḍitā guṇātītāḥ | viśeṣāgrahaṇam eva samaṃ guṇātītaṃ brahma | tad	paNxitAH guNa-atItAH | viSeza-agrahaNam eva samam guNa-atItam brahma | tat-
   draṣṭuṃ śīlaṃ yeṣāṃ te ||18||	drazwum SIlam yezAm te ||18||
   baladevaḥ : tān stauti vidyeti | tādṛśe brāhmaṇe śvapāke ceti karmaṇaitau	baladevaH : tAn stOti vidyA-iti | tAdRSe brAhmaNe SvapAke ca-iti karmaNA-etO
   viṣamau gavi hastini śuni ceti jātyaite viṣamāḥ | evaṃ viṣamatayā sṛṣṭeṣu	vizamO gavi hastini Suni ca-iti jAtyA-ete vizamAH | evam vizama-tayA sRzwezu
   brāhmaṇādiṣu ye paramātmānaṃ samaṃ paśyanti, ta eva paṇḍitāḥ |	brAhmaNa-Adizu ye paramAtmAnam samam paSyanti, te eva paNxitAH |
   tat-karmānusāriṇī tena teṣāṃ tathā tathā sṛṣṭiḥ, na tu	tat-karma-anusAriNI tena tezAm taTA taTA sRzwiH, na tu
   rāga-dveṣānusāriṇīti parjanyavat sarvatra samaḥ paramātmeti ||18||	rAga--dveza-anusAriNI-iti parjanya-vat sarvatra samaH paramAtmA-iti ||18||
   BhG 5.19	Bhu 5.19
   ihaiva tair jitaḥ sargo yeṣāṃ sāmye sthitaṃ manaḥ |	iha-eva tEH jitaH sargaH yezAm sAmye sTitam manaH |
   nirdoṣaṃ hi samaṃ brahma tasmād brahmaṇi te sthitāḥ ||19||	nirdozam hi samam brahma tasmAt brahmaNi te sTitAH ||19||
   śrīdharaḥ : nanu viṣamesu sama-darśanaṃ niṣiddhaṃ kurvanto 'pi kathaṃ te	SrIDaraH : nanu vizamesu sama-darSanam nizidDam kurvantaH api kaTam te
   paṇḍitāḥ ? yathāha gautamaḥ samāsam ābhyāṃ viṣama-same pūjātaḥ iti |	paNxitAH ? yaTA-Aha gOtamaH samAsam AByAm vizama--same pUjAtaH iti |
   asyārthaḥ samāya pūjayā viṣame prakāre kṛte sati viṣamāya ca same prakāre	asya-arTaH samAya pUjayA vizame prakAre kRte sati vizamAya ca same prakAre
   kṛte sati sa pūjaka iha lokāt para-lokāc ca hīyata iti | tatrāha ihaiveti	kRte sati sa pUjakaH iha lokAt para-lokAt ca hIyate iti | tatra-Aha iha-eva-iti
   | ihaiva jīvadbhir eva taiḥ | sṛjyate iti sargaḥ saṃsāraḥ | jito nirastaḥ	| iha-eva jIvadBiH eva tEH | sRjyate iti sargaH saMsAraH | jitaH nirastaH
   | kaiḥ ? yeṣāṃ manaḥ sāmye samatve sthitaṃ | tatra hetuḥ -- hi yasmād	| kEH ? yezAm manaH sAmye sama-tve sTitam | tatra hetuH - hi yasmAt-
   brahma samaṃ nirdoṣaṃ ca tasmāt te sama-darśino brahmaṇy eva sthitāḥ |	brahma samam nirdozam ca tasmAt te sama-darSinaH brahmaNi eva sTitAH |
   brahma-bhāvaṃ prāptā ity arthaḥ | gautamoktas tu doṣo brahma-bhāva-prāpteḥ	brahma-BAvam prAptAH iti arTaH | gOtama-uktaH tu dozaH brahma--BAva--prApteH
   pūrvam eva | pūjāta iti pūjakāvasthāśravaṇāt ||19||	pUrvam eva | pUjAtaH iti pUjaka-avasTA-SravaNAt ||19||
   madhusūdanaḥ : nanu sāttvika-rājasa-tāmaseṣu svabhāva-viṣameṣu prāṇiṣu	maDusUdanaH : nanu sAttvika-rAja-sa-tAmasezu svaBAva--vizamezu prANizu
   samatva-darśanaṃ dharma-śāstra-niṣiddham | tathā ca tasyānnam abhojyam ity	sama-tva--darSanam Darma-SAstra-nizidDam | taTA ca tasya-annam aBojyam iti-
   upakramya gautamaḥ smarati samāsam ābhyāṃ viṣama-same pūjāta iti | samāsam	upakramya gOtamaH smarati samAsam AByAm vizama--same pUjAte iti | samAsam
   ābhyām iti caturthī-dvi-vacanam | viṣama-sama iti dvandvaikavad bhāvena	AByAm iti caturTI--dvi-vacanam | vizama--samaH iti dvandva-eka-vat BAvena
   saptamy-eka-vacanam | catur-veda-pāragāṇām atyanta-sadācārāṇāṃ yādṛśo	saptamI--eka-vacanam | catur--veda--pAragANAm atyanta--sat-AcArANAm yAdRSaH-
   vastrālaṅkārānnādi-dāna-puraḥsaraḥ pūjā-viśesaḥ kriyate	vastra-alaFkAra-anna-Adi--dAna--puraHsaraH pUjA--viSesaH kriyate
   tat-samāyaivānyasmai caturveda-pāragāya sad-ācārāya viṣame tad-apekṣayā	tat-samAya-eva-anyasmE catur-veda--pAragAya sat--AcArAya vizame tad--apekzayA
   nyūne pūjā-prakāre kṛte | tathālpa-vedānāṃ hīnācārāṇāṃ yādṛśo	nyUne pUjA--prakAre kRte | taTA-alpa-vedAnAm hIna-AcArANAm yAdRSaH-
   hīna-sādhanaḥ pūjā-prakāraḥ kriyate tādṛśāyaivāsamāya	hIna--sADanaH pUjA--prakAraH kriyate tAdRSAya-eva-asamAya
   pūrvokta-veda-pāraga-sad-ācāra-brāhmaṇāpekṣayā hīnāya	pUrva-ukta--veda--pAraga--sat--AcAra--brAhmaNa-apekzayA hInAya
   tādṛśa-hīna-pūjādhike mukhya-pūjā-same pūjā-prakāre kṛte, uttamasya	tAdRSa--hIna--pUjA-aDike muKya--pUjA--same pUjA--prakAre kRte, uttamasya
   hīnatayā hīnasyottamatayā pūjāto hetos tasya pūjayitur annam abhojyaṃ	hIna-tayA hInasya-uttamatayA pUjAtaH hetoH tasya pUjayituH annam aBojyam
   bhavatīty arthaḥ | pūjayitā pratipatti-viśesam akurvan dhanād dharmāc ca	Bavati-iti arTaH | pUjayitA pratipatti-viSesam akurvan DanAt DarmAt ca
   hīyata iti ca doṣāntaram | yadyapi yatīnāṃ niṣparigrahāṇāṃ pākābhāvād	hIyate iti ca doza-antaram | yadi-api yatInAm nizparigrahANAm pAka-aBAvAt-
   dhanābhāvāc cābhojyānnatvaṃ dhana-hīnatvaṃ ca svata eva vidyate tathāpi	Dana-aBAvAt ca-aBojya-anna-tvam Dana--hIna-tvam ca svatas eva vidyate taTA-api
   dharma-hānir doso bhavaty eva | abhojyānnatvaṃ cāśucitvena	Darma-hAniH dosaH Bavati eva | aBojya-anna-tvam ca-aSuci-tvena
   pāptpatty-upalakṣaṇam | tapo-dhanānāṃ ca tapa eva dhanam iti tad-dhānir	pAptpatti--upalakzaNam | tapo-DanAnAm ca tapaH eva Danam iti tad--DAniH-
   api dūṣaṇaṃ bhavaty eveti kathaṃ sama-darśinaḥ paṇḍitā jīvan-muktā iti	api dUzaNam Bavati eva-iti kaTam sama-darSinaH paNxitAH jIvan-muktAH iti
   prāpte pariharati ihaiveti |	prApte pariharati iha-eva-iti |
   taiḥ sama-darśibhiḥ paṇḍitair ihaiva jīvana-daśāyām eva jito 'tikrāntaḥ	tEH sama-darSiBiH paNxitEH iha-eva jIvana-daSAyAm eva jitaH atikrAntaH
   sargaḥ sṛjyata iti vyutpattyā dvaita-prapañcaḥ | deha-pātād ūrdhvam	sargaH sRjyate iti vyutpattyA dvEta--prapaQcaH | deha--pAtAt UrDvam
   atikramitavya iti kim u vaktavyam ? kaiḥ ? yeṣāṃ sāmye sarva-bhūteṣu	atikramitavyaH iti kim u vaktavyam ? kEH ? yezAm sAmye sarva-BUtezu
   viṣameṣv api vartamānasya brahmaṇaḥ sama-bhāve sthitaṃ niścalaṃ manaḥ | hi	vizamezu api vartamAnasya brahmaNaH sama-BAve sTitam niScalam manaH | hi
   yasmān nirdoṣaṃ samaṃ sarva-vikāra-śūnyaṃ kūṭastha-nityam ekaṃ ca brahma	yasmAt nirdozam samam sarva-vikAra--SUnyam kUwasTa--nityam ekam ca brahma
   tasmāt te brahmaṇy eva sthitāḥ |	tasmAt te brahmaNi eva sTitAH |
   ayaṃ bhāvaḥ | duṣṭatvam hi dvedhā bhavati aduṣṭasyāpi duṣṭa-sambandhāt	ayam BAvaH | duzwa-tvam hi dveDA Bavati aduzwasya-api duzwa--sambanDAt-
   svato duṣṭatvād vā | yathā gaṅgodakasya mūtra-garta-pātāt | svata eva vā	svatas duzwa-tvAt vA | yaTA gaFgA-udakasya mUtra-garta--pAtAt | svatas eva vA
   yathā mūtrādeḥ | tatra doṣavatsu śvapākādiṣu sthitaṃ doṣair duṣyati	yaTA mUtra-AdeH | tatra dozavatsu SvapAka-Adizu sTitam dozEH duzyati
   brahmeti mūḍhair vibhāvyamānam api sarva-doṣāsaṃsṛṣṭam eva brahma vyomavad	brahma-iti mUXEH viBAvyamAnam api sarva--doza-asaMsRzwam eva brahma vyoma-vat-
   asaṅgatvāt | asaṅgo hy ayaṃ puruṣaḥ |	asaFga-tvAt | asaFgaH hi ayam puruzaH |
   sūryo yathā sarva-lokasya cakṣur	sUryaH yaTA sarva-lokasya cakzuH-
   na lipyate cākṣuṣair bāhya-doṣaiḥ |	na lipyate cAkzuzEH bAhya--dozEH |
   ekas tathā sarva-bhūtāntarātmā	ekaH taTA sarva-BUta-antarAtmA
   na lipyate loka-duḥkhena bāhyaḥ || iti śruteḥ |	na lipyate loka--duHKena bAhyaH || iti SruteH |
   nāpi kāmādi-dharmavattayā svata eva kaluṣitaṃ kāmāder	na-api kAma-Adi-Darmavat-tayA svatas eva kaluzitam kAma-AdeH-
   antaḥkaraṇa-dharmatvasya śruti-smṛti-siddhatvāt | tasmān	antaHkaraNa--Darma-tvasya Sruti--smRti--sidDa-tvAt | tasmAt-
   nirdoṣa-brahma-rūpā yatayo jīvan-muktā abhojyānnādi-doṣa-duṣṭāś ceti	nirdoza--brahma-rUpAH yatayaH jIvan-muktAH aBojya-anna-Adi-da-uza-duzwAH ca-iti
   vyāhṛtam | smṛtis tv avidvad-gṛhastha-viṣayaiva | tasyānna-bhojyam ity	vyAhRtam | smRtiH tu avidvat--gRhasTa-vizayA-eva | tasya-anna-Bojyam iti-
   upakramāt | pūjāta iti madhye nirdeśāt | dhanād dharmāc ca hīyata ity	upakramAt | pUjAtaH iti maDye nirdeSAt | DanAt DarmAt ca hIyate iti-
   upasaṃhārāc ceti draṣṭavyam ||19||	upasaMhArAt ca-iti drazwavyam ||19||
   viśvanāthaḥ : sama-dṛṣṭitvaṃ stauti | ihaiva iha loka eva sṛjyata iti	viSvanATaH : sama-dRzwi-tvam stOti | iha-eva iha lokaH eva sRjyate iti
   sargaḥ saṃsāro jitaḥ parābhūtaḥ ||19||	sargaH saMsAraH jitaH parABUtaH ||19||
   baladevaḥ : iheti | iha sādhana-daśāyām eva taiḥ sargaḥ saṃsāro jitaḥ	baladevaH : iha-iti | iha sADana-daSAyAm eva tEH sargaH saMsAraH jitaH
   parābhūtaḥ | kaiḥ ? yeṣāṃ manaḥ sāmye 'vaiṣamyākhye brahma-dharme sthitaṃ	parABUtaH | kEH ? yezAm manaH sAmye avEzamya-AKye brahma-Darme sTitam
   niviṣṭam | kuto brahmāviṣamam ? tatrāha nirdoṣaṃ hīti | hi yato brahmaṇy	nivizwam | kutas brahma-avizamam ? tatra-Aha nirdozam hi-iti | hi yatas brahmaNi-
   avaiṣamyādikaṃ niścikyus tasmāt prapañce tiṣṭhanto 'pi te brahmaṇy eva	avEzamyAdikam niScikyuH tasmAt prapaQce tizWantaH api te brahmaNi eva
   sthitāḥ muktis teṣāṃ sulabhety arthaḥ ||19||	sTitAH muktiH tezAm sulaBa-iti arTaH ||19||
   BhG 5.20	Bhu 5.20
   na prahṛṣyet priyaṃ prāpya nodvijet prāpya cāpriyam |	na prahRzyet priyam prApya na-udvijet prApya ca-apriyam |
   sthira-buddhir asaṃmūḍho brahmavid brahmaṇi sthitaḥ ||20||	sTira--budDiH asaMmUXaH brahma-vid brahmaNi sTitaH ||20||
   śrīdharaḥ : brahma-prāptasya lakṣaṇam āha na prahṛṣyed iti | brahma-vid	SrIDaraH : brahma--prAptasya lakzaNam Aha na prahRzyet iti | brahma-vid
   bhūtvā brahmaṇy eva yaḥ sthitaḥ sa priyaṃ prāpya na prahṛṣyet	BUtvA brahmaNi eva yaH sTitaH sa priyam prApya na prahRzyet-
   prakṛṣṭa-harṣavān syāt | apriyam prāpya ca nodvijet na viṣīdatīty arthaḥ |	prakRzwa--harzavAn syAt | apriyam prApya ca na-udvijet na vizIdati-iti arTaH |
   yataḥ sthira-buddhir sthirā niścalā buddhir yasya | tat kutaḥ ? yato	yatas sTira-budDiH sTirA niScalA budDiH yasya | tat kutas ? yatas-
   'saṃmūḍho nivṛtta-mohaḥ ||20||	asaMmUXaH nivRtta-mohaH ||20||
   madhusūdanaḥ : yasmān nirdoṣaṃ samaṃ brahma tasmāt tad-rūpam ātmānaṃ	maDusUdanaH : yasmAt nirdozam samam brahma tasmAt tad--rUpam AtmAnam
   sākṣātkurvann āha na prahṛṣyed iti | duḥkheṣv anudvigna-manāḥ sukheṣu	sAkzAt-kurvan Aha na prahRzyet iti | duHKezu anudvigna-manAH suKezu
   vigata-spṛhaḥ ity atra vyākhyātaṃ pūrvārdham | jīvan-muktānāṃ svābhāvikaṃ	vigata-spRhaH iti atra vyAKyAtam pUrva-arDam | jIvan-muktAnAm svABAvikam
   caritam eva mumukṣubhiḥ prayatna-pūrvakam anuṣṭheyam iti vadituṃ	caritam eva mumukzuBiH prayatna--pUrvakam anuzWeyam iti vaditum
   liṅga-pratyayau | advitīyātma-darśana-śīlasya	liFga--pratyayO | advitIya-Atma--darSana--SIlasya
   vyatirikta-priyāpriya-prāpty-ayogyāc ca tan-nimittau harṣa-viṣādāv ity	vyatirikta--priya-apriya--prApti--ayogyAt ca tan--nimittO harza--viza-AdO iti-
   arthaḥ |	arTaH |
   advitīyātma-darśanam eva vivṛṇoti - sthira-buddhiḥ sthirā niścalā	advitIya-Atma--darSanam eva vivRNoti  sTira-budDiH sTirA niScalA
   saṃnyāsa-pūrvaka-vedānta-vākya-vicāra-paripākeṇa sarva-saṃśaya-śūnyatvena	saMnyAsa--pUrvaka-veda-anta--vAkya--vicAra--paripAkeNa sarva-saMSaya--SUnya-tvena
   nirvicikitsā niścitā brahmaṇi buddhir yasya sa tathā	nirvicikitsA niScitA brahmaNi budDiH yasya sa taTA
   labdha-śravaṇa-manana-phala iti yāvat | etādṛśasya	labDa--SravaNa-manana-PalaH iti yAvat | etAdRSasya
   sarvāsaṃbhāvanā-śūnyatve 'pi viparīta-bhāva-pratibandhāt sākṣātkāro	sarva-asaMBAvanA--SUnya-tve api viparIta--BAva--pratibanDAt sAkzAtkAraH-
   nodetīti nididhyāsanam āha - asaṃmūḍhaḥ | nididhyāsanasya	na-udeti-iti nidiDi-Asanam Aha  asaMmUXaH | nidiDi-Asanasya
   vijātīya-pratyayānantarita-sajātīya-pratyaya-pravāhasya paripākeṇa	vijAtIya--pratyaya-anantarita--sajAtIya--pratyaya--pravAhasya paripAkeNa
   viparīta-bhāvanākhya-saṃmoha-rahitaḥ | tataḥ sarva-pratibandhāpagamād	viparIta--BAvanA-AKya--saMmoha--rahitaH | tatas sarva-pratibanDa-apagamAt-
   brahmavid brahma-sākṣātkāravān | tataś ca samādhi-paripākeṇa nirdoṣe same	brahma-vid brahma-sAkzAt-kAravAn | tatas ca samADi-paripAkeNa nirdoze same
   brahmaṇy eva sthito nānyatreti brahmaṇi sthito jīvan-muktaḥ sthita-prajña	brahmaNi eva sTitaH na-anyatra-iti brahmaNi sTitaH jIvan-muktaH sTita--prajQa
   ity arthaḥ | etādṛśasya dvaita-darśanābhāvāt praharṣodvegau na bhavata ity	iti arTaH | etAdRSasya dvEta--darSana-aBAvAt praharza-udvegO na BavataH iti-
   ucitam eva | sādhakena tu dvaita-darśane vidyamāne 'pi	ucitam eva | sADakena tu dvEta-darSane vidyamAne api
   viṣaya-doṣa-darśanādinā praharṣa-viṣādau tyājyāv ity abhiprāyaḥ ||20||	vizaya--doza--darSana-AdinA praharza--viza-AdO tyAjyO iti aBiprAyaH ||20||
   viśvanāthaḥ : evaṃ laukika-priyāpriyādiṣv api teṣāṃ sāmyam āha na	viSvanATaH : evam lOkika-priya-apriya-Adizu api tezAm sAmyam Aha na
   prahṛṣyed iti | na prahṛṣyet na prahṛṣyati | nodvijet nodvijate |	prahRzyet iti | na prahRzyet na prahRzyati | na-udvijet na-udvijate |
   sādhana-daśāyām evam abhyased iti vivakṣayā vā liṅ | asaṃmūḍho	sADana-daSAyAm evam aByaset iti vivakzayA vA liF | asaMmUXaH-
   harṣa-śokādīnām abhimāna-nibandhanatvena saṃmoha-mātratvāt ||20||	harza--Soka-AdInAm aBimAna--nibanDana-tvena saMmoha--mAtra-tvAt ||20||
   baladevaḥ : brahmaṇi sthitasya lakṣaṇam āha neti | vartamāne dehe sthitaḥ	baladevaH : brahmaNi sTitasya lakzaNam Aha na-iti | vartamAne dehe sTitaH
   prārabdhākṛṣṭaṃ priyam apriyaṃ ca prāpya na prahṛṣyen na codvijet | kutaḥ	prArabDa-AkRzwam priyam apriyam ca prApya na prahRzyet na ca-udvijet | kutas-
   ? sthirā svātmani buddhir yasya saḥ | asaṃmūḍho 'nityena dehena nityam	? sTirA sva-Atmani budDiH yasya saH | asaMmUXaH anityena dehena nityam
   ātmānam ekīkṛtya mohaṃ na labdhaḥ | brahmavit tādṛśaṃ brahmānubhavan |	AtmAnam ekIkRtya moham na labDaH | brahma-vid tAdRSam brahma-anuBavan |
   evaṃlakṣaṇo brahmaṇi sthito bodhyaḥ ||20||	evaMlakzaNaH brahmaNi sTitaH boDyaH ||20||
   BhG 5.21	Bhu 5.21
   bāhya-sparśeṣv asaktātmā vindaty ātmani yat sukham |	bAhya--sparSezu asakta-AtmA vindati Atmani yat suKam |
   sa brahma-yoga-yuktātmā sukham akṣayam aśnute ||21||	sa brahma-yoga--yukta-AtmA suKam akzayam aSnute ||21||
   śrīdharaḥ : moha-nivṛttyā buddhi-sthairye hetum āha bāhya-sparśeṣv iti |	SrIDaraH : moha--nivRttyA budDi--sTErye hetum Aha bAhya--sparSezu iti |
   indriyaiḥ spṛśyanta iti sparśā viṣayāḥ | bāhyendriya-viṣayeṣv	indriyEH spRSyante iti sparSAH vizayAH | bAhya-indriya--vizayezu-
   asaktātmānāsakta-cittaḥ | ātmani antaḥ-karaṇe yad upaśamātmakaṃ sāttvikaṃ	asakta-AtmA-anAsakta--cittaH | Atmani antaH--karaNe yat upaSama-Atmakam sAttvikam
   sukham tad vindati labhate | sa copaśamaṃ sukhaṃ labdhvā brahmaṇi yogena	suKam tat vindati laBate | sa ca-upaSamam suKam labDvA brahmaNi yogena
   samādhinā yuktas tadaikyaṃ prāpta ātmā yasya so 'kṣayaṃ sukham aśnute	samADinA yuktaH tad-A-Ekyam prAptaH AtmA yasya saH akzayam suKam aSnute
   prāpnoti ||21||	prApnoti ||21||
   madhusūdanaḥ : nanu bāhya-viṣaya-prīter	maDusUdanaH : nanu bAhya--vizaya--prIteH-
   aneka-janmānubhūtatvenātipracalatvāt tad-āsakta-cittasya katham alaukike	aneka--janma-anuBUta-tvena-ati-pracala-tvAt tad--Asakta--cittasya kaTam alOkike
   brahmaṇi dṛṣṭa-sarva-sukha-rahite sthitiḥ syāt | paramānanda-rūpatvād iti	brahmaNi dRzwa--sarva--suKa--rahite sTitiH syAt | parama-Ananda--rUpa-tvAt iti
   cet, na | tad-ānandasyānanubhūta-caratvena citta-sthiti-hetutvābhāvāt |	cet, na | tad--Anandasya-ananuBUta-cara-tvena citta--sTiti-hetu-tva-aBAvAt |
   tad uktaṃ vārttike -	tat uktam vArttike -
   apy ānandaḥ śrutaḥ sākṣān mānenāviṣayīkṛtaḥ |	api AnandaH SrutaH sAkzAt mAnena-avizayIkRtaH |
   dṛṣṭānandābhilāṣaṃ sa na mandīkartum apy alam || iti |	dRzwa-Ananda-aBilAzam sa na mandIkartum api alam || iti |
   tatrāha bāhyeti | indriyaiḥ spṛśyanta iti sparśāḥ śabdādayaḥ | te ca bāhyā	tatra-Aha bAhya-iti | indriyEH spRSyante iti sparSAH Sabda-AdayaH | te ca bAhyA
   anātma-dharmatvāt | teṣv asaktātmānāsakta-cittas tṛṣṇā-śūnyatayā viraktaḥ	anAtma--Darma-tvAt | tezu asakta-AtmA-anAsakta--cittaH tRzNA--SUnya-tayA viraktaH
   sann ātmani antaḥ-karaṇa eva bāhya-viṣaya-nirapekṣaṃ yad upaśamātmakaṃ	san Atmani antaH-karaNaH eva bAhya--vizaya--nirapekzam yat upaSama-Atmakam
   sukhaṃ tad vindati labhate nirmala-sattva-vṛttyā | tad uktaṃ bhārate -	suKam tat vindati laBate nirmala--sattva--vRttyA | tat uktam BArate -
   yac ca kāma-sukhaṃ loke yac ca divyaṃ mahat sukham |	yat ca kAma--suKam loke yat ca divyam mahat suKam |
   tṛṣṇākṣaya-sukhasyaite nārhataḥ ṣoḍaśīṃ kalām || iti |	tRzNA-kzaya--suKasya-ete na-arhataH zoxaSIm kalAm || iti |
   athavā pratyag-ātmani tvaṃ-padārthe yat sukhaṃ svarūpa-bhūtaṃ suṣuptāv	aTavA pratyag-a-Atmani tvaM-pada-arTe yat suKam svarUpa-BUtam suzuptO=-
   anubhūyamānaṃ bāhya-viṣayāsakti-pratibandhād alambhamānaṃ tad eva	anuBUyamAnam bAhya--vizaya-Asakti-pratibanDAt alamBamAnam tat eva
   tad-abhāvāl labhate |	tat--aBAvAt laBate |
   na kevalaṃ tvaṃ-padārtha-sukham eva labhate kintu	na kevalam tvaM-pada-arTa--suKam eva laBate kintu
   tat-padārthaikyānubhavena pūrṇa-sukham apīty āha sa tṛṣṇā-śūnyo brahmaṇi	tat--padArTa-Ekya-anuBavena pUrNa--suKam api-iti Aha sa tRzNA--SUnyaH brahmaNi
   paramātmani yogaḥ samādhis tena yuktas tasmin vyāpṛta ātmāntaḥ-karaṇaṃ	paramAtmani yogaH samADiH tena yuktaH tasmin vyApRtaH Atma-antaH--karaNam
   yasya sa brahma-yoga-yuktātmā | athavā brahmaṇi tat-padārthe yogena	yasya sa brahma-yoga--yukta-AtmA | aTavA brahmaNi tat--padArTe yogena
   vākyārthānubhava-rūpeṇa samādhinā yukta aikyaṃ prāpta ātmā	vAkya-arTa-anuBava--rUpeNa samADinA yuktaH Ekyam prAptaH AtmA
   tvaṃ-padārtha-svarūpaṃ yasya sa tathā | sukham akṣayam anantaṃ	tvaM-pada-arTa--svarUpam yasya sa taTA | suKam akzayam anantam
   sva-svarūpa-bhūtam aśnute vyāpnoti sukhānubhava-rūpa eva sarvadā bhavatīty	sva--svarUpa-BUtam aSnute vyApnoti suKa-anuBava--rUpaH eva sarvadA Bavati-iti-
   arthaḥ | nitye 'pi vastuny avidyānivṛtty-abhiprāyeṇa dhātv-artha-yoga	arTaH | nitye api vastuni avidyA-nivRtti--aBiprAyeNa DAtu--arTa--yoga
   aupacārikaḥ | tasmād ātmany akṣaya-sukhānubhavārthī san	OpacArikaH | tasmAt Atmani akzaya--suKa-anuBava-arTI san
   bāhya-viṣaya-prīteḥ kṣaṇikāyā mahā-narakānubandhinyāḥ sakāśād indriyāṇi	bAhya--vizaya--prIteH kzaNikAyAH mahA--naraka-anubanDinyAH sakASAt indriyANi
   nivartayet tāvataiva ca brahmaṇi sthitir bhavatīty abhiprāyaḥ ||21||	nivartayet tAvatA-eva ca brahmaNi sTitiH Bavati-iti aBiprAyaH ||21||
   viśvanāthaḥ : sa ca bāhya-sparśeṣu viṣaya-sukheṣv asaktātmā anāsakta-manāḥ	viSvanATaH : sa ca bAhya-sparSezu vizaya--suKezu asakta-AtmA anAsakta-manAH
   | tatra hetur ātmani jīvātmani paramātmānaṃ vindati sati prāpte yat sukhaṃ	| tatra hetuH Atmani jIvAtmani paramAtmAnam vindati sati prApte yat suKam
   tad akṣayaṃ sukham | sa evāśnute prāpnoti, na hi nirantaram amṛtāsvādine	tat akzayam suKam | saH eva-aSnute prApnoti, na hi nirantaram amRtA-su-Adine
   mṛttikā rocata iti bhāvaḥ ||21||	mRttikA rocate iti BAvaH ||21||
   baladevaḥ : paurvauttaryeṇa sva-parātmānāv anubhavatīty āha bāhyeti |	baladevaH : pOru-OttaryeNa sva-para-AtmAnO anuBavati-iti Aha bAhya-iti |
   bāhya-sparśeṣu śabdādi-viṣayānubhaveṣu asaktātmā san yadātmani sva-svarūpe	bAhya--sparSezu Sabda-Adi--vizaya-anuBavezu asakta-AtmA san yadAtmani sva--svarUpe
   'nubhūyamāne sukham tadādau vindati, tad uttaraṃ brahmaṇi paramātmani	anuBUyamAne suKam tad-AdO vindati, tat uttaram brahmaNi paramAtmani
   yogaḥ samādhis tad-yuktātmā san yad akṣayaṃ mahad-anubhava-lakṣaṇaṃ sukham	yogaH samADiH tad--yukta-AtmA san yat akzayam mahat--anuBava--lakzaNam suKam
   tad aśnute labhate ||21||	tat aSnute laBate ||21||
   BhG 5.22	Bhu 5.22
   ye hi saṃsparśajā bhogā duḥkha-yonaya eva te |	ye hi saMsparSa-jAH BogAH duHKa-yonayaH eva te |
   ādy-anta-vantaḥ kaunteya na teṣu ramate budhaḥ ||22||	Adi--anta-vantaH kOnteya na tezu ramate buDaH ||22||
   śrīdharaḥ : nanu priya-viṣaya-bhogānām api nivṛtteḥ kathaṃ mokṣaḥ	SrIDaraH : nanu priya--vizaya--BogAnAm api nivRtteH kaTam mokzaH
   puruṣārthaḥ syāt | tatrāha ye hīti | saṃsparśā viṣayās tebhyo jātā ye	puruza-arTaH syAt | tatra-Aha ye hi-iti | saMsparSAH vizayAH teByaH jAtAH ye
   bhogāḥ sukhāni | te hi vartamāna-kāle 'pi spardhāsūyādi-vyāptatvād	BogAH suKAni | te hi vartamAna-kAle api sparDA-AsUya-Adi--vyApta-tvAt-
   duḥkhasyaiva yonayaḥ kāraṇa-bhūtāḥ | tathādimanto 'ntavantaś ca | ato	duHKasya-eva yonayaH kAraNa-BUtAH | taTA-adimantaH antavantaH ca | atas-
   vivekī teṣu na ramate ||22||	vivekI tezu na ramate ||22||
   madhusūdanaḥ : nanu bāhya-viṣaya-prīti-nivṛttāv ātmany	maDusUdanaH : nanu bAhya--vizaya--prIti-nivRttO Atmani-
   akṣaya-sukhānubhavas tasmiṃś ca sati tat-prasādād eva	akzaya--suKa-anuBavaH tasmin ca sati tat--prasAdAt eva
   bāhya-viṣaya-prīti-nivṛttir itītaretarāśraya-vaśān naikam api sidhyed ity	bAhya--vizaya--prIti-nivRttiH iti-itaretara-ASraya--vaSAt na-ekam api siDyet iti-
   āśaṅkya viṣaya-doṣa-darśanābhyāsenaiva tat-prīti-nivṛttir bhavatīti	ASaFkya vizaya--doza--darSana-aByAsena-eva tat--prIti-nivRttiH Bavati-iti
   parihāram āha ye hīti | hi yasmād ye saṃsparśajā viṣayendriya-sambandha-jā	parihAram Aha ye hi-iti | hi yasmAt ye saMsparSa-jAH vizaya-indriya-sambanDa--jA
   bhogāḥ kṣudra-sukha-lavānubhavā iha vā paratra vā rāga-dveṣādi-vyāptatvena	BogAH kzudra--suKa-lava-anuBavAH iha vA paratra vA rAga--dveza-Adi--vyApta-tvena
   duḥkha-yonaya eva te | te sarve 'pi brahma-loka-paryantaṃ duḥkha-hetava	duHKa--yonayaH eva te | te sarve api brahma-loka--paryantam duHKa-hetava
   eva | tad uktaṃ viṣṇu-purāṇe -	eva | tat uktam vizNu-purANe -
   yāvataḥ kurute jantuḥ saṃbandhān manasaḥ priyān |	yAvataH kurute jantuH saMbanDAt manasaH priyAn |
   tāvanto 'sya nisvanyante hṛdaye śoka-śaṅkavaḥ || iti |	tAvantaH asya nisvanyante hRdaye Soka--SaFkavaH || iti |
   etādṛśā aḸ na sthirāḥ kintu ādy-anta-vantaḥ | ādir viṣayendriya-saṃyogo	etAdRSAH aḸ na sTirAH kintu Adi--anta-vantaH | AdiH vizaya-indriya--saMyogaH-
   'ntaś ca tad-viyoga evaṃ tau vidyete yeṣāṃ te pūrvāparayor asattvān madhye	antar ca tad--viyogaH evam tO vidyete yezAm te pUrva-aparayoH asattvAt maDye
   svapnavad āvirbhūtāḥ kṣaṇikā mithyā-bhūtāḥ | tad uktaṃ gauḍapādācāryaiḥ -	svapna-vat AvirBUtAH kzaNikAH miTyA--BUtAH | tat uktam gOxa-pAda-AcAryEH -
   ādāv ante ca yat tv asti vartamāne 'pi tat tathā iti |	AdO ante ca yat tu asti vartamAne api tat taTA iti |
   yasmād evaṃ tasmāt teṣu budho vivekī na ramate pratikūla-vedanīyatvāc ca	yasmAt evam tasmAt tezu buDaH vivekI na ramate pratikUla--vedanIya-tvAt ca
   prītim anubhavati | tad uktaṃ bhagavatā patañjalinā	prItim anuBavati | tat uktam BagavatA pataQjalinA
   pariṇāma-tāpa-saṃskāra-duḥkhair guṇa-vṛtti-virodhāc ca duḥkham eva sarvaṃ	pariNAma--tApa--saMskAra--duHKEH guNa-vRtti-viroDAt ca duHKam eva sarvam
   vivekinaḥ [YogS 2.15] iti | sarvam api viṣaya-sukhaṃ dṛṣṭam ānuśravikaṃ ca	vivekinaH [YogH 2.15] iti | sarvam api vizaya--suKam dRzwam AnuSravikam ca
   duḥkham eva pratikūla-vedanīyatvāt | vivekinaḥ	duHKam eva pratikUla--vedanIya-tvAt | vivekinaH
   parijñāta-kleśādi-svarūpasya na tv avivekinaḥ | akṣi-pātra-kalpo hi vidvān	parijQAta--kleSa-Adi-svarUpasya na tu avivekinaH | akzi--pAtra-kalpaH hi vidvAn
   atyalpa-duḥkha-leśenāpy udvijate yathorṇa-tantur atisukumāro 'py	ati-alpa--duHKa--leSena-api udvijate yaTA-UrNa-tantuH ati-sukumAraH api-
   akṣi-pātre nyastaḥ sparśena duḥkhayati netareṣv aṅgeṣu tadvad vivekina eva	akzi--pAtre nyastaH sparSena duHKayati na-itarezu aFgezu tadvat vivekinaH eva
   madhu-viṣa-saṃpṛktānna-bhojanavat sarvam api bhoga-sādhanaṃ kāla-traye 'pi	maDu--viza--saMpRktAn-na-Bojana-vat sarvam api Boga--sADanam kAla-traye api
   kleśānubiddhatvād duḥkhaṃ na mūḍhasya bahuvidha-duḥkha-sahiṣṇor ity arthaḥ	kleSa-anubidDa-tvAt duHKam na mUXasya bahuviDa--duHKa--sahizNoH iti arTaH
   | tatra pariṇāma-tāpa-saṃskāra-duḥkhair iti bhūta-vartamāna-bhaviṣyt-kāle	| tatra pariNAma-tApa--saMskAra--duHKEH iti BUta-vartamAna--Bavizyt--kAle
   'pi duḥkhānubiddhatvād aupādhikaṃ duḥkhatvaṃ viṣaya-sukhasyoktaṃ,	api duHKa-anubidDa-tvAt OpADikam duHKa-tvam vizaya--suKasya-uktaM,
   guṇa-vṛtti-virodhāc cety anena svarūpato 'pi duḥkhatvam | tatra pariṇāmaś	guNa-vRtti-viroDAt ca-iti anena svarUpataH api duHKa-tvam | tatra pariNAma-H-
   ca tāpaś ca saṃskāraś ca ta eva duḥkhāni tair ity arthaḥ |	ca tApaH ca saMskAraH ca te eva duHKAni tEH iti arTaH |
   itthaṃ-bhūta-lakṣaṇe tṛtīyā | tathā hi - rāgānubiddha eva sarvo 'pi	itTaM-BUta--lakzaNe tRtIyA | taTA hi  rAga-anubidDaH eva sarvaH api
   sukhānubhavaḥ | na hi tatra na rajyati tena sukhī ceti sambhavati | rāga	suKa-anuBavaH | na hi tatra na rajyati tena suKI ca-iti samBavati | rAga
   eva ca pūrvam udbhūtaḥ san viṣaya-prāptyā sukha-rūpeṇa pariṇamate | tasya	eva ca pUrvam udBUtaH san vizaya--prAptyA suKa--rUpeNa pariNamate | tasya
   ca pratikṣaṇaṃ vardhamānatvena	ca pratikzaNam varDamAna-tvena
   sva-viṣayāprāpti-nibandhana-duḥkhasyāparihāryatvād duḥkha-rūpataiva | yā	sva---vizaya-aprApti-nibanDana--duHKasya-aparihArya-tvAt duHKa--rUpa-tA-eva | yA
   hi bhogeṣv indriyāṇām upaśāntiḥ paritṛptatvāt tat sukham | yā laulyād	hi Bogezu indriyANAm upaSAntiH paritRpta-tvAt tat suKam | yA lOlyAt-
   anupaśāntis tad duḥkham | na cendriyāṇāṃ bhogābhyāsena vaitṛṣṇyaṃ kartuṃ	anupaSAntiH tat duHKam | na ca-indriyANAm Boga-aByAsena vEtRzNyam kartum
   śakyam | yato bhogābhyāsam anu vivardhante rāgāḥ kauśalāni cendriyāṇāṃ |	Sakyam | yatas Boga-aByAsam anu vivarDante rAgAH kOSalAni ca-indriyANAm |
   smṛtiś ca -	smRtiH ca -
   na jātu kāmaḥ kāmānām upabhogena śāmyati |	na jAtu kAmaH kAmAnAm upaBogena SAmyati |
   haviṣā kṛṣṇa-vartmaiva bhūya evābhivardhate || iti |	havizA kRzNa--vartmA-eva BUyas eva-aBivarDate || iti |
   tasmād duḥkhātmaka-rāga-pariṇāmatvād viṣaya-sukham api duḥkham eva	tasmAt duHKa-Atmaka--rAga--pariNAma-tvAt vizaya--suKam api duHKam eva
   kārya-kāraṇayor abhedād iti pariṇāma-duḥkhatvam |	kArya--kAraNayoH aBedAt iti pariNAma--duHKa-tvam |
   tathā sukhānubhava-kāle tat-pratikūlāni duḥkha-sādhanāni dveṣṭi |	taTA suKa-anuBava--kAle tat--pratikUlAni duHKa--sADanAni dvezwi |
   nānupahatya bhūtāny upabhogaḥ sambhavatīti bhūtāni ca hinasti | dveṣaś ca	na-anupahatya BUtAni upaBogaH samBavati-iti BUtAni ca hinasti | dvezaH ca
   sarvāṇi duḥkha-sādhanāni me mā bhūvann iti saṅkalpa-viśeṣaḥ | na ca tāni	sarvANi duHKa--sADanAni me mA BUvan iti saFkalpa--viSezaH | na ca tAni
   sarvāṇi kaścid api parihartuṃ śaknoti | ataḥ sukhānubhava-kāle 'pi	sarvANi kaScid api parihartum Saknoti | atas suKa-anuBava--kAle api
   tat-paripanthinaṃ prati dveṣasya sarvadaivāvasthitatvāt tāpa-duḥkhaṃ	tat-paripanTinam prati dvezasya sarvadA-eva-avasTita-tvAt tApa--duHKam
   duṣparihāram eva | tāpo hi dveṣaḥ | evaṃ duḥkha-sādhanāni parihartum	duzparihAram eva | tApaH hi dvezaH | evam duHKa--sADanAni parihartum
   aśakto muhyati ceti moha-duḥkhatāpi vyākhyeyā | tathā coktaṃ	aSaktaH muhyati ca-iti moha--duHKa-tA-api vyAKyeyA | taTA ca-uktam
   yoga-bhāṣya-kāraiḥ - sarvasya dveṣānubiddhaś cetanācetana-sādhanādhīnas	yoga--BAzya-kArEH  sarvasya dveza-anubidDaH cetana-acetana--sADana-aDInas
   tāpānubhava iti | tatrāsti dveṣajaḥ karmāśayaḥ | sukha-sādhanāni ca	tApa-anuBavaH iti | tatra-asti dveza-jaH karma-ASayaH | suKa--sADanAni ca
   prārthayamānaḥ kāyena vācā manasā ca parispandate | tataḥ param anugṛṇāty	prArTayamAnaH kAyena vAcA manasA ca parispandate | tatas param anugRNAti-
   upahanti ceti parānuraha-pīḍābhyāṃ dharmādharmāv upacinoti | na karmāśayo	upahanti ca-iti para-anuraha--pIxAByAm Darma-aDarmO upacinoti | na karma-ASayaH-
   lobhān mohāc ca bhavati ity eṣā tāpa-duḥkhatocyate | tathā vartamānaḥ	loBAt mohAt ca Bavati iti ezA tApa--duHKa-tA-ucyate | taTA vartamAnaH
   sukhānubhavaḥ sva-vināśa-kāle saṃskāram ādhatte | sa ca sukha-smaraṇaṃ,	suKa-anuBavaH sva--vinASa--kAle saMskAram ADatte | sa ca suKa--smaraNaM,
   tac ca rāgaṃ, sa ca manaḥ-kāya-vacana-ceṣṭāṃ, sā ca puṇyāpuṇya-karmāśayau,	tat ca rAgaM, sa ca manaH--kAya-vacana--cezwAM, sA ca puNyA-puNya-karma-ASayO,
   tau ca janmādīti saṃskāra-duḥkhatā | evaṃ tāpa-mohayor api saṃskārau	tO ca janma-Adi-iti saMskAra--duHKa-tA | evam tApa--mohayoH api saMskArO
   vyākhyeyau |	vyAKyeyO |
   evaṃ kāla-traye 'pi duḥkhānuvedhād viṣaya-sukhaṃ duḥkham evety uktvā	evam kAla-traye api duHKa-anuveDAt vizaya--suKam duHKam eva-iti uktvA
   svarūpato 'pi duḥkhatām āha guṇa-vṛtti-virodhāc ca | guṇāḥ	svarUpataH api duHKa-tAm Aha guNa-vRtti-viroDAt ca | guNAH
   sattva-rajas-tamāṃsi sukha-duḥkha-mohātmakāḥ paraspara-viruddha-svabhāvā	sattva-rajas-tamAMsi suKa--duHKa--moha-AtmakAH paraspara--virudDa--svaBAvA
   api taila-varty-agnaya iva dīpaṃ puruṣa-bhogopayuktatvena try-ātmakam ekaṃ	api tEla-varti--agnayaH iva dIpam puruza---Boga-upayukta-tvena try-a-Atmakam ekam
   kāryam ārabhante tatraikasya prādhānye dvayor guṇa-bhāvāt	kAryam AraBante tatra-ekasya prADAnye dvayoH guNa--BAvAt-
   pradhāna-mātra-vyapadeśena sāttvikaṃ rājasaṃ tāmasam iti triguṇam api	praDAna--mAtra--vyapadeSena sAttvikam rAjasam tAmasam iti triguNam api
   kāryam ekena guṇena vyapadiśyate | tatra sukhopabhoga-rūpo 'pi pratyaya	kAryam ekena guNena vyapadiSyate | tatra suKa-upaBoga--rUpaH api pratyaya
   udbhūta-sattva-kāryatve 'py anudbhūta-rajas-tamaḥ-kāryatvāt triguṇātmaka	udBUta--sattva--kArya-tve api anudBUta--rajas-tamaH--kArya-tvAt triguNa-Atmaka
   eva | tathā ca sukhātmakatvavad duḥkhātmakatvaṃ viṣādātmakatvaṃ ca tasya	eva | taTA ca suKa-Atmaka-tva-vat duHKa-Atmaka-tvam vizAda-Atmaka-tvam ca tasya
   dhruvam iti duḥkham eva sarvaṃ vivekinaḥ | na caitādṛśo 'pi pratyayaḥ	Druvam iti duHKam eva sarvam vivekinaH | na ca-etAdRSaH api pratyayaH
   sthiraḥ | yasmāc calaṃ ca guṇa-vṛttam iti kṣipra-pariṇāmi cittam uktam |	sTiraH | yasmAt calam ca guNa-vRttam iti kzipra--pariNAmi cittam uktam |
   nanv ekaḥ pratyayaḥ kathaṃ paraspara-viruddha-sukha-duḥkha-mohatvāny ekadā	nanu ekaH pratyayaH kaTam paraspara--virudDa--suKa--duHKa-moha-tvAni ekadA
   pratipadyata iti cet, na | udbhūtānudbhūtayor virodhābhāvāt |	pratipadyate iti cet, na | udBUtAn-udBUtayoH viroDa-aBAvAt |
   sama-vṛttikānām eva hi guṇānāṃ yugapad virodho na viṣama-vṛttikānām |	sama-vRttikAnAm eva hi guNAnAm yugapad viroDaH na vizama-vRttikAnAm |
   yathā dharma-jñāna-vairāgyaiśvaryāṇi labdha-vṛttikāni labdha-vṛttikair	yaTA Darma--jQAna-vErAgya-ESvaryANi labDa--vRttikAni labDa-vRttikEH-
   evādharmājñānāvairāgyānaiśvaryaiḥ saha virudhyante na tu svarūpa-sadbhiḥ |	eva-aDarma-ajQAna-avErAgyAnESvaryEH saha viruDyante na tu svarUpa-sadBiH |
   pradhānasya pradhānena saha virodho na tu durbaleneti hi nyāyaḥ | evaṃ	praDAnasya praDAnena saha viroDaH na tu durbalena-iti hi nyAyaH | evam
   sattva-rajas-tamāṃsy api parasparaṃ prādhānya-mātraṃ yugapan na sahante na	sattva--raja-s-ta-mAMsi api parasparam prADAnya--mAtram yugapad na sahante na
   tu sad-bhāvam api |	tu sat--BAvam api |
   etena pariṇāma-tāpa-saṃskāra-duḥkheṣv api rāga-dveṣa-mohānāṃ yugapat	etena pariNAma-tApa--saMskAra--duHKezu api rAga--dveza--mohAnAm yugapad-
   sad-bhāvo vyākhyātaḥ prasupta-tanu-vicchinnodāra-rūpeṇa kleśānāṃ	sad-BAvaH vyAKyAtaH prasupta---tanu--vicCinna-udAra--rUpeNa kleSAnAm
   catur-avasthatvāt | tathā hi - avidyāsmitā-rāga-dveṣābhiniveśāḥ	catur--avasTa-tvAt | taTA hi  avidyA-smitA--rAga--dveza-aBiniveSAH
   pañca-kleśāḥ | avidyā kṣetram uttareṣāṃ prasupta-tanu-vicchinnodārāṇām |	paQca---kleSAH | avidyA kzetram uttarezAm prasupta--tanu--vicCinna-udArANAm |
   anityāśuci-duḥkhānātmasu nitya-śuci-sukhātma-khyātir avidyā |	anitya-aSuci--duHKa-anAtmasu nitya--Suci--suKa-Atma---KyAtiH avidyA |
   dṛg-darśana-śaktyor ekātmataivāsmitā | sukhanuśayī rāgaḥ | duḥkhānuśayī	dRS--darSana--SaktyoH eka-Atma-tA-eva-asmitA | suKanu-SayI rAgaH | duHKa-anuSayI
   dveṣaḥ | svarasa-vāhī viduṣo 'pi tathārūḍho 'bhiniveśaḥ | te	dvezaH | svarasa-vAhI viduzaH api taTA-ArUXaH aBiniveSaH | te
   pratiprasava-heyāḥ sūkṣmāḥ | dhyāna-heyās tad-vṛttayaḥ | kleśa-mūlaḥ	pratiprasava--heyAH sUkzmAH | DyAna--heyAH tad--vRttayaH | kleSa-mUlaH
   karmāśayo dṛṣṭādṛṣṭa-janma-vedanīyaḥ | sati mūle tad-vipāko jātyāyur	karma-ASayaH dRzwa-adRzwa--janma--vedanIyaH | sati mUle tad--vipAkaH jAti-AyuH-
   bhogāḥ [YogS 2.3-13] iti pātañjalāni sūtrāṇi | tatrātasmiṃs tad-buddhir	BogAH [YogH 2.3-13] iti pAtaQjalAni sUtrANi | tatra-Atasmin tad--budDiH-
   viparyayo mithyā-jñānam avidyeti paryāyāḥ | tasyā viśeṣaḥ saṃsāra-nidānam	viparyayaH miTyA-jQAnam avidyA-iti paryAyAH | tasyAH viSezaH saMsAra-nidAnam
   | tatrānitye nitya-buddhir yathā - dhruvā pṛthivī dhruvā sa-candra-tārakā	| tatra-anitye nitya-budDiH yaTA  DruvA pRTivI DruvA sa-candra-tArakA
   dyaur amṛtā divaukasa iti | aśucau parama-bībhatse kāye śuci-buddhir yathā	dyOH amRtAH divOkasaH iti | aSucO parama--bIBatse kAye Suci-budDiH yaTA
   naveva śaśāṅkalekhā kamanīyeyaṃ kanyā madhv-amṛtāvayava-nirmiteva candraṃ	navA-iva SaSAFka-leKA kamanIyA-iyam kanyA maDu--amRta-avayava--nirmitA-iva candram
   bhittvā niḥsṛteva jñāyate nīlotpala-patrāyatākṣī hāvagarbhābhyāṃ	BittvA niHsRtA-iva jQAyate nIlotpala--patra-Ayata-akzI hAva-garBAByAm
   locanābhyāṃ jīva-lokam āśvāsayatīveti kasya kena sambandhaḥ |	locanAByAm jIva--lokam ASvAsayati-iva-iti kasya kena sambanDaH |
   sthānād bījād upaṣṭambhān	sTAnAt bIjAt upazwamBAn
   niṣyandān nidhanād api |	nizyandAt niDanAt api |
   kāyam ādheya-śaucatvāt	kAyam ADeya--SOca-tvAt-
   paṇḍitā hy aśuciṃ viduḥ || iti ca vaiyāsaki-ślokaḥ |	paNxitAH hi aSucim viduH || iti ca vEyAsaki-SlokaH |
   etenāpuṇye puṇya-pratyayo 'narthe cārtha-pratyayo vyākhyātaḥ | duḥkhe	etena-apuNye puNya--pratyayaH anarTe ca-arTa--pratyayaH vyAKyAtaH | duHKe
   sukha-khyātir udāhṛtā pariṇāma-tāpa-saṃskāra-duḥkhair guṇa-vṛtti-virodhāc	suKa-KyAtiH udAhRtA pariNAma-tApa--saMskAra--duHKEH guNa-vRtti-viroDAt-
   ca duḥkham eva sarvaṃ vivekina iti | anātmany ātma-khyātir yathā śarīre	ca duHKam eva sarvam vivekinaH iti | anAtmani Atma--KyAtiH yaTA SarIre
   manuṣyo 'ham ity ādiḥ | iyaṃ cāvidyā sarva-kleśa-mūla-bhūtā tama ity	manuzyaH aham iti AdiH | iyam ca-avidyA sarva--kleSa--mUla-BUtA tamaH iti-
   ucyate | buddhi-puruṣayor abhedābhimāno 'smitā mohaḥ | sādhana-rahitasyāpi	ucyate | budDi-puruzayoH aBeda-aBimAnaH asmitA mohaH | sADana--rahitasya-api
   sarvaṃ sukha-jātīyaṃ me bhūyād iti viparyaya-viśeṣo rāgaḥ | sa eva	sarvam suKa--jAtIyam me BUyAt iti viparyaya-viSezaH rAgaH | saH eva
   mahā-mohaḥ | duḥkha-sādhane vidyamāne 'pi kim api duḥkham me mā bhūd iti	mahA-mohaH | duHKa--sADane vidyamAne api kim api duHKam me mA BUt iti
   viparyaya-viśeṣo dveṣaḥ | sa tāmisraḥ | āyur-abhāve 'py etaiḥ	viparyaya--viSezaH dvezaH | sa tAmisraH | AyuH--aBAve api etEH
   śarīrendriyādibhir anityair api viyogo me mā bhūd ity āvidvad-aṅganā-bālaṃ	SarIra-indriya-AdiBiH anityEH api viyogaH me mA BUt iti Avidvat--aFga-nA--bAlam
   svābhāvikaḥ sarva-prāṇi-sādhāraṇo maraṇa-trāsa-rūpo viparyaya-viśeṣo	svABAvikaH sarva--prANi--sADAraNaH maraNa--trAsa--rUpaH viparyaya--viSezaH-
   'bhiniveśaḥ | so 'ndha-tāmisraḥ | tad uktaṃ purāṇe-	aBiniveSaH | saH anDa-tAmisraH | tat uktam purANe-
   tamo moho mahā-mohas tāmisro hy andha-saṃjñitaḥ |	tamaH mohaH mahA-mohaH tAmisraH hi anDa--saMjQitaH |
   avidyā pañca-parvaiṣā prādurbhūtā mahātmanaḥ || iti |	avidyA paQca--parvA-ezA prAdurBUtA mahAtmanaH || iti |
   ete ca kleśāś catur avasthā bhavanti | tatrāsato 'nutpatter	ete ca kleSAH catuH avasTAH Bavanti | tatra-asataH anutpatteH-
   anabhivyakta-rūpeṇāvasthānaṃ suptāvasthā | abhivyaktasyāpi	anaBivyakta-rUpeNa-avasTAnam supta-avasTA | aBivyaktasya-api
   saha-kārya-lābhāt kāryājanakatvaṃ tanv-avasthā | abhivyaktasya	saha--kArI-a--lABAt kArya-ajanaka-tvam tanu--avasTA | aBivyaktasya
   janita-kāryasyāpi kenacid balavatābhibhavo vicchedāvasthā | abhivyaktasya	janita-kAryasya-api kenacid balavatA-aBiBavaH vicCeda-avasTA | aBivyaktasya
   prāpta-sahakāri-sampatter apratibandhena sva-kārya-karatvam udārāvasthā |	prApta-sahakAri--sampatteH apratibanDena sva--kArya-kara-tvam udAra-avasTA |
   etādṛg avasthā-catuṣṭaya-viśiṣṭānām asmitādīnāṃ caturṇāṃ viparyaya-rūpāṇāṃ	etAdRS avasTA--catuzwaya--viSizwAnAm asmitA-AdInAm caturNAm viparyaya--rUpANAm
   kleśānām avidyaiva sāmānya-rūpā kṣetraṃ prasava-bhūmiḥ | sarveṣām api	kleSAnAm avidyA-eva sAmAnya--rUpA kzetram prasava--BUmiH | sarvezAm api
   viparyaya-rūpatvasya darśitatvāt | tenāvidyā-nivṛttyaiva kleśānāṃ nivṛttir	viparyaya---rUpa-tvasya darSita-tvAt | tena-avidyA--nivRttya-eva kleSAnAm nivRttiH-
   ity arthaḥ | te ca kleśāḥ prasuptā yathā prakṛti-līnānāṃ, tanavaḥ	iti arTaH | te ca kleSAH prasuptAH yaTA prakRti--lInAnAM, tanavaH
   pratipakṣa-bhāvanayā tanūkṛtā yathā yoginām | ta ubhaye 'pi sūkṣmāḥ	pratipakza-BAvanayA tanUkRtAH yaTA yoginAm | te uBaye api sUkzmAH
   pratiprasavena mano-nirodhenaiva nirbīja-samādhinā heyāḥ | ye tu	pratiprasavena mano--niroDena-eva nirbIja--samADinA heyAH | ye tu
   sūkṣma-vṛttayas tat-kārya-bhūtāḥ sthūlā vicchinnā udāhārāś ca vicchidya	sUkzma-vRttayaH tat-kArya--BUtAH sTUlAH vicCinnAH udAhArAH ca vicCidya
   vicchidya tena tenātmanā punaḥ prādurbhavantīti vicchinnāḥ | yathā	vicCidya tena tena-AtmanA punar prAdurBavanti-iti vicCinnAH | yaTA
   rāga-kāle krodho vidyamāno 'pi na prādurbhūta iti vicchinna ucyate | evam	rAga--kAle kroDaH vidyamAnaH api na prAdurBUtaH iti vicCinnaH ucyate | evam
   ekasyāṃ striyāṃ caitro rakta iti nānyāsu viraktaḥ kintv ekasyāṃ rāgo	ekasyAm striyAm cEtraH raktaH iti na-anyAsu viraktaH kintu ekasyAm rAgaH-
   labdha-vṛttir anyāsu ca bhaviṣyad-vṛttir iti sa tadā vicchinna ucyate, ye	labDa-vRttiH anyAsu ca Bavizyat--vRttiH iti sa tadA vicCinnaH ucyate, ye
   yadā viṣayeṣu labdha-vṛttayas te tadā sarvātmanā prādurbhūtā udārā	yadA vizayezu labDa-vRttayaH te tadA sarva-AtmanA prAdurBUtA udArA
   ucyante, ta ubhaye 'py atisthūlatvāc chuddha-sattva-bhavena	ucyante, te uBaye api ati-sTUla-tvAt SudDa--sattva--Bavena
   bhagavad-dhyānena heyā na mano-niodham apekṣante | nirodha-heyās tu sūkṣmā	Bagavat--DyAnena heyAH na mano-nioDam apekzante | niroDa--heyAH tu sUkzmA
   eva | tathā ca pariṇāma-tāpa-saṃskāra-duḥkheṣu	eva | taTA ca pariNAma-tApa--saMskAra--duHKezu
   prasupta-tanu-vicchinna-rūpeṇa sarve kleśāḥ sarvadā santi | udāratā tu	prasupta---tanu--vicCinna--rUpeNa sarve kleSAH sarvadA santi | udAra-tA tu
   kadācit kasyacid iti viśeṣaḥ | ete ca bādhanā-lakṣaṇaṃ duḥkham	kadAcid kasyacid iti viSezaH | ete ca bADanA--lakzaNam duHKam
   upajanayantaḥ kleśa-śabda-vācyā bhavanti | yataḥ karmāśayo	upajanayantaH kleSa--Sabda-vAcyAH Bavanti | yatas karma-ASayaH-
   dharmādharmākhyaḥ kleśa-mūlaka eva | sati ca mūla-bhūte kleśe tasya	Darma-aDarma-AKyaH kleSa-mUlakaH eva | sati ca mUla-BUte kleSe tasya
   karmāśayasya vipākaḥ phalaṃ janmāyur bhogaś ceti | sa ca karmāśaya iha	karma-ASayasya vipAkaH Palam janma-AyuH BogaH ca-iti | sa ca karma-ASayaH iha
   paratra ca sva-vipākārambhakatvena dṛṣṭādṛṣṭa-janma-vedanīyaḥ | evaṃ	paratra ca sva--vipAka-AramBaka-tvena dRzwa-adRzwa--janma--vedanIyaH | evam
   kleśa-santatir ghaṭī-yantravad aniśam āvartate | ataḥ samīcīnam uktaṃ ye	kleSa--santatiH GawI-yantra-vat aniSam Avartate | atas samIcInam uktam ye
   hi saṃsparśajā bhogā duḥkha-yonaya eva te ādyantavanta iti |	hi saMsparSa-jAH BogAH duHKa-yonayaH eva te Adi-antavantaH iti |
   duḥkha-yonitvaṃ pariṇāmādibhir guṇa-vṛtti-virodhāc ca ādyantavattvaṃ	duHKa--yoni-tvam pariNAma-AdiBiH guNa-vRtti-viroDAt ca Adi-antavat-tvam
   guṇa-vṛttasya calatvād iti yoga-mate vyākhyā |	guNa-vRttasya calatvAt iti yoga-mate vyAKyA |
   aupaniṣadānāṃ tu anādi bhāva-rūpam ajñānam avidyā |	OpanizadAnAm tu anAdi BAva--rUpam ajQAnam avidyA |
   ahaṃkāra-dharmy-adhyāso 'smitā | rāga-dveṣābhiniveśās tad-vṛtti-viśeṣā ity	ahaMkAra--DarmI--aDyAsaH asmitA | rAga--dveza-aBiniveSAH tad--vRtti-viSezAH iti-
   avidyā-mūlatvāt sarve 'py avidyātmakatvena mithyā-bhūtā	avidyA-mUla-tvAt sarve api avidyA-Atmaka-tvena miTyA-BUtA
   rajju-bhujaṅgādhyāsavan mithyātve 'pi duḥkha-yonayaḥ svapnādivad	rajju--BujaFga-aDyAsa-vat miTyAtve api duHKa-yonayaH svapna-Adi-vat-
   dṛṣṭi-sṛṣṭi-mātratvenādyantavantaś ceti budho 'dhiṣṭhāna-sākṣātkāreṇa	dRzwi--sRzwi--mAtra-tvena-Adi-antavantaH ca-iti buDaH aDizWAna--sAkzAtkAreNa
   nivṛtta-bhramas teṣu na ramate, mṛga-tṛṣṇikā-svarūpa-jñānavān iva	nivRtta--BramaH tezu na ramate, mRga-tRzNikA--svarUpa--jQAnavAn iva
   tatrodakārthī na pravartate | na saṃsāre sukhasya gandha-mātram apy astīti	tatra-udaka-arTI na pravartate | na saMsAre suKasya ganDa--mAtram api asti-iti
   buddhvā tataḥ sarvāṇīndriyāṇi nivartayed ity arthaḥ ||22||	budDvA tatas sarvANi-indriyANi nivartayet iti arTaH ||22||
   viśvanāthaḥ : vivekavān eva vastuto viṣaya-sukhenaiva sajjatīty āha ye	viSvanATaH : vivekavAn eva vastutas vizaya--suKena-eva sajjati-iti Aha ye
   hīti ||22||	hi-iti ||22||
   baladevaḥ : adṛṣṭākṛṣṭeṣu viṣaya-bhogeṣv anityatva-viniścayān na sajjatīty	baladevaH : adRzwa-AkRzwezu vizaya--Bogezu anitya-tva--viniScayAt na sajjati-iti-
   āha ye hīti | saṃsparśajā viṣaya-janyā bhogāḥ sukhāni | sphuṭam anyat	Aha ye hi-iti | saMsparSa-jAH vizaya-janyAH BogAH suKAni | sPuwam anyat-
   BhG 5.23	Bhu 5.23
   śaknotīhaiva yaḥ soḍhuṃ prāk śarīra-vimokṣaṇāt |	Saknoti-iha-eva yaH soXum prAk SarIra-vimokzaNAt |
   kāma-krodhodbhavaṃ vegaṃ sa yuktaḥ sa sukhī naraḥ ||23||	kAma--kroDa-udBavam vegam sa yuktaH sa suKI naraH ||23||
   śrīdharaḥ : yasmān mokṣa eva paramaḥ puruṣārthaḥ | tasya ca	SrIDaraH : yasmAt mokzaH eva paramaH puruza-arTaH | tasya ca
   kāma-krodha-vego 'tipratipakṣaḥ | atas tat-sahana-samartha eva mokṣa-bhāg	kAma--kroDa-vegaH ati-pratipakzaH | atas tat--sahana--samarTaH eva mokza--BAg
   ity āha śaknotīti | kāmāt kordhāc codbhavati yo vego	iti Aha Saknoti-iti | kAmAt korDAt ca-udBavati yaH vegaH-
   mano-netrādi-kṣobhādi-lakṣaṇaḥ | tam ihaiva tad-uttara-samaya eva yo naraḥ	mano--netra-Adi--kzoBa-Adi--lakzaNaH | tam iha-eva tad--uttara--samayaH eva yaH naraH
   soḍhuṃ pratiroddhuṃ śaknoti, tad api na kṣaṇa-mātram | kintu	soXum pratirodDum Saknoti, tat api na kzaNa--mAtram | kintu
   śarīra-vimokṣaṇāt prāk, yāvad-deha-pātam ity arthaḥ | ya evaṃbhūtaḥ sa eva	SarIra-vimokzaNAt prAk, yAvat--deha-pAtam iti arTaH | yaH evaMBUtaH saH eva
   yuktaḥ samāhitaḥ sukhī ca bhavati | nānyaḥ | yad vā maraṇād ūrdhvaṃ	yuktaH samAhitaH suKI ca Bavati | na-anyaH | yat vA maraNAt UrDvam
   vilapantībhir yuvatībhir āliṅgyamāno 'pi putrādibhir dahyamāno 'pi yathā	vilapantIBiH yuvatIBiH AliFgyamAnaH api putra-AdiBiH dahyamAnaH api yaTA
   prāṇa-śūnyaḥ kāma-krodha-vegaṃ sahate tathā maraṇāt prāg api jīvann eva	prANa--SUnyaH kAma---kroDa--vegam sahate taTA maraNAt prAk api jIvan eva
   yaḥ sahate sa eva yuktaḥ sukhī cety arthaḥ | tad uktaṃ vaśiṣṭhena -	yaH sahate saH eva yuktaH suKI ca-iti arTaH | tat uktam vaSizWena -
   prāṇe gate yathā dehaḥ sukhaṃ duḥkhaṃ na vindati |	prANe gate yaTA dehaH suKam duHKam na vindati |
   tathā cet prāṇa-yukto 'pi sa kaivalyāśrayo bhavet || iti ||23||	taTA ced prANa-yuktaH api sa kEvalya-ASrayaH Bavet || iti ||23||
   madhusūdanaḥ : sarvānartha-prāpti-hetur durnivāro 'yaṃ	maDusUdanaH : sarva-anarTa--prApti-hetuH durnivAraH ayam
   śreyo-mārga-pratipakṣaḥ kaṣṭatamo doṣo mahatā yatnena mumukṣuṇā nivāraṇīya	Sreyo--mArga--pratipakzaH kazwatamaH dozaH mahatA yatnena mumukzuNA nivAraNIya
   iti yatnādhikya-vidhānāya punar āha śaknotīti | ātmano 'nukūleṣu	iti yatna-ADikya--viDAnAya punar Aha Saknoti-iti | AtmanaH anukUlezu
   sukha-hetuṣu dṛśyamāneṣu smaryamāṇeṣu vā tad-guṇānusandhānābhyāsena yo	suKa--hetuzu dRSyamAnezu smaryamANezu vA tad--guNa-anusanDAna-aByAsena yaH-
   raty-ātmako gardho 'bhilāṣas tṛṣṇā lobhaḥ sa kāmaḥ | strī-puṃsayoḥ	raty-AtmakaH garDaH aBilAzaH tRzNA loBaH sa kAmaH | strI--puMsayoH
   paraspara-vyatikarābhilāṣe tv atyanta-nirūḍhaḥ kāma-śabdaḥ |	paraspara--vyatikara-aBilAze tu atyanta--nirUXaH kAma--SabdaH |
   etad-abhilāṣeṇa kāmaḥ krodhas tathā lobha ity atra dhana-tṛṣṇā lobhaḥ	etat--aBilAzeNa kAmaH kroDaH taTA loBaH iti atra Dana-tRzNA loBaH
   strī-vyatikara-tṛṣṇā kāma iti kāma-lobhau pṛthag uktau | iha tu	strI-vyatikara-tRzNA kAmaH iti kAma--loBO pRTak uktO | iha tu
   tṛṣṇā-sāmānyābhiprāyeṇa kāma-śabdaḥ prayukta iti lobhaḥ pṛthaṅ noktaḥ |	tRzNA--sAmAnya-aBiprAyeNa kAma--SabdaH prayuktaH iti loBaH pRTak na-uktaH |
   evam ātmanaḥ pratikūleṣu duḥkha-hetuṣu dṛśyamāneṣu śrūyamāṇeṣu vā	evam AtmanaH pratikUlezu duHKa-hetuzu dRSyamAnezu SrUyamANezu vA
   tad-doṣānusandhānābhyāsena yaḥprajvalanātmako dveṣo manyuḥ sa krodhaḥ |	tad--doza-anusanDAna-aByAsena yaH-prajvalana-AtmakaH dvezaH manyuH sa kroDaH |
   tayor utkaṭāvasthā loka-veda-virodha-pratisandhāna-pratibandhakatayā	tayoH utkawa-avasTA loka--veda--viroDa--pratisanDAna--pratibanDaka-tayA
   loka-veda-viruddha-pravṛtty-unmukhatva-rūpā nadī-vega-sāmyena vega ity	loka-veda--virudDa--pravRtti--unmuKa-tva--rUpA nadI--vega--sAmyena vegaH iti-
   ucyate | yathā hi nadyā vego varṣāsv atiprabalatayā	ucyate | yaTA hi nadyA vegaH varzAsu ati-prabala-tayA
   loka-veda-virodha-pratisandhānenānicchantam api garte pātayitvā majjayati	loka--veda--viroDa--pratisanDAn-ena-anicCantam api garte pAtayitvA majjayati
   cādho nayati ca, tathā kāma-krodhayor vego viṣayābhidhyānābhyāsena	ca-aDas nayati ca, taTA kAma--kroDayoH vegaH vizaya-aBiDyAna-aByAsena
   varṣā-kāla-sthānīyenātiprabalo loka-veda-virodha-pratisandhānenānicchantam	varzA--kAla--sTAnIyena-atiprabalaH loka--veda--viroDa--pratisanDAn-ena-anicCantam
   api viṣaya-garte pātayitvā saṃsāra-samudre majjayati cādho mahā-narakān	api vizaya--garte pAtayitvA saMsAra--samudre majjayati ca-aDas mahA--narakAn
   nayati ceti vega-pada-prayogeṇa sūcitam | etac cātha kena prayukto 'yam	nayati ca-iti vega-pada--prayogeNa sUcitam | etat ca-aTa kena prayuktaH ayam
   ity atra nivṛttam |	iti atra nivRttam |
   tam etādṛśaṃ kāma-krodhodbhavaṃ vegam antaḥkaraṇa-prakṣobha-rūpaṃ	tam etAdRSam kAma--kroDa-udBavam vegam antaHkaraNa--prakzoBa--rUpam
   stambha-svedādy-aneka-bāhya-vikāra-liṅgam ā-śarīra-vimokṣaṇāc	stamBa--sveda-Adi--aneka--bAhya--vikAra--liFgam A-SarIra-vimokzaNAt-
   charīra-vimokṣaṇa-paryantam aneka-nimitta-vaśāt sarvadā	CarIra--vimokzaNa--paryantam aneka--nimitta--vaSAt sarvadA
   sambhāvyamānatvenāvisrambhaṇīyam antar utpanna-doṣa-darśanābhyāsajena	samBAvyamAna-tvena-avisramBaNIyam antar utpanna--doza--darSana-aByAsa-jena
   vaśīkāra-saṃjñaka-vairāgyeṇa soḍhuṃ tad-anurūpa-kāryāsampādanenānarthakaṃ	vaSIkAra--saMjQa-ka-vErAgyeNa soXum tad--anurUpa-kArya-asampAdanena-anarTakam
   kartuṃ śaknoti samartho bhavati, sa eva yukto yogī, sa eva sukhī, sa eva	kartum Saknoti samarTaH Bavati, saH eva yuktaH yogI, saH eva suKI, saH eva
   naraḥ pumān puruṣārtha-sampādanāt | tad-itaras tv	naraH pumAn puruza-arTa--sampAdanAt | tad--itaraH tu-
   āhāra-nidrā-bhaya-maithunādi-paśu-dharma-mātra-ratatvena manuṣyākāraḥ	AhAra--nidrA--Baya--mETuna-Adi--paSu--Darma--mAtra---rata-tvena manuzya-AkAraH
   paśur eveti bhāvaḥ |	paSuH eva-iti BAvaH |
   ā-śarīra-vimokṣaṇād ity atrānyad vyākhyānam - yathā maraṇād ūrdhvaṃ	A-SarIra-vimokzaNAt iti atra-anyat vyAKyAnam  yaTA maraNAt UrDvam
   vilapantībhir yuvatībhir āliṅgyamāno 'pi putrādibhir dahyamāno 'pi	vilapantIBiH yuvatIBiH AliFgyamAnaH api putra-AdiBiH dahyamAnaH api
   prāṇa-śūnyatvāt kāma-krodha-vegaṃ sahate, tathā maraṇāt prāg api jīvann	prANa--SUnya-tvAt kAma---kroDa--vegam sahate, taTA maraNAt prAk api jIvan=-
   eva yaḥ sahate sa yukta ity ādi | atra yadi maraṇavaj jīvane 'pi	eva yaH sahate sa yuktaH iti Adi | atra yadi maraNa-vat jIvane api
   kāma-krodhānutpatti-mātraṃ brūyāt tadaitad yujyate | yathoktaṃ vaśiṣṭhena	kAma--kroDa-anutpatti--mAtram brUyAt tadA-etat yujyate | yaTA-uktam vaSizWena
   prāṇe gate yathā dehaḥ sukhaṃ duḥkhaṃ na vindati |	prANe gate yaTA dehaH suKam duHKam na vindati |
   tathā cet prāṇa-yukto 'pi sa kaivalyāśrame vaset || iti |	taTA ced prANa-yuktaH api sa kEvalya-ASrame vaset || iti |
   iha tūpannayoḥ kāma-krodhayor vega-sahane prastute tayor anutpatti-mātraṃ	iha tu-upannayoH kAma--kroDayoH vega--sahane prastute tayoH anutpatti--mAtram
   na dārṣṭānta iti kim atinirbandhena ||23||	na dArzwa-antaH iti kim ati-nirbanDena ||23||
   viśvanāthaḥ : saṃsāra-sindhau patito 'py eṣa eva yogī eṣa eva sukhīty āha	viSvanATaH : saMsAra--sinDO patitaH api ezaH eva yogI ezaH eva suKI-iti Aha
   śaknotīti ||23||	Saknoti-iti ||23||
   baladevaḥ : śaknotīhaiva yaḥ soḍhuṃ prāk śarīra-vimokṣaṇāt |	baladevaH : Saknoti-iha-eva yaH soXum prAk SarIra-vimokzaNAt |
   kāma-krodhodbhavaṃ vegaṃ sa yuktaḥ sa sukhī naraḥ ||23||	kAma--kroDa-udBavam vegam sa yuktaH sa suKI naraH ||23||
   BhG 5.24	Bhu 5.24
   yo 'ntaḥ-sukho 'ntarārāmas tathāntar-jyotir eva yaḥ |	yaH antaH--suKaH antara-ArAmaH taTA-antar-jyotiH eva yaH |
   sa yogī brahma-nirvāṇaṃ brahma-bhūto 'dhigacchati ||24||	sa yogI brahma--nirvANam brahma-BUtaH aDigacCati ||24||
   śrīdhara : na kevalaṃ kāma-krodha-vega-saṃharaṇa-mātreṇa mokṣaṃ prāpnoti |	SrIDara : na kevalam kAma---kroDa--vega--saMharaNa--mAtreNa mokzam prApnoti |
   api tu yo 'ntaḥ-sukha iti | antarātmany eva sukhaṃ yasya | na viṣayeṣu |	api tu yaH antaH--suKaH iti | antarAtmani eva suKam yasya | na vizayezu |
   antar evārāma ākrīḍā yasya na bahiḥ | antar eva jyotir dṛṣṭir yasya | na	antar eva-ArAmaH AkrIxA yasya na bahis | antar eva jyotiH dRzwiH yasya | na
   gīta-nṛtyādiṣu | sa evaṃ brahmaṇi bhūtaḥ sthitaḥ san brahmaṇi nirvāṇaṃ	gIta-nRtya-Adizu | saH evam brahmaNi BUtaH sTitaH san brahmaNi nirvANam
   layam adhigacchati prāpnoti ||24||	layam aDigacCati prApnoti ||24||
   madhusūdanaḥ : kāma-krodha-vega-sahana-mātreṇaiva mucyante iti na, kintu	maDusUdanaH : kAma---kroDa--vega--sahana--mAtreNa-eva mucyante iti na, kintu
   yo 'ntar iti |	yaH antar iti |
   antar-bāhya-viṣaya-nirapekṣam eva svarūpa-bhūtaṃ sukhaṃ yasya so	antar--bAhya--vizaya--nirapekzam eva svarUpa-BUtam suKam yasya saH-
   'ntaḥ-sukho bāhya-viṣaya-janita-sukha-śūnya ity arthaḥ | kuto	antaH--suKaH bAhya--vizaya-janita--suKa--SUnyaH iti arTaH | kuto
   bāhya-sukhābhāvas tatrāha antar ātmany eva na tu stry-ādi-viṣaye	bAhya--suKa-aBAvaH tatra-Aha antar Atmani eva na tu strI--Adi-vizaye
   bāhya-sukha-sādhana ārāma āramaṇaṃ krīḍā yasya so 'ntar-ārāmas	bAhya--suKa--sADanaH ArAmaH AramaNam krIxA yasya saH antar-ArAmas
   tyakta-sarva-parigrahatvena bāhya-sukha-sādhana-śūnya ity arthaḥ |	tyakta--sarva--parigraha-tvena bAhya--suKa--sADana--SUnyaH iti arTaH |
   nanu tyakta-sarva-parigrahasyāpi yater yadṛcchopanataiḥ	nanu tyakta--sarva--parigrahasya-api yateH yadRcCA-upanatEH
   kokilādi-madhura-śabda-śravaṇa-manda-pavana-sparśana-candrodaya-mayūra-nṛtyādi-darśanāti-madhura-śītala-gaṅgodaka-pāna-ketakī-kusuma-saurabhādy-avaghrāṇādibhir	kokila-Adi-maDura--Sabda--SravaNa-manda-pavana--sparSana--candra-udaya--mayUra-nRtya-Adi--darSana-ati-maDura-SItala-gaFgA-udaka--pAna--ketakI--kus
   grāmyaiḥ sukhotpatti-sambhavāt kathaṃ bāhya-sukha-tat-sādhana-śūnyatvam	grAmyEH suKa-utpatti--samBavAt kaTam bAhya--suKa--tat-sADana--SUnya-tvam
   iti tatrāha tathāntar-jyotir eva yaḥ | yathāntar eva sukhaṃ na bāhyair	iti tatra-Aha taTA-antar-jyotiH eva yaH | yaTA-antar eva suKam na bAhyEH-
   viṣayais tathāntar evātmani jyotir vijñānaṃ na bāhyair indriyair yasya so	vizayEH taTA-antar eva-Atmani jyotiH vijQAnam na bAhyEH indriyEH yasya saH-
   'ntar-jyotiḥ śrotrādi-janya-śabdādi-viṣaya-vijñāna-rahitaḥ | eva-kāro	antar-jyotiH Srotra-Adi-janya--Sabda-Adi--vizaya--vijQAna--rahitaH | eva-kAraH-
   viśeṣaṇa-traye 'pi sambadhyate | samādhi-kāle śabdādi-pratibhāsābhāvād	viSezaNa--traye api sambaDyate | samADi-kAle Sabda-Adi--pratiBAsA-BAvAt-
   vyutthāna-kāle tat-pratibhāse 'pi mithyātva-niścayān na bāhya-viṣayais	vyutTAna--kAle tat--pratiBAse api miTyA-tva--niScayAt na bAhya--vizayEH-
   tasya sukhotpatti-sambhava ity arthaḥ |	tasya suKa-utpatti--samBavaH iti arTaH |
   ya evaṃ yathokta-viśeṣaṇa-sampannaḥ sa yogī samāhito brahma-nirvāṇaṃ	yaH evam yaTA-ukta--viSezaNa--sampannaH sa yogI samAhitaH brahma--nirvANam
   brahma paramānanda-rūpaṃ kalpita-dvaitopaśama-rūpatvena nirvāṇaṃ tad eva,	brahma parama-Ananda-rUpam kalpita-dvEta-upaSama--rUpa-tvena nirvANam tat eva,
   kalpita-bhāvasyādhiṣṭhānātmakatvāt | avidyāvaraṇa-nivṛttyādhigacchati	kalpita-BAvasya-aDizWAna-Atmaka-tvAt | avidyA-AvaraNa--nivRttyA-aDigacCati
   nitya-prāptam eva prāpnoti | yataḥ sarvadaiva brahma-bhūto nānyaḥ |	nitya--prAptam eva prApnoti | yatas sarvadA-eva brahma--BUtaH na-anyaH |
   brahmaiva san brahmāpy eti iti śruteḥ | avasthiter iti kāśa-kṛtsnaḥ iti	brahma-eva san brahmA-api eti iti SruteH | avasTiteH iti kASa-kRtsnaH iti
   nyāyāc ca ||24||	nyAyAt ca ||24||
   viśvanātha - yas tu saṃsārātītas tasya tu brahmānubhava eva sukham ity āha	viSvanATaH  yaH tu saMsAra-atItaH tasya tu brahma-anuBavaH eva suKam iti Aha
   ya iti | antarātmany eva sukhaṃ yasya saḥ | yato 'ntarātmany eva ramate,	yaH iti | antarAtmani eva suKam yasya saH | yatas antarAtmani eva ramate,
   ato 'ntarātmany eva jyotir dṛṣṭir yasya saḥ ||24||	atas antarAtmani eva jyotiH dRzwiH yasya saH ||24||
   baladeva - yat prītyā taṃ soḍhuṃ śaktas tad āha yo 'ntar iti |	baladeva  yat prItyA tam soXum SaktaH tat Aha yaH antar iti |
   antarvartinānubhūtenātmanā sukhaṃ yasya saḥ, tenaivārāmaḥ krīḍā yasya saḥ	antarvartinA-anuBUtena-AtmanA suKam yasya saH, tena-eva-ArAmaH krIxA yasya saH
   | tasminn eva jyotir dṛṣṭir yasya saḥ | īdṛśo yogī niṣkāma-karmī	| tasmin eva jyotiH dRzwiH yasya saH | IdRSaH yogI nizkAma--karmI
   brahma-bhūto labdha-śuddha-jaiva-svarūpo brahmādhigacchati paramātmānaṃ	brahma-BUtaH labDa--SudDa--jA-eva--svarUpaH brahma-aDigacCati paramAtmAnam
   labhate | nirvāṇaṃ mokṣa-rūpaṃ tenaiva tal-lābhāt ||24||	laBate | nirvANam mokza--rUpam tena-eva tal-lABAt ||24||
   BhG 5.25	Bhu 5.25
   labhante brahma-nirvāṇam ṛṣayaḥ kṣīṇa-kalmaṣāḥ |	laBante brahma--nirvANam RzayaH kzINa-kalmazAH |
   chinna-dvaidhā yatātmānaḥ sarva-bhūta-hite ratāḥ ||25||	Cinna-dvEDAH yata-AtmAnaH sarva-BUta--hite ratAH ||25||
   śrīdharaḥ : kiṃ ca labhanta iti | ṛṣayaḥ samyag-darśinaḥ | kṣīṇaṃ kalmaṣaṃ	SrIDaraH : kim ca laBante iti | RzayaH samyak--darSinaH | kzINam kalmazam
   yeṣām | sarveṣāṃ bhūtānāṃ hite ratāḥ kṛpalavaḥ | te brahma-nirvāṇaṃ mokṣaṃ	yezAm | sarvezAm BUtAnAm hite ratAH kRpalavaH | te brahma--nirvANam mokzam
   labhante ||25||	laBante ||25||
   madhusūdanaḥ : mukti-hetor jñānasya sādhanāntarāṇi vivṛṇvann āha labhanta	maDusUdanaH : mukti-hetoH jQAnasya sADana-antarANi vivRNvan Aha laBanta
   iti | prathamaṃ yajñādibhiḥ kṣīṇa-kalmaṣāḥ | tato 'ntaḥkaraṇa-śuddhayā	iti | praTamam yajQa-AdiBiH kzINa-kalmazAH | tatas antaHkaraNa--SudDayA
   ṛṣayaḥ sūkṣma-vastu-vivecana-samarthāḥ saṃnyāsinaḥ | tataḥ	RzayaH sUkzma--vastu--vivecana--samarTAH saMnyAsinaH | tatas-
   śravaṇādi-paripākeṇa cchinna-dvaidhā nivṛtta-sarva-saṃśayāḥ | tato	SravaNa-Adi-paripAkeNa cCinna-dvEDAH nivRtta--sarva-saMSayAH | tatas-
   nididhyāsana-paripākeṇa saṃyatātmānaḥ paramātmany evaikāgra-cittāḥ |	nidiDi-Asana--paripAkeNa saMyata-AtmAnaH paramAtmani eva-ekAgra-cittAH |
   etādṛśāś ca dvaitādarśitvena sarva-bhūta-hite ratā hiṃsā-śūnyā brahma-vido	etAdRSAH ca dvEta-AdarSi-tvena sarva-BUta--hite ratA hiMsA--SUnyAH brahma-vidaH-
   brahma-nirvāṇaṃ labhante |	brahma--nirvANam laBante |
   yasmin sarvāṇi bhūtāni ātmaivābhūd vijānataḥ |	yasmin sarvANi BUtAni AtmA-eva-aBUt vijAnataH |
   tatra ko mohaḥ kaḥ śoka ekatvam anupaśyataḥ || iti śruteḥ |	tatra kaH mohaH kaH SokaH eka-tvam anupaSyataH || iti SruteH |
   bahu-vacanam, tad yo devānāṃ ity ādi-śruty-uktāniyama-pradarśanārtham	bahu-vacanam, tat yaH devAnAm iti Adi-Sruti--uktA-niyama--pradarSana-arTam
   viśvanāthaḥ : evaṃ bahava eva sādhana-siddhā bhavantīty āha labhanta iti	viSvanATaH : evam bahavaH eva sADana-sidDAH Bavanti-iti Aha laBante iti
   baladevaḥ : evaṃ sādhana-siddhā bahava bhavantīty āha labhanta iti |	baladevaH : evam sADana-sidDAH bahava Bavanti-iti Aha laBante iti |
   ṛṣayas tattva-draṣṭāraḥ | chinna-dvaidhā vinaṣṭ-saṃśayāḥ | sphuṭam anyat	RzayaH tattva--drazwAraH | Cinna-dvEDAH vinazw--saMSayAH | sPuwam anyat-
   BhG 5.26	Bhu 5.26
   kāma-krodha-viyuktānāṃ yatīnāṃ yata-cetasām |	kAma---kroDa--viyuktAnAm yatInAm yata--cetasAm |
   abhito brahma-nirvāṇaṃ vartate viditātmanām ||26||	aBitas brahma--nirvANam vartate vidita-AtmanAm ||26||
   śrīdharaḥ : kiṃ ca kāmety ādi | kāma-krodhābhyāṃ viyuktānām | yatīnāṃ	SrIDaraH : kim ca kAma-iti Adi | kAma--kroDAByAm viyuktAnAm | yatInAm
   saṃnyāsinām | saṃyata-cittānāṃ jñātātma-tattvānām abhita ubhayato jīvatāṃ	saMnyAsinAm | saMyata-cittAnAm jQAta-Atma--tattvAnAm aBitas uBayatas jIvatAm
   mṛtānāṃ ca | na dehānta eva teṣāṃ brahmaṇi layaḥ, api tu jīvatām api	mRtAnAm ca | na dehAntaH eva tezAm brahmaNi layaH, api tu jIvatAm api
   vartata ity arthaḥ ||26||	vartate iti arTaH ||26||
   madhusūdanaḥ : pūrvaṃ kāma-krodhayor utpannayor api vegaḥ soḍhavya ity	maDusUdanaH : pUrvam kAma--kroDayoH utpannayoH api vegaH soXavyaH iti-
   uktam adhunā tu tayor utpatti-pratibandha eva kartavya ity āha kāmeti |	uktam aDunA tu tayoH utpatti-pratibanDaH eva kartavyaH iti Aha kAma-iti |
   kāma-krodhayor viyogas tad-anutpattir eva tad-yuktānāṃ	kAma--kroDayoH viyogaH tad--anutpattiH eva tad--yuktAnAm
   kāma-krodha-viyuktānām | ataeva yata-cetasāṃ saṃyata-cittānāṃ yatīnāṃ	kAma---kroDa--viyuktAnAm | ataeva yata--cetasAm saMyata--cittAnAm yatInAm
   yatna-śīlānāṃ saṃnyāsināṃ viditātmanāṃ sākṣāt-kṛta-paramātmanām abhita	yatna--SIlAnAm saMnyAsinAm vidita-AtmanAm sAkzAt-kRta-paramAtmanAm aBita
   ubhayato jīvatāṃ mṛtānāṃ ca teṣāṃ brahma-nirvāṇaṃ mokṣo vartate nityatvāt,	uBayatas jIvatAm mRtAnAm ca tezAm brahma--nirvANam mokzaH vartate nitya-tvAt,
   na tu bhaviṣyati sādhyatvābhāvāt ||26||	na tu Bavizyati sADya-tva-aBAvAt ||26||
   viśvanāthaḥ : jñātas tvaṃ-padārtha-nāma-prāpta-paramātma-jñānānāṃ kiyatā	viSvanATaH : jQAtaH tvaM-pada-arTa--nAma--prApta-paramAtma--jQAnAnAm kiyatA
   kālena brahma-nirvāṇa-sukhaṃ syād ity apekṣāyām āha kāmeti | yata-cetasām	kAlena brahma-nirvANa--suKam syAt iti apekzAyAm Aha kAma-iti | yata--cetasAm
   uparata-manasāṃ kṣīṇa-liṅga-śarīrāṇām iti yāvat, abhitaḥ	uparata-manasAm kzINa--liFga--SarIrANAm iti yAvat, aBitas-
   sarvato-bhāvenaiva vartata eveti brahma-nirvāṇe tasya naivātivilambam iti	sarvato-BAvena-eva vartate eva-iti brahma--nirvANe tasya na-eva-ati-vilambam iti
   bhāvaḥ ||26||	BAvaH ||26||
   baladevaḥ : īdṛśān paramātmāpy anuvartata ity āha kāmeti | yatīnāṃ	baladevaH : IdRSAn paramAtmA-api anuvartate iti Aha kAma-iti | yatInAm
   prayatnavatāṃ tān abhito brahma vartata ity arthaḥ | yad uktaṃ -	prayatnavatAm tAn aBitas brahma vartate iti arTaH | yat uktam -
   darśana-dhyāna-saṃsparśair matsya-kūrma-vihaṅgamāḥ |	darSana--DyAna--saMsparSEH matsya--kUrma--vihaFgamAH |
   svāny apatyāni puṣṇanti tathāham api padmaja || iti ||26||	svAni apatyAni puzNanti taTA-aham api padmajaH || iti ||26||
   BhG 5.27-28	Bhu 5.27-28
   sparśān kṛtvā bahir bāhyāṃś cakṣuś caivāntare bhruvoḥ |	sparSAn kRtvA bahis bAhyAn cakzuH ca-eva-antare BruvoH |
   prāṇāpānau samau kṛtvā nāsābhyantara-cāriṇau ||27||	prANa-apAnO samO kRtvA nAsA-aByantara--cAriNO ||27||
   yatendriya-mano-buddhir munir mokṣa-parāyaṇaḥ |	yata-indriya--mano--budDiH muniH mokza-parAyaNaH |
   vigatecchā-bhaya-krodho yaḥ sadā mukta eva saḥ ||28||	vigata-icCA-Baya--kroDaH yaH sadA muktaH eva saH ||28||
   śrīdharaḥ : sa yogī brahma-nirvāṇam ity ādiṣu yogī mokṣam avāpnotīty uktam	SrIDaraH : sa yogI brahma--nirvANam iti Adizu yogI mokzam avApnoti-iti uktam
   | tam eva yogaṃ saṅkṣepeṇāha sparśān iti dvābhyām | bāhyā eva sparśā	| tam eva yogam saFkzepeNa-Aha sparSAn iti dvAByAm | bAhyAH eva sparSA
   rūpa-rasādayo viṣayāś cintitāḥ santo 'ntaḥ praviśanti | tāṃs	rUpa-rasa-AdayaH vizayAH cintitAH santaH antar praviSanti | tAn=-
   tac-cintā-tyāgena bahir eva kṛtvā | cakṣur bhruvor antare bhrū-madhya eva	tat--cintA--tyAgena bahis eva kRtvA | cakzuH BruvoH antare BrU-maDyaH eva
   kṛtvātyantaṃ netrayor nimīlane hi nidrayā mano līyate | unmīlane ca bahiḥ	kRtvA-atyantam netrayoH nimIlane hi nidrayA manaH lIyate | unmIlane ca bahis-
   prasarati | tad-ubhaya-doṣa-parihārārtham ardha-nimīlanena bhrū-madhye	prasarati | tad--uBaya--doza--parihAra-arTam arDa--nimIlanena BrU--maDye
   dṛṣṭiṃ nidhāyety arthaḥ | ucchvāsa-niḥśvāsa-rūpeṇa nāsikayor abhyantare	dRzwim niDAya-iti arTaH | ucCvAsa--niHSvAsa--rUpeNa nAsikayoH aByantare
   carantau prāṇāpānāv ūrdhvādho-gati-rodhena samau kṛtvā, kumbhakaṃ kṛtvety	carantO prANa-apAnO UrDva-aDas--gati--roDena samO kRtvA, kumBakam kRtvA-iti-
   arthaḥ | yad vā prāṇo 'yaṃ yathā na bhair niryāti yathā cāpāno 'ntar na	arTaH | yat vA prANaH ayam yaTA na BEH niryAti yaTA ca-apAnaH antar na
   praviśati, kintu nāsā-madhya eva dvāv api yathā caratas tathā mandābhyām	praviSati, kintu nAsA--maDye eva dvO api yaTA carataH taTA mandAByAm
   ucchvāsa-niḥśvāsābhyāṃ samau kṛtveti ||27||	ucCvAsa--niHSvAsAByAm samO kRtvA-iti ||27||
   yateti | anenopāyena yatāḥ saṃyatā indriya-mano-buddhayo yasya | mokṣa eva	yata-iti | anena-upAyena yatAH saMyatAH indriya-mano--budDayaH yasya | mokzaH eva
   param ayanaṃ prāpyaṃ yasya | ataeva vigatā icchā-bhaya-krodhā yasya |	param ayanam prApyam yasya | ataeva vigatAH icCA-Baya-kroDAH yasya |
   evaṃbhūto yo muniḥ sa sadā jīvann api mukta evety arthaḥ ||27-28||	evaMBUtaH yaH muniH sa sadA jIvan api muktaH eva-iti arTaH ||27-28||
   madhusūdanaḥ : pūrvam īśvarārpita-sarva-bhāvasya	maDusUdanaH : pUrvam ISvara-arpita--sarva-BAvasya
   karma-yogenāntaḥ-karaṇa-śuddhis tataḥ sarva-karma-saṃnyāsas tataḥ	karma---yogena-antaH--karaNa--SudDiH tatas sarva-karma--saMnyAsaH tatas-
   śravaṇādi-parasya tattva-jñānaṃ mokṣa-sādhanam udetīty uktam | adhunā sa	SravaNa-Adi-parasya tattva--jQAnam mokza--sADanam udeti-iti uktam | aDunA sa
   yogī brahma-nirvāṇam ity atra sūcitaṃ dhyāna-yogaṃ	yogI brahma-nirvANam iti atra sUcitam DyAna---yogam
   samyag-darśana-syāntaraṅga-sādhanaṃ vistareṇa vaktuṃ sūtra-sthānīyāṃs trīn	samyak--darSana-sya-antaraFga--sADanam vistareNa vaktum sUtra-sTAnIyAn trIn
   ślokān āha bhagavān | eteṣām eva vṛtti-sthānīyaḥ kṛtsnaḥ ṣaṣṭho 'dhyāyo	SlokAn Aha BagavAn | etezAm eva vRtti-sTAnIyaH kRtsnaH zazWaH aDyAyo
   bhaviṣyati | tatrāpi dvābhyāṃ saṅkṣepeṇa yoga ucyate | tṛtīyena tu	Bavizyati | tatra-api dvAByAm saFkzepeNa yogaH ucyate | tRtIyena tu
   tat-phalaṃ paramātma-jñānam iti vivekaḥ |	tat-Palam paramAtma--jQAnam iti vivekaH |
   sparśān śabdādīn bāhyān bahir bhavān api śrotrādi-dvārā	sparSAn Sabda-AdIn bAhyAn bahis BavAn api Srotra-Adi-dvArA
   tat-tad-ākārāntaḥ-karaṇa-vṛttibhir antaḥ-praviṣṭān punar bahir eva kṛtvā	tat--tad--AkAra-antaH-karaNa-vRttiBiH antaH--pravizwAn punar bahis eva kRtvA
   para-vairāgya-vaśena tat-tad-ākārāṃ vṛttim anutpādyety arthaḥ | yady eta	para-vErAgya--vaSena tat--tad--AkArAm vRttim anutpAdya-iti arTaH | yadi eta
   āntarā bhaveyus tadopāya-sahasreṇāpi bahir na syuḥ	AntarA BaveyuH tadA-upAya--sahasreNa-api bahis na syuH
   svabhāva-bhaṅga-prasaṅgāt | bāhyānāṃ tu rāga-vaśād antaḥ-praviṣṭānāṃ	svaBAva--BaFga--prasaFgAt | bAhyAnAm tu rAga--vaSAt antaH--pravizwAnAm
   vairāgyeṇa bahir gamanaṃ sambhavatīti vadituṃ bāhyān iti viśeṣaṇam | tad	vErAgyeNa bahis gamanam samBavati-iti vaditum bAhyAn iti viSezaNam | tat-
   anena vairāgyam uktvābhyāsam āha cakṣuś caivāntare bhruvoḥ kṛtvety	anena vErAgyam uktvA-aByAsam Aha cakzuH ca-eva-antare BruvoH kRtvA-iti-
   anuṣajyate | atyanta-nimīlane hi nidrākhyā layātmikā vṛttir ekā bhavet |	anuzajyate | atyanta--nimIlane hi nidrA-AKyA laya-AtmikA vRttiH ekA Bavet |
   prasāreṇa tu pramāṇa-viparyaya-viveka-vikalpa-smṛtayaś catasro	prasAreNa tu pramANa--viparyaya--viveka--vikalpa--smRtayaH catasraH-
   vikṣepātmikā vṛttayo bhaveyuḥ | pañcāpi tu vṛttayo niroddhavyā iti	vikzepa-AtmikAH vRttayaH BaveyuH | paQca-api tu vRttayaH nirodDavyAH iti
   ardha-nimīlanena bhrū-madhye cakṣuṣo nidhānam | tathā prāṇāpānau samau	arDa--nimIlanena BrU--maDye cakzuzaH niDAnam | taTA prANa-apAnO samO
   tulyāv ūrdhvādho-gati-vicchedena nāsābhyantara-cāriṇau kumbhakeṇa kṛtvā,	tulyO UrDva-aDas--gati-vicCedena nAsA-aByantara--cAriNO kumBakeNa kRtvA,
   anenopāyena yatāḥ saṃyatā indriya-mano-buddhayo yasya sa tathā |	anena-upAyena yatAH saMyatAH indriya-mano--budDayaH yasya sa taTA |
   mokṣa-parāyaṇaḥ sarva-viṣaya-virakto munir manana-śīlo bhavet |	mokza-parAyaNaH sarva--vizaya--viraktaH muniH manana--SIlaH Bavet |
   vigatecchā-bhaya-krodha iti vīrta-rāga-bhaya-krodha ity atra vyākhyātam |	vigata-icCA-Baya--kroDaH iti vIrta--rAga--Baya--kroDaH iti atra vyAKyAtam |
   etādṛśo yaḥ saṃnyāsī sadā bhavati mukta eva saḥ | na tu tasya mokṣaḥ	etAdRSaH yaH saMnyAsI sadA Bavati muktaH eva saH | na tu tasya mokzaH
   kartavyo 'sti | athavā ya etādṛśaḥ sa sadā jīvann api mukta eva ||27-28||	kartavyaH asti | aTavA yaH etAdRSaH sa sadA jIvan api muktaH eva ||27-28||
   viśvanāthaḥ : tad evam īśvarārpita-niṣkāma-karma-yogenāntaḥ-karaṇa-śuddhiḥ	viSvanATaH : tat evam ISvara-arpita--nizkAma--karma--yogena-antaH--karaNa--SudDiH
   | tato jñānaṃ tvaṃ-padārtha-viṣayakam | tatas tat-padārtha-jñānārthaṃ	| tatas jQAnam tvaM-pada-arTa--vizayakam | tatas tat-padArTa--jQAna-arTam
   bhaktiḥ | tad-uttha-jñānena guṇātītena brahmānubhava ity uktam | idānīṃ	BaktiH | tad--utTa--jQAnena guNa-atItena brahma-anuBavaH iti uktam | idAnIm
   niṣkāma-karma-yogena śuddhāntaḥkaraṇasyāṣṭāṅga-yogaṃ	nizkAma-karma--yogena SudDa-antaHkaraNasya-azwa-aFga--yogam
   brahmānubhava-sādhanaṃ jñāna-yogād apy utkṛṣṭatvena ṣaṣṭhādhyāye vaktuṃ	brahma-anuBava--sADanam jQAna--yogAt api utkRzwa-tvena zazWa-aDyAye vaktum
   tat-sūtra-rūpaṃ śloka-trayam āha sparśān iti | bāhyā eva	tat--sUtra-rUpam Sloka-trayam Aha sparSAn iti | bAhyAH eva
   śabda-sparśa-rūpa-rasa-gandhāḥ sparśa-śabda-vācyāḥ | manasi praviśya ye	Sabda--sparSa--rUpa-rasa-ganDAH sparSa--Sabda--vAcyAH | manasi praviSya ye
   vartante tān, tasmān manasaḥ sakāśād bahiṣkṛtya viṣayebhyo manaḥ	vartante tAn, tasmAt manasaH sakASAt bahizkRtya vizayeByaH manaH
   pratyāhṛtyety arthaḥ | cakṣuṣī ca bhruvor antare madhye kṭvā netrayoḥ	pratyAhRtya-iti arTaH | cakzuzI ca BruvoH antare maDye kwvA netrayoH
   sampūrṇa-nimīlane nidrayā mano līyata unmīlanena bahiḥ prasarati |	sampUrNa--nimIlane nidrayA manaH lIyate unmIlanena bahis prasarati |
   tad-ubhaya-doṣa-parihārārtham ardha-nimīlanena bhrū-madhye dṛṣṭiṃ	tad--uBaya--doza--parihAra-arTam arDa--nimIlanena BrU--maDye dRzwim
   nidhāyocchvāsa-niśvāsa-rūpeṇa nāsikayor abhyantare carantau prāṇāpānāv	niDAya-ucCvAsa--niSvAsa--rUpeNa nAsikayoH aByantare carantO prANa-apAnO=-
   ūrdhvādho-gati-nirodhena samau kṛtvā | yatā vaśīkṛtā indriyādayo yena saḥ	UrDva-aDas--gati--niroDena samO kRtvA | yatAH vaSIkRtAH indriya-AdayaH yena saH
   baladevaḥ : atha karmaṇā niṣkāmeṇa viśuddha-manāḥ samuditātma-jñānas	baladevaH : aTa karmaNA nizkAmeNa viSudDa-manAH samudita-Atma--jQAna-s
   tad-darśanāya samādhiṃ kuryād iti sāṅgaṃ yogaṃ sūcayann āha sparśān iti |	tad--darSanAya samADim kuryAt iti sAFgam yogam sUcayan Aha sparSAn iti |
   sparśā śabdādayo viṣayās te bāhyā eva smṛtāḥ santo manasi praviśanti |	sparSA Sabda-AdayaH vizayAH te bAhyAH eva smRtAH santaH manasi praviSanti |
   tāṃs tat-smṛti-parityāgena bahiṣkṛtya viṣayebhyo manaḥ pratyāhṛtyety	tAn tat-smRti--parityAgena bahizkRtya vizayeByaH manaH pratyAhRtya-iti-
   arthaḥ | bhruvor antare madhye cakṣuś ca kṭvā netrayoḥ saṃnimīlane nidrayā	arTaH | BruvoH antare maDye cakzuH ca kwvA netrayoH saMnimIlane nidrayA
   manaso layaḥ | pronmīlane ca bahis tasya prasāraḥ syāt |	manasaH layaH | pronmIlane ca bahis tasya prasAraH syAt |
   tad-ubhaya-vinivṛttaye 'rdha-nimīlanena bhrū-madhye dṛṣṭiṃ nidhāyety	tad--uBaya--vinivRttaye arDa--nimIlanena BrU--maDye dRzwim niDAya-iti-
   arthaḥ | tathā nāsābhyantara-cāriṇau prāṇāpānāv ūrdhvādho-gati-nirodhena	arTaH | taTA nAsA-aByantara--cAriNO prANa-apAnO UrDva-aDas--gati--niroDena
   samau tulyau kṛtvā kumbhayitvety arthaḥ | etenopāyena yatā ātmāvalokanāya	samO tulyO kRtvA kumBayitvA-iti arTaH | etena-upAyena yatAH Atma-avalokanAya
   sthāpitā indriyādayo yena saḥ | munir ātma-manana-śīlaḥ | mokṣa-parāyaṇo	sTApitAH indriya-AdayaH yena saH | muniH Atma-manana--SIlaH | mokza--parAyaNaH-
   mokṣaika-prayojanaḥ | ato vigatecchādiḥ | īdṛśo yaḥ sarvadā phala-kālavat	mokza-eka--prayojanaH | atas vigata-icCA-AdiH | IdRSaH yaH sarvadA Pala-kAla-vat-
   sādhana-kāle 'pi mukta eva ||27-28||	sADana--kAle api muktaH eva ||27-28||
   BhG 5.29	Bhu 5.29
   bhoktāraṃ yajña-tapasāṃ sarva-loka-maheśvaram |	BoktAram yajQa--tapasAm sarva-loka--maheSvaram |
   suhṛdaṃ sarva-bhūtānāṃ jñātvā māṃ śāntim ṛcchati ||29||	suhRdam sarva-BUtAnAm jQAtvA mAm SAntim RcCati ||29||
   śrīdharaḥ : nanv evam indriyādi-saṃyamana-mātreṇa kathaṃ muktiḥ syāt ? na	SrIDaraH : nanu evam indriya-Adi--saMyamana--mAtreNa kaTam muktiH syAt ? na
   tan-mātreṇa, kintu jñāna-dvāreṇety āha bhoktāram iti | yajñānāṃ tapasāṃ	tan--mAtreNa, kintu jQAna-dvAreNa-iti Aha BoktAram iti | yajQAnAm tapasAm
   caiva mama bhaktaiḥ samarpitānāṃ yadṛcchayā bhoktāraṃ pālakam iti vā |	ca-eva mama BaktEH samarpitAnAm yadRcCayA BoktAram pAlakam iti vA |
   sarveṣāṃ lokānāṃ mahāntam īśvaram | sarva-bhūtānāṃ suhṛdaṃ	sarvezAm lokAnAm mahAntam ISvaram | sarva-BUtAnAm suhRdam
   nirapekṣopakāriṇam | antaryāmiṇaṃ māṃ jñātvā mat-prasādena śāntiṃ mokṣam	nirapekza-upakAriNam | antaryAmiNam mAm jQAtvA mat--prasAdena SAntim mokzam
   ṛcchati prāpnoti ||29||	RcCati prApnoti ||29||
   vikalpa-śaṅkāpohena yenaivaṃ sāṅkhya-yogayoḥ |	vikalpa--SaFkA-apohena yena-evam sAFKya--yogayoH |
   samuccayaḥ krameṇoktaḥ sarvajñaṃ naumi taṃ harim ||	samuccayaH krameNa-uktaH sarvajQam nOmi tam harim ||
   iti śrī-śrīdhara-svāmi-kṛtāyāṃ bhagavad-gītā-ṭīkāyāṃ subodhinyāṃ	iti SrI--SrIDara-svAmi-kRtAyAm Bagavat--gItA-a-wIkAyAm su-boDinyAm
   saṃnyāsa-yogo nāma pañcamo 'dhyāyaḥ	saMnyAsa-yogaH nAma paQcamaH aDyAyaH
   madhusūdanaḥ : evaṃ yoga-yuktaḥ kiṃ jñātvā mucyata iti tadāha bhoktāram	maDusUdanaH : evam yoga--yuktaH kim jQAtvA mucyate iti tat-Aha BoktAram
   iti | sarveṣāṃ yajñānāṃ tapasāṃ ca kartṛ-rūpeṇa devatā-rūpeṇa ca bhoktāraṃ	iti | sarvezAm yajQAnAm tapasAm ca kartR---rUpeNa devatA--rUpeNa ca BoktAram
   bhoga-kartāraṃ pālakam iti vā | bhuja pālanābhyavahārayoḥ iti dhātuḥ |	Boga-kartAram pAlakam iti vA | Buja pAlana-aByavahArayoH iti DAtuH |
   sarveṣāṃ lokānāṃ mahāntam īśvaraṃ hiraṇyagarbhādīnām api niyantāram |	sarvezAm lokAnAm mahAntam ISvaram hiraNyagarBa-AdInAm api niyantAram |
   sarveṣāṃ prāṇināṃ suhṛdaṃ pratyupakāra-nirapekṣatayopakāriṇaṃ	sarvezAm prANinAm suhRdam pratyupakAra--nirapekza-tayA-upakAriNam
   sarvāntgaryāmiṇaṃ sarva-bhāsakaṃ paripūrṇa-sac-cid-ānanadaika-rasaṃ	sarva-antgaryAmiNam sarva-BAsakam paripUrNa--sac-cit--a-Ananada-eka-rasam
   paramārtha-satyaṃ sarvātmānaṃ nārāyaṇaṃ māṃ jñātvātmatvena sākṣātkṛtya	parama-arTa--satyam sarva-AtmAnam nArAyaNam mAm jQAtvA-Atma-tvena sAkzAtkRtya
   śāntiṃ sarva-saṃsāroparatiṃ muktim ṛcchati prāpnotīty arthaḥ | tvāṃ	SAntim sarva-saMsAra-uparatim muktim RcCati prApnoti-iti arTaH | tvAm
   paśyann api kathaṃ nāhaṃ mukta ity āśaṅkyānirākaraṇāya viśeṣaṇāni |	paSyan api kaTam na-aham muktaH iti ASaFkya-anirAkaraNAya viSezaNAni |
   ukta-rūpeṇaiva mama jñānaṃ mukti-kāraṇam iti bhāvaḥ ||29||	ukta--rUpeNa-eva mama jQAnam mukti-kAraNam iti BAvaH ||29||
   aneka-sādhanābhyāsa-niṣpannaṃ hariṇeritam |	aneka--sADana-aByAsa--nizpannam hariNA-Iritam |
   sva-svarūpa-parijñānaṃ sarveṣāṃ mukti-sādhanam ||5||	sva--svarUpa--parijQAnam sarvezAm mukti--sADanam ||5||
   iti	iti
   śrīmat-paramahaṃsa-parivrājakācārya-śrī-viśveśvara-sarasvatī-pāda-śiṣya-śrī-madhusūdana-sarasvatī-viracitāyāṃ	SrImat-paramahaMsa--parivrAjaka-AcArya--SrI--viSveSvara--sarasvatI--pAda--Sizya--SrI--maDusUdana--sarasvatI--viracitAyAm
   śrīmad-bhagavad-gītā-gūḍhārtha-dīpikāyām sva-svarūpa-parijñānaṃ nāma	SrI-mat--Bagavat--gItA--gUXa-arTa-dIpikAyAm sva-svarUpa-parijQAnam nAma
   pañcamo 'dhyāyaḥ ||5||	paQcamaH aDyAyaH ||5||
   viśvanāthaḥ : evambhūtasya yogino 'pi jñānina iva bhakty-utthena	viSvanATaH : evamBUtasya yoginaH api jQAninaH iva Bakti--utTena
   paramātma-jñānenaiva mokṣa ity āha bhoktāram iti | yajñānāṃ karmi-kṛtānāṃ	paramAtma--jQAnena-eva mokzaH iti Aha BoktAram iti | yajQAnAm karmi-kRtAnAm
   tapasāṃ ca jñāni-kṛtānāṃ bhoktāraṃ pālayitāram iti karmiṇāṃ jñānināṃ	tapasAm ca jQAni-kRtAnAm BoktAram pAlayitAram iti karmiNAm jQAninAm
   copāsyam | sarva-lokānāṃ maheśvaraṃ mahā-niyantāram antaryāminaṃ yoginām	ca-upAsyam | sarva--lokAnAm maheSvaram mahA--niyantAram antar-yAminam yoginAm
   upāsyam | sarva-bhūtānāṃ suhṛdaṃ kṛpayā sva-bhakta-dvārā	upAsyam | sarva-BUtAnAm suhRdam kRpayA sva-Bakta--dvArA
   sva-bhakty-upadeśena hita-kāriṇam iti bhaktānām upāsyaṃ māṃ jñātveti	sva-Bakti--upadeSena hita-kAriNam iti BaktAnAm upAsyam mAm jQAtvA-iti
   sattva-guṇa-maya-jñānena nirguṇasya mamānubhavāsambhavāt bhaktyāham ekayā	sattva--guNa-maya--jQAnena nirguNasya mama-anuBava-asamBavAt BaktyA-aham ekayA
   grāhyaḥ iti mad-ukteḥ | nirguṇayā bhaktyaiva yogī svopāsyaṃ paramātmānaṃ	grAhyaH iti mad--ukteH | nirguNayA BaktyA-eva yogI sva-upAsyam paramAtmAnam
   mām aparokṣānubhava-gocarīkṛtya śāntiṃ mokṣam ṛcchati prāpnoti ||29||	mAm aparokza-anuBava--gocarIkRtya SAntim mokzam RcCati prApnoti ||29||
   niṣkāma-karmaṇā jñānī yogī cātra vimucyate |	nizkAma-karmaNA jQAnI yogI ca-atra vimucyate |
   jñātvātma-paramātmānāv ity adhyāyārtha īritaḥ ||	jQAtvA-Atma-paramAtmAnO iti aDyAya-arTaH IritaH ||
   iti sārārtha-darśinyāṃ harṣiṇyāṃ bhakta-cetasām |	iti sAra-arTa-darSinyAm harziNyAm Bakta--cetasAm |
   gītāsu pañcamo 'dhyāyaḥ saṃgataḥ saṅgataḥ satām ||5||	gItAsu paQcamaH aDyAyaH saMgataH saFgataH satAm ||5||
   baladevaḥ : evaṃ samādhi-sthaḥ kṛta-svātmāvalokanaḥ paramātmānam upāsyam	baladevaH : evam samADi--sTaH kRta-sva-Atma-avalokanaH paramAtmAnam upAsyam
   ucyata ity āha bhoktāram iti | yajñānāṃ tapasāṃ ca bhoktāraṃ pālakam |	ucyate iti Aha BoktAram iti | yajQAnAm tapasAm ca BoktAram pAlakam |
   sarveṣāṃ lokānāṃ vidhi-rudrādīnām api maheśvaram | tam īśvarāṇāṃ paramaṃ	sarvezAm lokAnAm viDi-rudra-AdInAm api maheSvaram | tam ISvarANAm paramam
   maheśvaraṃ [ŚvetU 6.7] ity ādi śravaṇāt | sarva-bhūtānāṃ suhṛdaṃ	maheSvaram [ŚvetU 6.7] iti Adi SravaNAt | sarva-BUtAnAm suhRdam
   nirapekṣopakārakam | īdṛśaṃ māṃ jñātvā svārādhyatayānubhūya śāntiṃ	nirapekzA-upakArakam | IdRSam mAm jQAtvA su-ArADyatayA-anuBUya SAntim
   saṃsāra-nivṛttim ṛcchati labhate | sarveśvarasya suhṛdaś ca samārādhanaṃ	saMsAra-nivRttim RcCati laBate | sarva-ISvarasya suhRdaH ca samArADanam
   khalu sukhāvahaṃ sukha-sādhanam iti ||29||	Kalu suKa-Avaham suKa--sADanam iti ||29||
   niṣkāma-karmaṇā yoga-śiraskena vimucyate |	nizkAma-karmaNA yoga--Siraskena vimucyate |
   sa-niṣṭho jñāna-garbheṇety eṣa pañcama-nirṇayaḥ ||	sa-nizWaH jQAna--garBeNa-iti eza paQcama--nirNayaH ||
   iti śrīmad-bhagavad-gītopaniṣad-bhāṣye pañcamo 'dhyāyaḥ	iti SrI-mat--Bagavat--gIta-upanizad--BAzye paQcamaH aDyAyaH
   pañcamo 'dhyāyaḥ sannyāsa-yogaḥ	paQcamaH aDyAyaH sannyAsa--yogaH
