   atha ṣaṣṭho 'dhyāyaḥ	aTa zazWaH aDyAyaH
   atha ṣaṣṭhādhyāyasya praśamaṃ brāhmaṇam	aTa zazWa-aDyAyasya praSamam brAhmaNam
   START BrhUp 6,1.1	START BrhUp 6,1.1
   yo ha vai jyeṣṭhaṃ ca śreṣṭhaṃ ca veda jyeṣṭhaś ca śreṣṭhaś ca svānāṃ	yaH ha vE jyezWam ca SrezWam ca veda jyezWaH ca SrezWaH ca svAnAm
   bhavati |	Bavati |
   prāṇo vai jyeṣṭhaś ca śreṣṭhaś ca |	prANaH vE jyezWaH ca SrezWaH ca |
   jyeṣṭhaś ca śreṣṭhaś ca svānāṃ bhavati |	jyezWaH ca SrezWaH ca svAnAm Bavati |
   api ca yeṣāṃ bubhūṣati |	api ca yezAm buBUzati |
   ya evaṃ veda || BrhUp_6,1.1 ||	yaH evam vedaH || BrhUp_6,1.1 ||
   BrhUpBh_6,1.1 oṃ prāṇo gāyatrītyuktam /	Brhu-upBh_6,1.1 om prANaH gAyatrI-iti-uktam /
   kasmātpunaḥ kāraṇātprāṇabhāvo gāyatryā na punarvāgādibhāva iti	kasmAt-punar kAraNAt-prANa-BAvaH gAyatryA na punar-vAc-Adi-BAvaH iti
   yasmājjyeṣṭhaśca śreṣṭhaśca prāṇo na vāgādayo jyaiṣṭhyaśraiṣṭhyabhājaḥ /	yasmAt-jyezWaH-ca SrezWaH-ca prANaH na vAc-AdayaH jyEzWya-SrEzWya-BAjaH /
   kathaṃ jyeṣṭhatvaṃ śreṣṭhatvaṃ ca prāṇasyoti	kaTam jyezWa-tvam SrezWa-tvam ca prANasya-uti
   tannirdidhārayiṣayedamārabhyate /	tat-nirdiDArayizayA-idam-AraByate /
   athavokthayajuḥ sāmakṣattrādibhāvaiḥ prāṇasyaivopāsanamabhihitaṃ	aTavA-ukTa-yajuH sAmakzattra-Adi-BAvEH prANasya-eva-upAsanam-aBihitam
   satsvapyanyeṣu cakṣurādiṣu /	satsu-api-anyezu cakzuH-Adizu /
   tatra hetumātramihā'nantaryeṇa saṃbadhyate /	tatra hetu-mAtram-ihA-anantaryeNa saMbaDyate /
   na punaḥ pūrvaśeṣatā /	na punar pUrva-Seza-tA /
   vivakṣitaṃ tu khilatvādasya kāṇḍasya pūrvatra yadanuktaṃ viśiṣṭaphalaṃ	vivakzitam tu Kila-tvAt-asya kANxasya pUrvatra yat-anuktam viSizwa-Palam
   prāṇaviṣayamupāsanaṃ tadvaktavyamiti /	prANa-vizayam-upAsanam tat-vaktavyam-iti /
   yaḥ kaściddha vā ityāvadhāraṇarchai /	yaH kaScid-ha vA iti-AvaDAraNaRCE /
   yo jyeṣṭhaśreṣṭhaguṇaṃ vakṣyamāṇaṃ yo vedāsau bhavatyeva jyeṣṭhaśca	yaH jyezWa-SrezWa-guNam vakzyamANam yaH vedAsO Bavati-eva jyezWaH-ca
   śreṣṭhaśca /	SrezWaH-ca /
   evaṃ phalena pralobhitaḥ sanpraśnāyāmukhībhūtastasmai cā'ha-prāṇo vai	evam Palena praloBitaH san-praSnAya-amuKIBUtaH-tasmE cA-aha--prANaH vE
   jyeṣṭhaśca śreṣṭhaśceti /	jyezWaH-ca SrezWaH-ca-iti /
   kathaṃ punaravagamyate prāṇo jyeṣṭhaśca śreṣṭhaśceti /	kaTam punar-avagamyate prANaH jyezWaH-ca SrezWaH-ca-iti /
   yasmānniṣekakāla eva śukraśoṇitasaṃmbandhaḥ prāṇādikalāpasyāviśiṣṭaḥ /	yasmAt-nizeka-kAle eva Sukra-SoNita-saMmbanDaH prANa-Adi-kalApasya-aviSizwaH /
   tathāpi nāprāṇaṃ śukraṃ virohatīti prathamo vṛttilābhaḥ prāṇasya	taTA-api na-aprANam Sukram virohati-iti praTamaH vRtti-lABaH prANasya
   cakṣurādibhyaḥ /	cakzuH-AdiByaH /
   ataḥ jyeṣṭho vayasā prāṇaḥ /	atas jyezWaH vayasA prANaH /
   niṣekakāladārabhya garbhaṃ puṣyati prāṇaḥ /	nizeka-kAladAraBya garBam puzyati prANaH /
   prāṇe hi labdhavṛttau paścāccakṣurādīnāṃ vṛttilābhaḥ /	prANe hi labDa-vRttO paScAt-cakzuH-AdInAm vRtti-lABaH /
   atoyuktaṃ prāṇasya jyeṣṭhatvaṃ cakṣurādiṣu /	atas-yuktam prANasya jyezWa-tvam cakzuH-Adizu /
   bhavati tu kaścitkule jyeṣṭho guṇahīnatvāttu na śreṣṭhaḥ /	Bavati tu kaScid-kule jyezWaH guNa-hIna-tvAt-tu na SrezWaH /
   madhyamaḥ kaniṣṭho vā guṇāḍhyatvādbhavecchreṣṭho na jyeṣṭhaḥ /	maDyamaH kanizWaH vA guNa-AXya-tvAt-Bavet-SrezWaH na jyezWaH /
   na tu tathehetyāha-prāṇa eva tu jyeṣṭhaśca śreṣṭhaśca /	na tu taTA-iha-iti-Aha--prANaH eva tu jyezWaH-ca SrezWaH-ca /
   kathaṃ punaḥ śraiṣṭhyamavagamyate prāṇasya tadiha saṃvādenadarśayiṣyāmaḥ /	kaTam punar SrEzWyam-avagamyate prANasya tat-iha saMvAdena-darSayizyAmaH /
   sarvathāpi tu prāṇaṃ jyeṣṭhaśreṣṭhaguṇaṃ yo vedopāste sa svānāṃ jñātīnāṃ	sarvaTA-api tu prANam jyezWa-SrezWa-guNam yaH veda-upAste sa svAnAm jQAtInAm
   jyeṣṭhaśca śreṣṭhaśca bhavati /	jyezWaH-ca SrezWaH-ca Bavati /
   jyeṣṭhaśreṣṭhaguṇopāsanasāmarthyātsvavyatirekeṇāpi ca yeṣāṃ madhye	jyezWa-SrezWa-guNa-upAsana-sAmarTyAt-su-a-vyatirekeNa-api ca yezAm maDye
   jyeṣṭhaśca śreṣṭhaśca bhaviṣyāmīti bubhūṣati bhavitumicchati teṣāmapi	jyezWaH-ca SrezWaH-ca BavizyAmi-iti buBUzati Bavitum-icCati tezAm-api
   jyeṣṭhaśreṣṭhaprāṇadarśī jyeṣṭhaśca śreṣṭhaśca bhavati /	jyezWa-SrezWa-prANa-darSI jyezWaH-ca SrezWaH-ca Bavati /
   nanu vayenimittaṃ jyeṣṭhatvaṃ tadicchātaḥ kathaṃ bhavatītyucyate /	nanu vayenimittam jyezWa-tvam tat-icCAtaH kaTam Bavati-iti-ucyate /
   naiṣa doṣaḥ /	na-eza dozaH /
   prāṇavadvṛttilābhasyaiva jyeṣṭhatvasya vivakṣitatvāt //1//	prANa-vat-vRtti-lABasya-eva jyezWa-tvasya vivakzita-tvAt //1//
   START BrhUp 6,1.2	START BrhUp 6,1.2
   yo ha vai vasiṣṭhāṃ veda vasiṣṭhaḥ svānāṃ bhavati |	yaH ha vE vasizWAm veda vasizWaH svAnAm Bavati |
   vāg vai vasiṣṭhā |	vAc vE vasizWAH |
   vasiṣṭhaḥ svānāṃ bhavati |	vasizWaH svAnAm Bavati |
   api ca yeṣāṃ bubhūṣati |	api ca yezAm buBUzati |
   ya evaṃ veda || BrhUp_6,1.2 ||	yaH evam vedaH || BrhUp_6,1.2 ||
   BrhUpBh_6,1.2 yo ha vai vasiṣṭhāṃ veda vasiṣṭhaḥ svānāṃ bhavati /	Brhu-upBh_6,1.2 yaH ha vE vasizWAm veda vasizWaH svAnAm Bavati /
   taddarśanānurūpeṇa phalam /	tad-darSana-anurUpeNa Palam /
   yeṣāṃ ca jñātivyatirekeṇa vasiṣṭho bhavitumicchati teṣāṃ ca vasiṣṭho	yezAm ca jQAti-vyatirekeNa vasizWaH Bavitum-icCati tezAm ca vasizWaH-
   bhavati /	Bavati /
   ucyatāṃ tarhi kāsau vasiṣṭheti /	ucyatAm tarhi kAsO vasizWa-iti /
   vāgvai vasiṣṭhā /	vAc-vE vasizWAH /
   vāsayatyatiśayena vaste veti vasiṣṭhā /	vAsayati-atiSayena vaH-te vA-iti vasizWAH /
   vāggmino hi dhanavanto vasantyatiśayena /	vAggminaH hi DanavantaH vasanti-atiSayena /
   ācchādanārthasya vā vaservasiṣṭhā /	AcCAdana-arTasya vA vaseH-vasizWAH /
   abhibhavanti hi vācā vāggmino 'nyān /	aBiBavanti hi vAcA vAggminaH anyAn /
   tena vasiṣṭhaguṇavatparijñānādvasiṣṭhaguṇo bhavatīti darśanānurūpaṃ phalam	tena vasizWa-guNavat-parijQAnAt-vasizWa-guNaH Bavati-iti darSana-anurUpam Palam
   START BrhUp 6,1.3	START BrhUp 6,1.3
   yo ha vai pratiṣṭhāṃ veda pratitiṣṭhati same |	yaH ha vE pratizWAm veda pratitizWati same |
   pratitiṣṭhati durge |	pratitizWati durge |
   cakṣur vai pratiṣṭhā |	cakzuH vE pratizWA |
   cakṣuṣā hi same ca durge ca pratitiṣṭhati |	cakzuzA hi same ca durge ca pratitizWati |
   pratitiṣṭhati same pratitiṣṭhati durge |	pratitizWati same pratitizWati durge |
   ya evaṃ veda || BrhUp_6,1.3 ||	yaH evam vedaH || BrhUp_6,1.3 ||
   BrhUpBh_6,1.3 yo ha vai pratiṣṭhāṃ veda pratitiṣṭhatyanayeti pratiṣṭhā tāṃ	Brhu-upBh_6,1.3 yaH ha vE pratizWAm veda pratitizWati-anayA-iti pratizWA tAm
   pratiṣṭhāṃ pratiṣṭhāguṇavatīṃ yo veda tasyaitatphalaṃ pratitiṣṭhati same	pratizWAm pratizWA-guNavatIm yaH veda tasya-etat-Palam pratitizWati same
   deśe kāle ca /	deSe kAle ca /
   tathā durge viṣame ca durgamane ca deśe durbhikṣādau vā kāle viṣame /	taTA durge vizame ca durgamane ca deSe durBikza-AdO vA kAle vizame /
   yadyevamucyatāṃ kāsau pratiṣṭhā /	yadi-evam-ucyatAm kAsO pratizWA /
   cakṣurvai pratiṣṭhā /	cakzuH-vE pratizWA /
   kathaṃ cakṣuṣaḥ pratiṣṭhātvamityāha-cakṣuṣā hi same ca durge dṛṣṭavā	kaTam cakzuzaH pratizWAtvam-iti-Aha--cakzuzA hi same ca durge dRzwavA
   pratitiṣṭhati /	pratitizWati /
   ato 'nurūpaṃ phalaṃ pratitiṣṭhati same pratitiṣṭhati durge ya evaṃ vedeti	atas anurUpam Palam pratitizWati same pratitizWati durge yaH evam veda-iti
   START BrhUp 6,1.4	START BrhUp 6,1.4
   yo ha vai saṃpadaṃ veda saṃ hāsmai padyate yaṃ kāmaṃ kāmayate |	yaH ha vE saMpadam veda sam ha-asmE padyate yam kAmam kAmayate |
   śrotraṃ vai saṃpat |	Srotram vE saMpad |
   śrotre hīme sarve vedā abhisaṃpannāḥ |	Srotre hi-ime sarve vedAH aBisaMpannAH |
   saṃ hāsmai padyate yaṃ kāmaṃ kāmayate |	sam ha-asmE padyate yam kAmam kAmayate |
   ya evaṃ veda || BrhUp_6,1.4 ||	yaH evam vedaH || BrhUp_6,1.4 ||
   BrhUpBh_6,1.4 yo ha vai sampadaṃ veda sampadguṇayuktaṃ yo veda	Brhu-upBh_6,1.4 yaH ha vE sampadam veda sampad-guNa-yuktam yaH veda
   tasyaitatphalamasmai viduṣe saṃpadyate ha /	tasya-etat-Palam-asmE viduze saMpadyate ha /
   kim /	kim /
   yaṃ kāmaṃ kāmayate sa kāmaḥ /	yam kAmam kAmayate sa kAmaH /
   kiṃ punaḥ saṃpadguṇakam /	kim punar saMpad-guNakam /
   śrotraṃ vai saṃpat /	Srotram vE saMpad /
   kathaṃ punaḥ śrotrasya saṃpadguṇatvamiti /	kaTam punar Srotrasya saMpad-guNa-tvam-iti /
   ucyate-śrotre sati hi yasmātsarve vedā abhisampannāḥ śrotrendriyavato	ucyate-Srotre sati hi yasmAt-sarve vedAH aBisampannAH Srotra-indriyavataH-
   'dhyeyatvāt /	aDyeya-tvAt /
   vedavihitakarmāyattāśca kāmāstasmācchrotraṃ saṃpat /	veda-vihita-karma-AyattAH-ca kAmAH-tasmAt-Srotram saMpad /
   ato vijñānānurūpaṃ phalam /	atas vijQAna-anurUpam Palam /
   saṃ hāsmai padyate yaṃ kāmaṃ kāmayate ya evaṃ veda //4//	sam ha-asmE padyate yam kAmam kAmayate yaH evam vedaH //4//
   START BrhUp 6,1.5	START BrhUp 6,1.5
   yo ha vā āyatanaṃ vedāyatanaṃ svānāṃ bhavaty āyatanaṃ janānām |	yaH ha vA Ayatanam veda-Ayatanam svAnAm Bavati Ayatanam janAnAm |
   mano vā āyatanam |	manaH vA Ayatanam |
   āyatanaṃ svānāṃ bhavaty āyatanaṃ janānām |	Ayatanam svAnAm Bavati Ayatanam janAnAm |
   ya evaṃ veda || BrhUp_6,1.5 ||	yaH evam vedaH || BrhUp_6,1.5 ||
   BrhUpBh_6,1.5 yo ha vā āyatanaṃ veda /	Brhu-upBh_6,1.5 yaH ha vA Ayatanam veda /
   āyatanamāśrayastadyo vedā'yatanaṃ svānāṃ bhavatyāyatanaṃ janānāmanyeṣāmapi	Ayatanam-ASrayaH-tat-yaH vedA-ayatanam svAnAm Bavati-Ayatanam janAnAm-anyezAm-api
   kiṃ punastadāyatanamiti /	kim punar-tat-Ayatanam-iti /
   ucyate-mano vā āyatanamāśraya indriyāṇāṃ viṣayāṇāṃ ca /	ucyate-manaH vA Ayatanam-ASrayaH indriyANAm vizayANAm ca /
   manaāśritā hi viṣayā ātmano bhogyatvaṃ pratipadyante /	manaA-ASritAH hi vizayAH AtmanaH Bogya-tvam pratipadyante /
   manaḥsaṃkalpavaśāni cendriyāṇi pravartante nivartante ca /	manaH-saMkalpa-vaSAni ca-indriyANi pravartante nivartante ca /
   ato mana āyatanamindriyāṇām /	atas manaH Ayatanam-indriyANAm /
   ato darśanānurūpeṇa phalamāyatanaṃ svānāṃ bhavatyāyatanaṃ janānāṃ ya evaṃ	atas darSana-anurUpeNa Palam-Ayatanam svAnAm Bavati-Ayatanam janAnAm yaH evam
   veda //5//	veda //5//
   START BrhUp 6,1.6	START BrhUp 6,1.6
   yo ha vai prajātiṃ veda prajāyate ha prajayā paśubhiḥ |	yaH ha vE prajAtim veda prajAyate ha prajayA paSuBiH |
   reto vai prajātiḥ |	retaH vE prajAtiH |
   prajāyate ha prajayā paśubhiḥ |	prajAyate ha prajayA paSuBiH |
   ya evaṃ veda || BrhUp_6,1.6 ||	yaH evam vedaH || BrhUp_6,1.6 ||
   BrhUpBh_6,1.6 yo ha vai prajātiṃ veda prajāyate ha prajayā paśubhiśca	Brhu-upBh_6,1.6 yaH ha vE prajAtim veda prajAyate ha prajayA paSuBiH-ca
   sampanno bhavati /	sampannaH Bavati /
   reto vai prajātiḥ /	retaH vE prajAtiH /
   retasā prajananendriyamupalakṣyate /	retasA prajanana-indriyam-upalakzyate /
   tadvijñānānurūpaṃ phalaṃ prajāyate ha prajayā paśubhirya evaṃ veda //6//	tad-vijQAna-anurUpam Palam prajAyate ha prajayA paSuBiH-yaH evam veda //6//
   START BrhUp 6,1.7	START BrhUp 6,1.7
   te heme prāṇā ahaṃśreyase vivadamānā brahma jagmuḥ |	te heme prANAH ahaMSreyase vivadamAnAH brahma jagmuH |
   tad dhocuḥ -- ko no vasiṣṭha iti |	tat DocuH - kaH naH vasizWaH iti |
   tad dhovāca -- yasmin va utkrānta idaṃ śarīraṃ pāpiyo manyate sa vo	tat DA-uvAca - yasmin vaH utkrAntaH idam SarIram pApiyaH manyate sa vaH-
   vasiṣṭha iti || BrhUp_6,1.7 ||	vasizWaH iti || BrhUp_6,1.7 ||
   BrhUpBh_6,1.7 te heme prāṇā vāgādayo 'haṃśreyase 'haṃ śreyānityetasmai	Brhu-upBh_6,1.7 te heme prANAH vAc-AdayaH ahaMSreyase aham SreyA-an-iti-etasmE
   prayojanāya vivadamānā biruddhaṃ vadamānā brahma jagmurbrahma gatavanto	prayojanAya vivadamAnA birudDam vadamAnAH brahma jagmuH-brahma gatavantaH-
   brahmaśabdavācyaṃ prajāpati gatvā ca tadbrahma hocuruktavantaḥ /	brahma-Sabda-vAcyam prajApati gatvA ca tat-brahma ha-UcuH-uktavantaH /
   ko no 'smākaṃ madhye vasiṣṭhaḥ ko 'smākaṃ madhye vasati ca vāsayati ca /	kaH naH asmAkam maDye vasizWaH kaH asmAkam maDye vasati ca vAsayati ca /
   tadbrahma taiḥ pṛṣṭaṃ saddhovācoktavadyasminvo yuṣmākaṃ madhya utkrānte	tat-brahma tEH pRzwam sadhA-uvAca-ukta-vat-yasmin-vaH yuzmAkam maDye utkrAnte
   nirgate śarīrādidaṃ śarīraṃ pūrvasmādatiśayena pāpīyaḥ pāpataraṃ manyate	nirgate SarIrAt-idam SarIram pUrvasmAt-atiSayena pApIyaH pApataram manyate
   lokaḥ /	lokaH /
   śarīraṃ hi nāmānekāśucisaṃdhātatvājjīvato 'pi pāpameva tato 'pi kaṣṭataraṃ	SarIram hi nAma-aneka-aSuci-saMDAta-tvAt-jIvataH api pApam-eva tatas api kazwataram
   yasminnutkrānte bhavati /	yasmin=-utkrAnte Bavati /
   vairāgyārthamidamucyate-pāpīya iti /	vErAgya-arTam-idam-ucyate--pApIyaH iti /
   sa vo yuṣmākaṃ madhye vasiṣṭho bhaviṣyati jānannapi vasiṣṭhaṃ	sa vaH yuzmAkam maDye vasizWaH Bavizyati jAnan=-api vasizWam
   prajāpatirtovācāyaṃ vasiṣṭha itītareṣāmapriyaparihārāya //7//	prajApatirta-uvAcAyam vasizWaH iti-itarezAm-apriya-parihArAya //7//
   START BrhUp 6,1.8	START BrhUp 6,1.8
   vāg ghoccakrāma |	vAc Ga-uccakrAma |
   sā saṃvatsaraṃ proṣyāgatyovāca -- katham aśakata mad ṛte jīvitum iti |	sA saMvatsaram prozya-Agatya-uvAca - kaTam aSakata mat Rte jIvitum iti |
   te hocuḥ -- yathākalā avadanto vācā prāṇantaḥ prāṇena paśyantaś cakṣuṣā	te ha-UcuH - yaTA-kalAH avadantaH vAcA prANantaH prANena paSyantaH cakzuzA
   śṛṇvantaḥ śrotreṇa vidvāṃso manasā prajāyamānā retasaivam ajīviṣmeti |	SRNvantaH SrotreNa vidvAMsaH manasA prajAyamAnAH retasA-evam ajIvizma-iti |
   praviveśa ha vāk || BrhUp_6,1.8 ||	praviveSa ha vAc || BrhUp_6,1.8 ||
   BrhUpBh_6,1.8 ta evamuktā brahmaṇā prāṇā ātmano vīryaparīkṣaṇāya	Brhu-upBh_6,1.8 te evam-uktA brahmaNA prANAH AtmanaH vIrya-parIkzaNAya
   krameṇoccakramuḥ /	krameNa-ucca-kramuH /
   tatra vāgeva prathamaṃ hāsmāccharīrāduccakrāmotkrāntavatī /	tatra vAc-eva praTamam ha-asmAt-SarIrAt-ucca-krAma-utkrAntavatI /
   sā cotkramya saṃvatsaraṃ proṣya proṣitā bhūtvā	sA ca-utkramya saMvatsaram prozya prozitA BUtvA
   punarāgatyovāca-kathamaśakata śaktavanto yūyaṃ madṛte māṃ vinā jīvitumiti	punar-Agatya-uvAca--kaTam-aSakata SaktavantaH yUyam mad-Rte mAm vinA jIvitum-iti
   ta evamuktā ūcuryathā loke 'kalā mūkā avadanto vācā prāṇantaḥ	te evam-uktAH UcuH-yaTA loke akalAH mUkAH avadantaH vAcA prANantaH
   prāṇanavyāpāraṃ kurvantaḥ prāṇena paśyanto darśanavyāpāraṃ cakṣuṣā	prANana-vyApAram kurvantaH prANena paSyantaH darSana-vyApAram cakzuzA
   kurvantastathā śṛṇvantaḥ śrotreṇa vidvāṃso manasā kāryākāryādiviṣayaṃ	kurvantaH-taTA SRNvantaH SrotreNa vidvAMsaH manasA kArya-akArya-Adi-vizayam
   prajāyamānā retasā putrānutpādayanta evamajīviṣma vayamityevaṃ	prajAyamAnAH retasA putrAn-utpAdayante evam-ajIvizma vayam-iti-evam
   prāṇairdattottarā vāgātmano 'sminnavasiṣṭhatvaṃ buddhvā praviveśa ha vāk	prANEH-datta-uttarA vAc-AtmanaH asmin=-avasizWa-tvam budDvA praviveSa ha vAc-
   START BrhUp 6,1.9-12	START BrhUp 6,1.9-12
   cakṣur hoccakrāma |	cakzuH ha-uccakrAma |
   tat saṃvatsaraṃ proṣyāgatyovāca -- katham aśakata mad ṛte jīvitum iti |	tat saMvatsaram prozya-Agatya-uvAca - kaTam aSakata mat Rte jIvitum iti |
   te hocuḥ -- yathāndhā apaśyantaś cakṣuṣā prāṇantaḥ prāṇena vadanto vācā	te ha-UcuH - yaTA-anDAH apaSyantaH cakzuzA prANantaH prANena vadantaH vAcA
   śṛṇvantaḥ śrotreṇa vidvāṃso manasā prajāyamānā retasaivam ajīviṣmeti |	SRNvantaH SrotreNa vidvAMsaH manasA prajAyamAnAH retasA-evam ajIvizma-iti |
   praviveśa ha cakṣuḥ || BrhUp_6,1.9 ||	praviveSa ha cakzuH || BrhUp_6,1.9 ||
   śrotraṃ hoccakrāma |	Srotram ha-uccakrAma |
   tat saṃvatsaraṃ proṣyāgatyovāca -- katham aśakata mad ṛte jīvitum iti |	tat saMvatsaram prozya-Agatya-uvAca - kaTam aSakata mat Rte jIvitum iti |
   te hocuḥ -- yathā badhirā aśṛṇvantaḥ śrotreṇa prāṇantaḥ prāṇena vadanto	te ha-UcuH - yaTA baDirAH aSRNvantaH SrotreNa prANantaH prANena vadantaH-
   vācā paśyantaś cakṣuṣā vidvāṃso manasā prajāyamānā retasaivam ajīviṣmeti |	vAcA paSyantaH cakzuzA vidvAMsaH manasA prajAyamAnAH retasA-evam ajIvizma-iti |
   praviveśa ha śrotram || BrhUp_6,1.10 ||	praviveSa ha Srotram || BrhUp_6,1.10 ||
   mano hoccakrāma |	manaH ha-uccakrAma |
   tat saṃvatsaraṃ proṣyāgatyovāca -- katham aśakata mad ṛte jīvitum iti |	tat saMvatsaram prozya-Agatya-uvAca - kaTam aSakata mat Rte jIvitum iti |
   te hocuḥ -- yathā mugdhā avidvāṃso manasā prāṇantaḥ prāṇena vadanto vācā	te ha-UcuH - yaTA mugDAH avidvAMsaH manasA prANantaH prANena vadantaH vAcA
   paśyantaś cakṣuṣā śṛṇvantaḥ śrotreṇa prajāyamānā retasaivam ajīviṣmeti |	paSyantaH cakzuzA SRNvantaH SrotreNa prajAyamAnAH retasA-evam ajIvizma-iti |
   praviveśa ha manaḥ || BrhUp_6,1.11 ||	praviveSa ha manaH || BrhUp_6,1.11 ||
   reto hoccakrāma |	retaH ha-uccakrAma |
   tat saṃvatsaraṃ proṣyāgatyovāca -- katham aśakata mad ṛte jīvitum iti |	tat saMvatsaram prozya-Agatya-uvAca - kaTam aSakata mat Rte jIvitum iti |
   te hocuḥ -- yathā klībā aprajāyamānā retāsā prāṇantaḥ prāṇena vadanto vācā	te ha-UcuH - yaTA klIbAH aprajAyamAnAH retAsA prANantaH prANena vadantaH vAcA
   paśyantaś cakṣuṣā śṛṇvantaḥ śrotreṇa vidvāṃso manasaivam ajīviṣmeti |	paSyantaH cakzuzA SRNvantaH SrotreNa vidvAMsaH manasA-evam ajIvizma-iti |
   praviveśa ha retaḥ || BrhUp_6,1.12 ||	praviveSa ha retaH || BrhUp_6,1.12 ||
   BrhUpBh_6,1.9-12 tathā cakṣurheccakrāmetyādi pūrvavat /	Brhu-upBh_6,1.9-12 taTA cakzuH-het-cakrAma-ityAdi pUrvavat /
   śrotraṃ manaḥ prajātirita //9-12 //	Srotram manaH prajA-atirita //9-12 //
   START BrhUp 6,1.13	START BrhUp 6,1.13
   atha ha prāṇa utkramiṣyan yathā mahāsuhayaḥ saindhavaḥ paḍvīśaśaṅkhūnt	aTa ha prANaH utkramizyan yaTA mahA-su-hayaH sEnDavaH paxvISa-SaFKUnt
   saṃvṛhed evaṃ haivemān prāṇānt saṃvavarha |	saMvRhet evam ha-eva-imAn prANAnt saMvavarha |
   te hocuḥ -- mā bhagava utkramīḥ |	te ha-UcuH - mA BagavaH utkramIH |
   na vai śakṣyāmas tvad ṛte jīvitum iti |	na vE SakzyAmaH tvat Rte jIvitum iti |
   tasyo me baliṃ kuruteti |	tasyaH me balim kuruta-iti |
   tatheti || BrhUp_6,1.13 ||	taTA-iti || BrhUp_6,1.13 ||
   BrhUpBh_6,1.13 atha ha prāṇa utkramiṣyannutkramamaṃ kariṣyaṃstadānīmeva	Brhu-upBh_6,1.13 aTa ha prANaH utkramizyan=-utkramamam karizyan=-tadAnIm-eva
   svasthānātpracalitā vāgādayaḥ /	sva-sTAnAt-pracalitA vAc-AdayaH /
   kimivetyāha-yathā loke mahāṃścāsau suhayaśca mahāsuhayaḥ śobhano hayo	kim-iva-iti-Aha-yaTA loke mahAn=-ca-asO suhayaH-ca mahAsu-hayaH SoBanaH hayaH-
   lakṣaṇopeto mahānparimāṇataḥ sindhudeśe bhavaḥ saindhavo 'bhijanataḥ	lakzaNa-upetaH mahAn-parimANataH sinDu-deSe BavaH sEnDavaH aBijanataH
   paḍvīśaśaṅkūnpādabandhanaśaṅkūnpaḍvīśāśca te śaṅkavaśca tān	paxvISa-SaFkUn-pAda-banDana-SaFkUn-paxvISAH-ca te SaFkavaH-ca tAn
   saṃvṛhedudyacchedyugapadutkhanedaśvāroha ārūḍhe parīkṣaṇāya /	saMvRhet-udyacCet-yugapad-utKanet-aSva-ArohaH ArUXe parIkzaNAya /
   evaṃ haivemānvāgādīnprāṇānsaṃvavarhedyatavānsvasthānādbhraṃśitavān /	evam ha-eva-ima-anvAc-AdIn-prANAn-saMvavarhet-yatavAn-sva-sTAnAt-BraMSitavAn /
   te vāgādayo hocurhe bhagavo bhagavanmotkramīryasmānnavai śakṣyāmastvadṛte	te vAc-AdayaH ha-UcuH-he BagavaH Bagavat-mA-utkram-IryasmAt-na-vE SakzyAmaH-tvad-Rte
   tvāṃ vinā jīvitumiti /	tvAm vinA jIvitum-iti /
   yadyevaṃ mama śreṣṭhatā vijñātā bhavadbhirahamatra śreṣṭhastasya u me mama	yadi-evam mama SrezWa-tA vijQAtA BavadBiH-aham-atra SrezWaH-tasya u me mama
   baliṃ karaṃ kuruta karaṃ prayacchateti /	balim karam kuruta karam prayacCata-iti /
   ayaṃ ca prāṇasamvādaḥ kalpito viduṣaḥ śreṣṭhaparīkṣaṇaprakāropadeśaḥ /	ayam ca prANa-samvAdaH kalpitaH viduzaH SrezWa-parIkzaNa-prakAra-upadeSaH /
   anena hi prakāreṇa vidvānko nu khalvatra śreṣṭha iti parīkṣaṇaṃ karoti /	anena hi prakAreNa vidvAn-kaH nu Kalu-atra SrezWaH iti parIkzaNam karoti /
   sa eṣa parīkṣaṇaprakāraḥ samvādabhūtaḥ kathyate /	saH eza parIkzaNa-prakAraH samvAda-BUtaH kaTyate /
   na hyanyathā saṃhatyakāriṇāṃ satāmeṣāmañjasaiva	na hi-anyaTA saMhatya-kAriNAm satAm-ezAm-aQjasA-eva
   saṃvatsaramātramevaikaikasya nirgamanādyupapadyate /	saMvatsara-mAtram-eva-ekEkasya nirgamana-Adi-upapadyate /
   tasmādvidvānevānena prakāreṇa vicārayati vāgādīnāṃ	tasmAt-vidvAn-eva-anena prakAreNa vicArayati vAc-AdInAm
   pradhānabubhutsurupāsanāya /	praDAna-buButsurupAsanAya /
   baliṃ prārthitāḥ santaḥ prāṇāstatheti pratijñātavantaḥ //13//	balim prArTitAH santaH prANAH-taTA-iti pratijQAtavantaH //13//
   START BrhUp 6,1.14	START BrhUp 6,1.14
   sā ha vāg uvāca -- yad vā ahaṃ vasiṣṭhāsmi tvaṃ tad vasiṣṭho 'sīti |	sA ha vAc uvAca - yat vE aham vasizWA-asmi tvam tat vasizWaH asi-iti |
   yad vā ahaṃ pratiṣṭhāsmi tvaṃ tat pratiṣṭho 'sīti cakṣuḥ |	yat vE aham pratizWA-asmi tvam tat pratizWaH asi-iti cakzuH |
   yad vā ahaṃ saṃpad asmi tvaṃ tat saṃpad asīti śrotram |	yat vE aham saMpad asmi tvam tat saMpad asi-iti Srotram |
   yad vā aham āyatanam asmi tvaṃ tad āyatanam asīti manaḥ |	yat vE aham Ayatanam asmi tvam tat Ayatanam asi-iti manaH |
   yad vā ahaṃ prajātir asmi tvaṃ tat prajātir asīti retaḥ |	yat vE aham prajAtiH asmi tvam tat prajAtiH asi-iti retaH |
   tasyo me kim annaṃ kiṃ vāsa iti |	tasyaH me kim annam kim vAsaH iti |
   yad idaṃ kiñcā śvabhya ā kṛmibhya ā kīṭapataṅgebhyas tat te 'nnam |	yat idam kiQcA SvaByaH A kRmiByaH A kIwa-pataFgeByaH tat te annam |
   āpo vāsa iti |	ApaH vAsaH iti |
   na ha vā asyānannaṃ jagdhaṃ bhavati nānannaṃ pratigṛhītaṃ ya evam etad	na ha vE asya-anannam jagDam Bavati na-anannam pratigRhItam yaH evam etat-
   anasyānnaṃ veda |	anasya-annam veda |
   tad vidvāṃsaḥ śrotriyā aśiṣyanta ācāmanty aśitvācāmanti |	tat vidvAMsaH SrotriyAH aSizyante AcAmanti aSitvA-AcAmanti |
   etam eva tad annam anagnaṃ kurvanto manyante || BrhUp_6,1.14 ||	etam eva tat annam anagnam kurvantaH manyante || BrhUp_6,1.14 ||
   BrhUpBh_6,1.14 sā ha vākprathamaṃ balidānāya pravṛttā ha kilovācoktavatī	Brhu-upBh_6,1.14 sA ha vAc-praTamam bali-dAnAya pravRttA ha kila-uvAcA-uktavatI
   yadvā ahaṃ vasiṣṭhāsmi yanmama vasiṣṭhatvaṃ tattavaiva tena vasiṣṭhaguṇena	yat-vA aham vasizWA-asmi yat-mama vasizWa-tvam tat-tava-eva tena vasizWa-guNena
   tvaṃ tadvasiṣṭho 'sīti /	tvam tad-vasizWaH asi-iti /
   yadvā ahaṃ pratiṣṭhāsmi tvaṃ tatpratiṣṭho 'si yā mama pratiṣṭhā sā	yat-vA aham pratizWA-asmi tvam tad-pratizWaH asi yA mama pratizWA sA
   tvamasīti /	tvam-asi-iti /
   cakṣuḥ /	cakzuH /
   samānamanyat /	samAnam-anyat /
   sampadāyatanaprajātitvagiṇānkrameṇa samarpitavantaḥ /	sampad-A-Ayatana-prajA-ati-tva-giNAn-krameNa samarpitavantaH /
   yadyevaṃ sādhu baliṃ dattavanto bhavanto brūta tasya u ma	yadi-evam sADu balim dattavantaH BavantaH brUta tasya u me-
   evaṅguṇaviśiṣṭasya kimannaṃ kiṃ vāsa iti /	evaFguNa-viSizwasya kim-annam kim vAsaH iti /
   āhuritare-yadidaṃ loke kiñca kiñcidannaṃ nāmāpyā śvabhya ā kṛmibhya ā	AhuH-itare-yat-idam loke kiQca kiQcid-annam nAma-apyA SvaByaH A kRmiByaH A
   kīṭapataṅgebhyaḥ /	kIwa-pataFgeByaH /
   yacca śvānnaṃ kṛbhyannaṃ kīṭapataṅgānnaṃ ca tena saha sarvameva	yat-ca Sva-annam kRByannam kIwa-pataFga-annam ca tena saha sarvam-eva
   yatkiñcitprāṇibhiradyamānamannaṃ tatsarvaṃ tavānnaṃ sarvaṃ prāṇasyānnamiti	yat-kiQcitprANiBiH-adyamAnam-annam tat-sarvam tava-annam sarvam prANasya-annam-iti
   dṛṣṭiratra vidhīyate /	dRzwiH-atra viDIyate /
   kecitu sarvabhakṣaṇe doṣābhāvaṃ vadanti prāṇānnavidaḥ /	kecitu sarva-BakzaNe doza-aBAvam vadanti prANAn-na-vidaH /
   tadasat /	tat-asat /
   śāsrāntareṇa pratiṣiddhatvāt /	SAsra-antareNa pratizidDa-tvAt /
   tenāsya vikalpa iti cet /	tena-asya vikalpaH iti ced /
   na /	na /
   avidhāyakatvāt /	aviDAyaka-tvAt /
   na ha vā asyānannaṃ jagdhaṃ bhavatīti sarvaṃ prāṇasyānnamityetasya	na ha vE asya-anannam jagDam Bavati-iti sarvam prANasya-annam-iti-etasya
   vijñānasya vihitasya stutyarthametat /	vijQAnasya vihitasya stuti-arTam-etat /
   tenaikavākyatāpatteḥ /	tena-eka-vAkyatA-ApatteH /
   na tu śāsrāntaravihitasya bādhane sāmarthyamanyaparatvādasya /	na tu SAsra-antara-vihitasya bADane sAmarTyam-anya-para-tvAt-asya /
   prāṇamātrasya sarvamannamityetaddarśanamihi vidhitsitaṃ na tu sarvaṃ	prANa-mAtrasya sarvam-annam-iti-etat-darSanam-ihi viDitsitam na tu sarvam
   bhakṣayediti /	Bakzayet-iti /
   yattu sarvabhakṣaṇe doṣābhāvajñānaṃ sanmithyaiva pramāṇābhāvāt /	yat-tu sarva-BakzaNe doza-aBAva-jQAnam sat-miTyA-eva pramANa-aBAvAt /
   viduṣaḥ prāṇatvātsarvānnopapatteḥ sāmarthyādadoṣa eveti cet /	viduzaH prANa-tvAt-sarvAn-na-upapatteH sAmarTyAt-adozaH eva-iti ced /
   na /	na /
   aśeṣānnatvānupapatteḥ /	aSezAn-na-tva-anupapatteH /
   satyaṃ yadyapi vidvānprāṇo yena kāryatakaraṇasaṃghātena viśiṣṭasya	satyam yadi-api vidvAn-prANaH yena kAryata-karaNa-saMGAtena viSizwasya
   vidvattā tena kāryakaraṇasaṃghātena kṛmikīṭadevādyaśeṣānnabhakṣaṇaṃ	vidvattA tena kArya-karaNa-saMGAtena kRmi-kIwa-deva-Adi-aSeza-anna-BakzaNam
   nopapadyate /	na-upapadyate /
   tena tatrāśeṣānnabhakṣaṇe doṣābhāvajñāpanamanarthakam /	tena tatra-aSeza-anna-BakzaNe doza-aBAva-jQApanam-anarTakam /
   aprāptatvādaśeṣānnabhakṣaṇadoṣasya /	aprApta-tvAt-aSeza-anna-BakzaNa-dozasya /
   nanu prāṇaḥ sanbhakṣayatyeva kṛmikīṭādyannamapi /	nanu prANaH san-Bakzayati-eva kRmi-kIwa-Adi-annam-api /
   bāḍham /	bAXam /
   kintu na tadviṣayaḥ pratiṣedho 'sti /	kintu na tad-vizayaH pratizeDaH asti /
   tasmāddaivaraktaṃ kiṃśukaṃ tatra doṣābhāvaḥ /	tasmAt-dEva-raktam kiMSukam tatra doza-aBAvaH /
   atastadrūpeṇa doṣābhāvajñāpanamanarthakam /	atas-tad-rUpeNa doza-aBAva-jQApanam-anarTakam /
   aprāptatvādaśeṣānnabhakṣaṇadeṣasya /	aprApta-tvAt-aSeza-anna-BakzaNa-dezasya /
   yena tu kāryakaraṇasaṃghātasambandhena pratiṣedhaḥ kriyate tatsambandhena	yena tu kArya-karaNa-saMGAta-sambanDena pratizeDaH kriyate tad-sambanDena
   tviha naiva pratiprasavo 'sti /	tu-iha na-eva pratiprasavaH asti /
   tasmāttatpratiṣedhātikrame doṣa eva syādanyaviṣayatvānna ha vā ityādeḥ /	tasmAt-tad-pratizeDa-atikrame dozaH eva syAt-anya-vizaya-tvAt-na ha vA iti-AdeH /
   na ca brāhmaṇādiśarīrasya sarvānnatvadarśanamiha vidhīyate kintu	na ca brAhmaNa-Adi-SarIrasya sarvAnna-tva-darSanam-iha viDIyate kintu
   prāṇamātrasyaiva /	prANa-mAtrasya-eva /
   yathā ca sāmānyena sarvānnasya prāṇasya kiñcidannajātaṃ	yaTA ca sAmAnyena sarva-annasya prANasya kiQcid-anna-jAtam
   kasyacijjīvanahetuḥ /	kasyacid-jIvana-hetuH /
   yathā viṣaṃ viṣajasya krimestadevānyasya prāṇānnamapi saddṛṣṭameva	yaTA vizam viza-jasya krimeH-tat-eva-anyasya prANa-annam-api sat-dRzwam-eva
   doṣamutpādayati maraṇādilakṣaṇam /	dozam-utpAdayati maraNa-Adi-lakzaNam /
   tathā sarvānnasyāpi prāṇasya pratiṣiddhānnabhakṣaṇe	taTA sarva-annasya-api prANasya pratizidDa-anna-BakzaNe
   brāhmaṇatvādidehasaṃbandhāddoṣa eva syāt /	brAhmaNa-tva-Adi-deha-saMbanDAt-dozaH eva syAt /
   tasmānmithyājñānamevābhakṣyabhakṣaṇe doṣābhāvajñānam /	tasmAt-miTyAjQAnam-eva-aBakzya-BakzaNe doza-aBAva-jQAnam /
   āpo vāsa ityāpo bhakṣamāṇā vāsaḥsthānīyāstava /	ApaH vAsaH iti-ApaH BakzamANAH vAsaH-sTAnIyAH-tava /
   atra ca prāṇasyā'po vāsa ityetaddarśanaṃ vidhīyate /	atra ca prANasyA-apaH vAsaH iti-etad-darSanam viDIyate /
   na tu vāsaḥkārye āpo viniyoktuṃ śakyāḥ /	na tu vAsaH-kArye ApaH viniyoktum SakyAH /
   tasmādyathāprāpte 'bbhakṣaṇe darśanamātraṃ kartavyam /	tasmAt-yaTA-prApte abBakzaNe darSana-mAtram kartavyam /
   na ha vā asya sarvaṃ prāṇasyānnamityevaṃvido 'nannamanadanīyaṃ jagdhaṃ	na ha vE asya sarvam prANasya-annam-iti-evaMvidaH anannam-anadanIyam jagDam
   bhuktaṃ na bhavati ha /	Buktam na Bavati ha /
   yadyapyanenānadanīyaṃ bhuktamadanīyameva bhuktaṃ syānna tu tatkṛtadoṣeṇa	yadi-api-anena-AnadanIyam Bukta-madanIyam-eva Buktam syAt-na tu tad-kRta-dozeNa
   lipyata ityetadvidyāstutirityavocāma /	lipyate iti-etat-vidyA-stutiH-iti-avocAma /
   tathā nānannaṃ pratigṛhītaṃ yadyapyapratighrāhyaṃ hastyādi pratigṛhītaṃ	taTA na-anannam pratigRhItam yadi-api-apratiGrAhyam hasti-Adi pratigRhItam
   syāttadapyannameva pratigrāhyaṃ syāttatrāpyapratigrāhyapratigrahadoṣeṇa na	syAt-tat-api-annam-eva pratigrAhyam syAt-tatra-api-apratigrAhya-pratigraha-dozeNa na
   lipyata iti stutyarthameva ya evametadanasya prāṇasyānnaṃ veda /	lipyate iti stuti-arTam-eva yaH evam-etat-anasya prANasya-annam veda /
   phalaṃ tu prāṇātmabhāva eva na tvetatphalābhiprāyeṇa kiṃ tarhi	Palam tu prANa-Atma-BAvaH eva na tu-etat-Pala-aBiprAyeNa kim tarhi
   stutyabhiprāyeṇeti /	stuti-aBiprAyeNa-iti /
   nanvetadeva phalaṃ kasmānna bhavati /	nanu-etat-eva Palam kasmAt-na Bavati /
   na prāṇātmadarśinaḥ prāṇātmabhāva eva phalam /	na prANa-Atma-darSinaH prANa-Atma-BAvaH eva Palam /
   tatra ca prāṇātmabhūtasya sarvātmano 'nadanīyamapyādyameva /	tatra ca prANa-Atma-BUtasya sarva-AtmanaH anadanIyam-api-Adyam-eva /
   tathāpratigrāhyamapi pratigrāhyameveti yathāprāptamevopādāya vidyā stūyate	taTA-apratigrAhyam-api pratigrAhyam-eva-iti yaTAprAptam-eva-upAdAya vidyA stUyate
   ato naiva phalavidhisarūpatā vākyasya /	atas na-eva Pala-viDi-sarUpa-tA vAkyasya /
   yasmādāpo vāsaḥ prāṇasya tasmādvidvāṃso brāhmaṇāḥ śrotriyā adhītavedā	yasmAt-ApaH vAsaH prANasya tasmAt-vidvAMsaH brAhmaNAH SrotriyAH aDIta-vedAH-
   aśiṣyanto bhokṣyamāṇā ācāmantyapo 'śitvā'cāmanti bhuktyā cottarakālamapo	aSizyantaH BokzyamANAH AcAmanti-apaH aSitvA-acAmanti BuktyA ca-uttara-kAlam-apo
   bhakṣayanti /	Bakzayanti /
   tatra teṣāmācāmatāṃ ko 'bhiprāya ityāha-etamevānaṃ prāṇamanagnaṃ kurvanto	tatra tezAm-AcAma-tAm kaH aBiprAyaH iti-Aha--etam-eva-anam prANam-anagnam kurvantaH-
   manyante /	manyante /
   asti caitadyoyasmai vāso dadāti sa tamanagnaṃ karomīti hi manyate /	asti ca-etat-yoyasmE vAsaH dadAti sa tam-anagnam karomi-iti hi manyate /
   prāṇasya cā'po vāsa iti hyuktam /	prANasya cA-apaH vAsaH iti hi-uktam /
   yadapaḥ pibāmi tatprāṇasya vāso dadāmīti vijñānaṃ	yat-apaH pibAmi tad-prANasya vAsaH dadAmi-iti vijQAnam
   kartavyamityevamarthametat /	kartavyam-iti-evam-arTam-etat /
   nanu bhokṣyamāṇo bhuktavāṃśca prayato bhaviṣyāmītyācāmati /	nanu BokzyamANaH BuktavAn=-ca prayataH BavizyAmi-iti-AcAmati /
   tatra ca prāṇasyānagnatākaraṇārthatve ca dvikāryatā'camanasya syāt /	tatra ca prANasya-anagna-tA-karaNa-arTa-tve ca dvi-kArya-tA-acamanasya syAt /
   na ca kāryadvayamācamanasyaikasya yuktam /	na ca kArya-dvayam-Acamanasya-ekasya yuktam /
   yadi prāyatyārthaṃ nānagnatārthamathānagnatārthaṃ na prāyatyārtham /	yadi prAyatya-arTam na-anagnatA-arTam-aTa-anagnatA-arTam na prAyatya-arTam /
   yasmādevaṃ tasmāddvitīyamācamanāntaraṃ prāṇasyānagnatākaraṇāya bhavatu /	yasmAt-evam tasmAt-dvitIyam-Acamana-antaram prANasya-anagna-tA-karaNAya Bavatu /
   na /	na /
   kriyādvitvopapatteḥ /	kriyA-dvi-tva-upapatteH /
   dve hyete kriye bhotryamāṇasya bhuktavataśca yadācamanaṃ smṛtivihitaṃ	dve hi-ete kriye BotryamANasya BuktavataH-ca yat-Acamanam smRti-vihitam
   tatprāyatyārthaṃ bhavati /	tad-prAyatya-arTam Bavati /
   kriyāmātrameva na tu tatra prāyatyaṃ darśanādyapekṣate /	kriyA-mAtram-eva na tu tatra prAyatyam darSana-Adi-apekzate /
   tatra cā'camanāṅgabhūtāsvapsu vāsovijñānaṃ prāṇasyetikartavyatayā codyate	tatra cA-acamana-aFga-BUtAsu-apsu vAsaH-vijQAnam prANasya-iti-kartavya-tayA codyate
   na tu tasminkriyamāṇa ācamanasya prāyatyarthatā vādhyate	na tu tasmin-kriyamANaH Acamanasya prAyatyarTa-tA vA-aDyate
   kriyāntaratvādācamanasya /	kriyA-antara-tvAt-Acamanasya /
   tasmādbhokṣyamāṇasya bhuktavataśca yadācamanaṃ tatrā /	tasmAt-BokzyamANasya BuktavataH-ca yat-Acamanam tatrA /
   āpo vāsaḥ prāṇasyeti darśanamātraṃ vidhīyate /	ApaH vAsaH prANasya-iti darSana-mAtram viDIyate /
   aprāptatvādanyataḥ //14//	aprApta-tvAt-anyatas //14//
   iti bṛhadāraṇyakopaniṣadi ṣaṣṭhādhyāyasya prathamaṃ brāhmaṇam //1//	iti bRhadAraNyaka-upanizadi zazWa-aDyAyasya praTamam brAhmaNam //1//
   START BrhUp 6,2.1	START BrhUp 6,2.1
   śvetaketur vā āruṇeyaḥ pancālānāṃ pariṣadam ājagāma |	SvetaketuH vA AruNeyaH pancAlAnAm parizadam AjagAma |
   sa ājagāma jaivaliṃ pravāhaṇaṃ paricārayamāṇam |	saH AjagAma jEvalim pravAhaNam paricArayamANam |
   tam udīkṣyābhyuvāda kumārā3 iti |	tam udIkzya-aByuvAda kumArA3 iti |
   sa bho3 iti pratiśuśrāva |	sa Bo3 iti pratiSuSrAva |
   anuśiṣṭo nv asi pitreti |	anuSizwaH nu asi pitrA-iti |
   om iti hovāca || BrhUp_6,2.1 ||	om iti ha-uvAca || BrhUp_6,2.1 ||
   BrhUpBh_6,2.1 śvetaketurha vā āruṇeyaḥ ityasya saṃbandhaḥ /	Brhu-upBh_6,2.1 SvetaketuH-ha vA AruNeyaH iti-asya saMbanDaH /
   khilādhikāro 'yaṃ tatra yadanuktaṃ taducyate /	Kila-aDikAraH ayam tatra yat-anuktam tat-ucyate /
   saptamādhyāyānte jñānakarmasamuccayakāriṇāgnermārgayācanaṃ kṛtam-agne naya	saptama-aDyAya-ante jQAna-karma-samuccaya-kAriNA-agneH-mArga-yAcanam kRtam--agne naya
   supatheti /	supaTA-iti /
   tatrānekeṣāṃ pathāṃ sadbhāvo mantreṇa sāmarthyātpradarśitaḥ /	tatra-anekezAm paTAm sadBAvaH mantreNa sAmarTyAt-pradarSitaH /
   supatheti viśeṣaṇāt /	supaTA-iti viSezaNAt /
   panthānaśca kṛtavipākapratipattimārgāḥ /	panTAnaH-ca kRta-vipAka-pratipatti-mArgAH /
   vakṣyati ca yatkṛtvetyādi /	vakzyati ca yat-kRtvA-ityAdi /
   tatra ca kati karmavipākapratipattimārgā iti	tatra ca kati karma-vipAka-pratipatti-mArgAH iti
   sarvasaṃsāragatyupasaṃhārārtho 'yamārambhaḥ /	sarva-saMsAra-gati-upasaMhAra-arTaH ayam-AramBaH /
   etāvatī hi saṃsāragatiḥ /	etAvatI hi saMsAra-gatiH /
   etāvānkarmaṇo vipākaḥ svābhāvikasya śāsrīyasya ca savijñānasyeti /	etAvAn-karmaNaH vipAkaH svABAvikasya SAsrIyasya ca sa-vijQAnasya-iti /
   yadyapi dvayā ha prājāpatyā ityatra svābhāvikaḥ pāpmā sūcitaḥ /	yadi-api dvayAH ha prAjApatyAH iti-atra svABAvikaH pApmA sUcitaH /
   na ca tasyedaṃ kāryamiti vipākaḥ pradarśitaḥ /	na ca tasya-idam kAryam-iti vipAkaH pradarSitaH /
   śāsrīyasyaiva tu vipākaḥ pradarśitastryannātmapratipattyantena /	SAsrIyasya-eva tu vipAkaH pradarSitaH-tri-anna-Atma-pratipatti-antena /
   brahmavidyārambhe tadvairāgyasya vivakṣitatvāt /	brahma-vidyA-AramBe tad-vErAgyasya vivakzita-tvAt /
   tatrāpi kevalena karmaṇā pitṛloko vidyayā vidyāsaṃyuktena ca karmaṇā	tatra-api kevalena karmaNA pitR-lokaH vidyayA vidyA-saMyuktena ca karmaNA
   devaloka ityuktam /	deva-loke iti-uktam /
   tatra kena mārgeṇa pitṛlokaṃ pratipadyate kena vā devalokamiti noktam /	tatra kena mArgeNa pitR-lokam pratipadyate kena vA deva-lokam-iti na-uktam /
   tacceha khilaprakaraṇe 'śeṣato vaktavyamityata ārabhyate /	tat-ca-iha Kila-prakaraNe aSezatas vaktavyam-iti-atas AraByate /
   ante ca sarvopasaṃhāraḥ śāsrasyeṣṭaḥ /	ante ca sarva-upasaMhAraH SAsrasya-izwaH /
   api caitāvadamṛtatvamityuktaṃ na karmaṇo 'mṛtatvāśāstīti ca tatra	api ca-etAvat-amRta-tvam-iti-uktam na karmaNaH amRta-tva-aSA-asti-iti ca tatra
   heturnoktastadarthaścāyamārambhaḥ /	hetuH-na-uktaH-tad-arTaH-ca-ayam-AramBaH /
   yasmādiyaṃ karmaṇo gatirna nitye 'mṛtatve vyāpāro 'sti	yasmAt-iyam karmaNaH gatiH-na nitye amRta-tve vyApAraH asti
   tasmādetāvadevāmṛtatvasādhanamiti sāmarthyāddhetutvaṃ saṃpadyate /	tasmAt-etAvat-eva-amRta-tva-sADanam-iti sAmarTyAt-hetu-tvam saMpadyate /
   api coktamagnihotre na tvevainayostvamutkrātiṃ na gatiṃ na pratiṣṭhāṃ na	api ca-uktam-agnihotre na tu-eva-enayoH-tvam-utkrAtim na gatim na pratizWAm na
   tṛptiṃ na punarāvṛtiṃ na lokaṃ pratyutthāyinaṃ vettheti /	tRptim na punarAvRtim na lokam pratyutTAyinam vetTa-iti /
   tatra prativacane te vā ete āhutī hute utkrāmata ityādinā āhuteḥ	tatra prativacane te vE ete AhutI hute utkrAmate ityAdinA AhuteH
   kāryamuktam /	kAryam-uktam /
   taccaitatkarturāhutilakṣaṇasya karmaṇaḥ phalam /	tat-ca-etat-kartuH-Ahuti-lakzaNasya karmaNaH Palam /
   na hi kartāramanāśrityā'hutilakṣaṇasya karmaṇaḥ	na hi kartA-ram-anASrityA-ahuti-lakzaNasya karmaNaH
   svātantryeṇotkrāntyādikāryārambha upapadyate /	svAtantryeNa-utkrAnti-Adi-kArya-AramBaH upapadyate /
   kartrarthatvātkarmaṇaḥ kāryārambhasya /	kartR-arTa-tvAt-karmaNaH kArya-AramBasya /
   sādhanāśrayatvācca karmaṇaḥ /	sADana-ASraya-tvAt-ca karmaNaH /
   tatrāgnihotrastutyarthatvādagnihotrasyaiva kāryamityuktaṃ ṣaṭ prakāramapi	tatra-agnihotra-stuti-arTa-tvAt-agni-hotrasya-eva kAryam-iti-uktam zaw prakAram-api
   iha tu tadeva kartuḥ phalamityupadiśyate /	iha tu tat-eva kartuH Palam-iti-upadiSyate /
   ṣaṭprakāramapi karmaphalavijñānasya vivakṣitatvāt /	zaz-prakAram-api karma-Pala-vijQAnasya vivakzita-tvAt /
   taddvāreṇa ca pañcāgnidarśanamihottaramārgapratipattisādhanaṃ vidhitsitam	tad-dvAreNa ca paQca-agni-darSanam-iha-uttara-mArga-pratipatti-sADanam viDitsitam
   evamaśeṣasaṃsāragatyupasaṃhāraḥ /	evam-aSeza-saMsAra-gati-upasaMhAraH /
   karmakāṇḍasyaiṣā niṣṭhetyetaddvayaṃ didarśayiṣurākhyāyikāṃ praṇayati /	karma-kANxasya-ezA nizWA-iti-etat-dvayam didarSayizuH-AKyAyikAm praNayati /
   śvetaketurnāmato 'ruṇasyāpatyamāruṇistasyāpatyamāruṇeyaḥ /	SvetaketuH-nAmataH aruNasya-apatyam-AruNiH-tasya-apatyam-AruNeyaH /
   haśabda aitihyārthaḥ /	ha-SabdaH Etihya-arTaH /
   vai niścayārthaḥ /	vE niScaya-arTaH /
   pitrānuśiṣṭaḥ sannātmano yaśaḥprathanāya pañcālānāṃ pariṣadamāgatya jitvā	pitrA-anuSizwaH san=-a-AtmanaH yaSaH-praTanAya paQcAlAnAm parizadam-Agatya jitvA
   rājño 'pi pariṣadaṃ jeṣyāmīti garveṇa sa ājagāma /	rAjQaH api parizadam jezyAmi-iti garveNa saH AjagAma /
   jīvalasyāpatyaṃ jevaliṃ pañcālarājaṃ pravāhaṇanāmānaṃsvabhṛtyaiḥ	jIvalasya-apatyam jevalim paQcAla-rAjam pravAhaNa-nAma-anaMsu-aBRtyEH
   paricārayamāṇamātmanaḥ paricaraṇaṃ kārayantamityetat /	paricArayamANam-AtmanaH paricaraNam kArayantam-iti-etat /
   sa rājā pūrvameva tasya vidyābhimānagarvaṃ śrutvā vinetavyo 'yamiti matvā	sa rAjA pUrvam-eva tasya vidyA-aBimAna-garvam SrutvA vinetavyaH ayam-iti matvA
   tamudīkṣyotprekṣyā'gatamātramevābhyuvādābhyuktavānkumārā3iti saṃbodhya /	tam-udIkzya-utprekzyA-agata-mAtram-eva-aByuvAda-aByuktavAn-kumArA3-iti saMboDya /
   bhartsanārthā plutiḥ /	Bartsana-arTA plutiH /
   evamuktaḥ sa pratiśuśrāva bho3iti /	evam-uktaH sa pratiSuSrAva Bo3iti /
   bho3ityapratirūpamapi kṣattriyaṃ pratyuktavānkruddhaḥ san /	Bo3iti-apratirUpam-api kzattriyam pratyuktavAn-krudDaH san /
   anuśiṣṭo 'nuśāsito 'si bhavasi kiṃ pitretyuvāca rājā /	anuSizwaH anuSAsitaH asi Bavasi kim pitrA-iti-uvAca rAjA /
   pratyāhetara oṃmiti bāḍhamanuśiṣṭo 'smi pṛccha yadi saṃśayaste //1//	pratyAha-itaraH oMm-iti bAXam-anuSizwaH asmi pRcCa yadi saMSayaH-te //1//
   START BrhUp 6,2.2	START BrhUp 6,2.2
   vettha yathemāḥ prajāḥ prayatyo vipratipadyantā3 iti |	vetTa yaTA-imAH prajAH prayatyaH vipratipadyantA3 iti |
   neti hovāca |	na-iti ha-uvAca |
   vettho yathemaṃ lokaṃ punar āpadyantā3 iti |	vetTaH yaTA-imam lokam punar Apadi-antA3 iti |
   neti haivovāca |	na-iti ha-eva-uvAca |
   vettho yathāsau loka evaṃ bahubhiḥ punaḥ punaḥ prayadbhir na saṃpūryatā3	vetTaH yaTA-asO loke evam bahuBiH punar punar prayadBiH na saMpUryatA3
   iti |	iti |
   neti haivovāca |	na-iti ha-eva-uvAca |
   vettho yatithyām āhutyāṃ hutāyām āpaḥ puruṣavāco bhūtvā samutthāya	vetTaH yatiTyAm AhutyAm hutAyAm ApaH puruza-vAcaH BUtvA samutTAya
   vadantī3 iti |	vadantI3 iti |
   neti haivovāca |	na-iti ha-eva-uvAca |
   vettho devayānasya vā pathaḥ pratipadaṃ pitṛyāṇasya vā |	vetTaH deva-yAnasya vA paTaH pratipadam pitRyANasya vA |
   yat kṛtvā devayānaṃ vā panthānaṃ pratipadyante pitṛyāṇaṃ vā |	yat kRtvA deva-yAnam vA panTAnam pratipadyante pitRyANam vA |
   api hi na ṛṣer vacaḥ śrutaṃ --	api hi naH RzeH vacaH Srutam --
   dve sṛtī aśṛṇavaṃ pitṝṇām ahaṃ devānām uta martyānām |	dve sRtI aSRNavam pitLNAm aham devAnAm uta martyAnAm |
   tābhyām idaṃ viśvam ejat sameti yad antarā pitaraṃ mātaraṃ ceti |	tAByAm idam viSvam ejat sameti yat antarA pitaram mAtaram ca-iti |
   nāham ata ekaṃ cana vedeti hovāca || BrhUp_6,2.2 ||	na-aham atas ekam cana veda-iti ha-uvAca || BrhUp_6,2.2 ||
   BrhUpBh_6,2.2 yadyevaṃ vettha vijānāsi kiṃ yathā yena prakāreṇemāḥ prajāḥ	Brhu-upBh_6,2.2 yadi-evam vetTa vijAnAsi kim yaTA yena prakAreNa-imAH prajAH
   prasiddhāḥ prayatyo mriyamāṇā vipratipadyantā3iti vipratipadyante	prasidDAH prayatyaH mriyamANA vipratipadyantA3-iti vipratipadyante
   vicāraṇārthā plutiḥ /	vicAraNa-arTA plutiH /
   samānena mārgeṇa gacchantīnāṃ mārgadvaividhyaṃ yatra kāścitprajā anyena	samAnena mArgeNa gacCantInAm mArga-dvEviDyam yatra kAScid-prajAH anyena
   mārgeṇa gacchanti kāścidanyeneti vipratipattiḥ /	mArgeNa gacCanti kAScid-anyena-iti vipratipattiH /
   yathā tāḥ prajā vipratipadyante tatkiṃ vetthetyarthaḥ /	yaTA tAH prajAH vipratipadyante tat-kim vetTa-iti-arTaH /
   neti hovācetaraḥ /	na-iti ha-uvAca-itaraH /
   tarhi vettha u yathemaṃ lokaṃ punarāpadyantā3iti punarāpadyante yathā	tarhi vetTaH u yaTA-imam lokam punar-Apadi-antA3-iti punar-Apadyante yaTA
   punarāgacchantīmaṃ lokam /	punar-AgacCanti-imam lokam /
   neti haivovāca śvetaketuḥ /	na-iti ha-eva-uvAca SvetaketuH /
   vettho yathāsau lokaḥ evaṃ prasiddhena nyāyena punaḥ	vetTaH yaTA-asO lokaH evam prasidDena nyAyena punar-
   punarasakṛtprayadbhirmariyamāṇairyathāyena prakāreṇa na saṃpūryatā3iti na	punar-asakRt-prayadBiH-mariyamANEH-yaTAyena prakAreNa na saMpUryatA3-iti na
   saṃpūryate 'sau lokastatkiṃ vettha /	saMpUryate asO lokaH-tat-kim vetTa /
   neti haivovāca /	na-iti ha-eva-uvAca /
   vettho yatithyāṃ yatsaṃkhyākāyāmāhutyāmāhutau hutāyāmāpaḥ puruṣavācaḥ	vetTaH yatiTyAm yat-saMKyA-kAyAm-AhutyAm-AhutO hutAyAmApaH puruza-vAcaH
   puruṣasya yā vāksaiva yāsāṃ vāktāḥ puruṣavāco bhūtvā puruṣaśabdavācyā vā	puruzasya yA vAc-sA-eva yAsAm vA-aktAH puruza-vAcaH BUtvA puruza-Sabda-vAcyA vA
   bhūtvā /	BUtvA /
   yadā puruṣākārapariṇatāstadā puruṣavāco bhavanti /	yadA puruza-AkAra-pariNatAH-tadA puruza-vAcaH Bavanti /
   samutthāya samyagutthāyodbhūtāḥ satyo vadantī3iti /	samutTAya samyak-utTAya-udBUtAH satyaH vadantI3-iti /
   neti haivovāca /	na-iti ha-eva-uvAca /
   puruṣākārapariṇatāstadā puruṣavāco bhavanti /	puruza-AkAra-pariNatAH-tadA puruza-vAcaH Bavanti /
   samutthāya samyagutthāyodbhūtāḥ satyo vadantī3iti /	samutTAya samyak-utTAya-udBUtAH satyaH vadantI3-iti /
   neti haivovāca /	na-iti ha-eva-uvAca /
   yadyevaṃ vettha u devayānasya patho mārgasya pratipadaṃ pratipadyate yena	yadi-evam vetTaH u deva-yAnasya paTaH mArgasya pratipadam pratipadyate yena
   sā pratipattāṃ pratipadaṃ pitṛyāṇasya vā pratipadaṃ	sA pratipattAm pratipadam pitRyANasya vA pratipadam
   pratipacchabdavācyamarthamāha /	pratipad-Cabda-vAcyam-arTam-Aha /
   yatkarma kṛtvā yathāviśiṣṭaṃ karma kṛtvetyarthaḥ /	yat-karma kRtvA yaTA-viSizwam karma kRtvA-iti-arTaH /
   devayānaṃ vā panthānaṃ mārgaṃ pratipadyante pitṛyāṇaṃ vā yatkarma kṛtvā	deva-yAnam vA panTAnam mArgam pratipadyante pitRyANam vA yat-karma kRtvA
   pratidyante tatkarma pratipadicyate tāṃ pratipadaṃ kiṃ vettha	pratidyante tat-karma pratipad-icyate tAm pratipadam kim vetTa
   devalokapitṛlokapratipattisādhanaṃ kiṃ vetthetyarthaḥ /	deva-loka-pitR-loka-pratipatti-sADanam kim vetTa-iti-arTaH /
   apyatrāsyārthasya prakāśakamṛṣermantrasya vaco vākyaṃ naḥ śrutamasti /	api-atra-asya-arTasya prakASakam-RzeH-mantrasya vacaH vAkyam naH Srutam-asti /
   mantro 'pyasyārthasya prakāśako vidyata ityarthaḥ /	mantraH api-asya-arTasya prakASakaH vidyate iti-arTaH /
   ko 'sau mantra iti /	kaH asO mantraH iti /
   ucyate-dve sṛtī dvau mārgāvaśṛṇavaṃ śṛtavānasmi tayorekā pitṛṇāṃ prāpikā	ucyate--dve sRtI dvO mArgO=-aSRNavam SRtavAn-asmi tayoH-ekA pitRNAm prApikA
   pitṛlokasaṃbaddhā tayā sṛtyā pitṛlokaṃ prāpnotītyarthaḥ /	pitR-loka-saMbadDA tayA sRtyA pitR-lokam prApnoti-iti-arTaH /
   ahamaśṛṇavamiti vyavahitena saṃbandhaḥ /	aham-aSRNavam-iti vyavahitena saMbanDaH /
   devānāmutāpi devānāṃ saṃbandhinyanyā devānprāpayati sā /	devAnAm-uta-api devAnAm saMbanDini-anyA devAn-prApayati sA /
   ke punarubhābhyāṃ sṛtibhyāṃ pitṝndevāṃśca gacchantīti /	ke punar-uBAByAm sRtiByAm pitLn-devAn=-ca gacCanti-iti /
   ucyate-utāpi martyānāṃ manuṣyāṇāṃ saṃbandhinyau manuṣyā eva hi sṛtibhyāṃ	ucyate-utA-api martyAnAm manuzyANAm saMbanDinyO manuzyAH eva hi sRtiByAm
   gacchantītyarthaḥ /	gacCanti-iti-arTaH /
   tābhyāṃ sṛtihyāmidaṃ viśvaṃ samastametadgacchatsameti saṃgacchate /	tAByAm sRti-hyAm-idam viSvam samastam-etat-gacCat-sameti saMgacCate /
   te ca dve sṛtī yadantarā yayorantarā yadantarā pitaraṃ mātaraṃ ca	te ca dve sRtI yad-antarA yayoH-antarA yad-antarA pitaram mAtaram ca
   mātāpitrorantarā madhya ityarthaḥ /	mAtA-pitroH-antarA maDye iti-arTaH /
   kau tau mātāpitarau dyāvāpṛthivyāvaṇḍakapāle /	kO tO mAtA-pitarO dyAvApRTivI-AvaNxa-kapAle /
   iyaṃ vai mātāsau piteti hi vyākhyātaṃ brāhmaṇena /	iyam vE mAtA-asO pitA-iti hi vyAKyAtam brAhmaNena /
   aṇḍakapālayormadhye saṃsāraviṣaye evaite sṛtī nā'tyantikāmṛtatvagamanāya /	aNxa-kapAlayoH-maDye saMsAra-vizaye eva-ete sRtI nA-atyantika-amRta-tva-gamanAya /
   itara āha-nāhamato 'smātpraśnasamudāyādekañcanaikamapi praśnaṃ na veda	itaraH Aha-na-aham-atas asmAt-praSna-samudAyAt-ekaQcana-ekam-api praSnam na veda
   nāhaṃ vedeti hovāca śvetaketuḥ //2//	na-aham veda-iti ha-uvAca SvetaketuH //2//
   START BrhUp 6,2.3	START BrhUp 6,2.3
   athainaṃ vasatyopamantrayāṃ cakre |	aTa-enam vasatyA-upamantrayAm cakre |
   anādṛtya vasatiṃ kumāraḥ pradudrāva |	anAdRtya vasatim kumAraH pradudrAva |
   sa ājagāma pitaram |	saH AjagAma pitaram |
   taṃ hovāca -- iti vāva kila no bhavān purānuśiṣṭān avoca iti |	tam ha-uvAca - iti vAva kila naH BavAn purA-anuSizwAn avocaH iti |
   katham sumedha iti |	kaTam sumeDaH iti |
   pañca mā praśnān rājanyabandhur aprākṣīt |	paQca mA praSnAn rAjanya-banDuH aprAkzIt |
   tato naikaṃ cana vedeti |	tatas na-ekam cana veda-iti |
   katame ta iti |	katame te iti |
   ima iti ha pratīkāny udājahāra || BrhUp_6,2.3 ||	ime iti ha pratIkAni udAjahAraH || BrhUp_6,2.3 ||
   BrhUpBh_6,2.3 athānantaramapanīya vidyābhimānagarvamenaṃ prakṛtaṃ	Brhu-upBh_6,2.3 aTa-anantaram-apanIya vidyA-aBimAna-garvam-enam prakRtam
   śvetaketuṃ vasatyā vasatiprayojanenopamantrayāñcakre /	Svetaketum vasatyA vasati-prayojanena-upamantrayAQcakre /
   iha vasantu bhavantaḥ pādyamarpyaṃ cā'nīyatāmityupamantraṇaṃ kṛtavānrājā /	iha vasantu BavantaH pAdyam-arpyam cA-anIyatAm-iti-upamantraNam kRtavAn-rAjAH /
   anādṛtya tāṃ vasatiṃ kumāraḥ śvetaketuḥ pradudrāva pratigatavānpitaraṃ	anAdRtya tAm vasatim kumAraH SvetaketuH pradudrAva pratigatavAn-pitaram
   prati /	prati /
   sa cā'jagāma pitaramāgatya covāca taṃ kathamiti vāva kilaivaṃ kila no	sa cA-ajagAma pitaram-Agatya ca-uvAca tam kaTam-iti vAva kila-evam kila no
   'smānbhavānpurā samāvagatavānpitaraṃ prati /	asmAn-BavAn-purA samAvagatavAn-pitaram prati /
   sa cā'jagāma pitaramāgatya covāca taṃ kathamiti vāva kilaivaṃ kila no	sa cA-ajagAma pitaram-Agatya ca-uvAca tam kaTam-iti vAva kila-evam kila no
   'smānbhavānpurā samāvartanakāle 'nuśiṣṭānsarvābhirvidyābhiravoco 'vocaditi	asmAn-BavAn-purA samAvartana-kAle anuSizwAn-sarvABiH-vidyABiH-avocaH avocat-iti
   sopālambhaṃ putrasya vacaḥ śrutvā'ha pitā /	sa-upAlamBam putrasya vacaH SrutvA-aha pitA /
   katha kena prakāreṇa tava duḥkhamupajātaṃ he sumedhaḥ śobhanā medhā	kaTa kena prakAreNa tava duHKam-upajAtam he sumeDaH SoBanA meDA
   yasyeti sumedhāḥ /	yasya-iti sumeDAH /
   śṛṇu mama yathā vṛttaṃ pañca pañcasaṃkhyākānpraśnānmā māṃ rājanyabandhū	SRNu mama yaTA vRttam paQca paQca-saMKyAkAn-praSnAt-mA mAm rAjanya-banDU
   rājanyā bandhavo yasyeti /	rAjanyA banDavaH yasya-iti /
   paribhavavacanametadrājanyabandhuriti /	pariBava-vacanam-etat-rAjanyabanDuH-iti /
   aprākṣītpṛṣṭavāṃstatastasmānnaikañcanaikamapi na veda na vijñātavānasmi /	aprAkzIt-pRzwavAn=-tatas-tasmAt-nEkaQcana-ekam-api na veda na vijQAtavAn-asmi /
   katame te rājñāḥ pṛṣṭāḥ praśnā iti pitroktaḥ putra ime ta iti ha pratīkāni	katame te rAjQAH pRzwAH praSnAH iti pitrA-uktaH putraH ime te iti ha pratIkAni
   mukhāni praśnānāmudājahārodāhṛtavān //3//	muKAni praSnAnAm-udAjahAra-udAhRtavAn //3//
   START BrhUp 6,2.4	START BrhUp 6,2.4
   sa hovāca -- tathā nas tvaṃ tata jānīthā yathā yad ahaṃ kiṃca veda sarvam	sa ha-uvAca - taTA naH tvam tata jAnITAH yaTA yat aham kiMca veda sarvam
   ahaṃ tat tubham avocam |	aham tat tuBam avocam |
   prehi tu tatra |	prehi tu tatra |
   pratītya brahmacaryaṃ vatsyāva iti |	pratItya brahmacaryam vatsyAvaH iti |
   bhavān eva gacchatv iti |	BavAn eva gacCatu iti |
   sa ājagāma gautamo yatra pravāhaṇasya jaivaler āsa |	saH AjagAma gOtamaH yatra pravAhaNasya jEvaleH Asa |
   tasmā āsanam āhṛtyodakam āhārayāṃ cakāra |	tasmE Asanam AhRtya-udakam AhArayAm cakAra |
   atha hāsmā arghyaṃ cakāra |	aTa ha-asmE arGyam cakAra |
   taṃ hovāca -- varaṃ bhagavate gautamāya dadma iti || BrhUp_6,2.4 ||	tam ha-uvAca - varam Bagavate gOtamAya dadmaH iti || BrhUp_6,2.4 ||
   BrhUpBh_6,2.4 sa hovāca pitā putraṃ kruddhamupaśamayaṃstathā tena	Brhu-upBh_6,2.4 sa ha-uvAca pitA putram krudDam-upaSamayan=-taTA tena
   prakāreṇa no 'smāṃstvaṃ he tāta vatsa jānīthā gṛhṇīthā yathā yadahaṃ kiñca	prakAreNa naH asmAn=-tvam he tAta vatsa jAnITAH gRhNITAH yaTA yat-aham kiQca
   vijñānajātaṃ veda sarvaṃ tatubhyamavocamityeva jānīthāḥ /	vijQAna-jAtam veda sarvam tatuByam-avocam-iti-eva jAnITAH /
   ko 'nyo mama priyataro 'sti tvatto yadarthaṃrakṣiṣye /	kaH anyaH mama priyataraH asti tvattaH yad-arTaMrakzizye /
   ahamapyetanna jānāmi yadrājñā pṛṣṭam /	aham-api-etat-na jAnAmi yat-rAjQA pRzwam /
   tasmātprehyāgaccha tatra pratītya gatvā rājñi brahmacaryaṃ vatsyāvo	tasmAt-prehya-AgacCa tatra pratItya gatvA rAjQi brahmacaryam vatsyAvaH-
   vidyārthamiti /	vidyA-arTam-iti /
   sa āha bhavāneva gacchatviti nāhaṃ tasya mukhaṃ nirīkṣitumutsahe /	saH Aha BavAn-eva gacCatu-iti na-aham tasya muKam nirIkzitum-utsahe /
   sa ājagāma gautamo gotrato gautama āruṇiryatra pravāhaṇasya	saH AjagAma gOtamaH gotrataH gOtamaH AruNiH-yatra pravAhaNasya
   jaivalerāsā'sanamāsthāyikā ṣaṣṭhīdvayaṃ prathamamāsthāne /	jEvalerAsA-asanam-AsTAyikA zazWI-dvayam praTamam-AsTAne /
   tasmai gautamāyā'gatāyā'sanamanurūpamāhṛtyodakaṃ bhṛtyairāhārayāñcakāra /	tasmE gOtamAyAH-agatAyAH-asanam-anurUpam-AhRtya-udakam BRtyEH-AhAra-yAQcakAra /
   atha hāsmā ardhyaṃ purodhasā kṛtavānmantravanmadhuparkaṃ ca /	aTa ha-asmE arDyam puroDasA kRtavAn-mantravat-maDuparkam ca /
   kṛtvā caivaṃ pūjāṃ taṃ hovāca varaṃ bhagavate gautamāya tubhyaṃ dadbha iti	kRtvA ca-evam pUjAm tam ha-uvAca varam Bagavate gOtamAya tuByam dadBe iti
   gośvādilakṣaṇam //4//	go-Sva-Adi-lakzaNam //4//
   START BrhUp 6,2.5	START BrhUp 6,2.5
   sa hovāca -- pratijñato ma eṣa varaḥ |	sa ha-uvAca - pratijQataH me eza varaH |
   yāṃ tu kumārasyānte vācam abhāṣathās tāṃ me brūhīti || BrhUp_6,2.5 ||	yAm tu kumArasya-ante vAcam aBAzaTAH tAm me brUhi-iti || BrhUp_6,2.5 ||
   BrhUpBh_6,2.5 sa hovāca gautamaḥ pratijñāto me mamaiṣa varastvayāsyāṃ	Brhu-upBh_6,2.5 sa ha-uvAca gOtamaH pratijQAtaH me mama-eza varaH-tvayA-asyAm
   pratijñāyāṃ dṛḍhī kurvātmānaṃ yāṃ tu vācaṃ kumārasya mama putrasyānte	pratijQAyAm dRXI kurva-AtmAnam yAm tu vAcam kumArasya mama putrasya-ante
   samīpe vācamabhāṣathāḥ praśnarūpāṃ tāmeva me brūhi sa eva no vara iti	samIpe vAcam-aBAzaTAH praSna-rUpAm tAm-eva me brUhi saH eva naH varaH iti
   START BrhUp 6,2.6	START BrhUp 6,2.6
   sa hovāca -- daiveṣu vai gautama tad vareṣu |	sa ha-uvAca - dEvezu vE gOtama tat varezu |
   mānuṣāṇāṃ brūhīti || BrhUp_6,2.6 ||	mAnuzANAm brUhi-iti || BrhUp_6,2.6 ||
   BrhUpBh_6,2.6 sa hovāca rājā daiveṣu vareṣu tadvai gautama yastvaṃ	Brhu-upBh_6,2.6 sa ha-uvAca rAjA dEvezu varezu tat-vE gOtama yaH-tvam
   prārthayase mānuṣāṇāmanyatamaṃ prārthaya varam //6//	prArTayase mAnuzANAm-anyatamam prArTaya varam //6//
   START BrhUp 6,2.7	START BrhUp 6,2.7
   sa hovāca -- vijñāyate hāstihiraṇyasyāpāttaṃ goaśvānāṃ dāsīnāṃ pravārāṇāṃ	sa ha-uvAca - vijQAyate hAsti-hiraNyasya-apAttam go-aSvAnAm dAsInAm pravArANAm
   paridhānasya |	pariDAnasya |
   mā no bhavān bahor anantasyāparyantasyābhyavadānyo bhūd iti |	mA naH BavAn bahoH anantasya-aparyantasya-aByavadAnyaH BUt iti |
   sa vai gautama tīrthenecchasā iti |	sa vE gOtama tIrTena-icCasA iti |
   upaimy ahaṃ bhavantam iti |	upEmi aham Bavantam iti |
   vācā ha smaiva pūrva upayanti |	vAcA ha sma-eva pUrvaH upayanti |
   sa hopāyanakīrtyovāsa || BrhUp_6,2.7 ||	sa ha-upAyana-kIrtyA-uvAsa || BrhUp_6,2.7 ||
   BrhUpBh_6,2.7 sa hovāca gautamo bhavatāpi vijñāyate ha mamāsti saḥ /	Brhu-upBh_6,2.7 sa ha-uvAca gOtamaH BavatA-api vijQAyate ha mama-asti saH /
   na tena prārthitena kṛtyaṃ mama yaṃ tvaṃ ditsasi mānuṣaṃ varam /	na tena prArTitena kRtyam mama yam tvam ditsasi mAnuzam varam /
   yasmānmamāpyasti hiraṇyasya prabhūtasyāpāttaṃ prāptaṃ	yasmAt-mama-api-asti hiraNyasya praBUtasya-apAttam prAptam
   go'aśvānānāmāpāttamastīti sarvatrānuṣaṅgo dāsīnāṃ pravārāṇāṃ parivārāṇāṃ	go-aaSvAnAnAm-ApAttam-asti-iti sarvatra-anuzaFgaH dAsInAm pravArANAm parivArANAm
   paridhānasya ca /	pariDAnasya ca /
   na ca yanmama vidyamānaṃ tattvattaḥ prārthanīyaṃ tvayā vā deyam /	na ca yat-mama vidyamAnam tat-tvattaH prArTanIyam tvayA vA deyam /
   pratijñātaśca varastvayā tvameva jānīṣe yadatra yuktaṃ pratijñā rakṣaṇīyā	pratijQAtaH-ca varaH-tvayA tvam-eva jAnIze yat-atra yuktam pratijQA rakzaNIyA
   taveti /	tava-iti /
   mama punarayamabhiprāyo mā bhūnno 'smānabhyasmāneva kevalānprati	mama punar-ayam-aBiprAyaH mA BUt-naH asmAn-aByasmAn-eva kevalAn-prati
   bhavānsarvatra vadānyo bhūtvāvadānyo mā bhūtkadaryo mā bhūdityarthaḥ /	BavAn-sarvatra vadAnyaH BUtvA-avadAnyaH mA BUt-kadaryaH mA BUt-iti-arTaH /
   bahoḥ prabhūtasyānantasyānantaphalasyetyetat /	bahoH praBUtasya-anantasya-ananta-Palasya-iti-etat /
   aparyantasyāparisamāptikasya putrapautrādigāmikasyetyetat /	aparyantasya-aparisamAptikasya putra-pOtra-Adi-gAmikasya-iti-etat /
   īdṛśasya vittasya māṃ pratyeva kevalamādātā mā bhūdbhavān /	IdRSasya vittasya mAm pratyeva kevalam-AdAtA mA BUt-BavAn /
   na cānyatrādeyamasti bhavataḥ /	na ca-anyatra-Adeyam-asti BavataH /
   evamukta āha-sa tvaṃ vai he gautama tīrthena nyāyena śāsravihitena vidyāṃ	evam-uktaH Aha-sa tvam vE he gOtama tIrTena nyAyena SAsra-vihitena vidyAm
   matta icchāsā icchānvāptumityukto gautama āha-upaimyupagacchāmi	mattaH icCAsA icCA-anvAptum-iti-uktaH gOtamaH Aha-upEmi-upagacCAmi
   śiṣyatvenāhaṃ bhavantamiti /	Sizya-tvena-aham Bavantam-iti /
   vācā ha smaiva kila pūrva brāhmaṇāḥ kṣattriyānvidyārthinaḥ santo vaiśyānvā	vAcA ha sma-eva kila pUrva brAhmaNAH kzattriyAn-vidyA-arTinaH santaH vESyAn-vA
   kṣattriyā vā vaiśyānāpadyupayanti śiṣyavṛttyā hyupacchanti	kzattriyAH vA vESyAn-Apadyupayanti Sizya-vRttyA hi-upacCanti
   nopāyanaśuśrūṣādibiḥ /	na-upAyana-SuSrUzA-AdibiH /
   ataḥ /	atas /
   sa gautamo hopāyanakortyopagamanakīrtanamātreṇaivovāsoṣitavānnopāyanaṃ	sa gOtamaH ha-upAyana-kortyA-upagamana-kIrtana-mAtreNa-eva-uvAsa-uzitavAn-na-upAyanam
   cakāra //7//	cakAra //7//
   START BrhUp 6,2.8	START BrhUp 6,2.8
   sa hovāca -- tathā nas tvam gautama māparādhās tava ca pitāmahāḥ |	sa ha-uvAca - taTA naH tvam gOtama mA-aparADAH tava ca pitAmahAH |
   yatheyaṃ vidyetaḥ pūrvaṃ na kasmiṃś cana brāhmana uvāsa |	yaTA-iyam vidyetas pUrvam na kasmin cana brAhmanaH uvAsa |
   tāṃ tv ahaṃ tubhyaṃ vakṣyāmi |	tAm tu aham tuByam vakzyAmi |
   ko hi tvaivaṃ bruvantam arhati pratyākhyātum iti || BrhUp_6,2.8 ||	kaH hi tvA-evam bruvantam arhati pratyAKyAtum iti || BrhUp_6,2.8 ||
   BrhUpBh_6,2.8 evaṃ gautamenā'padantara ukte sa hovāca rājā pīḍitaṃ matvā	Brhu-upBh_6,2.8 evam gOtamenA-apad-antaraH ukte sa ha-uvAca rAjA pIxitam matvA
   kṣāmayaṃstathā no 'smānprati māparādhā aparādhaṃ mā kārṣīrasmadīyo	kzAmayan=-taTA naH asmAn-prati mA-aparADAH aparADam mA kArzIH-asmadIyaH-
   'parādho na grahītavya ityarthaḥ /	aparADaH na grahItavyaH iti-arTaH /
   tava ca pitāmahā asmatpitāmaheṣu yatāparādhaṃ na jagṛhustathā pitāmahānāṃ	tava ca pitAmahAH asmad-pitAmahezu yata-aparADam na jagRhuH-taTA pitAmahAnAm
   vṛttamasmāsvapi bhavatā rakṣaṇīyamityarthaḥ /	vRttam-asmAsu-api BavatA rakzaNIyam-iti-arTaH /
   yatheyaṃ vidyā tvayā prārthitetastvatsaṃpradānātpūrvaṃ prāṅna kasminnapi	yaTA-iyam vidyA tvayA prArTitetaH-tvad-saMpradAnAt-pUrvam prAk-na kasmin=-api
   brāhmaṇa uvāsoṣitavatītathā tvamapi jānīṣe sarvadā kṣattriyaparamparayeyaṃ	brAhmaNaH uvAsa-uzitavatI-taTA tvam-api jAnIze sarvadA kzattriya-param-parayeyam
   vidyā'gatā sā sthitirmayāpi rakṣaṇīyā yadi śakyata ityuktaṃ daiveṣu	vidyA-agatA sA sTitiH-mayA-api rakzaNIyA yadi Sakyate iti-uktam dEvezu
   gautama tadvareṣu mānuṣāṇāṃ brūhīti na punastavādeyo vara itītaḥ para na	gOtama tad-varezu mAnuzANAm brUhi-iti na punar-tava-AdeyaH varaH iti-itaH para na
   śakyate rakṣitum /	Sakyate rakzitum /
   tāmapi vidyāmahaṃ tubhyaṃ vakṣyāmi ko hyanyo 'pi hi yasmādevaṃ bruvantaṃ	tAm-api vidyAm-aham tuByam vakzyAmi kaH hi-anyaH api hi yasmAt-evam bruvantam
   tvāmarhati pratyākhyātuṃ na vakṣyāmīti /	tvAm-arhati pratyAKyAtum na vakzyAmi-iti /
   ahaṃ punaḥ kathaṃ na vakṣye tubhyamiti //8//	aham punar kaTam na vakzye tuByam-iti //8//
   START BrhUp 6,2.9	START BrhUp 6,2.9
   asau vai loko 'gnir gautama |	asO vE lokaH agniH gOtamaH |
   tasyāditya eva samit |	tasya-AdityaH eva samiD |
   raśmayo dhūmaḥ |	raSmayaH DUmaH |
   ahar arciḥ |	ahar arciH |
   diśo 'ṅgārāḥ |	diSaH aFgArAH |
   avāntaradiśo viṣphuliṅgāḥ |	avAntara-diSaH vizPuliFgAH |
   tasminn etasminn agnau devāḥ śraddhāṃ juhvati |	tasmin etasmin agnO devAH SradDAm juhvati |
   tasyā āhutyai somo rājā saṃbhavati || BrhUp_6,2.9 ||	tasyE AhutyE somaH rAjA saMBavati || BrhUp_6,2.9 ||
   BrhUpBh_6,2.9 asau vai loko 'gnirgotametyādicaturthaḥ praśnaḥ prāthamyena	BrhUpBh_6,2.9 asO vE lokaH agniH-gotama-ityAdi-caturTaH praSnaH prATamyena
   nirṇīyate /	nirNIyate /
   kramabhaṅgastvetannirṇayāyattatvāditaraprasnanirṇayasya /	krama-BaFgaH-tu-etat-nirNaya-Ayatta-tvAt-itara-prasna-nirNayasya /
   asau dyaurloko 'gnirhe gautama dyuloke 'gnidṛṣṭiranagnau vidhīyate yathā	asO dyOH-lokaH agniH-he gOtama dyuloke agni-dRzwiH-anagnO viDIyate yaTA
   yoṣitpuruṣayostasya dyulokāgnerāditya eva samitsamindhanāt /	yozit-puruzayoH-tasya dyu-loka-agneH-AdityaH eva samiD-saminDanAt /
   ādityena hi samidhyate 'sau lokaḥ /	Adityena hi samiDyate asO lokaH /
   raśmayo dhūmaḥ samidha uththānasāmānyāt /	raSmayaH DUmaH samiDaH uTTAna-sAmAnyAt /
   ādityāddhi raśmayo nirgatāḥ /	AdityAt-hi raSmayaH nirgatAH /
   samidhaśca dhūmo loka uttiṣṭhati /	samiDaH-ca DUmaH loke uttizWati /
   ahararciḥ prakāśasāmānyāt /	ahararciH prakASa-sAmAnyAt /
   diśo 'ṅgārā upaśamasāmānyāt /	diSaH aFgArAH upaSama-sAmAnyAt /
   avāntaradiṣo visphuliṅgā visphuliṅgavadvikṣepāt /	avAntara-dizaH visPuliFgAH visPuliFga-vat-vikzepAt /
   tasminnetasminnevaṅguṇaviśiṣṭe dyulokāgnau devā indrādayaḥ śraddhāṃ	tasmin=-etasmin=-evaFguNa-viSizwe dyu-loka-agnO devAH indra-AdayaH SradDAm
   juhvatyāhutidravyasthānīyāṃ prakṣipanti /	juhvati-Ahuti-dravya-sTAnIyAm prakzipanti /
   tasyā āhutyā āhuteḥ somo rājā pitṝṇāṃ brāhmaṇānāṃ ca saṃbhavati /	tasyAH AhutyE AhuteH somaH rAjA pitLNAm brAhmaNAnAm ca saMBavati /
   tatra ke devāḥ kathaṃ juhvati kiṃvā śraddhākhyaṃ havirityata uktamasmābhiḥ	tatra ke devAH kaTam juhvati kiMvA SradDA-AKyam haviH-iti-atas uktam-asmABiH
   saṃbandhe /	saMbanDe /
   na tvevainayostvamutkrāntimityādipadārthaṣaṭkanirṇayārthamagnihotra uktam	na tu-eva-enayoH-tvam-utkrAntim-iti-Adi-padArTa-zawka-nirNaya-arTam-agnihotraH uktam
   te vā ete agnihotrāhutī hute satyāvutkrāmataḥ /	te vE ete agni-hotra-AhutI hute satyO=-utkrAmataH /
   te antarikṣamāviśataḥ /	te antarikzam-AviSataH /
   te antarikṣamāhavanīyaṃ kurvāte vāyuṃ samidhaṃ marīcīreva śukrāmāhutim /	te antarikzam-AhavanIyam kurvAte vAyum samiDam marIcIH-eva SukrAm-Ahutim /
   te antarikṣantarpayataḥ /	te antarikzan-tarpayataH /
   te tata utkrāmataḥ /	te tatas utkrAmataH /
   te divamāviśataḥ /	te divam-AviSataH /
   te divamāhavanīyaṃ kurvāte ādityaṃ samidhamityevamādyuktam /	te divam-AhavanIyam kurvAte Adityam samiDam-iti-evamAdi-uktam /
   tatrāgnihotrāhutī sasādhane evotkrāmataḥ /	tatra-agni-hotra-AhutI sa-sADane eva-utkrAmataH /
   yatheha yaiḥ sādhanairviśiṣṭe ye jñāyete	yaTA-iha yEH sADanEH-viSizwe ye jQAyete
   āhavanīyāgnisamiddhūmāṅgāravisphuliṅgāhutidravyaiste tathaivotkrāmato	AhavanIya-agni-samidDUma-aFgAra-visPuliFga-Ahuti-dravyEH-te taTA-eva-utkrAmato
   'smāllokādamuṃ lokam /	asmAt-lokAt-amum lokam /
   tatrāgniragnitvena samitsamittvena dhūmo dhūmatvenāṅgārā aṅgāratvena	tatra-agniH-agni-tvena samiD-samittvena DUmaH DUma-tvena-aFgArAH aFgAra-tvena
   visphuliṅgatvenā'hutidravyamapi paya ādyāhutidravyatvenaiva	visPuliFga-tvenA-ahuti-dravyam-api payaH AdyAhuti-dravya-tvena-eva
   sargādāvavyākṛtāvasthāyāmapi pareṇasūkṣmeṇā'tmanā vyavatiṣṭhate /	sarga-AdO=-avyAkRta-avasTAyAm-api pareNa-sUkzmeNA-atmanA vyavatizWate /
   tadvidyamānameva sasādhanamagnihotralakṣaṇaṃ karmāpūrveṇā'tmanā	tat-vidyamAnam-eva sa-sADanam-agnihotra-lakzaNam karma-apUrveNA-atmanA
   vyavasthitaṃ sattatpunarvyākaraṇakāle	vyavasTitam sat-tad-punar-vyAkaraNa-kAle
   tathaivāntarikṣādīnāmāhavanīyādyagnyādibhāvaṃ kurvadvipariṇamate /	taTA-eva-antarikza-AdInAm-AhavanIya-Adi-agni-Adi-BAvam kurvat-vipariNamate /
   tathaivedānīmapyagnihotrākhyaṃ karma /	taTA-eva-idAnIm-api-agnihotra-AKyam karma /
   evamagnihotrāhutyapūrvavipariṇāmātmakaṃ jagatsarvamityāhutyoreva	evam-agni-hotra-Ahuti-apUrva-vipariNAma-Atmakam jagat-sarvam-iti-AhutyoH-eva
   stutyarthatvenotkrāntyādyā lokaṃ pratyutthāyināntāḥ ṣaṭ padārthāḥ	stuti-arTa-tvena-utkrAnti-AdyAH lokam pratyutTAyinA-antAH zaw padArTAH
   karmaprakaraṇe 'dhastānnirṇītāḥ /	karma-prakaraNe aDastAt-nirNItAH /
   iha tu kartuḥ karmavivakṣāyāṃ dyulokāgnyādyārabhya	iha tu kartuH karma-vivakzAyAm dyu-loka-agni-Adi-AraBya
   pañcāgnidarśanamuttaramārgapratipattisādhanaṃ viśiṣṭakarmaphalopabhogāya	paQca-agni-darSanam-uttara-mArga-pratipatti-sADanam viSizwa-karma-Pala-upaBogAya
   vidhitsitamiti dyulokāgnyādidarśanaṃ prastūyate /	viDitsitam-iti dyu-loka-agni-Adi-darSanam prastUyate /
   tatra ya ādhyātmikāḥ prāṇā ihāgnihotrasya hotārasta evā'dhidaivikatvena	tatra ye ADyAtmikAH prANAH iha-agnihotrasya hotAraH-te evA-aDidEvika-tvena
   pariṇatāḥ santa indrādayo bhavanti ta eva tatra hotāro dyulokāgnau /	pariNatAH santaH indra-AdayaH Bavanti te eva tatra hotAraH dyu-loka-agnO /
   te cehāgnihotrasya phalabhogāyāgnihotraṃ hutavantaḥ /	te ca-iha-agnihotrasya Pala-BogAya-agnihotram hutavantaH /
   ta eva phalapariṇāmakāle 'pi tatphalabhoktṛtvāttatra tatra hotṛtvaṃ	te eva Pala-pariNAma-kAle api tad-Pala-BoktR-tvAt-tatra tatra hotR-tvam
   pratipadyante tathā tathā vipariṇamamānā devaśabdavācyāḥ santaḥ /	pratipadyante taTA taTA vipariNamamAnAH deva-Sabda-vAcyAH santaH /
   atra ca yatpayodravyamagnihotrakarmāśrayabhūtamihā'havanīye	atra ca yat-payaH-dravyam-agnihotra-karma-ASraya-BUtam-ihA-ahavanIye
   prakṣiptamagninā bhakṣitamadṛṣṭena sūkṣmema rūpeṇa vipariṇataṃ saha kartrā	prakziptam-agninA Bakzitam-adRzwena sUkzmema rUpeNa vipariNatam saha kartrA
   yajamānenāmuṃ lokaṃ dhūmādikrameṇāntarikṣāddyulokamāviśati /	yajamAnena-amum lokam DUma-Adi-krameNa-antarikzAt-dyulokam-AviSati /
   tāḥ sūkṣmā āpa āhutikāryabhūtā agnihotrasamavāyinyaḥ kartṛsahitāḥ	tAH sUkzmAH ApaH Ahuti-kArya-BUtAH agnihotra-sama-vAyinyaH kartR-sahitAH
   śraddhāśabdavācyāḥ somaloke kartuḥ śarīrāntarārambhāya dyulokaṃ	SradDA-Sabda-vAcyAH soma-loke kartuH SarIra-antara-AramBAya dyulokam
   praviśantyo hūyante ityucyante /	praviSantyaH hUyante iti-ucyante /
   tāstatra dyulokaṃ praviśya somamaṇḍale kartuḥ śarīramārabhante /	tAH-tatra dyulokam praviSya soma-maNxale kartuH SarIram-AraBante /
   tadetaducyate devāḥ śraddhāṃ juhvati tasyā āhutyai somo rājā saṃbhavatīti	tat-etat-ucyate devAH SradDAm juhvati tasyE AhutyE somaH rAjA saMBavati-iti
   "śraddhā vā āpaḥ"iti śruteḥ /	"SradDA vA ApaH"iti SruteH /
   vettha yatithyāmāhutyāṃ hutāyāmāpaḥ puruṣavāco bhūtvā samutthāya vadantoti	vetTa yatiTyAm-AhutyAm hutAyAmApaH puruza-vAcaH BUtvA samutTAya vadantoti
   praśnastasya ca nirṇayaviṣaye 'sau vai loko 'gniriti prastutam /	praSnaH-tasya ca nirNaya-vizaye asO vE lokaH agniH-iti prastutam /
   tasmādāpaḥ karmasamāvāyinyaḥ kartuḥ śarīrārambhikāḥ śraddhāśabdavācyā iti	tasmAt-ApaH karma-samAvAyinyaH kartuH SarIra-AramBikAH SradDA-Sabda-vAcyAH iti
   niścīyate /	niScIyate /
   bhūyastvādāpaḥ puruṣavāca iti vyapadeśo na tvitarāṇi bhūtāni na santīti /	BUyas-tvAdApaH puruza-vAcaH iti vyapadeSaH na tu-itarANi BUtAni na santi-iti /
   karmaprayuktaśca śarīrārambhaḥ /	karma-prayuktaH-ca SarIra-AramBaH /
   karma cāpsamavāyi /	karma ca-apsamavAyi /
   tataścāpāṃ prādhānyaṃ śarīrakartṛtve /	tatas-ca-apAm prADAnyam SarIra-kartR-tve /
   tena cā'paḥ puruṣavāca iti vyapadeśaḥ /	tena cA-apaH puruza-vAcaH iti vyapadeSaH /
   karmakṛto hi janmārambhaḥ sarvatra /	karma-kRtaH hi janma-AramBaH sarvatra /
   tatra yadyapyagnihotrāhutistutidvāreṇotkrāntyādayaḥ prastutāḥ ṣaṭpadārthā	tatra yadi-api-agnihotra-Ahuti-stuti-dvAreNa-utkrAnti-AdayaH prastutAH zawpadArTA
   agnihotre tathāpi vaidikāni sarvāṇyeva karmāṇyagnihotraprabhṛtīni	agnihotre taTA-api vEdikAni sarvANi-eva karmANi-agnihotra-praBRtIni
   lakṣyante /	lakzyante /
   dārāgnisaṃbaddhaṃ hi pāṅktaṃ karma prastutyoktam-karmaṇā pitṛloka iti /	dAra-agni-saMbadDam hi pAFktam karma prastutya-uktam-karmaNA pitR-lokaH iti /
   vakṣyati ca-atha ye yajñena dānena tapasā lokāñjayantīti //9//	vakzyati ca-aTa ye yajQena dAnena tapasA lokAn-jayanti-iti //9//
   START BrhUp 6,2.10	START BrhUp 6,2.10
   parjanyo vā agnir gautama |	parjanyaH vE agniH gOtamaH |
   tasya saṃvatsara eva samit |	tasya saMvatsaraH eva samiD |
   abhrāṇi dhūmaḥ |	aBrANi DUmaH |
   vidyud arciḥ |	vidyut arciH |
   aśanir aṅgārāḥ |	aSaniH aFgArAH |
   hrādunayo viṣphuliṅgāḥ |	hrAdunayaH vizPuliFgAH |
   tasminn etasminn agnau devāḥ somaṃ rājānaṃ juhvati |	tasmin etasmin agnO devAH somam rAjAnam juhvati |
   tasyā āhutyai vṛṣṭiḥ saṃbhavati || BrhUp_6,2.10 ||	tasyE AhutyE vRzwiH saMBavati || BrhUp_6,2.10 ||
   BrhUpBh_6,2.10 parjanyo vā agnirgautama dvitīya āhutyādhāra	BrhUpBh_6,2.10 parjanyaH vE agniH-gOtama dvitIyaH Ahuti-ADAra
   āhutyorāvṛttikrameṇa /	AhutyoH-AvRtti-krameNa /
   parjanyo nāma vṛṣṭyupakaraṇābhimānī devatātmā /	parjanyaH nAma vRzwi-upakaraNa-aBimAnI devatA-AtmA /
   tasya saṃvatsara eva samit /	tasya saMvatsaraH eva samiD /
   saṃvatsareṇa hi śaradādibhirgrīṣmāntaiḥ svāvayavairvaparivartamānena	saMvatsareNa hi Sarad-AdiBiH-grIzma-antEH sva-avayavEH-va-parivartamAnena
   parjanyo 'gnirdīpyate /	parjanyaH agniH-dIpyate /
   abhrāṇi dhūmaḥ /	aBrANi DUmaH /
   dhūmaprabhavatvāddhūmavadupalakṣyatvādvā /	DUma-praBava-tvAt-DUma-vat-upalakzya-tvAt-vA /
   vidyudarciḥ /	vidyut-arciH /
   prakāśasāmānyāt /	prakASa-sAmAnyAt /
   aśaniraṅgārāḥ /	aSaniH-aFgArAH /
   upaśāntakāṭhinyasāmānyābhyām /	upaSAnta-kAWinya-sAmAnyAByAm /
   hrādunayo hlādunayaḥ stanayitnuśabdā visphuliṅgāḥ /	hrAdunayaH hlAdunayaH stanayitnu-SabdAH visPuliFgAH /
   vikṣepānekatvasāmānyāt /	vikzepa-aneka-tva-sAmAnyAt /
   tasminnetasminnityāhutyadhikaraṇanirdeśaḥ /	tasmin=-etasmin=-iti-Ahuti-aDikaraNa-nirdeSaH /
   devā iti ta eva hotāraḥ somaṃ rājānaṃ juhvati /	devAH iti te eva hotAraH somam rAjAnam juhvati /
   yo 'sau dyulokāgnau śraddhāyāṃ hutāyāmabhinirvṛttaḥ somaḥ sa dvitīye	yaH asO dyu-loka-agnO SradDAyAm hutAyAm-aBinirvRttaH somaH sa dvitIye
   parjanyāgnau hūyate /	parjanya-agnO hUyate /
   tasyāśca somāhutervṛṣṭiḥ saṃbhavati //10//	tasyAH-ca soma-AhuteH-vRzwiH saMBavati //10//
   START BrhUp 6,2.11	START BrhUp 6,2.11
   ayaṃ vai loko 'gnir gautama |	ayam vE lokaH agniH gOtamaH |
   tasya pṛthivy eva samit |	tasya pRTivI eva samiD |
   agnir dhūmaḥ |	agniH DUmaH |
   rātrir arciḥ |	rAtriH arciH |
   candramā aṅgārāḥ |	candramAH aFgArAH |
   nakṣatrāṇi viṣphuliṅgāḥ |	nakzatrANi vizPuliFgAH |
   tasminn etasminn agnau devā vṛṣṭiṃ juhvati |	tasmin etasmin agnO devAH vRzwim juhvati |
   tasyā āhutyā annaṃ saṃbhavati || BrhUp_6,2.11 ||	tasyE AhutyE annam saMBavati || BrhUp_6,2.11 ||
   BrhUpBh_6,2.11 ayaṃ vai loko 'gnirgotama /	Brhu-upBh_6,2.11 ayam vE lokaH agniH-gotamaH /
   ayaṃ loka iti prāṇijanmopabhogāśrayaḥ kriyākārakaphalaviśiṣṭaḥ sa tṛtīyo	ayam lokaH iti prANi-janma-upaBoga-ASrayaH kriyA-kAraka-Pala-viSizwaH sa tRtIyaH-
   'gniḥ /	agniH /
   tasyāgneḥ pṛthivyeva samit /	tasya-agneH pRTivI-eva samiD /
   pṛthivyā hyayaṃ loko 'nekaprāṇyupabhogasaṃpannayā samidhyate /	pRTivyAH hi-ayam lokaH aneka-prANi-upaBoga-saMpannayA samiDyate /
   agnirdhūmaḥ /	agniH-DUmaH /
   pṛthivyāśrayotthānasāmānyāt /	pRTivI-ASraya-utTAna-sAmAnyAt /
   pārthivaṃ hīndhanadravyamāśrityāgniruttiṣṭhati /	pArTivam hi-inDana-dravyam-ASritya-agniH-uttizWati /
   yathā samidāśrayena dhūmaḥ /	yaTA samiD-ASrayena DUmaH /
   rātrirarciḥ /	rAtriH-arciH /
   samitsaṃbandhaprabhavasāmānyāt /	samiD-saMbanDa-praBava-sAmAnyAt /
   agneḥ samitsaṃbandhena hyarciḥ saṃbhavati /	agneH samiD-saMbanDena hi-arciH saMBavati /
   tathā pṛthivīsamitsaṃbandhena śarvarī /	taTA pRTivI-samiD-saMbanDena SarvarI /
   pṛthivīchāyāṃ hi śārvaraṃ taṃ ācakṣate /	pRTivI-CAyAm hi SArvaram tam Acakzate /
   candramā aṅgārāḥ /	candramAH aFgArAH /
   tatprabhavatvasāmānyāt /	tad-praBava-tva-sAmAnyAt /
   arciṣo hyaṅgārāḥ prabhavanti tathā rātrau candramāḥ /	arcizaH hi-aFgArAH praBavanti taTA rAtrO candramAH /
   upaśāntatvasāmānyādvā /	upaSAnta-tva-sAmAnyAt-vA /
   nakṣatrāṇi visphuliṅgāḥ /	nakzatrANi visPuliFgAH /
   bisphuliṅgavadvikṣepasāmānyāt /	bisPuliFga-vat-vikzepa-sAmAnyAt /
   tasminnetasminnityādi pūrvavat /	tasmin=-etasmin=-ityAdi pUrvavat /
   vṛṣṭiṃ juhvati tasyā āhuterannaṃ saṃbhavati /	vRzwim juhvati tasyAH AhuteH-annam saMBavati /
   vṛṣṭiprabhavatvasya prasiddhatvādvrīhiyavāderannasya //11//	vRzwi-praBava-tu-asya prasidDa-tvAt-vrIhi-yava-AdeH-annasya //11//
   START BrhUp 6,2.12	START BrhUp 6,2.12
   puruṣo vā agnir gautama |	puruzaH vE agniH gOtamaH |
   tasya vyāttam eva samit |	tasya vyAttam eva samiD |
   prāṇo dhūmaḥ |	prANaH DUmaH |
   vāg arciḥ |	vAc arciH |
   cakṣur aṅgārāḥ |	cakzuH aFgArAH |
   śrotraṃ viṣphuliṅgāḥ |	Srotram vizPuliFgAH |
   tasminn etasminn agnau devā annaṃ juhvati |	tasmin etasmin agnO devAH annam juhvati |
   tasyā āhutyai retaḥ saṃbhavati || BrhUp_6,2.12 ||	tasyE AhutyE retaH saMBavati || BrhUp_6,2.12 ||
   BrhUpBh_6,2.12 puruṣo vā agnirgautama prasiddhaḥ	Brhu-upBh_6,2.12 puruzaH vE agniH-gOtama prasidDaH
   śiraḥpāṇyādimānpuruṣaścaturtho 'gnistasya vyāttaṃ vivṛtaṃ mukhaṃ samit /	SiraH-pANi-AdimAn-puruzaH-caturTaH agniH-tasya vyAttam vivRtam muKam samiD /
   vivṛtena hi mukhena dīpyate puruṣo vacanasvādhyāyādau /	vivRtena hi muKena dIpyate puruzaH vacana-svADyAya-AdO /
   yathā samidhāgniḥ prāṇo dhūmastadutthānasāmānyāt /	yaTA samiDA-agniH prANaH DUmaH-tad-utTAna-sAmAnyAt /
   mukhāddhi prāṇa uttiṣṭhati /	muKAt-hi prANaH uttizWati /
   vākyaśabdo 'rcirvyañjakatvasāmānyāt /	vAkya-SabdaH arciH-vyaQjaka-tva-sAmAnyAt /
   arciśca vyañjakam /	arciH-ca vyaQjakam /
   tathā vākśabdo 'bhidheyavyañjakaḥ /	taTA vAc-SabdaH aBiDeya-vyaQjakaH /
   cakṣuraṅgārā upaśamasāmānyātprakāśāśrayatvādvā /	cakzuH-aFgArAH upaSama-sAmAnyAt-prakASa-ASraya-tvAt-vA /
   śrotraṃ visphuliṅgā vikṣepasāmānyāt /	Srotram visPuliFgAH vikzepa-sAmAnyAt /
   tasminnannaṃ juhvati /	tasmin=-annam juhvati /
   nanu naiva devā annamiha juhvato dṛśyante /	nanu na-eva devAH annam-iha juhvataH dRSyante /
   naiṣa doṣaḥ /	na-eza dozaH /
   prāṇānāṃ devatvopapatteḥ /	prANAnAm deva-tva-upapatteH /
   adhidaivamindrādayo devāsta evādhyātmaṃ prāṇāste cānnasya puruṣe	aDidEvam-indra-AdayaH devAH-te eva-aDyAtmam prANAH-te ca-annasya puruze
   prakṣeptāraḥ /	prakzeptAraH /
   tasyā āhute retaḥ saṃbhavati /	tasyAH Ahute retaH saMBavati /
   annapariṇāmo hi retaḥ //12//	anna-pariNAmaH hi retaH //12//
   START BrhUp 6,2.13	START BrhUp 6,2.13
   yoṣā vā agnir gautama |	yozA vE agniH gOtamaH |
   tasyā upastha eva samit |	tasyAH upasTaH eva samiD |
   lomāni dhūmaḥ |	lomAni DUmaH |
   yonir arciḥ |	yoniH arciH |
   yad antaḥ karoti te 'ṅgārāḥ |	yat antar karoti te aFgArAH |
   abhinandā viṣphuliṅgāḥ |	aBinandAH vizPuliFgAH |
   tasminn etasminn agnau devā reto juhvati |	tasmin etasmin agnO devAH retaH juhvati |
   tasyā āhutyai puruṣaḥ saṃbhavati |	tasyE AhutyE puruzaH saMBavati |
   sa jīvati yāvaj jīvati |	sa jIvati yAvat jIvati |
   atha yadā mriyate || BrhUp_6,2.13 ||	aTa yadA mriyate || BrhUp_6,2.13 ||
   BrhUpBh_6,2.13 yoṣā vā agnirgautama /	Brhu-upBh_6,2.13 yozAH vE agniH-gOtamaH /
   yoṣeti srī pañcamo homādhikaraṇo 'gnistasyā upastha eva samit /	yozA-iti srI paQcamaH homa-aDikaraNaH agniH-tasyAH upasTaH eva samiD /
   tena hi sā samidhyate /	tena hi sA samiDyate /
   lomāni dhūmastadutthānasāmānyāt /	lomAni DUmaH-tad-utTAna-sAmAnyAt /
   yonirarcirvarṇasāmānyāt /	yoniH-arciH-varNa-sAmAnyAt /
   yadantaḥ karoti te 'ṅgārā antaḥ karaṇaṃ maithunavyāpāraste 'ṅgārā	yat-antar karoti te aFgArAH antar karaNam mETuna-vyApAraH-te aFgArA
   vīryopaśamahetutvasāmānyāt /	vIrya-upaSama-hetu-tva-sAmAnyAt /
   vīryādyupaśamakāraṇaṃ maithunam /	vIrya-Adi-upaSama-kAraNam mETunam /
   tathāṅgārabhāvo 'gnerupaśamakāraṇam /	taTA-aFgAra-BAvaH agneH-upaSama-kAraNam /
   abhinandāḥ sukhalavāḥ kṣudratvasāmānyādvisphuliṅgāḥ /	aBinandAH suKa-lavAH kzudra-tva-sAmAnyAt-visPuliFgAH /
   tasminreto juhvati /	tasmin-retaH juhvati /
   tasyā āhuteḥ puruṣaḥ saṃbhavati /	tasyAH AhuteH puruzaH saMBavati /
   evaṃ dyuparjanyāyaṃlokapuruṣayoṣāgniṣu kramema hūyamānāḥ	evam dyuparjanyAyaMloka-puruza-yoza-agnizu kramema hUyamAnAH
   śraddhāsomavṛṣṭyannaretobhāvena sthūlatāratamyakramamāpadyamānāḥ	SradDA-soma-vRzwi-anna-retaH-BAvena sTUla-tAratamya-kramam-ApadyamAnAH
   śraddhāśabdavācyā āpaḥ puruṣaśabdamārabhante /	SradDA-Sabda-vAcyAH ApaH puruza-Sabdam-AraBante /
   yaḥ praśnaścaturtho vettha yatithyāmāhutyāṃ hutāyāmāpaḥ puraṣavāco bhūtvā	yaH praSnaH-caturTaH vetTa yatiTyAm-AhutyAm hutAyAmApaH purazavAcaH BUtvA
   samutthāya vadantī3iti sa eṣa nirṇītaḥ /	samutTAya vadantI3-iti saH eza nirNItaH /
   pañcamyāmāhutau yoṣāgnau hutāyāṃ retobhūtā āpaḥ puruṣavāco bhavantīti /	paQcamyAm-AhutO yoza-agnO hutAyAm retaH-BUtAH ApaH puruza-vAcaH Bavanti-iti /
   sa puruṣa evaṃ krameṇa jāto jīvati /	sa puruzaH evam krameNa jAtaH jIvati /
   kiyantaṃ kālamiti /	kiyantam kAlam-iti /
   ucyate-yāvajjīvati yāvadasmiñcharīre sthitinimittaṃ karma vidyate	ucyate--yAvat-jIvati yAvat-asmin-SarIre sTiti-nimittam karma vidyate
   tāvadityarthaḥ /	tAvat-iti-arTaH /
   atha tatkṣaye yadā yasmikāle mriyate //13//	aTa tad-kzaye yadA yasmi-kAle mriyate //13//
   START BrhUp 6,2.14	START BrhUp 6,2.14
   athainam agnaye haranti |	aTa-enam agnaye haranti |
   tasyāgnir evāgnir bhavati |	tasya-agniH eva-agniH Bavati |
   samit samit |	samiD samiD |
   dhūmo dhūmaḥ |	DUmaH DUmaH |
   arcir arciḥ |	arciH arciH |
   aṅgārā aṅgārāḥ |	aFgArAH aFgArAH |
   viṣphuliṅgā viṣphuliṅgāḥ |	vizPuliFgAH vizPuliFgAH |
   tasminn etasminn agnau devāḥ puruṣaṃ juhvati |	tasmin etasmin agnO devAH puruzam juhvati |
   tasyā āhutyai puruṣo bhāsvaravarṇaḥ saṃbhavati || BrhUp_6,2.14 ||	tasyE AhutyE puruzaH BAsvara-varNaH saMBavati || BrhUp_6,2.14 ||
   BrhUpBh_6,2.14 atha tadainaṃ mṛtamagnaye 'gnyarthamevāntyāhutyai haranti	Brhu-upBh_6,2.14 aTa tadA-enam mRtam-agnaye agni-arTam-eva-antya-AhutyE haranti
   śratvijastasyā'hutibhūtasya prasiddho 'gnireva homādhikaraṇaṃ na	SratvijaH-tasyAH-ahuti-BUtasya prasidDaH agniH-eva homa-aDikaraNam na
   parikalpyo 'gniḥ /	parikalpyaH agniH /
   prasiddhaiva samitsamiddhūmo dhūmo 'rcirarciraṅgārā aṅgārā visphuliṅgā	prasidDA-eva samiD-samiD-DUmaH DUmaH arciH-arciH-aFgArA aFgArA visPuliFgA
   visphuliṅgā yathāprasiddhameva sarvamityarthaḥ /	visPuliFgAH yaTAprasidDam-eva sarvam-iti-arTaH /
   tasminpuruṣamantyāhutiṃ juhvati tasyā āhutyā āhuteḥ puruṣo bhāsvaravarṇo	tasmin-puruzam-antya-Ahutim juhvati tasyAH AhutyAH AhuteH puruzaH BAsvara-varNaH-
   'tiśayadīptimānniṣekādibhirantyāhutyantaiḥ karmabhiḥ	atiSaya-dIptimAn-nizeka-AdiBiH-anti-Ahuti-antEH karmaBiH
   saṃskṛtatvātsaṃbhavati niṣpadyate //14//	saMskRta-tvAt-saMBavati nizpadyate //14//
   START BrhUp 6,2.15	START BrhUp 6,2.15
   te ya evam etad vidur ye cāmī araṇye śraddhāṃ satyam upāsate te 'rcir	te yaH evam etat viduH ye ca-amI araNye SradDAm satyam upAsate te arciH-
   abhisaṃbhavanti |	aBisaMBavanti |
   arciṣo 'haḥ |	arcizaH ahar |
   ahna āpūryamāṇapakṣam |	ahnaH ApUryamANa-pakzam |
   āpūryamāṇapakṣād yān ṣaṇ māsān udaṅṅ āditya eti |	ApUryamANa-pakzAt yAn zaw mAsAn udaF AdityaH eti |
   māsebhyo devalokam |	mAseByaH deva-lokam |
   devalokād ādityam |	deva-lokAt Adityam |
   ādityād vaidyutam |	AdityAt vEdyutam |
   tān vaidyutān puruṣo mānasa etya brahmalokān gamayati |	tAn vEdyutAn puruzaH mAnasaH etya brahma-lokAn gamayati |
   te teṣu brahmalokeṣu parāḥ parāvato vasanti |	te tezu brahma-lokezu parAH parAvataH vasanti |
   teṣāṃ na punar āvṛttiḥ || BrhUp_6,2.15 ||	tezAm na punar AvRttiH || BrhUp_6,2.15 ||
   BrhUpBh_6,2.15 idānīṃ prathamapraśnanirākaraṇārthamāha-te /	Brhu-upBh_6,2.15 idAnIm praTama-praSna-nirAkaraNa-arTam-Aha-te /
   ke /	ke /
   ya evaṃ yathoktaṃ pañcāgnidarśanametadviduḥ /	yaH evam yaToktam paQca-agni-darSanam-etat-viduH /
   evaṃ śabdādagnisamiddhūmārciraṅgāravisphuliṅgaśraddhādiviśiṣṭāḥ pañcāgnayo	evam SabdAt-agni-samidDUma-arciH-aFgAra-visPuliFga-SradDA-Adi-viSizwAH paQca-agnayaH-
   nirdiṣṭāstānevametānpañcāgnīnvidurityarthaḥ /	nirdizwAH-tAn-evam-etAn-paQca-agnIn-viduH-iti-arTaH /
   nanvagnihotrāhutidarśanaviṣayamevaitaddarśanam /	nanu-agni-hotra-Ahuti-darSana-vizayam-eva-etat-darSanam /
   tatra hyuktamutkrāntyādipadārthaṣaṭkanirṇaye divamevā'havanīyaṃ kurvāte	tatra hi-uktam-utkrAnti-Adi-padArTa-zawka-nirNaye divam-evA-ahavanIyam kurvAte
   ityādi /	ityAdi /
   ihāpyamuṣya lokasyāgnitvamādityasya ca samittvamityādi bahu sāmyam /	iha-api-amuzya lokasya-agni-tvam-Adityasya ca samittvam-ityAdi bahu sAmyam /
   tasmāttaccheṣamevaitaddarśanamiti /	tasmAt-tad-Sezam-eva-etat-darSanam-iti /
   na, yatithyāmiti prasnaprativacanaparigrahāt /	na, yatiTyAm-iti prasna-prativacana-parigrahAt /
   yatithyāmityasya praśnasya prativacanasya yāvadeva	yatiTyAm-iti-asya praSnasya prativacanasya yAvat-eva
   parigrahastāvadevaivaṃśabdena parāmraṣṭuṃ yuktam /	parigrahaH-tAvat-eva-evaMSabdena parAmrazwum yuktam /
   anyathā praśnānarthakyānnirjñātatvācca saṃkhyāyā agnaya eva vaktavyāḥ /	anyaTA praSna-AnarTakyAn-nirjQAta-tvAt-ca saMKyAyAH agnayaH eva vaktavyAH /
   atha nirjñātamapyanūdyate /	aTa nirjQAtam-api-anUdyate /
   yathāprāptasyaivānuvadanaṃ yuktaṃ na tvasau loko 'gniriti /	yaTA-prAptasya-eva-anuvadanam yuktam na tu-asO lokaH agniH-iti /
   athopalakṣaṇārthaḥ tathāpyādyenāntyena copalakṣaṇaṃ yuktam /	aTa-upalakzaNa-arTaH taTA-api-Adyena-antyena ca-upalakzaNam yuktam /
   śrutyantarācca /	Sruti-antarAt-ca /
   samāne hi prakaraṇe chāndogyaśrutau pañcāgnīnvedeti pañcasaṃkhyāyā	samAne hi prakaraNe CAndogya-SrutO paQca-agnIn-veda-iti paQca-saMKyAyAH-
   evopādānādanagnihotraśeṣametat /	eva-upAdAnAt-anagnihotra-Sezam-etat /
   pañcāgnidarśanam /	paQca-agni-darSanam /
   yattvagnisamidādisāmānyaṃ tadagnihotrastutyarthamityavocāma /	yat-tu-agni-samiD-Adi-sAmAnyam tat-agni-hotra-stuti-arTam-iti-avocAma /
   tasmānnotkrāntyādipadārthaṣaṭkaparijñānādarcirādipratipattiḥ /	tasmAt-na-utkrAnti-Adi-padArTa-zawka-parijQAnAt-arcira-Adi-pratipattiH /
   evamiti prakṛtopādānenārcirādipratipattividhānāt /	evam-iti prakRta-upAdAnena-arciH-Adi-pratipatti-viDAnAt /
   ke punaste ya evaṃ vidurgṛhasthā eva /	ke punar-te yaH evam viduH-gRhasTAH eva /
   nanu teṣāṃ yajñādisādhanena dhūmādipratipattirvidhitsita /	nanu tezAm yajQa-Adi-sADanena DUma-Adi-pratipattiH-viDitsitaH /
   na, anevaṃvidāmapi gṛhasthānāṃ yajñādisādhanopapatteḥ /	na, anevaMvidAm-api gRhasTAnAm yajQa-Adi-sADana-upapatteH /
   bhikṣuvānaprasthayoścāraṇyasaṃbandhena grahaṇāt /	BikzuvAnaprasTayoH-ca-araNya-saMbanDena grahaNAt /
   gṛhasthakarmasaṃbaddhatvāccapañcāgnidarśanasya /	gRhasTa-karma-saMbadDa-tvAt-ca-paQca-agni-darSanasya /
   ato nāpi brahmacāriṇa evaṃ viduriti gṛhyante /	atas na-api brahmacAriNaH evam viduH-iti gRhyante /
   teṣāṃ tūttare pathi praveśaḥ	tezAm tu-uttare paTi praveSaH
   smṛtiprāmāṇyāt-"aṣṭāśītisahasrāṇāmṛṣīṇāmūrdhvaretasām /	smRti-prAmANya-at-"azwa-aSIti-sahasrANAm-RzINAm-UrDvaretasAm /
   uttareṇāryamṇaḥ panthāste 'mṛtatvaṃ hi bhejire"iti /	uttareNa-aryamNaH panTAH-te amRta-tvam hi Bejire"-iti /
   tasmādye gṛhasthā evamagnijo 'hamagnyapatyamityevaṃ krameṇāgnibhyo jāto	tasmAt-ye gRhasTAH evam-agni-jaH aham-agni-apatyam-iti-evam krameNa-agniByaH jAtaH-
   'gnirūpa ityevaṃ ye viduste ca ye cāmī araṇye vānaprasthāḥ	agni-rUpaH iti-evam ye viduH-te ca ye ca-amI araNye vAnaprasTAH
   parivrājakāścāraṇyaniṣṭhāḥ śraddhāṃ śraddhāyuktāḥ snataḥ satyaṃ brahma	parivrAjakAH-ca-araNya-nizWAH SradDAm SradDA-yuktAH snataH satyam brahma
   hiraṇyagarbhātmānamupāsate na punaḥ śraddhāṃ copāsate te sarve	hiraNyagarBa-AtmAnam-upAsate na punar SradDAm ca-upAsate te sarve
   'rcirabhisaṃbhavanti /	arciH-aBisaMBavanti /
   yāvadgṛhasthāḥ pañcāgnividyāṃ satyaṃ vā brahma na	yAvat-gRhasTAH paQca-agni-vidyAm satyam vA brahma na
   vidustāvacchraddhādyāhutikrameṇa pañcamyāmāhutau hutāyāṃ tato	viduH-tAvat-SradDA-Adi-Ahuti-krameNa paQcamyAm-AhutO hutAyAm tatas-
   yoṣāgnerjātāḥ punarlokaṃ pratyutthāyino 'gnihotrādikarmānuṣṭhātāro	yoza-agneH-jAtAH punar-lokam pratyutTAyinaH agnihotra-Adi-karma-anuzWA-tAraH-
   bhavanti /	Bavanti /
   tena karmaṇā dhūmādikrameṇa punaḥ pitṛlokaṃ punaḥ	tena karmaNA DUma-Adi-krameNa punar pitR-lokam punar-
   parjanyādikrameṇemamāvartante /	parjanya-Adi-krameNa-imam-Avartante /
   punaryoṣāgnerjātāḥ punaḥ karma kṛtvetyevameva ghaṭīyantravadgatyāgatibhyāṃ	punar-yoza-agneH-jAtAH punar karma kRtvA-iti-evam-eva GawIyantra-vat-gati-AgatiByAm
   punaḥ punarāvartante /	punar punar-Avartante /
   yadā tvevaṃ vidustato ghaṭīyantrabhramaṇādvinirmuktāḥ santo	yadA tu-evam viduH-tatas GawIyantra-BramaNAt-vinirmuktAH santaH-
   'rcirabhisaṃbhavanti /	arciH-aBisaMBavanti /
   arciriti nāgnijvālāmātraṃ kiṃ tarhyarcirabhimāninyarciḥ śabdavācyā	arciH-iti na-agni-jvAlA-mAtram kim tarhi-arciH-aBimAninI-arciH Sabda-vAcyA
   devatottaramārgalakṣaṇā vyavasthitaiva tāmabhisaṃbhavanti /	devatA-uttara-mArga-lakzaNAH vyavasTitA-eva tAm-aBisaMBavanti /
   na hi parivrājakānāmagnyarciṣaiva sākṣātsaṃbandho 'sti /	na hi parivrAjakAnAm-agni-arcizA-eva sAkzAt-saMbanDaH asti /
   tena devataiva parigṛhyate 'rciḥśabdavācyā /	tena devatA-eva parigRhyate arciH-Sabda-vAcyA /
   ato 'hardevatām /	atas ahar-devatAm /
   maraṇakālaniyamānupapatterahaḥśabdo 'pi devataiva /	maraNa-kAla-niyama-anupapatteH-ahar-SabdaH api devatA-eva /
   āyuṣaḥ kṣaye hi maraṇam /	AyuzaH kzaye hi maraNam /
   na hyevaṃvidāhanyeva martavyamityaharmaraṇakālo niyantuṃ śakyate /	na hi-evaMvidAhani-eva martavyam-iti-ahar-maraNa-kAlaH niyantum Sakyate /
   na ca rātrau pretāḥ santo 'haḥ pratīkṣante /	na ca rAtrO pretAH santaH ahar pratIkzante /
   "sa yāvatkṣipyenmanastāvadādityaṃ gacchati"iti śrutyantarāt /	"sa yAvat-kzipyet-manaH-tAvat-Adityam gacCati"-iti Sruti-antarAt /
   ahna āpūryamāṇapakṣamahardevatayātivāhitā āpūryamāṇapakṣadevatāṃ	ahnaH ApUryamANa-pakzam-ahar-devatayA-ativAhitAH ApUryamANa-pakza-devatAm
   pratipadyante śuklapakṣadevatāmityetat /	pratipadyante Sukla-pakza-devatAm-iti-etat /
   āpūryamāṇapakṣādyānṣaṇmāsānudaṅṅuttarāṃ diśamādityaḥ savitaiti	ApUryamANa-pakza-AdyAn-zaz-mAsAn-udaFFuttarAm diSam-AdityaH savitA-eti
   tānmāsānpratipadyante śuklapakṣadevatayātivāhitāḥsantaḥ /	tAn-mAsAn-pratipadyante Sukla-pakza-devatayA-ativAhitAH-santaH /
   māsāniti bahuvacanātsaṃghacāriṇyaḥ ṣaḍuttarāyaṇadevatāstebhyo māsebhyaḥ	mAsAn-iti bahuvacanAt-saMGa-cAriNyaH zaz-uttarAyaNa-devatAH-teByaH mAseByaH
   ṣaṇmāsadevatābhirativāhitā devalokābhimāninīṃ devatāṃ pratipadyante /	zaz-mAsa-devatABiH-ativAhitAH deva-loka-aBimAninIm devatAm pratipadyante /
   devalokādādityamādityādvaidyutaṃ vidyudabhimāninīṃ devatāṃ pratipadyante /	deva-lokAt-Adityam-AdityAt-vEdyutam vidyut-aBimAninIm devatAm pratipadyante /
   vidyuddevatāṃ prāptānbrahmalokavāsī puruṣo brahmaṇā manasā sṛṣṭo mānasaḥ	vidyut-devatAm prAptAn-brahma-loka-vAsI puruzaH brahmaNA manasA sRzwaH mAnasaH
   kaścidetyā'gatya brahmalokāngamayati /	kaScid-etyA-agatya brahma-lokAn-gamayati /
   brahmalokānityadharottarabhūmibhedena bhinnā iti gamyante /	brahma-lokAn-iti-aDara-uttara-BUmi-Bedena BinnAH iti gamyante /
   bahuvacanaprayogāt /	bahuvacana-prayogAt /
   upāsanatāratamyopapatteśca /	upAsana-tAratamya-upapatteH-ca /
   te tena puruṣeṇa gamitāḥ santasteṣu brahmalokeṣu parāḥ prakṛṣṭāḥ santaḥ	te tena puruzeNa gamitAH santaH-tezu brahma-lokezu parAH prakRzwAH santaH
   svayaṃ parāvataḥ prakṛṣṭāḥ samāḥ saṃvatsarānanekānvasanti /	svayam parAvataH prakRzwAH samAH saMvatsarAn-anekAn-vasanti /
   brahmaṇo 'nekānkalpānvasantītyarthaḥ /	brahmaNaH anekAn-kalpAn-vasanti-iti-arTaH /
   teṣāṃ brahmalokaṃ gatānāṃ nāsti punarāvṛttirasminsaṃsāre na	tezAm brahma-lokam gatAnAm na-asti punarAvRttiH-asmin-saMsAre na
   punarāgamanamiheti śākhāntarapāṭhāt /	punar-Agamanam-iha-iti SAKA-antara-pAWAt /
   ihetyākṛtimātragrahaṇamiti cecchvobhūte paurṇamāsīmiti yadvat /	iha-iti-AkRti-mAtra-grahaNam-iti ced-SvaH-BUte pOrNamAsIm-iti yadvat /
   na, ihetiviśeṣaṇānarthakyāt /	na, iha-iti-viSezaNa-AnarTakyAt /
   yadi hi nā'vartanta evehagrahaṇamanarthakameva syāt /	yadi hi nA-avartantaH eva-iha-grahaNam-anarTakam-eva syAt /
   śvobhūte paurṇamāsīmityatra paurṇamāsyāḥ śvobhūtatvamanuktaṃna jñāyata iti	SvoBUte pOrNamAsIm-iti-atra pOrNamAsyAH Svas-BUta-tvam-anuktaMna jQAyate iti
   yukta viśeṣayitum /	yukta viSezayitum /
   na hi tatra śvaākṛtiḥ śabdārtho vidyata iti śvaśabdo virarthaka eva	na hi tatra SvaAkRtiH Sabda-arTaH vidyate iti Sva-SabdaH virarTakaH eva
   prayujyate /	prayujyate /
   yatra tu viśeṣaṇaśabde prayukte 'nviṣyamāṇe viśeṣaṇaphalaṃ cenna gamyate	yatra tu viSezaNa-Sabde prayukte anvizyamANe viSezaNa-Palam ced-na gamyate
   tatra yukto nirarthakatvenotsraṣṭuṃ viśeṣaṇaśabdo na tu satyāṃ	tatra yuktaH nirarTaka-tvena-utsrazwum viSezaNa-SabdaH na tu satyAm
   viśeṣaṇaphalāvagatau /	viSezaNa-Pala-avagatO /
   tasmādasmātkalpādūrdhvamāvṛttirgamyate //15//	tasmAt-asmAt-kalpAt-UrDvam-AvRttiH-gamyate //15//
   START BrhUp 6,2.16	START BrhUp 6,2.16
   atha ye yajñena dānena tapasā lokāñ jayanti te dhūmam abhisaṃbhavanti |	aTa ye yajQena dAnena tapasA lokAn jayanti te DUmam aBisaMBavanti |
   dhūmād rātrim |	DUmAt rAtrim |
   rātrer apakṣīyamāṇapakṣam |	rAtreH apakzIyamANa-pakzam |
   apakṣīyamāṇapakṣād yān ṣaṇ māsān dakṣiṇāditya eti |	apakzIyamANa-pakzAt yAn zaw mAsAn dakziNa-AdityaH eti |
   māsebhyaḥ pitṛlokam |	mAseByaH pitR-lokam |
   pitṛlokāc candram |	pitR-lokAt candram |
   te candraṃ prāpyānnaṃ bhavanti |	te candram prApya-annam Bavanti |
   tāṃs tatra devā yathā somaṃ rājānam āpyāyasvāpakṣīyasvety evam enāṃs tatra	tAn tatra devAH yaTA somam rAjAnam ApyAyasva-apakzIyasva-iti evam enAn tatra
   bhakṣayanti |	Bakzayanti |
   teṣāṃ yadā tat paryavaity athemam evākāśam abhiniṣpadyante |	tezAm yadA tat paryavEti aTa-imam eva-AkASam aBinizpadyante |
   ākāśād vāyum |	AkASAt vAyum |
   vāyor vṛṣṭim |	vAyoH vRzwim |
   vṛṣṭeḥ pṛthivīm |	vRzweH pRTivIm |
   te pṛthivīṃ prāpyānnaṃ bhavanti |	te pRTivIm prApya-annam Bavanti |
   te punaḥ puruṣāgnau hūyante tato yoṣāgnau jāyante |	te punar puruza-agnO hUyante tatas yoza-agnO jAyante |
   lokān pratyuthāyinas ta evam evānuparivartante |	lokAn pratyuTAyinaH te evam eva-anuparivartante |
   atha ya etau panthānau na vidus te kīṭāḥ pataṅgā yad idaṃ dandaśūkam ||	aTa yaH etO panTAnO na viduH te kIwAH pataFgAH yat idam dandaSUkam ||
   BrhUp_6,2.16 ||	BrhUp_6,2.16 ||
   BrhUpBh_6,2.16 atha punarye naivaṃ	Brhu-upBh_6,2.16 aTa punar-ye na-evam
   vidurutkrāntyādyagnihotrasaṃbandhapadārthaṣaṭkasyaiva veditāraḥ	viduH-utkrAnti-Adi-agnihotra-saMbanDa-padArTa-zawkasya-eva veditAraH
   kevalakarmiṇo yajñenāgnihotrādinā dānena bahirvedi bhikṣamāṇeṣu	kevala-karmiNaH yajQena-agnihotra-AdinA dAnena bahis-vedi BikzamANezu
   dravyasaṃvibhāgalakṣaṇena tapasā bahirvedyeva dīkṣādivyatiriktena	dravya-saMviBAga-lakzaNena tapasA bahis-vedyeva dIkzA-Adi-vyatiriktena
   kṛcchracāndrāyaṇādinā lokāñjayanti /	kRcCra-cAndrAyaNa-AdinA lokAn-jayanti /
   lokāniti bahuvacanāttatrāpi phalatāramyamabhipretam /	lokAn-iti bahuvacanAt-tatra-api Pala-tA-ramyam-aBipretam /
   te dhūmamabhisaṃbhavanti /	te DUmam-aBisaMBavanti /
   uttaramārga ivehāpi devatā eva dhūmādiśabdavācyāḥ /	uttara-mArgaH iva-iha-api devatAH eva DUma-Adi-Sabda-vAcyAH /
   dhūmadevatāṃ pratipadyanta ityarthaḥ /	DUma-devatAm pratipadyante iti-arTaH /
   ātivāhikatvaṃ ca devatānāṃ tadvadeva /	AtivAhika-tvam ca devatAnAm tadvat-eva /
   dhūmādrātriṃ rātridevatāṃ tato 'pakṣīyamāṇapakṣadevatāṃ tato	DUmAt-rAtrim rAtri-devatAm tatas apakzIyamANa-pakza-devatAm tatas-
   yānṣaṇmāsāndakṣiṇāṃ diśamāditya eti tānmāsadevatāviśeṣānpratipadyante /	yAn-zaz-mAsAn-dakziNAm diSam-AdityaH eti tAn-mAsa-devatA-viSezAn-pratipadyante /
   māsebhyaḥ pitṛlokaṃ pitṛlokāccandram /	mAseByaH pitR-lokam pitR-lokAt-candram /
   te candraṃ prāpyānnaṃ bhavanti tāṃstatrānnabhūtānyathā somaṃ rājānamiha	te candram prApya-annam Bavanti tAn=-tatra-anna-BUtA-anyaTA somam rAjAnam-iha
   yajña ṛtvija āpyāyasvāpakṣīyasveti bhakṣayantyevamenāṃścandraṃ	yajQaH RtvijaH ApyAyasva-apakzIyasva-iti Bakzayanti-evam-enAn=-candram
   prāptānkarmiṇo bhṛtyāniva svāmino bhakṣayantyupabhuñjate devāḥ	prAptAn-karmiNaH BRtyAn-iva svAminaH Bakzayanti-upaBuQjate devAH
   āpyāyasvāpakṣīyasveti na mantraḥ kiṃ tarhyāpyāyyā'pyāyya camasasthaṃ	ApyAyasva-apakzIyasva-iti na mantraH kim tarhi-ApyAyyA-apyAyya camasa-sTam
   bhakṣaṇenāpakṣayaṃ ca kṛtvā punaḥ punarbhakṣayantītyarthaḥ /	BakzaNena-apakzayam ca kRtvA punar punar-Bakzayanti-iti-arTaH /
   evaṃ devā api somaloke labdhaśarīrānkarmiṇa upakaraṇabhūtānpunaḥ	evam devAH api soma-loke labDa-SarIrAn-karmiNaH upakaraNa-BUtAn-punar-
   punarviśrāmayantaḥ karmānurūpaṃ phalaṃ prayacchantaḥ /	punar-viSrAmayantaH karma-anurUpam Palam prayacCantaH /
   taddhi teṣāmāpyāyanaṃ somasyā'pyāyanamivopabhuñjata upakaraṇabhūtāndevāḥ	tat-hi tezAm-ApyAyanam somasya-AapyAyanam-iva-upaBuQjate upakaraNa-BUtAn-devAH
   teṣāṃ karmiṇāṃ yadā yasminkāle tadyajñadānādilakṣaṇaṃ somalokaprāpakaṃ	tezAm karmiNAm yadA yasmin-kAle tat-yajQa-dAna-Adi-lakzaNam soma-loka-prApakam
   karma paryavaiti parigacchati parikṣīyata ityarthaḥ /	karma paryavEti parigacCati parikzIyate iti-arTaH /
   atha tademameva prasiddhamākāśamabhiniṣpadyante /	aTa tadA-imam-eva prasidDam-AkASam-aBinizpadyante /
   yāstāḥ śraddhāśabdavācyā dyulokāgnau hutā āpaḥ somākārapariṇatā yābhiḥ	yAH-tAH SradDA-Sabda-vAcyAH dyu-loka-agnO hutAH ApaH soma-AkAra-pariNatAH yABiH
   somaloke karmiṇāmupabhogāya śarīramārabdhamammayaṃ tāḥ	soma-loke karmiNAm-upaBogAya SarIram-ArabDam-ap-mayam tAH
   karmakṣayāddhimapiṇḍa ivā'tapasaṃparkātpravilīyante /	karma-kzayAt-hima-piNxaH ivA-atapa-saMparkAt-pravilIyante /
   pravilīnāḥ sūkṣmā ākāśabhūtā iva bhavanti tadidamucyata	pravilInAH sUkzmAH AkASa-BUtAH iva Bavanti tat-idam-ucyata
   imamevā'kāśamabhiniṣpadyanta iti /	imam-eva-aakASam-aBinizpadyante iti /
   te punarapi karmiṇastaccharīrāḥ santaḥ purovātādinā itāścāmutaśca nīyante	te punar-api karmiNaH-tad-SarIrAH santaH purovAta-AdinA itAH-ca-amutaH-ca nIyante
   'ntarikṣagāstadāha-ākāśādvāyumiti /	antarikza-gAH-ta-dAha-a-AkASAt-vAyum-iti /
   vāyorvṛṣṭiṃ pratipadyante /	vAyoH-vRzwim pratipadyante /
   taduktam-parjanyāgnau somaṃ rājānaṃ juhvatīti /	tat-uktam--parjanya-agnO somam rAjAnam juhvati-iti /
   tato vṛṣṭibhūtā imāṃ pṛthivīṃ patanti /	tatas vRzwi-BUtAH imAm pRTivIm patanti /
   te pṛthivīṃ prāpya vrīhiyavādyannaṃ bhavanti /	te pRTivIm prApya vrIhi-yava-Adi-annam Bavanti /
   taduktamasmiṃlloke 'gnau vṛṣṭiṃ juhvati tasyā āhutyā annaṃ saṃbhavatīti /	tat-uktam-asmin=-loke agnO vRzwim juhvati tasyE AhutyE annam saMBavati-iti /
   te punaḥ puruṣāgnau hūyante 'nnabhūtā retaḥsici /	te punar puruza-agnO hUyante anna-BUtAH retaH-sici /
   tato retobhūtā yoṣāgnau hūyante tato jāyante lokaṃ pratyutthāyinaste lokaṃ	tatas retaH-BUtAH yoza-agnO hUyante tatas jAyante lokam pratyutTAyinaH-te lokam
   pratyuttiṣṭhanto 'gnihotrādikarmānutiṣṭhanti /	pratyuttizWantaH agnihotra-Adi-karma-anutizWanti /
   tato dhūmādinā punaḥ punaḥ somalokaṃ punarimaṃ lokamiti /	tatas DUma-AdinA punar punar soma-lokam punar-imam lokam-iti /
   ta evaṃ karmiṇo 'nuparivartante ghaṭīyantravaccakrībhūtā	te evam karmiNaH anuparivartante GawIyantra-vat-cakrIBUtA
   baṃbhramantītyarthaḥ /	baMBram-anti-iti-arTaH /
   uttaramārgāya sadyomuktaye vā yāvadbrahma na viduḥ /	uttara-mArgAya sadyas-muktaye vA yAvat-brahma na viduH /
   iti nu kāmayamānaḥ saṃsaratītyuktam /	iti nu kAmayamAnaH saMsarati-iti-uktam /
   atha punarya uttaraṃ dakṣiṇaṃ caitau panthānau na viduruttarasya	aTa punar-yaH uttaram dakziNam ca-etO panTAnO na viduH-uttarasya
   dakṣiṇasya vā pathaḥ pratipattaye jñānaṃ karma vā nānutiṣṭhantītyarthaḥ /	dakziNasya vA paTaH pratipattaye jQAnam karma vA na-anutizWanti-iti-arTaH /
   te kiṃ bhavantīti /	te kim Bavanti-iti /
   ucyate-te kīṭāḥ pataṅgā yadidaṃ yaccedaṃ dandaśūkaṃ	ucyate-te kIwAH pataFgAH yat-idam yat-ca-idam dandaSUkam
   daṃśamaśakamityetadbhavanti /	daMSam-aSakam-iti-etat-Bavanti /
   evaṃ hīyaṃ saṃsāragatiḥ kaṣṭāsyāṃ nimagnasya punaruddhāra eva durlabhaḥ /	evam hi-iyam saMsAra-gatiH kazwa-AsyAm nimagnasya punar-udDAraH eva durlaBaH /
   tathā ca śrutyantaram-"tānīmāni kṣudrāṇyasakṛdāvartīni bhūtāni bhavanti	taTA ca Sruti-antaram-"tAni-imAni kzudrANi-asakRt-AvartIni BUtAni Bavanti
   jāyasva mriyasva"iti /	jAyasva mriyasva"-iti /
   tasmātsarvotsāhena yathāśakti svābhāvikakarmajñānahānena	tasmAt-sarva-utsAhena yaTASakti svABAvika-karma-jQAna-hAnena
   dakṣiṇottaramārgapratipattisādhanaṃ śāsrīyaṃ karma jñānaṃ vānutiṣṭhediti	dakziNa-uttara-mArga-pratipatti-sADanam SAsrIyam karma jQAnam vA-anutizWet-iti
   vākyārthaḥ /	vAkya-arTaH /
   tathā coktam"ato vai khalu durniṣprapataraṃ tasmājjugupseta"iti	taTA ca-uktam"atas vE Kalu durnizprapataram tasmAt-jugupseta"-iti
   śrutyantarānmokṣāya prayatetetyarthaḥ /	Sruti-antarAt-mokzAya prayateta-iti-arTaH /
   atrāpyuttaramārgapratipattisādhana eva mahānyatnaḥ kartavya iti gamyate /	atra-api-uttara-mArga-pratipatti-sADanaH eva mahAn-yatnaH kartavyaH iti gamyate /
   evamevānuparivartanta ityuktatvāt /	evam-eva-anuparivartante iti-ukta-tvAt /
   evaṃ praśnāḥ sarve nirṇītāḥ /	evam praSnAH sarve nirNItAH /
   esau vai loka ityārabhya puruṣaḥ saṃbhavatīticaturthaḥ praśno	esO vE lokaH iti-AraBya puruzaH saMBavati-iti-caturTaH praSnaH-
   yatithyāmāhutyāmityādiḥ prathamyena /	yatiTyAm-AhutyAm-ityAdiH praTamyena /
   pañcamastu dvitīyatvena devayānasya vā pathaḥ pratipadaṃ pitṛyāṇasya veti	paQcamaH-tu dvitIya-tvena deva-yAnasya vA paTaH pratipadam pitRyANasya vA-iti
   dakṣiṇottaramārgapratipattisādhanakathanena /	dakziNa-uttara-mArga-pratipatti-sADana-kaTanena /
   tenaiva ca prathamo 'pyagnerābhya kecidarciḥ pratipadyante keciddhūmamiti	tena-eva ca praTamaH api-agneH-ABya kecid-arciH pratipadyante kecid-DUmam-iti
   vipratipattiḥ /	vipratipattiH /
   punarāvṛttiśca dvitīyaḥ praśna ākāśādikrameṇemaṃ lokamāgacchantīti /	punarAvRttiH-ca dvitIyaH praSnaH AkASa-Adi-krameNa-imam lokam-AgacCanti-iti /
   tenaivāsau loko na saṃpūryate kīṭapataṅgādipratipatteśca keṣāñciditi	tena-eva-asO lokaH na saMpUryate kIwa-pataFga-Adi-pratipatteH-ca kezAQcid-iti
   tṛtīyo 'pi praśno nirṇītaḥ16 //	tRtIyaH api praSnaH nirNItaH16 //
   iti bṛhadāraṇyakopaniṣadi ṣaṣṭhādhyāyasya dvitīyaṃ brāhmaṇam //2//	iti bRhadAraNyaka-upanizadi zazWa-aDyAyasya dvitIyam brAhmaNam //2//
   START BrhUp 6,3.1	START BrhUp 6,3.1
   sa yaḥ kāmayeta -- mahat prāpnuyām ity udagayana āpūryamāṇapakṣasya	sa yaH kAmayeta - mahat prApnuyAm iti udagayane ApUryamANa-pakzasya
   puṇyāhe dvādaśāham upasadvratī bhūtvaudumbare kaṃse camase vā sarvauṣadhaṃ	puNya-ahe dvAdaSa-aham upasadvratI BUtvA-Odumbare kaMse camase vA sarva-OzaDam
   phalānīti saṃbhṛtya parisamuhya parilipyāgnim upasamādhāya	PalAni-iti saMBRtya parisamuhya parilipya-agnim upasamADAya
   paristīryāvṛtājyaṃ saṃskṛtya puṃsā nakṣatreṇa manthaṃ saṃnīya juhoti --	paristIrya-AvRta-Ajyam saMskRtya puMsA nakzatreNa manTam saMnIya juhoti --
   yāvanto devās tvayi jātavedas tiryañco ghnanti puruṣasya kāmān |	yAvantaH devAH tvayi jAtavedaH tiryaQcaH Gnanti puruzasya kAmAn |
   tebhyo 'haṃ bhāgadheyaṃ juhomi te mā tṛptāḥ sarvaiḥ kāmais tarpayantu	teByaH aham BAgaDeyam juhomi te mA tRptAH sarvEH kAmEH tarpayantu
   svāhā |	svAhA |
   yā tiraścī nipadyase 'haṃ vidharaṇī iti |	yA tiraScI nipadyase aham viDaraNI iti |
   tāṃ tvā ghṛtasya dhārayā yaje saṃrādhanīm ahaṃ svāhā || BrhUp_6,3.1 ||	tAm tvA GRtasya DArayA yaje saMrADanIm aham svAhA || BrhUp_6,3.1 ||
   BrhUpBh_6,3.1 sa yaḥ kāmayeta /	Brhu-upBh_6,3.1 sa yaH kAmayeta /
   jñānakarmaṇorgatiruktā /	jQAna-karmaNoH-gatiH-uktAH /
   tatra jñānaṃ svatantraṃ karma tu daivamānuṣavittadvayāyattaṃ tena	tatra jQAnam svatantram karma tu dEva-mAnuza-vitta-dvaya-Ayattam tena
   karmārthaṃ vittamupārjanīyam /	karma-arTam vittam-upArjanIyam /
   taccāpratyavāyakāriṇopāyeneti tadarthaṃ manthākhyaṃ karmā'rabhyate	tat-ca-apratyavAya-kAriNA-upAyena-iti tad-arTam manTa-AKyam karmA-araByate
   mahattvaprāptaye /	mahat-tva-prAptaye /
   mahattve ca satyarthasiddhaṃ hi vittam /	mahat-tve ca satyarTa-sidDam hi vittam /
   taducyate-sa yaḥ kāmayeta sa yo vittārthī karmaṇyadhikṛto yaḥ kāmayeta /	tat-ucyate--sa yaH kAmayeta sa yaH vitta-arTI karmaNi-aDikRtaH yaH kAmayeta /
   kim /	kim /
   mahanmahattvaṃ prāpnuyāṃ mahānsyāmitītyarthaḥ /	mahat-mahat-tvam prApnuyAm mahAn-syAm-iti-iti-arTaH /
   tatra manthakarmaṇo vidhitsitasya kālo 'bhidhīyate-udagayana ādityasya	tatra manTa-karmaNaH viDitsitasya kAlaH aBiDIyate-udagayane Adityasya
   tatra sarvatra prāptāvāpūryamāṇapakṣasya śuklapakṣasya /	tatra sarvatra prAptO=-ApUryamANa-pakzasya Sukla-pakzasya /
   tatrāpi sarvatra prāptau puṇyāhe 'nukūla ātmanaḥ karmasiddhikara ityarthaḥ	tatra-api sarvatra prAptO puNya-ahe anukUlaH AtmanaH karma-sidDi-karaH iti-arTaH
   dvādaśāhaṃ yasminpuṇye 'nukūle karma cikīrṣati tataḥ	dvAdaSa-aham yasmin-puNye anukUle karma cikIrzati tatas-
   prākpuṇyāhamevā'rabhya dvādaśāhamupasadvratī /	prAc-puNya-aham-evA-araBya dvAdaSa-aham-upasadvratI /
   upasatsu vratamupasadaḥ prasiddhā jyotiṣṭome /	upasatsu vratam-upasadaH prasidDA jyotizwome /
   tatra ca stanopacayāpacayadvāreṇa payobhakṣaṇaṃ tadvratam /	tatra ca stana-upacaya-apacaya-dvAreNa payaH-BakzaNam tat-vratam /
   atra ca tatkarmānupasaṃhārātkevalamitikartavyatāśūnyaṃ	atra ca tad-karma-anupasaMhArAt-kevalam-itikartavya-tA-SUnyam
   payobhakṣaṇamātramupādīyate /	payaH-BakzaNa-mAtram-upAdIyate /
   nanūpasado vratamiti yadā vigrahastadā sarvamitikartavyatārūpaṃ grāhyaṃ	nanu-upasadaH vratam-iti yadA vigrahaH-tadA sarvamiti-kartavya-tA-rUpam grAhyam
   bhavati tatkasmānna parigṛhyata iti /	Bavati tat-kasmAt-na parigRhyate iti /
   ucyate-smārtatvātkarmaṇaḥ /	ucyate--smArta-tvAt-karmaNaH /
   smārtaṃ hīdaṃ manthakarma /	smArtam hi-idam manTa-karma /
   nanu śrutivihitaṃ satkathaṃ smārtaṃ bhavitumarhati /	nanu Sruti-vihitam sat-kaTam smArtam Bavitum-arhati /
   smṛtyanuvādinīhi śrutiriyam /	smRti-anuvAdinIhi SrutiH-iyam /
   śrautatve hi prakṛtivikārabhāvastataśca prākṛtadharmagrāhitvaṃ	SrOta-tve hi prakRti-vikAra-BAvaH-tatas-ca prAkRta-Darma-grAhi-tvam
   vikārakarmaṇo na tviha śrautatvam /	vikAra-karmaNaH na tu-iha SrOta-tvam /
   ata eva cā'vasathyāgnāvetatkarma vidhīyate /	atas eva cA-avasaTya-agnO=-etat-karma viDIyate /
   sarvā cā'vṛtsmārtaiveti /	sarvA cA-avRtsmArtA-eva-iti /
   upasadvratī bhūtvā payovratī sannītyarthaḥ /	upasadvratI BUtvA payaH-vratI sannIti-arTaH /
   audumbara udumbaravṛkṣamaye kaṃse camase vā tasyaiva viśeṣaṇaṃ kaṃsākāre	OdumbaraH udumbara-vRkza-maye kaMse camase vA tasya-eva viSezaNam kaMsa-AkAre
   camasākāre vaudumbara eva /	camasa-AkAre vOdumbaraH eva /
   ākāre tu vikalpo naudumbaratve /	AkAre tu vikalpaH na-Odumbara-tve /
   etra sarvauṣadhaṃ sarvāsāmoṣadhīnāṃ samūhaṃ yathāsambhavaṃ yathāśakti ca	etra sarva-OzaDam sarvAsAm-ozaDInAm samUham yaTAsamBavam yaTASakti ca
   sarvā oṣadhīḥ samāhṛtya tatra grāmyāṇāṃ tu daśa niyamena grāhyā	sarvAH ozaDIH samAhRtya tatra grAmyANAm tu daSa niyamena grAhyA
   vrīhiyavādyā vakṣyamāṇāḥ /	vrIhi-yava-AdyAH vakzyamANAH /
   adhikagrahaṇe tu na doṣaḥ /	aDika-grahaNe tu na dozaH /
   grāmyāṇāṃ phalāni ca yathāsambhavaṃ yathāśakti ca /	grAmyANAm PalAni ca yaTAsamBavam yaTASakti ca /
   itiśabdaḥ samastasambhāropacayapradarśanārthaḥ /	iti-SabdaH samasta-samBAra-upacaya-pradarSana-arTaH /
   anyadapi yatsambharaṇīyaṃ tatsarvaṃ saṃbhṛtyetyarthaḥ /	anyat-api yat-samBaraNIyam tat-sarvam saMBRtya-iti-arTaH /
   kramastatra gṛhyokto draṣṭavyaḥ /	kramaH-tatra gRhya-uktaH drazwavyaH /
   parisamūhanaparilepane bhūmisaṃskāraḥ /	parisamUhana-parilepane BUmi-saMskAraH /
   agnimupasamādhāyeti vacanādāvasathye 'gnāviti gamyate /	agnim-upasamADAya-iti vacanAt-AvasaTye agnO=-iti gamyate /
   ekavacanādupasamādhānaśravaṇācca /	eka-vacanAt-upasamADAna-SravaNAt-ca /
   vidyamānasyaivopasamādhānam /	vidyamAnasya-eva-upasamADAnam /
   paristīrya darbhānāvṛtā smārtatvātkarmaṇaḥ sthālīpākāvṛtparigṛhyate /	paristIrya darBa-an-AvRtA smArta-tvAt-karmaNaH sTAlIpAka-AvRt-parigRhyate /
   tayā'jyaṃ saṃskṛtya puṃsā nakṣatreṇa puṃnāmnā nakṣatreṇa puṇyāhasaṃyuktena	tayA-ajyam saMskRtya puMsA nakzatreNa puMnAmnA nakzatreNa puNyAha-saMyuktena
   manthaṃ sarvauṣadhaphalapiṣṭaṃ tatraudumbare camase dadhani madhuni ghṛte	manTam sarva-OzaDa-Pala-pizwam tatra-Odumbare camase daDani maDuni GRte
   copasicyaikayopamanthanyopamaṃmathya saṃnīya madhye saṃsthāpyaudumbareṇa	ca-upasicya-ekayA-upamanTanya-upamaMmaTya saMnIya maDye saMsTApya-OdumbareNa
   sruveṇā'vāpasthāna ājyasya juhotyetairmantrairyāvanto devā ityādyaiḥ //1//	sruveNA-avApa-sTAnaH Ajyasya juhoti-etEH-mantrEH-yAvantaH devAH ityAdyEH //1//
   START BrhUp 6,3.2-3	START BrhUp 6,3.2-3
   jyeṣṭhāya svāhā śreṣṭhāya svāhety agnau hutvā manthe saṃsravam avanayati |	jyezWAya svAhA SrezWAya svAhA-iti agnO hutvA manTe saMsravam avanayati |
   prāṇāya svāhā vasiṣṭhāyai svāhety agnau hutvā manthe saṃsravam avanayati |	prANAya svAhA vasizWAyE svAhA-iti agnO hutvA manTe saMsravam avanayati |
   vāce svāhā pratiṣṭhāyai svāhety agnau hutvā manthe saṃsravam avanayati |	vAce svAhA pratizWAyE svAhA-iti agnO hutvA manTe saMsravam avanayati |
   cakṣuṣe svāhā saṃpade svāhety agnau hutvā manthe saṃsravam avanayati |	cakzuze svAhA saMpade svAhA-iti agnO hutvA manTe saMsravam avanayati |
   śrotrāya svāhāyatanāya svāhety agnau hutvā manthe saṃsravam avanayati |	SrotrAya svAhA-AyatanAya svAhA-iti agnO hutvA manTe saMsravam avanayati |
   manase svāhā prajātyai svāhety agnau hutvā manthe saṃsravam avanayati |	manase svAhA prajAtyE svAhA-iti agnO hutvA manTe saMsravam avanayati |
   retase svāhety agnau hutvā manthe saṃsravam avanayati || BrhUp_6,3.2 ||	retase svAhA-iti agnO hutvA manTe saMsravam avanayati || BrhUp_6,3.2 ||
   agnaye svāhety agnau hutvā manthe saṃsravam avanayati |	agnaye svAhA-iti agnO hutvA manTe saMsravam avanayati |
   somāya svāhety agnau hutvā manthe saṃsravam avanayati |	somAya svAhA-iti agnO hutvA manTe saMsravam avanayati |
   bhūḥ svāhety agnau hutvā manthe saṃsravam avanayati |	BUH svAhA-iti agnO hutvA manTe saMsravam avanayati |
   bhuvaḥ svāhety agnau hutvā manthe saṃsravam avanayati |	BuvaH svAhA-iti agnO hutvA manTe saMsravam avanayati |
   svaḥ svāhety agnau hutvā manthe saṃsravam avanayati |	svar svAhA-iti agnO hutvA manTe saMsravam avanayati |
   bhūr bhuvaḥ svaḥ svāhety agnau hutvā manthe saṃsravam avanayati |	BUH BuvaH svar svAhA-iti agnO hutvA manTe saMsravam avanayati |
   brahmaṇe svāhety agnau hutvā manthe saṃsravam avanayati |	brahmaNe svAhA-iti agnO hutvA manTe saMsravam avanayati |
   kṣatrāya svāhety agnau hutvā manthe saṃsravam avanayati |	kzatrAya svAhA-iti agnO hutvA manTe saMsravam avanayati |
   bhūtāya svāhety agnau hutvā manthe saṃsravam avanayati |	BUtAya svAhA-iti agnO hutvA manTe saMsravam avanayati |
   bhaviṣyate svāhety agnau hutvā manthe saṃsravam avanayati |	Bavizyate svAhA-iti agnO hutvA manTe saMsravam avanayati |
   viśvāya svāhety agnau hutvā manthe saṃsravam avanayati |	viSvAya svAhA-iti agnO hutvA manTe saMsravam avanayati |
   sarvāya svāhety agnau hutvā manthe saṃsravam avanayati |	sarvAya svAhA-iti agnO hutvA manTe saMsravam avanayati |
   prajāpataye svāhety agnau hutvā manthe saṃsravam avanayati || BrhUp_6,3.3	prajApataye svAhA-iti agnO hutvA manTe saMsravam avanayati || BrhUp_6,3.3
   BrhUpBh_6,3.2-3 jyeṣṭhāya svāhā śreṣṭhāya svāhetyārabhya dve dve āhutī	BrhUpBh_6,3.2-3 jyezWAya svAhA SrezWAya svAhA-iti-AraBya dve dve AhutI
   hutvā manthe saṃsravamavanayati /	hutvA manTe saMsravam-avanayati /
   sruvāvalepanamājyaṃ manthe saṃsrāvayati /	sruva-avalepanam-Ajyam manTe saMsrAvayati /
   etasmādeva jyeṣṭhāya śreṣṭhāyetyādiprāṇaliṅgājjyeṣṭhaśreṣṭhādiprāṇavida	etasmAt-eva jyezWAya SrezWAya-ityAdi-prANa-liFgAt-jyezWa-SrezWa-Adi-prANa-vida
   evāsminkarmaṇyadhikāraḥ /	eva-asmin-karmaNi-aDikAraH /
   retasa ityārambhaikaikāmāhutiṃ hutvā manthe	retasaH iti-AramBa-eka-ekAm-Ahutim hutvA manTe
   saṃsravamavanayatyaparayopamanthanyā punarmathnāti //2-3 //	saMsravam-avanayati-aparayA-upamanTanyA punar-maTnAti //2-3 //
   START BrhUp 6,3.4	START BrhUp 6,3.4
   athainam abhimṛśati -- bhramad asi |	aTa-enam aBimRSati - Bramat asi |
   jvalad asi |	jvalat asi |
   pūrṇam asi |	pUrNam asi |
   prastabdham asi |	prastabDam asi |
   ekasabham asi |	eka-saBam asi |
   hiṅkṛtam asi |	hiFkRtam asi |
   hiṅkriyamānam asi |	hiFkriyamAnam asi |
   udgītham asi |	udgITam asi |
   udgīyamānam asi |	udgIyamAnam asi |
   śrāvitam asi |	SrAvitam asi |
   pratyāśrāvitam asi |	pratyASrAvitam asi |
   ārdre saṃdīptam asi |	Ardre saMdIptam asi |
   vibhūr asi |	viBUH asi |
   prabhūr asi |	praBUH asi |
   annam asi |	annam asi |
   jyotir asi |	jyotiH asi |
   nidhanam asi |	niDanam asi |
   saṃvargo 'sīti || BrhUp_6,3.4 ||	saMvargaH asi-iti || BrhUp_6,3.4 ||
   BrhUpBh_6,3.4 athainamabhimṛśati bhramadasītyanena mantreṇa //4//	Brhu-upBh_6,3.4 aTa-enam-aBimRSati Bramat-asi-iti-anena mantreNa //4//
   START BrhUp 6,3.5	START BrhUp 6,3.5
   athainam udyacchaty āmaṃsy āmaṃ hi te mahi |	aTa-enam udyacCati AmaMsi Amam hi te mahi |
   sa hi rājeśāno 'dhipatiḥ |	sa hi rAjA-ISAnaH aDipatiH |
   sa māṃ rājeśano 'dhipatiṃ karotv iti || BrhUp_6,3.5 ||	sa mAm rAjeSanaH aDipatim karotu iti || BrhUp_6,3.5 ||
   BrhUpBh_6,3.5 athainamucchati saha pātreṇa haste gṛhṇātyāmaṃsyāmaṃhi te	Brhu-upBh_6,3.5 aTa-enam-ucCati saha pAtreNa haste gRhNAti-Am-aMsya-amaMhi te
   mahītyanena //5//	mahi-iti-anena //5//
   START BrhUp 6,3.6	START BrhUp 6,3.6
   athainam ācāmati --	aTa-enam AcAmati --
   tat savitur vareṇyam |	tat savituH vareNyam |
   madhu vātā ṛtāyate madhu kṣaranti sindhavaḥ |	maDu vAtAH RtAyate maDu kzaranti sinDavaH |
   mādhvīr naḥ santv oṣadhīḥ |	mADvIH naH santu ozaDIH |
   bhūḥ svāhā |	BUH svAhA |
   bhargo devasya dhīmahi	BargaH devasya DImahi
   madhu naktam utoṣaso madhumat pārthivaṃ rajaḥ |	maDu naktam uta-uzasaH maDumat pArTivam rajaH |
   madhu dyaur astu naḥ pitā |	maDu dyOH astu naH pitA |
   bhuvaḥ svāhā |	BuvaH svAhA |
   dhiyo yo naḥ pracodayāt |	DiyaH yaH naH pracodayAt |
   madhumān no vanaspatir madhumāṃ astu sūryaḥ |	maDumAn naH vanaspatiH maDumAm astu sUryaH |
   mādhvīr gavo bhavantu naḥ |	mADvIH gavaH Bavantu naH |
   svaḥ svāhā |	svar svAhA |
   sarvāṃ ca sāvitrīm anvāha |	sarvAm ca sAvitrIm anvAha |
   sarvāś ca madhumatīr aham evedaṃ sarvaṃ bhūyāsaṃ bhūr bhuvaḥ svaḥ svāheti	sarvAH ca maDumatIH aham eva-idam sarvam BUyAsam BUH BuvaH svar svAhA-iti
   antata ācamya pāṇī prakṣālya jaghanenāgniṃ prākśirāḥ saṃviśati |	antatas Acamya pANI prakzAlya jaGanena-agnim prAc-SirAH saMviSati |
   prātar ādityam upatiṣṭhate |	prAtar Adityam upatizWate |
   diśām ekapuṇḍarīkam asi |	diSAm eka-puNxarIkam asi |
   ahaṃ manuṣyāṇām ekapuṇḍarīkaṃ bhūyāsam iti |	aham manuzyANAm eka-puNxarIkam BUyAsam iti |
   yathetam etya jaghanenāgnim āsīno vaṃśaṃ japati || BrhUp_6,3.6 ||	yaTetam etya jaGanena-agnim AsInaH vaMSam japati || BrhUp_6,3.6 ||
   BrhUpBh_6,3.6 athainamācāmati bhakṣayati gāyatryāḥ prathamapādena	Brhu-upBh_6,3.6 aTa-enam-AcAmati Bakzayati gAyatryAH praTama-pAdena
   madhumatyaikayā vyāhṛtyā ca prathamayā prathamagrāsamācāmati /	maDumatyA-ekayA vyAhRtyA ca praTamayA praTama-grAsam-AcAmati /
   tathā gāyatrīdvitīyapādena madhumatyā dvitīyayā dvitīya yā ca vyahṛtyā	taTA gAyatrI-dvitIya-pAdena maDumatyA dvitIyayA dvitIya yA ca vyahRtyA
   dvitīyaṃ grāsam /	dvitIyam grAsam /
   tathā tṛtīyena gāyatrīpādena tṛtīyayā madhumatyā tṛtīyayā ca vyāhṛtyā	taTA tRtIyena gAyatrI-pAdena tRtIyayA maDumatyA tRtIyayA ca vyAhRtyA
   tṛtīyaṃ grāsam /	tRtIyam grAsam /
   sarvāṃ sāvitrīṃ sarvāśca madhumatīruktvāhamevedaṃ sarvaṃ bhūyāsamiti cānte	sarvAm sAvitrIm sarvAH-ca maDumatIruktvA-aham-eva-idam sarvam BUyAsam-iti ca-ante
   bhūrbhavaḥ svaḥ svāheti samastaṃ bhaśrayati /	BUH-BavaH svar svAhA-iti samastam BaSrayati /
   yathā caturbhirgrāsaistaddravyaṃ sarvaṃ parisamāpyate tathā pūrvameva	yaTA caturBiH-grAsEH-tat-dravyam sarvam parisamApyate taTA pUrvam-eva
   nirupyet /	nirupyet /
   yatpātrāvaliptaṃ tatpātraṃ sarvaṃ nirṇijya tūṣṇīṃ pivet /	yat-pAtra-avaliptam tat-pAtram sarvam nirNijya tUzNIm pivet /
   pāṇī prakṣālyāpa ācamya jaghanenāgniṃ paścādagneḥ prākśirāḥ saṃviśati /	pANI prakzAlya-apaH Acamya jaGanena-agnim paScAt-agneH prAc-SirAH saMviSati /
   prātaḥ saṃdhyāmupāsyā'dityamupatiṣṭhate diśāmekapuṇḍarīkamityanena	prAtar saMDyAm-upAsyA-adityam-upatizWate diSAm-eka-puNxarIkam-iti-anena
   mantreṇa /	mantreNa /
   yathetaṃ yathāgatametyā'gatya jaghanenāgnimāsīno vaṃśaṃ japati //6//	yaTetam yaTAgatametyA-agatya jaGanena-agnim-AsInaH vaMSam japati //6//
   START BrhUp 6,3.7-12	START BrhUp 6,3.7-12
   taṃ haitam uddālaka āruṇir vājasaneyāya yājñavalkyāyāntevāsina uktvovāca	tam ha-etam uddAlakaH AruNiH vAjasaneyAya yAjQavalkyAya-antevAsinaH uktvA-uvAca
   -- api ya enaṃ śuṣke sthāṇau niṣiñcej jāyerañ chākhāḥ praroheyuḥ	- api yaH enam Suzke sTANO niziQcet jAyeran CAKAH praroheyuH
   palāśānīti || BrhUp_6,3.7 ||	palASAni-iti || BrhUp_6,3.7 ||
   etam u haiva vājasaneyo yājnavalkyo madhukāya paiṅgyāyāntevāsina uktvovāca	etam u ha-eva vAjasaneyaH yAjnavalkyaH maDukAya pEFgyAya-antevAsinaH uktvA-uvAca
   -- api ya enaṃ śuṣke sthāṇau niṣiñcej jāyerañ chākhāḥ praroheyuḥ	- api yaH enam Suzke sTANO niziQcet jAyeran CAKAH praroheyuH
   palāśānīti || BrhUp_6,3.8 ||	palASAni-iti || BrhUp_6,3.8 ||
   etam u haiva madhukaḥ paiṅgyaś cūlāya bhāgavittaye 'ntevāsina uktvovāca --	etam u ha-eva maDukaH pEFgyaH cUlAya BAga-vittaye antevAsinaH uktvA-uvAca --
   api ya enaṃ śuṣke sthāṇau niṣiñcej jāyerañ chākhāḥ praroheyuḥ palāśānīti	api yaH enam Suzke sTANO niziQcet jAyeran CAKAH praroheyuH palASAni-iti
   || BrhUp_6,3.9 ||	|| BrhUp_6,3.9 ||
   etam u haiva cūlo bhāgavittir jānakaya āyaḥsthūṇāyāntevāsina uktvovāca --	etam u ha-eva cUlaH BAga-vittiH jAnakaye AyaH-sTUNAya-antevAsinaH uktvA-uvAca --
   api ya enaṃ śuṣke sthāṇau niṣiñcej jāyerañ chākhāḥ praroheyuḥ palāśānīti	api yaH enam Suzke sTANO niziQcet jAyeran CAKAH praroheyuH palASAni-iti
   || BrhUp_6,3.10 ||	|| BrhUp_6,3.10 ||
   etam u haiva jānakir āyasthūṇaḥ satyakāmāya jābālāyāntevāsina uktvovāca --	etam u ha-eva jAnakiH AyasTUNaH satyakAmAya jAbAlAya-antevAsinaH uktvA-uvAca --
   api ya enaṃ śuṣke sthāṇau niṣiñcej jāyerañ chākhāḥ praroheyuḥ palāśānīti	api yaH enam Suzke sTANO niziQcet jAyeran CAKAH praroheyuH palASAni-iti
   || BrhUp_6,3.11 ||	|| BrhUp_6,3.11 ||
   etam u haiva satyakāmo jābālo 'ntevāsibhya uktvova -- acāpi ya enaṃ śuṣke	etam u ha-eva satyakAmaH jAbAlaH antevAsiByaH uktvA-uvaH - aca-api yaH enam Suzke
   sthāṇau niṣiñcej jāyerañ chākhāḥ praroheyuḥ palāśānīti |	sTANO niziQcet jAyeran CAKAH praroheyuH palASAni-iti |
   tam etaṃ nāputrāya vānantevāsine vā brūyāt || BrhUp_6,3.12 ||	tam etam na-aputrAya vA-anantevAsine vA brUyAt || BrhUp_6,3.12 ||
   BrhUpBh_6,3.7-12 taṃ haitamuddālaka ityādi satyakāmo jābālo 'ntevāsibhya	Brhu-upBh_6,3.7-12 tam ha-etam-uddAlakaH ityAdi satyakAmaH jAbAlaH antevAsiBya
   uktvovācāpi ya enaṃ śuṣke sthāṇau niṣiñcejjāyerannevāsmiñśākhāḥ praroheyuḥ	uktvA-uvAca-api yaH enam Suzke sTANO niziQcet-jAyeran=-eva-asmin-SAKAH praroheyuH
   palāśānītyevamantamenaṃ manthamuddālakātprabhṛtyekaikācāryakramāgataṃ	palASAni-iti-evam-antam-enam manTam-uddAlakAt-praBRti-ekEka-AcArya-krama-Agatam
   satyakāma ācāryo bahubhyo 'ntevāsibhya uktvovāca /	satyakAmaH AcAryaH bahuByaH antevAsiByaH uktvA-uvAca /
   kimanyaduvācetyucyate-api ya enaṃ śuṣke sthāṇau gataprāṇe 'pyenaṃ manthaṃ	kim-anyat-uvAca-iti-ucyate--api yaH enam Suzke sTANO gata-prANe api-enam manTam
   bhakṣaṇāya saṃskṛtaṃ niṣiñcetprakṣipejjāyerannutpadyerannevāsminsthāṇau	BakzaNAya saMskRtam niziQcet-prakzipet-jAyeu-an=-utpadyeran=-eva-asmin-sTANO
   śākhā avayavā vṛkṣasya praroheyuśca palāśāni parṇāni yathā jīvataḥ sthāṇoḥ	SAKAH avayavAH vRkzasya praroheyuH-ca palASAni parNAni yaTA jIvataH sTANoH
   kimutānena karmaṇā kāmaḥ sidhyediti /	kim-uta-anena karmaNA kAmaH siDyet-iti /
   dhruvaphalamidaṃ karmeti karmastutyarthametat /	Druva-Palam-idam karma-iti karma-stuti-arTam-etat /
   vidyādhigame ṣṭatīrthāni teṣāmiha saprāṇadarśanasya	vidyA-aDigame zwa-tIrTAni tezAm-iha sa-prANa-darSanasya
   manthavijñānasyādhigame dve eva tīrthe anujñāyete putraścāntevāsī ca	manTa-vijQAnasya-aDigame dve eva tIrTe anujQAyete putraH-ca-antevAsI ca
   START BrhUp 6,3.13	START BrhUp 6,3.13
   caturaudumbaro bhavati |	catur-OdumbaraH Bavati |
   audumbaraḥ sruva audumbaraś camasa audumbara idhma audumbaryā	OdumbaraH sruva OdumbaraH camasaH OdumbaraH iDmaH OdumbaryA
   upamanthanyau |	upamanTanyO |
   daśa grāmyāṇi dhānyāni bhavanti |	daSa grAmyANi DAnyAni Bavanti |
   vrīhiyavās tilamāṣā aṇupriyaṃgavo godhūmāś ca masūrāś ca khalvāś ca	vrIhi-yavAH tila-mAzAH aNu-priyaMgavaH goDUmAH ca masUrAH ca KalvAH ca
   khalakulāś ca |	Kala-kulAH ca |
   tān piṣṭān dadhani madhuni ghṛta upasiñcati |	tAn pizwAn daDani maDuni GRtaH upasiQcati |
   ājyasya juhoti || BrhUp_6,3.13 ||	Ajyasya juhoti || BrhUp_6,3.13 ||
   BrhUpBh_6,3.13 caturaudumbaro bhavatīti vyākhyātam /	Brhu-upBh_6,3.13 catur-OdumbaraH Bavati-iti vyAKyAtam /
   daśa grāmyāṇi bhavanti grāmyāṇāṃ tu dhānyānāṃ daśa niyamena grāhyā	daSa grAmyANi Bavanti grAmyANAm tu DAnyAnAm daSa niyamena grAhyA
   ityavocāma /	iti-avocAma /
   ke ta iti nirdiśyante-vrīhiyavāstilamāṣā aṇupriyaṅgavo	ke te iti nirdiSyante--vrIhi-yavAH-tila-mAzAH aNu-priyaFgavaH-
   'ṇavaścāṇuśabdavācyāḥ kvaciddeśe /	aNavaH-ca-aNu-Sabda-vAcyAH kvacid-deSe /
   priyaṅgavaḥ prasiddhāḥ kaṅguśabdena /	priyaFgavaH prasidDAH kaFgu-Sabdena /
   khalvā niṣpāvā vallaśabdavācyā loke khalakulāḥ kulatthāḥ /	KalvAH nizpAvAH valla-Sabda-vAcyAH loke Kala-kulAH kulatTAH /
   etadvyatirekeṇa yathāśakti sarvauṣadhayo grāhyāḥ phalāni	etat-vyatirekeNa yaTASakti sarva-ozaDayaH grAhyAH PalAni
   cetyavocāmāyājñikāni varjayitvā //13//	ca-iti-avocAma-aya-ajQikAni varjayitvA //13//
   iti bṛhadāraṇyakopaniṣadi ṣaṣṭhādhyāyasya tṛtīyaṃ brāhmaṇam //2//	iti bRhadAraNyaka-upanizadi zazWa-aDyAyasya tRtIyam brAhmaNam //2//
   START BrhUp 6,4.1	START BrhUp 6,4.1
   eṣāṃ vai bhūtānāṃ pṛthivī rasaḥ |	ezAm vE BUtAnAm pRTivI rasaH |
   pṛthivyā āpaḥ |	pRTivyAH ApaH |
   apām oṣadhayaḥ |	apAm ozaDayaH |
   oṣadhīnāṃ puṣpāṇi |	ozaDInAm puzpANi |
   puṣpāṇāṃ phalāni |	puzpANAm PalAni |
   phalānāṃ puruṣaḥ |	PalAnAm puruzaH |
   puruṣasya retaḥ || BrhUp_6,4.1 ||	puruzasya retaH || BrhUp_6,4.1 ||
   BrhUpBh_6,4.1"sarvebhyo 'ṅgebhyastejaḥ saṃbhūtam"iti śrutyantarāt //1//	Brhu-upBh_6,4.1"-sarveByaH aFgeByaH-tejaH saMBUtam-"iti Sruti-antarAt //1//
   START BrhUp 6,4.2	START BrhUp 6,4.2
   sa ha prajāpatir īkṣāṃ cakre -- hantāsmai pratiṣṭhāṃ kalpayānīti sa	sa ha prajApatiH IkzAm cakre - hanta-asmE pratizWAm kalpayAni-iti sa
   striyaṃ sasṛje |	striyam sasRje |
   tāṃ sṛṣṭvādha upāsta |	tAm sRzwvA-aDas upAste |
   tasmāt striyam adha upāsīta |	tasmAt striyam aDas upAsIta |
   sa etaṃ prāñcaṃ grāvāṇam ātmana eva samudapārayat |	saH etam prAQcam grAvANam AtmanaH eva samudapArayat |
   tenainām abhyasṛjata || BrhUp_6,4.2 ||	tena-enAm aByasRjata || BrhUp_6,4.2 ||
   BrhUpBh_6,4.2 yata evaṃ sarvabhūtānāṃ sāratamametadreto 'taḥ kā nu	Brhu-upBh_6,4.2 yatas evam sarva-BUtAnAm sAratamam-etat-retaH atas kA nu
   khalvasya yogyā pratiṣṭheti sa ha sraṣṭā prajāpatirīkṣāñcake /	Kalu-asya yogyA pratizWA-iti sa ha srazwA prajApatiH-I-kzAQcake /
   īkṣāṃ kṛtvā sa sriyaṃ sasṛje /	IkzAm kRtvA sa sriyam sasRje /
   tāṃ ca sṛṣṭvādha upāsta maithunākhyaṃ karmādhaupāsanaṃ nāma kṛtavān /	tAm ca sRzwvA-aDas upAsta mETuna-AKyam karmADOpAsanam nAma kRtavAn /
   tasmātsriyamadha upāsīta śreṣṭhānuśrayaṇā hi prajāḥ /	tasmAt-sriyam-aDas upAsIta SrezWa-anuSrayaNAH hi prajAH /
   atra vājapeyasāmānyakḷptimāha-sa etaṃ prāñcaṃ prakṛṣṭagatiyuktamātmano	atra vAjapeya-sAmAnya-k?ptimAha-saH etam prAQcam prakRzwa-gati-yuktam-AtmanaH-
   grāvāṇaṃ somābhiṣavopalasthānīyaṃ	grAvANam soma-aBizava-upala-sTAnIyam
   kāṭhinyasāmānyātprajananendriyamudapārayadutpūritavānsrīvyañjanaṃ prati	kAWinya-sAmAnyAt-prajanana-indriyam-udapArayat-utpUritavAn-srI-vyaQjanam prati
   tenaināṃ sriyamabhyasṛjadabhisaṃsargaṃ kṛtavān //2//	tena-enAm sriyam-aByasRjat-aBisaMsargam kRtavAn //2//
   START BrhUp 6,4.3	START BrhUp 6,4.3
   tasyā vedir upasthaḥ |	tasyAH vediH upasTaH |
   lomāni barhiś |	lomAni barhiH |
   carmādhiṣavaṇe |	carma-aDizavaNe |
   samiddho madhyatas tau muṣkau |	samidDaH maDyatas tO muzkO |
   sa yāvān ha vai vājapeyena yajamanasya loko bhavati tāvān asya loko	sa yAvAn ha vE vAjapeyena yajamanasya lokaH Bavati tAvAn asya lokaH-
   bhavati |	Bavati |
   ya evaṃ vidvān adhopahāsaṃ caraty āsāṃ strīṇāṃ sukṛtaṃ vṛṅkte |	yaH evam vidvAn aDopahAsam carati AsAm strINAm sukRtam vRFkte |
   atha ya idam avidvān adhopahāsaṃ caraty āsya striyaḥ sukṛtaṃ vṛñjate ||	aTa yaH idam avidvAn aDopahAsam carati Asya striyaH sukRtam vRQjate ||
   BrhUp_6,4.3 ||	BrhUp_6,4.3 ||
   BrhUpBh_6,4.3 etaddha sma vai tadvidvānuddālaka āruṇirāhādhopahāsākhyaṃ	Brhu-upBh_6,4.3 etat-ha sma vE tad-vidvAn-uddAlakaH AruNirAha-aDA-upahAsa-AKyam
   maithunakarma vājapeyasampannaṃ vidvānityarthaḥ /	mETuna-karma vAjapeya-sampannam vidvAn-iti-arTaH /
   tathā nāko maudgalyaḥ kumārahāritaśca /	taTA nAkaH mOdgalyaH kumArahAritaH-ca /
   kiṃ ta āhurityujyate-bahavo maryā maraṇadharmiṇo manuṣyā brāhmaṇā ayanaṃ	kim te AhuH-iti-ujyate--bahavaH maryAH maraNa-DarmiNaH manuzyAH brAhmaNAH ayanam
   yeṣāṃ te brahmaṇāyanā brahmabandhavo jātimātropajīvina ityetat /	yezAm te brahmaNA-ayanAH brahmabanDavaH jAti-mAtra-upajIvinaH iti-etat /
   nirindriyā viśliṣṭendriyā visukṛto vigatasukṛtakarmāṇo 'vidvāṃsau	nirindriyAH viSlizwa-indriyAH visukRtaH vigata-sukRta-karmANaH avidvAMsO
   maithunakarmāsaktā ityarthaḥ /	mETuna-karma-AsaktA iti-arTaH /
   te kimasmāllokātprayanti paralokātparibhraṣṭā iti maithunakarmaṇo	te kim-asmAt-lokAt-prayanti para-lokAt-pariBrazwAH iti mETuna-karmaNaH-
   'tyantapāpahetutvaṃ darśayati-ya idamavidvāṃso 'dhopahāsaṃ carantīti /	atyanta-pApa-hetu-tvam darSayati-yaH idam-avidvAMsaH aDopahAsam caranti-iti /
   śrīmanthaṃ kṛtvā patnyā ṛtukālaṃ brahmacaryeṇa pratīkṣate yadīda rataḥ	SrImanTam kRtvA patnyA Rtu-kAlam brahmacaryeNa pratIkzate yadi-ida rataH
   skandati bahu vālpaṃ vā suptasya vā jāgrato vā rāgaprābalyāt //4//	skandati bahu vA-alpam vA suptasya vA jAgrataH vA rAga-prAbalyAt //4//
   START BrhUp 6,4.4	START BrhUp 6,4.4
   etad dha sma vai tad vidvān uddālaka ārunir āha |	etat Da sma vE tat vidvAn uddAlakaH AruniH Aha |
   etad dha sma vai tad vidvān nāko maudgalya āha |	etat Da sma vE tat vidvAn nAkaH mOdgalyaH Aha |
   etad dha sma vai tad vidvān kumārahārita āha -- bahavo maryā brāhmanāyanā	etat Da sma vE tat vidvAn kumArahAritaH Aha - bahavaH maryA brAhmanAyanA
   nirindriyā visukṛto 'smāl lokāt prayanti ya idam avidvāṃso 'dhopahāsaṃ	nirindriyAH visukRtaH asmAt lokAt prayanti yaH idam avidvAMsaH aDopahAsam
   carantīti |	caranti-iti |
   bahu vā idaṃ suptasya vā jāgrato vā retaḥ skandati || BrhUp_6,4.4 ||	bahu vE idam suptasya vA jAgrataH vA retaH skandati || BrhUp_6,4.4 ||
   BrhUpBh_6,4.4 etaddha sma vai tadvidvānuddālaka āruṇirāhādhopahāsākhyaṃ	Brhu-upBh_6,4.4 etat-ha sma vE tad-vidvAn-uddAlakaH AruNirAha-aDA-upahAsa-AKyam
   maithunakarma vājapeyasampannaṃ vidvānityarthaḥ /	mETuna-karma vAjapeya-sampannam vidvAn-iti-arTaH /
   tathā nāko maudgālya- kumārahāritaśca /	taTA nAkaH mOdgAlya kumArahAritaH-ca /
   kiṃ ta āhurityucyate-bahavo maryā maraṇadharmiṇo manuṣyā brāhmaṇā ayanaṃ	kim te AhuH-iti-ucyate-bahavaH maryAH maraNa-DarmiNaH manuzyAH brAhmaNAH ayanam
   yeṣāṃ te brāhmaṇāyanā brahmabandhavo jātimātropajīvina ityetat /	yezAm te brAhmaNAyanAH brahmabanDavaH jAti-mAtra-upajIvinaH iti-etat /
   nirindriyā viśilaṣṭendriyā visukṛto vigatasukṛtakarmāṇo 'vidvāṃsau	nirindriyAH viSilazwa-indriyAH visukRtaH vigata-sukRta-karmANaH avidvAMsO
   maithunakarmāsaktā ityarthaḥ /	mETuna-karma-AsaktA iti-arTaH /
   te kimasmāllokātprayanti paralokātparibhraṣṭā iti maithunakarmaṇo	te kim-asmAt-lokAt-prayanti para-lokAt-pariBrazwAH iti mETuna-karmaNaH-
   'tyantapāpahetutvaṃ darśayati-ya idamavidvāṃso 'dhopahāsaṃ carantīti /	atyanta-pApa-hetu-tvam darSayati-yaH idam-avidvAMsaH aDopahAsam caranti-iti /
   śrīmanthaṃ kṛtvā patnyā śratukālaṃ brahmacaryeṇa pratīkṣate yadīda rataḥ	SrImanTam kRtvA patnyA Sratu-kAlam brahmacaryeNa pratIkzate yadi-ida rataH
   skandati bahu vālpaṃ vā suptasya vā jāgrato vā rāgaprābalyāt //4//	skandati bahu vA-alpam vA suptasya vA jAgrataH vA rAga-prAbalyAt //4//
   START BrhUp 6,4.5	START BrhUp 6,4.5
   tad abhimṛśed anu vā mantrayeta -- yan me 'dya retaḥ pṛthivīm askāntsīd	tat aBimRSet anu vA mantrayeta - yat me adya retaH pRTivIm askAntsId
   yad oṣadhīr apy asarad yad apaḥ |	yat ozaDIH api asarat yat apaH |
   idam ahaṃ tad reta ādade |	idam aham tat retaH Adade |
   punar mām aitu indriyaṃ punas tejaḥ punar bhagaḥ |	punar mAm Etu indriyam punar tejaH punar BagaH |
   punar agnir dhiṣṇyā yathāsthānaṃ kalpantām |	punar agniH DizNyAH yaTAsTAnam kalpantAm |
   ity anāmikāṅguṣṭhābhyām ādāyāntareṇa stanau vā bhruvau vā nimṛjyāt ||	iti anAmikA-aFguzWAByAm AdAya-antareNa stanO vA BruvO vA nimRjyAt ||
   BrhUp_6,4.5 ||	BrhUp_6,4.5 ||
   BrhUpBh_6,4.5 tadabhimṛśedanumantrayeta vānujapedityarthaḥ /	Brhu-upBh_6,4.5 tad-aBimRSet-anumantrayeta vA-anujapet-iti-arTaH /
   yadābhimṛśati tadānāmikāṅguṣṭhābhyāṃ tadreta ādade ityevamantena mantreṇa	yadA-aBimRSati tadA-anAmikA-aFguzWAByAm tat-retaH Adade iti-evam-antena mantreNa
   punarmāmityetenanimṛjyādantareṇa madhye bhruvau bhruvervā stanau	punar-mAm-iti-etena-nimRjyAt-antareNa maDye BruvO BruveH-vA stanO
   stanayorvā //5//	stanayoH-vA //5//
   START BrhUp 6,4.6	START BrhUp 6,4.6
   atha yady udaka ātmānaṃ paśyet tad abhimantrayeta -- mayi teja indriyaṃ	aTa yadi udakaH AtmAnam paSyet tat aBimantrayeta - mayi tejaH indriyam
   yaśo draviṇaṃ sukṛtam iti |	yaSaH draviNam sukRtam iti |
   śrīr ha vā eṣā strīṇāṃ yan malodvāsāḥ |	SrIH ha vE ezA strINAm yat mala-udvAsAH |
   tasmān malodvāsasaṃ yaśasvinīm abhikramyopamantrayeta || BrhUp_6,4.6 ||	tasmAt mala-udvAsasam yaSasvinIm aBikramya-upamantrayeta || BrhUp_6,4.6 ||
   BrhUpBh_6,4.6 atha yadi kadācidudaka ātmānamātmacchāyāṃ	Brhu-upBh_6,4.6 aTa yadi kadAcid-udakaH AtmAnam-Atma=-CAyAm
   paśyettatrāpyatrimantrayetānena mantreṇa-mayi teja iti /	paSyet-tatra-api-atri-mantra-yeta-anena mantreNa-mayi tejaH iti /
   śrīrha vā eṣā patnā srīṇāṃ madhye yadyasmānmalodvāsā	SrIH-ha vE ezA patnA srINAm maDye yadi-asmAt-mala-udvAsA
   udgatamalavadvāsāstasmāttāṃ malodvāsasaṃ yaśasvinīṃ	udgata-malavat-vAsAH-tasmAt-tAm mala-udvAsasam yaSasvinIm
   śrīmatīmabhikramyābhigatyopamantrayetedamadyā'vābhyāṃ kāryaṃ	SrImatIm-aBikramya-aBigatya-upamantrayeta-idam-adyA-avAByAm kAryam
   yatputrotpādanamiti trirātrānta āplutām //6//	yat-putra-utpAdanam-iti tri-rAtra-ante AplutAm //6//
   START BrhUp 6,4.7	START BrhUp 6,4.7
   sā ced asmai na dadyāt kāmam enām avakriṇīyāt |	sA ced asmE na dadyAt kAmam enAm avakriNIyAt |
   sā ced asmai naiva dadyāt kāmam enāṃ yaṣṭyā vā pāṇinā vopahatyātikrāmet |	sA ced asmE na-eva dadyAt kAmam enAm yazwyA vA pANinA vA-upahatyA-atikrAmet |
   indriyena te yaśasā yaśa ādada iti |	indriyena te yaSasA yaSaH AdadaH iti |
   ayaśā eva bhavati || BrhUp_6,4.7 ||	ayaSAH eva Bavati || BrhUp_6,4.7 ||
   BrhUpBh_6,4.7 sā cedasmai na dadyānmaithunaṃ kartuṃ yatputrotpādanamiti	Brhu-upBh_6,4.7 sA ced-asmE na dadyAt-mETunam kartum yat-putra-utpAdanam-iti
   trirātrānta jñāpayet /	tri-rAtra-anta jQApayet /
   tathāpi sā naiva dadyātkāmamenāṃ yaṣṭyā vā pāṇinā	taTA-api sA na-eva dadyAt-kAmam-enAm yazwyA vA pANinA
   vopahatyātikrāmenmaithunāya /	vA-upahatya-atikrAmet-mETunAya /
   śāpsyāmi tvāṃ durbhagāṃ kariṣyāmīti prakhyāpya tāmanena	SApsyAmi tvAm durBagAm karizyAmi-iti praKyApya tAm-anena
   mantreṇopagacchedindriyeṇa te yaśasā yaśa ādada iti /	mantreNa-upagacCet-indriyeNa te yaSasA yaSaH AdadaH iti /
   sā tasmāttadabhiśāpādvandhyā durbhageti khyātāyaśā eva bhavati //7//	sA tasmAt-tad-aBiSApAt-vanDyA durBagA-iti KyAta-ayaSAH eva Bavati //7//
   START BrhUp 6,4.8	START BrhUp 6,4.8
   sā ced asmai dadyād indriyeṇa te yaśasā yaśa ādadhāmīti |	sA ced asmE dadyAt indriyeNa te yaSasA yaSaH AdaDAmi-iti |
   yaśasvināv eva bhavataḥ || BrhUp_6,4.8 ||	yaSasvinO eva BavataH || BrhUp_6,4.8 ||
   BrhUpBh_6,4.8 sā cedasmai dadyādanuguṇaiva syādbhartustadānena	Brhu-upBh_6,4.8 sA ced-asmE dadyAt-anuguNA-eva syAt-BartuH-tadA-anena
   mantreṇopagacchendriyeṇa te yaśasā yaśa ādadhāmīti tadā	mantreNa-upagacCa-indriyeNa te yaSasA yaSaH AdaDAmi-iti tadA
   yaśasvināvevobhāvapi bhavataḥ //8//	yaSasvinO=-eva-uBO=-api BavataH //8//
   START BrhUp 6,4.9	START BrhUp 6,4.9
   sa yām icchet -- kāmayeta meti tasyām arthaṃ niṣṭhāya mukhena mukhaṃ	sa yAm icCet - kAmayeta mA-iti tasyAm arTam nizWAya muKena muKam
   saṃdhāyopastham asyā abhimṛśya japet --	saMDAya-upasTam asyAH aBimRSya japet --
   aṅgād aṅgāt saṃbhavasi hṛdayād adhijāyase |	aFgAt aFgAt saMBavasi hRdayAt aDijAyase |
   sa tvam aṅgakaṣāyo 'si digdhaviddhām iva mādayemām amūṃ mayīti ||	sa tvam aFga-kazAyaH asi digDa-vidDAm iva mAdaya-imAm amUm mayi-iti ||
   BrhUp_6,4.9 ||	BrhUp_6,4.9 ||
   BrhUpBh_6,4.9 sa yāṃ svabhāryāmicchediyaṃ māṃ kāmayeteti tasyāmarthaṃ	Brhu-upBh_6,4.9 sa yAm sva-BAryAm-icCet-iyam mAm kAmayeta-iti tasyAm-arTam
   prajananendriyaṃ niṣṭhāya nikṣipya mukhena mukhaṃ saṃdhāyopasthamasyā	prajanana-indriyam nizWAya nikzipya muKena muKam saMDAya-upasTam-asya-a
   abhimṛśya japedimaṃ mantramaṅgādaṅgāditi //9//	aBimRSya japet-imam mantram-aFgAt-aFgAt-iti //9//
   START BrhUp 6,4.10	START BrhUp 6,4.10
   atha yām icchen na garbhaṃ dadhīteti tasyām arthaṃ niṣṭhāya mukhena mukhaṃ	aTa yAm icCet na garBam daDIta-iti tasyAm arTam nizWAya muKena muKam
   saṃdhāyābhiprāṇyāpānyāt |	saMDAya-aBiprANya-apAnyAt |
   indriyeṇa te retasā reta ādada iti |	indriyeNa te retasA retaH AdadaH iti |
   aretā eva bhavati || BrhUp_6,4.10 ||	aretAH eva Bavati || BrhUp_6,4.10 ||
   BrhUpBh_6,4.10 atha yāmicchenna garbhaṃ dadhīta na dhārayedgarbhiṇī mā	Brhu-upBh_6,4.10 aTa yAm-icCet-na garBam daDIta na DArayet-garBiNI mA
   bhūditi tasyāmarthamiti pūrvavat /	BUt-iti tasyAm-arTam-iti pUrvavat /
   abhiprāṇyābhiprāṇanaṃ prathamaṃ kṛtvā paścādapānyādindriyeṇa te retasā	aBiprANya-aBiprANanam praTamam kRtvA paScAt-apAnyAt-indriyeNa te retasA
   reta ādada ityanena mantreṇāretā eva bhavati na garbhiṇī bhavatītyarthaḥ	retaH AdadaH iti-anena mantreNa-AretAH eva Bavati na garBiNI Bavati-iti-arTaH
   START BrhUp 6,4.11	START BrhUp 6,4.11
   atha yām icched dadhīteti tasyām arthaṃ niṣṭhāya mukhena mukhaṃ	aTa yAm icCet daDIta-iti tasyAm arTam nizWAya muKena muKam
   saṃdhāyāpānyābhiprāṇyāt |	saMDAya-apAnya-aBiprANyAt |
   indriyeṇa te retasā reta ādadhāmīti |	indriyeNa te retasA retaH AdaDAmi-iti |
   garbhiṇy eva bhavati || BrhUp_6,4.11 ||	garBiNI eva Bavati || BrhUp_6,4.11 ||
   BrhUpBh_6,4.11 atha yāmiccheddadhīta garbhamiti tasyāmarthamityādi	Brhu-upBh_6,4.11 aTa yAm-icCet-daDIta garBam-iti tasyAm-arTam-ityAdi
   pūrvavat /	pUrvavat /
   pūrvaviparyayeṇāpānyābhiprāṇyādindriyeṇa te retasā reta ādadhāmīti	pUrva-viparyayeNa-apAnya-aBiprANyAt-indriyeNa te retasA retaH AdaDAmi-iti
   garbhiṇyeva bhavati //11//	garBiNI-eva Bavati //11//
   START BrhUp 6,4.12	START BrhUp 6,4.12
   atha yasya jāyāyai jāraḥ syāt taṃ ced dviṣyād āmapātre 'gnim upasamādhāya	aTa yasya jAyAyE jAraH syAt tam ced dvizyAt Ama-pAtre agnim upasamADAya
   pratilomaṃ śarabarhiḥ stīrtvā tasminn etāḥ śarabhṛṣṭīḥ pratilomāḥ	pratilomam Sara-barhiH stIrtvA tasmin etAH Sara-BRzwIH pratilomAH
   sarpiṣāktā juhuyāt |	sarpizA-aktA juhuyAt |
   mama samiddhe 'hauṣīḥ |	mama samidDe ahOzIH |
   prāṇāpānau ta ādade 'sāv iti |	prANa-apAnO te Adade asO iti |
   mama samiddhe 'hauṣīḥ |	mama samidDe ahOzIH |
   putrapaśūṃs ta ādade 'sāv iti |	putra-paSUn te Adade asO iti |
   mama samiddhe 'hauṣīḥ |	mama samidDe ahOzIH |
   iṣṭāsukṛte ta ādade 'sāv iti |	izwa-asu-kRte te Adade asO iti |
   mama samiddhe 'hauṣīḥ |	mama samidDe ahOzIH |
   aśāparākāśau ta ādade 'sāv iti |	aSApara-AkASO te Adade asO iti |
   sa vā eṣa nirindriyo visukṛto 'smāl lokād praiti yam evaṃvid brāhmaṇaḥ	sa vE eza nirindriyaH visukRtaH asmAt lokAt prEti yam evaMvid brAhmaNaH
   śapati |	Sapati |
   tasmād evaṃvitśrotriyasya dāreṇa nopahāsam icchet |	tasmAt evaMvid-Srotriyasya dAreNa na-upahAsam icCet |
   uta hy evaṃvit paro bhavati || BrhUp_6,4.12 ||	uta hi evaMvid paraH Bavati || BrhUp_6,4.12 ||
   BrhUpBh_6,4.12 atha punaryasya jāyāyai jāra upapatiḥ syāttaṃ	Brhu-upBh_6,4.12 aTa punar-yasya jAyAyE jAraH upapatiH syAt-tam
   ceddviṣyādabhicariṣyāmyenamiti manyeta tasyedaṃ karma /	ced-dvizyAt-aBicarizyAmi-enam-iti manyeta tasya-idam karma /
   āmapātre 'gnimupasamādhāya sarvaṃ pratilomaṃ kuryāttasminnagnāvetāḥ	Ama-pAtre agnim-upasamADAya sarvam pratilomam kuryAt-tasmin=-agnO=-etAH
   śarabhṛṣṭīḥ śareṣīkāḥ pratilomāḥ sarpiṣāktā ghṛtābhyaktā juhuyānmama	Sara-BRzwIH Sara-izIkAH pratilomAH sarpizA-aktA GRta-aByaktA juhuyAt-mama
   samiddhe 'hauṣīrityādyā āhutīrante sarvāsāmasāviti nāmagrahaṇaṃ pratyekam	samidDe ahOzIH-iti-AdyAH AhutIH-ante sarvAsAm-asO=-iti nAma-grahaNam pratyekam
   sa eṣa evaṃvidyā brāhmaṇaḥ śapati sa visukṛto vigatapuṇyakarmā praiti /	saH ezaH evaMvidyA brAhmaNaH Sapati sa visukRtaH vigata-puNya-karmA prEti /
   tasmādevaṃvicchrotrisya dāreṇa nopahāsamicchennarmāpi na	tasmAt-evaMvid-Srotrisya dAreNa na-upahAsam-icCet-narma-api na
   kuryātkimutādhopahāsaṃ hi yasmādevaṃvidapi tāvatparo bhavati	kuryAt-kim-uta-aDopahAsam hi yasmAt-evaMvid-api tAvat-paraH Bavati
   śatrurbhavatītyarthaḥ //12//	SatruH-Bavati-iti-arTaH //12//
   START BrhUp 6,4.13	START BrhUp 6,4.13
   atha yasya jāyām ārtavaṃ vindet tryahaṃ kaṃse na pibet |	aTa yasya jAyAm Artavam vindet tri-aham kaMse na pibet |
   ahatavāsāḥ |	ahata-vAsAH |
   naināṃ vṛṣalo na vṛṣaly apahanyāt |	na-enAm vRzalaH na vRzalI apahanyAt |
   trirātrānta āplutya vrīhīn avaghātayet || BrhUp_6,4.13 ||	tri-rAtra-ante Aplutya vrIhIn avaGAtayet || BrhUp_6,4.13 ||
   BrhUpBh_6,4.13 atha yasya jāyāmārtavaṃ vindedṛtubhāvaṃ	Brhu-upBh_6,4.13 aTa yasya jAyAm-Artavam vindet-Rtu-BAvam
   prāpnuyādityevamādigranthaḥ śrīrha vā eṣā srīṇāmityataḥ pūrvaṃ draṣṭavyaḥ	prApnuyAt-iti-evamAdi-granTaH SrIH-ha vE ezA srINAm-iti-atas pUrvam drazwavyaH
   sāmarthyāt /	sAmarTyAt /
   tryahaṃ kaṃsena pibedahatavāsāśca syāt /	tri-aham kaMsena pibet-ahata-vAsAH-ca syAt /
   naināṃ snātāmasnātāṃ ca vṛṣalo vṛṣalī vā nopahanyānnopaspṛśet /	na-enAm snAtAm-asnAtAm ca vRzalaH vRzalI vA na-upahanyAt-na-upaspRSet /
   trirātrānte trirātravratasamāptāvāplutya snātvāhatavāsā syāditi	tri-rAtra-ante tri-rAtra-vrata-samAptO=-Aplutya snAtvA-ahata-vAsA syAt-iti
   vyavahitena saṃbandhaḥ /	vyavahitena saMbanDaH /
   tāmāplutāṃ vrīhīnavaghātayedvrīhyavaghātāya tāmeva viniyuñjyāt //13//	tAm-AplutAm vrIhIn-avaGAtayet-vrIhi-avaGAtAya tAm-eva viniyuQjyAt //13//
   START BrhUp 6,4.14	START BrhUp 6,4.14
   sa ya icchet -- putro me śuklo jāyeta vedam anubruvīta sarvam āyur iyād	sa yaH icCet - putraH me SuklaH jAyeta vedam anubruvIta sarvam AyuH iyAd
   iti kṣīraudanaṃ pācayitvā sarpiṣmantam aśnīyātām |	iti kzIra-odanam pAcayitvA sarpizmantam aSnIyAtAm |
   īśvarau janayitavai || BrhUp_6,4.14 ||	ISvarO janayitavE || BrhUp_6,4.14 ||
   BrhUpBh_6,4.14 sa ya icchetputro me śuklo varṇato jāyeta	Brhu-upBh_6,4.14 sa yaH icCet-putraH me SuklaH varNataH jAyeta
   vedamekamanubruvīta sarvamāyuriyādvarṣaśataṃ kṣīraudanaṃ pācayitvā	vedam-ekam-anubruvIta sarvam-AyuH-iyAt-varza-Satam kzIra-odanam pAcayitvA
   sarpiṣmantamaśnīyātāmāśvarau samarthau janayitavai janayitum //14//	sarpizmantam-aSnIyAtAma-aSvarO samarTO janayitavEH janayitum //14//
   START BrhUp 6,4.15	START BrhUp 6,4.15
   atha ya icchet -- putro me kapilaḥ piṅgalo jāyeta dvau vedāv anubruvīta	aTa yaH icCet - putraH me kapilaH piFgalaH jAyeta dvO vedO anubruvIta
   sarvam āyur iyād iti dadhyodanaṃ pācayitvā sarpiṣmantam aśnīyātām |	sarvam AyuH iyAt iti daDi-odanam pAcayitvA sarpizmantam aSnIyAtAm |
   īśvarau janayitavai || BrhUp_6,4.15 ||	ISvarO janayitavE || BrhUp_6,4.15 ||
   BrhUpBh_6,4.15 dadhyodanaṃ dadhnā caruṃ pācayitvā dvidevaṃ cedicchati	Brhu-upBh_6,4.15 daDi-odanam daDnA carum pAcayitvA dvidevam ced-icCati
   putraṃ tadaivamaśananiyamaḥ //15//	putram tadA-evam-aSana-niyamaH //15//
   START BrhUp 6,4.16	START BrhUp 6,4.16
   atha ya icchet -- putro me śyāmo lohitākṣo jāyeta trīn vedān anubruvīta	aTa yaH icCet - putraH me SyAmaH lohita-akzaH jAyeta trIn vedAn anubruvIta
   sarvam āyur iyād iti udaudanaṃ pācayitvā sarpiṣmantam aśnīyātām |	sarvam AyuH iyAt iti uda-odanam pAcayitvA sarpizmantam aSnIyAtAm |
   īśvarau janayitavai || BrhUp_6,4.16 ||	ISvarO janayitavE || BrhUp_6,4.16 ||
   BrhUpBh_6,4.16 kevalameva svābhāvikamodanam /	Brhu-upBh_6,4.16 kevalam-eva svABAvikam-odanam /
   udagrahaṇamanyaprasaṅganivṛttyatham //16//	udagrahaNam-anya-prasaFga-nivRtti-aTam //16//
   START BrhUp 6,4.17	START BrhUp 6,4.17
   atha ya icched -- duhitā me paṇḍitā jāyeta sarvam āyur iyād iti tilaudanaṃ	aTa yaH icCet - duhitA me paNxitA jAyeta sarvam AyuH iyAt iti tila-odanam
   pācayitvā sarpiṣmantam aśnīyātām |	pAcayitvA sarpizmantam aSnIyAtAm |
   īśvarau janayitavai || BrhUp_6,4.17 ||	ISvarO janayitavE || BrhUp_6,4.17 ||
   BrhUpBh_6,4.17 duhituḥ pāṇḍityaṃ gṛhatantraviṣayameva vede 'nadhikārāt /	Brhu-upBh_6,4.17 duhituH pANxityam gRha-tantra-vizayam-eva vede anaDikArAt /
   tilaudanaṃ kṛtaram //17//	tila-odanam kRtaram //17//
   START BrhUp 6,4.18	START BrhUp 6,4.18
   atha ya icchet -- putro me paṇḍito vigītaḥ samitiṃgamaḥ śuśrūṣitāṃ vācaṃ	aTa yaH icCet - putraH me paNxitaH vigItaH samitiMgamaH SuSrUzitAm vAcam
   bhāṣitā jāyeta sarvān vedān anubruvīta sarvam āyur iyād iti māṃsaudanaṃ	BAzitA jAyeta sarvAn vedAn anubruvIta sarvam AyuH iyAt iti mAMsa-odanam
   pācayitvā sarpiṣmantam aśnīyātām |	pAcayitvA sarpizmantam aSnIyAtAm |
   īśvarau janayitavāi |	ISvarO janayitavAi |
   aukṣeṇa vārṣabheṇa vā || BrhUp_6,4.18 ||	OkzeNa vArzaBeNa vA || BrhUp_6,4.18 ||
   BrhUpBh_6,4.18 vividhaṃ gīto vigītaḥ prakhyāta ityarthaḥ /	Brhu-upBh_6,4.18 viviDam gItaH vigItaH praKyAtaH iti-arTaH /
   samitiṅgamaḥ sabhāṃ gacchatīti pragalbha ityarthaḥ /	samitiFgamaH saBAm gacCati-iti pragalBaH iti-arTaH /
   pāṇḍityasya pṛthaggrahaṇāt /	pANxityasya pRTak-grahaNAt /
   śuśrūṣitāṃ śrotumiṣṭāṃ ramaṇīyāṃ vācaṃ bhāṣitā saṃskṛtāyā arthavatyā vāco	SuSrUzitAm Srotum-izwAm ramaNIyAm vAcam BAzitA saMskRtAyAH arTavatyA vAcaH-
   bhāṣitetyarthaḥ /	BAzitA-iti-arTaH /
   māṃsamiśramodanaṃ māṃsaudanam /	mAMsa-miSram-odanam mAMsa-odanam /
   tanmāṃsaniyamārthamāha-aukṣeṃ vā māṃsena /	tad-mAMsa-niyama-arTamAha--Okzem vA mAMsena /
   ukṣā secanasamarthaḥ puṅgavastadīyaṃ māṃsam /	ukzA secana-samarTaH puFgavaH-tadIyam mAMsam /
   ṛṣabhastato 'pyadhikavayāstadīyamārṣabhaṃ māṃsam //17//	RzaBaH-tatas api-aDikavayAH-tadIyam-ArzaBam mAMsam //17//
   START BrhUp 6,4.19	START BrhUp 6,4.19
   athābhiprātar eva sthālīpākāvṛtājyaṃ ceṣṭitvā sthālīpākasyopaghātaṃ juhoty	aTa-aBiprAtar eva sTAlI-pAka-AvRta-Ajyam cezwitvA sTAlIpAkasya-upaGAtam juhoti-
   agnaye svāhānumataye svāhā devāya savitre satyaprasavāya svāheti |	agnaye svAhA-anumataye svAhA devAya savitre satya-prasavAya svAhA-iti |
   hutvoddhṛtya prāśnāti |	hutvA-udDRtya prASnAti |
   prāśyetarasyāḥ prayacchati |	prASya-itarasyAH prayacCati |
   prakṣālya pāṇī udapātraṃ pūrayitvā tenaināṃ trir abhyukṣati --	prakzAlya pANI uda-pAtram pUrayitvA tena-enAm tris aByukzati --
   uttiṣṭhāto viśvāvaso 'nyām iccha prapūrvyām |	uttizWAtaH viSvAvasaH anyAm icCa prapUrvyAm |
   saṃ jāyāṃ patyā saheti || BrhUp_6,4.19 ||	sam jAyAm patyA saha-iti || BrhUp_6,4.19 ||
   BrhUpBh_6,4.19 athāmiprātareva kāle 'vaghātanirvṛttāṃstaṇḍulānādāya	Brhu-upBh_6,4.19 aTa-Ami-prAtareva kAle avaGAta-nirvRttAn=-taNxulAn-AdAya
   sthālīpākāvṛtā sthālīpākavidhinā'jyaṃ ceṣṭitvā'jyasaṃskāraṃ kṛtvā caruṃ	sTAlI-pAka-AvRtA sTAlI-pAka-viDinA-ajyam cezwitvA-ajya-saMskAram kRtvA carum
   śrapayitvā sthālīpākasyā'hutīrjuhotyupaghātamupahatyopahatyāgnaye	SrapayitvA sTAlI-pAkasya-AahutIH-juhoti-upaGAtam-upahatya-upahatya-agnaye
   svāhetyādyāḥ /	svAhA-ityAdyAH /
   gārhyaḥ sarvo vidhirdraṣṭavyo 'tra hutvoddhṛtya caruśeṣaṃ prāśnāti svayaṃ	gArhyaH sarvaH viDiH-drazwavyaH atra hutvA-udDRtya caru-Sezam prASnAti svayam
   prāśyetarasyāḥ patnyai prayacchatyucchiṣṭam /	prASya-itarasyAH patnyE prayacCati-ucCizwam /
   prakṣālya pāṇī ācamyodapātraṃ pūrayitvā tenodakenaināṃ trirabhyukṣatyena	prakzAlya pANI Acamya-uda-pAtram pUrayitvA tena-udakena-enAm tris-aByukzatyena
   mantreṇottiṣṭhāta iti sakṛnmantroccāraṇam //19//	mantreNa-uttizWAte iti sakRt-mantra-uccAraNam //19//
   START BrhUp 6,4.20	START BrhUp 6,4.20
   athainām abhipadyate -- amo 'ham asmi sā tvam |	aTa-enAm aBipadyate - amaH aham asmi sA tvam |
   sā tvam asy amo 'ham |	sA tvam asi amaH aham |
   sāmāham asmi ṛk tvam |	sAma-aham asmi Rc tvam |
   dyaur aham pṛthivī tvam |	dyOH aham pRTivI tvam |
   tāv ehi saṃrabhāvahai saha reto dadhāvahai |	tO ehi saMraBAvahE saha retaH daDAvahE |
   puṃse putrāya vittaya iti || BrhUp_6,4.20 ||	puMse putrAya vittayaH iti || BrhUp_6,4.20 ||
   BrhUpBh_6,4.20 athaināmabhimantrya kṣīraudanādi yathāpatyakāmaṃ bhuktveti	Brhu-upBh_6,4.20 aTa-enAm-aBimantrya kzIra-odana-Adi yaTA-apatya-kAmam BuktvA-iti
   kramo draṣṭavyaḥ /	kramaH drazwavyaH /
   saṃveśanakāle 'mo 'hamasmītyādimantreṇābhipadyate //20//	saMveSana-kAle amaH aham-asmi-ityAdi-mantreNa-aBipadyate //20//
   START BrhUp 6,4.21	START BrhUp 6,4.21
   athāsyā ūrū vihāpayati -- vijihīthāṃ dyāvāpṛthivī iti |	aTa-asyAH UrU vihApayati - vijihITAm dyAvApRTivI iti |
   tasyām arthaṃ niṣṭhāya mukhena mukhaṃ saṃdhāya trir enām anulomām	tasyAm arTam nizWAya muKena muKam saMDAya tris enAm anulomAm
   anumārṣṭi --	anumArzwi --
   viṣṇur yoniṃ kalpayatu tvaṣṭā rūpāṇi piṃśatu |	vizNuH yonim kalpayatu tvazwA rUpANi piMSatu |
   ā siñcatu prajāpatir dhātā garbhaṃ dadhātu te |	A siQcatu prajApatiH DAtA garBam daDAtu te |
   garbhaṃ dhehi sinīvāli garbhaṃ dhehi pṛthuṣṭuke |	garBam Dehi sinIvAli garBam Dehi pRTuzwuke |
   garbhaṃ te aśvinau devāv ādhattāṃ puṣkarasrajau || BrhUp_6,4.21 ||	garBam te aSvinO devO ADattAm puzkara-srajO || BrhUp_6,4.21 ||
   BrhUpBh_6,4.21 athāsyā ūrū vihāpayati vijihīthāṃ dyāvāpṛthivī ityanena /	Brhu-upBh_6,4.21 aTa-asyAH UrU vihApayati vijihITAm dyAvApRTivI iti-anena /
   tasyāmarthamityādi pūrvavat /	tasyAm-arTam-ityAdi pUrvavat /
   trirenāṃ śiraḥ prabhṛtyanulomāmanumārṣṭi viṣṇuryonimityādi pratimantram	tris-enAm SiraH praBRti-anulomAm-anumArzwi vizNuH-yonim-ityAdi pratimantram
   START BrhUp 6,4.22	START BrhUp 6,4.22
   hiraṇmayī araṇī yābhyāṃ nirmanthatām aśvinau |	hiraNmayI araNI yAByAm nirmanTa-tAm aSvinO |
   taṃ te garbhaṃ havāmahe daśame māsi sūtaye |	tam te garBam havAmahe daSame mAsi sUtaye |
   yathāgnigarbhā pṛthivī yathā dyaur aindreṇa garbhiṇī |	yaTA-agni-garBA pRTivI yaTA dyOH EndreNa garBiNI |
   vāyur diśāṃ yathā garbha evaṃ garbhaṃ dadhāmi te 'sāv iti || BrhUp_6,4.22	vAyuH diSAm yaTA garBaH evam garBam daDAmi te asO iti || BrhUp_6,4.22
   BrhUpBh_6,4.22 ante nāma gṛhṇātyasāviti tasyāḥ //22//	BrhUpBh_6,4.22 ante nAma gRhNAti-asO=-iti tasyAH //22//
   START BrhUp 6,4.23	START BrhUp 6,4.23
   soṣyantīm adbhir abhyukṣati --	sozyantIm adBiH aByukzati --
   yathā vāyuḥ puṣkariṇīṃ samiṅgayati sarvataḥ |	yaTA vAyuH puzkariNIm samiFgayati sarvatas |
   evā te garbha ejatu sahāvaitu jarāyuṇā |	evA te garBaH ejatu saha-avEtu jarAyuNA |
   indrasyāyaṃ vrajaḥ kṛtaḥ sārgalaḥ sapariśrayaḥ |	indrasya-ayam vrajaH kRtaH sArgalaH sa-pariSrayaH |
   tam indra nirjahi garbheṇa sāvarāṃ saheti || BrhUp_6,4.23 ||	tam indra nirjahi garBeNa sa-avarAm saha-iti || BrhUp_6,4.23 ||
   BrhUpBh_6,4.23 soṣyantīmadbhirabhyukṣati prasavakāle	Brhu-upBh_6,4.23 sozyantIm-adBiH-aByukzati prasava-kAle
   sukhaprasavanārthamanena mantreṇa /	suKa-prasavana-arTam-anena mantreNa /
   yathā vāyuḥ puṣkariṇīṃ samiṅgayati sarvataḥ /	yaTA vAyuH puzkariNIm samiFgayati sarvatas /
   evā te garbha ejatviti //23//	evA te garBaH ejatu-iti //23//
   START BrhUp 6,4.24	START BrhUp 6,4.24
   jāte 'gnim upasamādhāyāṅka ādhāya kaṃse pṛṣadājyaṃ saṃnīya	jAte agnim upasamADAya-aFkaH ADAya kaMse pRzadAjyam saMnIya
   pṛṣadājyasyopaghātaṃ juhoti --	pRzadAjyasya-upaGAtam juhoti --
   asminsahasraṃ puṣyāsam edhamānaḥ sve gṛhe |	asmin-sahasram puzyAsam eDamAnaH sve gRhe |
   asyopasandyāṃ mā chaitsīt prajayā ca paśubhiś ca svāhā |	asya-upasandyAm mA CEtsIt prajayA ca paSuBiH ca svAhA |
   mayi prāṇāṃs tvayi manasā juhomi svāhā |	mayi prANAn tvayi manasA juhomi svAhA |
   yat karmaṇātyarīricam yad vā nyūnam ihākaram |	yat karmaNA-atyarIricam yat vA nyUnam iha-akaram |
   agniṣṭat sviṣṭakṛd vidvān sviṣṭaṃ suhutaṃ karotu naḥ svāheti ||	agnizwat svizwakRt vidvAn su-izwam su-hutam karotu naH svAhA-iti ||
   BrhUp_6,4.24 ||	BrhUp_6,4.24 ||
   BrhUpBh_6,4.24atha jātakarma /	Brhu-upBh_6,4.24aTa jAtakarma /
   jāte 'gnimupasamādhāyāṅka ādhāya putraṃ kaṃse pṛṣadājyaṃ saṃmīya saṃyojya	jAte agnim-upasamADAya-aFkaH ADAya putram kaMse pRzadAjyam saMmIya saMyojya
   dadhi ghṛte pṛṣadājyasyopaghātaṃ juhotyasminsahasramityādyāvāpasthāne	daDi GRte pRzadAjyasya-upaGAtam juhoti-asmin-sahasram-iti-Adi-AvApa-sTAne
   START BrhUp 6,4.25	START BrhUp 6,4.25
   athāsya dakṣiṇaṃ karṇam abhinidhāya vāg vāg iti triḥ |	aTa-asya dakziNam karNam aBiniDAya vAc vAc iti tris |
   atha dadhi madhu ghṛtaṃ saṃnīyānantarhitena jātarūpeṇa prāśayati |	aTa daDi maDu GRtam saMnIya-anantarhitena jAtarUpeNa prASayati |
   bhūs te dadhāmi bhuvas te dadhāmi svas te dadhāmi bhūr bhuvaḥ svaḥ sarvaṃ	BUH te daDAmi BuvaH te daDAmi svar te daDAmi BUH BuvaH svar sarvam
   tvayi dadhāmīti || BrhUp_6,4.25 ||	tvayi daDAmi-iti || BrhUp_6,4.25 ||
   BrhUpBh_6,4.25 athāsya dakṣiṇaṃ karṇamabhinidhāya svaṃ mukhaṃ vāgvāgiti	Brhu-upBh_6,4.25 aTa-asya dakziNam karNam-aBiniDAya svam muKam vAc-vAc-iti
   trirjapet /	tris-japet /
   atha dadhi madhu ghṛtaṃ saṃnīyānantarhitenāvyavahitena jātarūpeṇa	aTa daDi maDu GRtam saMnIya-anantarhitena-avyavahitena jAtarUpeNa
   hiraṇyena prāśayatyetairmantraiḥ pratyekam //25//	hiraNyena prASayati-etEH-mantrEH pratyekam //25//
   START BrhUp 6,4.26	START BrhUp 6,4.26
   athāsya nāma karoti vedo 'sīti |	aTa-asya nAma karoti vedaH asi-iti |
   tad asyaitad guhyam eva nāma bhavati || BrhUp_6,4.26 ||	tat asya-etat guhyam eva nAma Bavati || BrhUp_6,4.26 ||
   BrhUpBh_6,4.26 athāsya nāmadheyaṃ karoti vedo 'sīti /	Brhu-upBh_6,4.26 aTa-asya nAmaDeyam karoti vedaH asi-iti /
   tadasya tadguhyaṃ nāma bhavati veda iti //26//	tat-asya tat-guhyam nAma Bavati vedaH iti //26//
   START BrhUp 6,4.27	START BrhUp 6,4.27
   athainaṃ mātre pradāya stanaṃ prayacchati -- yas te stanaḥ śaśayo yo	aTa-enam mAtre pradAya stanam prayacCati - yaH te stanaH SaSayaH yaH-
   mayobhūr yo ratnadhā vasuvid yaḥ sudatraḥ |	mayaH-BUH yaH ratnaDA vasu-vid yaH su-datraH |
   yena viśvā puṣyasi vāryāṇi sarasvati tam iha dhātave kar iti ||	yena viSvA puzyasi vAryANi sarasvati tam iha DAtave kar iti ||
   BrhUp_6,4.27 ||	BrhUp_6,4.27 ||
   BrhUpBh_6,4.27 athainaṃ mātre pradāya svāṅkasthaṃ stanaṃ prayacchati yaste	Brhu-upBh_6,4.27 aTa-enam mAtre pradAya sva-aFka-sTam stanam prayacCati yaH-te
   stana ityādimantreṇa //27//	stanaH ityAdi-mantreNa //27//
   START BrhUp 6,4.28	START BrhUp 6,4.28
   athāsya mātaram abhimantrayate -- ilāsi maitrāvaruṇī vīre vīram ajījanat |	aTa-asya mAtaram aBimantrayate - ilA-asi mEtrAvaruNI vIre vIram ajIjanat |
   sā tvaṃ vīravatī bhava yāsmān vīravato 'karad iti |	sA tvam vIravatI Bava yA-asmAn vIravataH akarat iti |
   taṃ vā etam āhuḥ -- atipitā batābhūḥ |	tam vE etam AhuH - atipitA bata-aBUH |
   atipitāmaho batābhūḥ |	atipitAmahaH bata-aBUH |
   paramāṃ bata kāṣṭhāṃ prāpa śriyā yaśasā brahmavarcasena |	paramAm bata kAzWAm prApa SriyA yaSasA brahmavarcasena |
   ya evaṃvido brāhmaṇasya putro jāyata iti || BrhUp_6,4.28 ||	yaH evaMvidaH brAhmaNasya putraH jAyate iti || BrhUp_6,4.28 ||
   BrhUpBh_6,4.28 athāsya mātaramabhimantrayata ilāsītyanena /	Brhu-upBh_6,4.28 aTa-asya mAtaram-aBimantrayataH ilAsi-iti-anena /
   taṃ vā etamāhurityanena vidhinā jātaḥ putraḥ pitaraṃ pitāmahaṃ cātiśeta	tam vE etam-AhuH-iti-anena viDinA jAtaH putraH pitaram pitAmaham ca-atiSeta
   iti śriyā yaśasā brahmavarcasena paramāṃ niṣṭhāṃ prāpadityevaṃ stutyo	iti SriyA yaSasA brahmavarcasena paramAm nizWAm prApat-iti-evam stutyaH-
   bhavatītyarthaḥ /	Bavati-iti-arTaH /
   yasya caivaṃvido brāhmaṇasya putro jāyate sa caivaṃ bhavatītyadhyāhāryam	yasya ca-evaMvidaH brAhmaNasya putraH jAyate sa ca-evam Bavati-iti-aDyAhAryam
   iti bṛhadāraṇyakopaniṣadi ṣaṣṭhādhyāyasya caturthaṃ brāhmaṇam //4//	iti bRhadAraNyaka-upanizadi zazWa-aDyAyasya caturTam brAhmaNam //4//
   START BrhUp 6,5.1-4	START BrhUp 6,5.1-4
   atha vaṃśaḥ |	aTa vaMSaH |
   pautimāṣīputraḥ kātyāyanīputrāt |	pOtimAzI-putraH kAtyAyanIputrAt |
   kātyāyanīputro gautamīputrāt |	kAtyAyanIputraH gOtamIputrAt |
   gautamīputro bhāradvājīputrāt |	gOtamIputraH BAradvAjI-putrAt |
   bhāradvājīputraḥ pārāśarīputrāt |	BAradvAjI-putraH pArASarIputrAt |
   pārāśarīputra aupasvastīputrāt |	pArASarIputra OpasvastIputrAt |
   aupasvastīputraḥ pārāśarīputrāt |	OpasvastIputraH pArASarIputrAt |
   pārāśarīputraḥ kātyāyanīputrāt |	pArASarIputraH kAtyAyanIputrAt |
   kātyāyanīputraḥ kauśikīputrāt |	kAtyAyanIputraH kOSikIputrAt |
   kauśikīputra ālambīputrāc ca vaiyāghrapadīputrāc ca |	kOSikIputraH AlambIputrAt ca vEyAGrapadIputrAt ca |
   vaiyāghrapadīputrah kāṇvīputrāc ca kāpīputrāc ca |	vEyAGrapadIputrah kANvIputrAt ca kApIputrAt ca |
   kāpīputraḥ || BrhUp_6,5.1 ||	kApIputraH || BrhUp_6,5.1 ||
   ātreyīputrāt |	AtreyIputrAt |
   ātreyīputro gautamīputrāt |	AtreyIputraH gOtamIputrAt |
   gautamīputro bhāradvājīputrāt |	gOtamIputraH BAradvAjI-putrAt |
   bhāradvājīputraḥ pārāśarīputrāt |	BAradvAjI-putraH pArASarIputrAt |
   pārāśarīputro vātsīputrāt |	pArASarI-putraH vAtsIputrAt |
   vātsīputraḥ pārāśarīputrāt |	vAtsIputraH pArASarIputrAt |
   pārāśarīputro vārkārunīputrāt |	pArASarIputraH vA-arkArunIputrAt |
   vārkāruṇīputro vārkāruṇīputrāt |	vArkAruNIputraH vArkAruNIputrAt |
   vārkāruṇīputra ārtabhāgīputrāt |	vArkAruNIputraH ArtaBAgIputrAt |
   ārtabhāgīputraḥ śauṅgīputrāt |	ArtaBAgIputraH SOFgIputrAt |
   śauṅgīputraḥ sānkṛtīputrāt |	SOFgIputraH sAnkRtIputrAt |
   sāṅṛtīputra ālambāyanīputrāt |	sa-aFRtIputraH AlambAyanIputrAt |
   ālambāyanīputra ālambīputrāt |	AlambAyanIputraH AlambIputrAt |
   ālambīputro jāyantīputrāt |	AlambIputraH jAyantIputrAt |
   jāyantīputro māṇḍūkāyanīputrāt |	jAyantIputraH mANxUkAyanIputrAt |
   māṇḍūkāyanīputro māṇḍūkīputrāt |	mANxUkAyanIputraH mANxUkIputrAt |
   māṇḍūkīputraḥ śāṇḍilīputrāt |	mANxUkIputraH SANxilIputrAt |
   śāṇḍilīputro rāthītarīputrāt |	SANxilIputraH rATItarIputrAt |
   rāthītarīputro bhālukīputrāt |	rATItarIputraH BAlukIputrAt |
   bhālukīputraḥ krauñcikīputrābhyām |	BAlukIputraH krOQcikIputrAByAm |
   krauñcikīputrau vaidabhṛtīputrāt |	krOQcikIputrO vEdaBRtIputrAt |
   vaidabhṛtīputraḥ kārśakeyīputrāt |	vEdaBRtIputraH kArSakeyI-putrAt |
   kārśakeyīputraḥ prācīnayogīputrāt |	kArSakeyI-putraH prAcIna-yogIputrAt |
   prācīnayogīputraḥ sāñjīvīputrāt |	prAcIna-yogIputraH sAQjIvIputrAt |
   sāñjīvīputraḥ prāśnīputrād āsurivāsinaḥ |	sAQjIvIputraH prASnIputrAt AsurivAsinaH |
   prāśnīputra āsurāyaṇāt |	prASnIputraH AsurAyaNAt |
   āsurāyaṇa āsureḥ |	AsurAyaNaH AsureH |
   āsuriḥ| BrhUp_6,5.2 ||	AsuriH| BrhUp_6,5.2 ||
   yājñavalkyāt |	yAjQavalkyAt |
   yājñavalkya uddālakāt |	yAjQavalkyaH uddAlakAt |
   uddālako 'ruṇāt |	uddAlakaH aruNAt |
   aruṇa upaveśeḥ |	aruNaH upaveSeH |
   upaveśiḥ kuśreḥ |	upaveSiH kuSreH |
   kuśrir vājaśravasaḥ |	kuSriH vAjaSravasaH |
   vājaśravā jīhvāvato bādhyogāt |	vAjaSravAH jIhvAvataH bADyogAt |
   jīhvāvān bādhyogo 'sitād vārṣagaṇāt |	jIhvAvAn bADyogaH asitAt vArza-gaNAt |
   asito vārṣagaṇo haritāt kaśyapāt |	asitaH vArza-gaNaH haritAt kaSyapAt |
   haritaḥ kaśyapaḥ śilpāt kaśyapāt |	haritaH kaSyapaH SilpAt kaSyapAt |
   śilpaḥ kaśyapaḥ kaśyapān naidhruveḥ |	SilpaH kaSyapaH kaSyapAt nEDruveH |
   kaśyapo naidhruvir vācaḥ |	kaSyapaH nEDruviH vAcaH |
   vāg ambhiṇyāḥ |	vAc amBiNyAH |
   ambhiṇy ādityāt |	amBiNI AdityAt |
   ādityānīmāni śuklāni yajūṃṣi vājasaneyena yājñavalkyenākhyayante ||	AdityAni-imAni SuklAni yajUMzi vAjasaneyena yAjQavalkyena-AKyayante ||
   BrhUp_6,5.3 ||	BrhUp_6,5.3 ||
   samānam ā sāñjīvīputrāt |	samAnam A sAQjIvIputrAt |
   sañjivīputro māṇḍūkāyaneḥ |	saQjivIputraH mANxUkAyaneH |
   māṇḍūkāyanir māṇḍavyāt |	mANxUkAyaniH mANxavyAt |
   māṇḍavyaḥ kautsāt |	mANxavyaH kOtsAt |
   kautso māhittheḥ |	kOtsaH mAhitTeH |
   māhitthir vāmakakṣāyaṇāt |	mAhitTiH vAmakakzAyaNAt |
   vāmakakṣāyaṇaḥ śāṇḍilyāt |	vAmakakzAyaNaH SANxilyAt |
   śāṇḍilyo vātsyāt |	SANxilyaH vAtsyAt |
   vātsyaḥ kuśreḥ |	vAtsyaH kuSreH |
   kuśrir yajñavacasaḥ rājastambāyanāt |	kuSriH yajQa-vacasaH rAja-stambAyanAt |
   yajñavacā rājastambāyanaḥ turāt kāvaṣeyāt |	yajQavacAH rAjastambAyanaH turAt kAvazeyAt |
   turaḥ kāvaṣeyaḥ prajāpateḥ |	turaH kAvazeyaH prajApateH |
   prajāpatir brahmaṇaḥ |	prajApatiH brahmaNaH |
   brahma svayaṃbhu |	brahma svayaMBu |
   brahmaṇe namaḥ || BrhUp_6,5.4 ||	brahmaNe namaH || BrhUp_6,5.4 ||
   BrhUpBh_6,5.1-4 athedānīṃ samastapravacanavaṃśaḥ /	Brhu-upBh_6,5.1-4 aTa-idAnIm samasta-pravacana-vaMSaH /
   srīprādhānyāt guṇavānputro bhavatīti prastutam /	srI-prADAnyAt guNavAn-putraH Bavati-iti prastutam /
   ataḥ srīviśeṣaṇenaiva putraviśeṣaṇādācāryaparamparā kīrtyate /	atas srI-viSezaNena-eva putra-viSezaNAt-AcArya-paramparA kIrtyate /
   tānīmāni śuklānītyavyāmiśrāṇi brāhmaṇena /	tAni-imAni SuklAni-iti-avyAmiSrANi brAhmaNena /
   athavā yānīmāni yajūṃṣi tānī śuklāni śuddhānītyetat /	aTavA yAni-imAni yajUMzi tAnI SuklAni SudDAni-iti-etat /
   prajāpatimārabhya yāvatpautimāṣīputrastāvadadhomukho niyatācāryapūrvakramo	prajApatim-AraBya yAvat-pOtimAzI-putraH-tAvat-aDomuKaH niyata-AcArya-pUrva-kramaH-
   vaṃśaḥ samānamāsāṃjīvīputrāt /	vaMSaH samAna-mAsAMjIvIputrAt /
   brahmaṇaḥ pravacanākhyasya /	brahmaNaH pravacana-AKyasya /
   taccaitadbrahma	tat-ca-etat-brahma
   prajāpatiprabandhaparamparayā'gatyāsmāsvanekadhāviprasṛtamanādyanantaṃ	prajApati-prabanDa-paramparayA-agatya-asmAsu-anekaDA-viprasRtam-anAdi-anantam
   svayaṃbhu brahma nityaṃ tasmai brahmaṇe namaḥ /	svayaMBu brahma nityam tasmE brahmaNe namaH /
   namastadanuvartibhyo gurubhyaḥ //1-4 //	namaH-tad-anuvartiByaH guruByaH //1-4 //
   iti bṛhadāraṇyakopaniṣadi ṣaṣṭhādhyāyasya pañcamaṃ brāhmaṇam //5//	iti bRhadAraNyaka-upanizadi zazWa-aDyAyasya paQcamam brAhmaNam //5//
   iti vājasaneyake bṛhadāraṇyakopaniṣadi ṣaṣṭhodhyāyaḥ //6//	iti vAjasaneyake bRhadAraNyaka-upanizadi zazWoDyAyaH //6//
   iti vājasaneyakebṛhadāraṇyakakrameṇāṣṭamo 'dhyāyaḥ //8//	iti vAjasaneyakebRhat-AraNyaka-krameNa-azwamaH aDyAyaH //8//
   iti śuklayajurvedīyā bṛhadāraṇyakopaniṣat saṃpūrṇā	iti Sukla-yajurvedIyA bRhadAraNyaka-upanizad saMpUrNA
   oṃ pūrṇamadaḥ pūrṇamidaṃ pūrṇātpūrṇamudacyate /	om pUrNamadaH pUrNam-idam pUrNAt-pUrNam-udacyate /
   pūrṇasya pūrṇamādāya pūrṇamevāvaśiṣyate //	pUrNasya pUrNam-AdAya pUrNam-eva-avaSizyate //
   oṃ śāntiḥ śāntiḥ śāntiḥ	om SAntiH SAntiH SAntiH
