   Upāyahṛdayam /	UpAya hRdayam /
   atha prathamaṃ prakaraṇam /	aTa praTamam prakaraNam /
   etādvādāvabodhena vādadharmāvabodhanam /	etAdvAda avaboDena vAda Darma avaboDanam /
   vistareṇa ca gambhīro 'yamartho 'trābhidhīyate //	vistareNa ca gamBIraH ayam arTaH atra aBiDIyate //
   vādo na kartavyaḥ / kasmāt? prāyeṇa hi vādakārakāṇāṃ	vAdaH na kartavyaH / kasmAt? prAyeNa hi vAda kArakANAm
   sañjātavipulakrodhamadamattānāṃ svayaṃ vibhrāntacittānāṃ manaso	saQjAta vipula kroDa mada mattAnAm svayam viBrAnta cittAnAm manasaH 
   'natimṛdutā parapāpaprakāśakatvaṃ svapāṇḍityānumodakatvañcetyādayo doṣā	anatimRdu tA para pApa prakASaka tvam sva pANxitya anumodaka tvaQca ityAdayaH dozA
   budhirnirbhatsitāḥ / tasmādāryajanā	buDiH nirBatsitAH / tasmAt Arya janA
   asaṃkhyeyopāyairvivādachedakāstatparihāraprītāśca viṣabhājanaparityāgādiva	asaMKyeya upAyEH vivAda CedakAH tad parihAra prItAH ca viza BAjana parityAgAt iva
   / vādakārakāṇāñcāntaraṃ vastuto mṛdvapi paraṃ bahirbahudoṣaṃ dṛśyate /	/ vAda kAra kANAQca antaram vastutas mRdu api param bahis bahu dozam dRSyate /
   tasmātsvahitaparahitābhilāṣiṇaite vivādadharmāḥ praheyāḥ /	tasmAt sva hita para hita aBilAziNA ete vivAda DarmAH praheyAH /
   atrocyate / maivaṃ, naiṣa vādaprārambhaḥ paribhavalābhakhyātyartho 'pi tu	atra ucyate / mA evaM, na eza vAda prAramBaH pariBava lABa KyAti arTaH api tu
   sulakṣaṇadurlakṣaṇopadeśecchayaiva vādasya prārambhaḥ /	su lakzaNa durlakzaNa upadeSa icCayA eva vAdasya prAramBaH /
   yadīha loke vādo na bhavet, mugdhānāṃ bāhulyaṃ syāt / tataśca	yadi iha loke vAdaH na Bavet, mugDAnAm bAhulyam syAt / tatas ca
   laukikamithyājñānakuśalatāsahacarabhrāntisamudbhūtakukarmabhiḥ	lOkika miTyA jQAna kuSa la tA sahacara BrAnti samudBUta kukarmaBiH
   saṃsāradurgatiḥ sadarthahāniśca /	saMsAra durgatiH sat arTa hAniH ca /
   vādāvagame tu svayaṃ sulakṣadurlakṣaṇaśūnyalakṣaṇaparijñānatvāt sarve	vAda avagame tu svayam su lakza durlakzaNa SUnya lakzaNa parijQAna tvAt sarve
   mārāstīrthikā mithyādṛṣṭimanuṣyāśca viheṭhanāsamarthā (# Uh 4.#)	mArAH tIrTikAH miTyA dRzwi manuzyAH ca viheWanA samarTAH (# Uh 4.#)
   apratibandhakārāśca / tasmātsattvahitecchayeha loke saddharmasya	apratibanDa kArAH ca / tasmAt sattva hita icCayA iha loke sadDarmasya
   pracārecchayā ca mayaiṣa samyagvāda ārabhyate /	pracAra icCayA ca mayA eza samyak vAdaH AraByate /
   yathāsraphalaparipuṣṭikāmena tat(phala)parirakṣaṇārthaṃ	yaTA asra Pala paripuzwi kAmena tat( Pala) parirakzaNa arTam
   bahirbahutīkṣṇakaṇṭakanikaravinyāsaḥ kriyate /	bahis bahu tIkzNa kaNwaka nikara vinyAsaH kriyate /
   vādārambho 'pi tathaivādhunā saddharmmarakṣaṇecchayā na tu khyātilābhāya /	vAda AramBaH api taTA eva aDunA sadDarmma rakzaNa icCayA na tu KyAti lABAya /
   yaduktaṃ (bhavatā) pūrvaṃ [eṣa vādo] vivādapravardhaka iti / tadayuktam /	yat uktam (BavatA) pUrvam [eza vAdo] vivAda pravarDakaH iti / tat ayuktam /
   dharmarakṣaṇārthameva hi vāda ārabdhavyaḥ /	Darma rakzaNa arTam eva hi vAdaH ArabDavyaH /
   āha / yaduktaṃ pūrvaṃ bhavatā yadyetaṃ vādaṃ	Aha / yat uktam pUrvam BavatA yadi etam vAdam
   jānīyādvādadharmānavagacchediti vaktavyametasya lakṣaṇam /	jAnIyAt vAda DarmAn avagacCet iti vaktavyam etasya lakzaNam /
   atrocyate / tasya vādasyāṣṭavidho bhedaḥ / tadarthagatiprajñānasāmarthye	atra ucyate / tasya vAdasya azwaviDaH BedaH / tad arTa gati prajQAna sAmarTye
   paravādāvagamaḥ, yathā dhānyamuptvā siktā codakena tasya puṣṭiḥ	para vAda avagamaH, yaTA DAnyam uptvA siktA ca udakena tasya puzwiH
   samṛddhiśca sādhyate / tṛṇādyanutsāraṇe tūṭkṛṣṭāṅkurā na jāyante / yadi	samRdDiH ca sADyate / tRNa Adi anutsAraNe tu uwkRzwa aFkurAH na jAyante / yadi
   kaścidetamaṣṭāvidhaṃ [vādaṃ] śṛṇuyādarthantu tasya nāvagacchettadā [tasya]	kaScid etam azwAviDam [vAdaM] SRNuyAt arTantu tasya na avagacCet tadA [tasya]
   sarveṣu vādeṣu saṃśayo bhavet / yadi kaścidetamaṣṭavidhamarthaṃ	sarvezu vAdezu saMSayaH Bavet / yadi kaScid etam azwaviDam arTam
   parijānīyānniyatameva sarvavādadharmāvagame samartho bhavet /	parijAnIyAt niyatam eva sarva vAda Darma avagame samarTaH Bavet /
   āha / etadvādaparijñānādeva vādadharmā niyatamavagamyanta iti	Aha / etad vAda parijQAnAt eva vAdaDarmAH niyatam avagamyante iti
   (bhavato)ktam / atha tīrthikānāṃ vādadharmāḥ santi na vā / atrocyate	(BavatA u)ktam / aTa tIrTikAnAm vAda DarmAH santi na vA / atra ucyate
   santyeva / yathā vaiśeṣikāṇāṃ ṣaṭ padārthāḥ / dravyaṃ guṇaḥ sāmānyaṃ	santi eva / yaTA vESezikANAm zaw padArTAH / dravyam guNaH sAmAnyam
   viśeṣaḥ karma samavāyaścetyādikavādadharmeṣu svavagateṣvapi	viSezaH karma samavAyaH ca iti Adika vAda Darmezu su avagatezu api
   parasūtraśāstrāṇāmapratītiḥ /	para sUtra SAstrANAm apratItiH /
   ato vādanayapratipādanārthaṃ prapañcocchedanārthañcaite 'ṣṭavidhā	atas vAdanaya pratipAdana arTam prapaQca ucCedana arTaQcA ete azwaviDA
   gambhīrāḥ sadvādadharmāḥ saṃkṣepato mayā kathyante / (# Uh 5.#) dṛṣṭāntaḥ	gamBIrAH sa dvAda DarmAH saMkzepataH mayA kaTyante / (# Uh 5.#) dRzwAntaH
   siddhānto vākyapraśaṃsā vākyadoṣaḥ pramāṇaṃ prāptakālavākyaṃ hetvābhāso	sidDAntaH vAkya praSaMsA vAkya dozaH pramANam prApta kAla vAkyam hetvABAsaH 
   vākchalam /	vAkCalam /
   dṛṣṭānto dvividhaḥ / saṃpūrṇadṛṣṭānta āśiṃkadṛṣṭāntaśca / siddhānto	dRzwAntaH dviviDaH / saMpUrNa dRzwAnte ASiMka dRzwAntaH ca / sidDAntaH 
   niścitārtha iti / vākyapraśaṃsā vākyasyārthānugamaḥ / vākyadoṣo vākyasya	niScitA arTaH iti / vAkya praSaMsA vAkyasya arTa anugamaH / vAkya dozaH vAkyasya
   yuktivyatyayaḥ / pramāṇaṃ dvividhajñāpakaheturutpattiheturvyañjanahetuśca	yukti vyatyayaH / pramANam dviviDa jQApaka hetuH utpatti hetuH vyaQjana hetuH ca
   / prāptakāla vākyam / yathā yadi pūrvaṃ dhātvāyatanāni vadet / paścāttu	/ prApta kAla vAkyam / yaTA yadi pUrvam DAtu AyatanAni vadet / paScAt tu
   pañcaskandhān tadaitadaprāptakālamityucyate / prāptakālavākyaṃ tu	paQca skanDAn tadA etat aprApta kAlam iti ucyate / prApta kAla vAkyam tu
   vākyakramāvagame / hetvābhāso yathā marīcābudakābhāsaḥ, na tu vastuta	vAkya krama avagame / hetvABAsaH yaTA marIca abudaka ABAsaH, na tu vastuta
   udakam / yadi vādī svalaṅkṛtairvākyairudakamiti vadettadā sa hetvābhāsaḥ /	udakam / yadi vAdI su alaFkRtEH vAkyEH udakam iti vadet tadA sa hetvABAsaH /
   vākchalaṃ yathā / navakambala ityukte taddūṣayan vadet / vastraṃ na kālaḥ	vAkCalam yaTA / nava kambalaH iti ukte tat dUzayan vadet / vastram na kAlaH
   kathaṃ nava ityucyate / iti chalam / evaṃ samāmato 'ṣṭavidho 'rthaḥ	kaTam navaH iti ucyate / iti Calam / evam samAmataH azwaviDaH arTaH
   samākhyātaḥ / idānīṃ krameṇa tallakṣaṇāni vistareṇa vyākhyāsyāmaḥ /	samAKyAtaH / idAnIm krameNa tad lakzaNAni vistareNa vyAKyAsyAmaH /
   āha / ukto bhavatā pūrvaṃ dṛṣṭāntaḥ / kastāvadupāyo dṛṣṭāntasya sthāpane /	Aha / uktaH BavatA pUrvam dRzwAntaH / kaH tAvat upAyaH dRzwAntasya sTApane /
   atrocyate / dṛṣṭāntavacanaṃ hi yatra pṛthagjanānāmāryāṇāñca buddhisāmyaṃ	atra ucyate / dRzwAnta vacanam hi yatra pRTagjanAnAm AryANAn ca budDi sAmyam
   tadā vaktavyam / yathā cittaṃ cañcalaṃ drutavāyuvat / sarveṣāṃ janānāṃ	tadA vaktavyam / yaTA cittam caQcalam druta vAyu vat / sarvezAm janAnAm
   vāyucāñcalyasya pratīteḥ / tadā cittasthiratāyā niścayaḥ / apratītau	vAyucAQcalyasya pratIteH / tadA citta sTira tAyAH niScayaH / apratItO
   dṛṣṭāntālābhaḥ / āha / kasmātsadartha eva nocyate 'pi tu dṛṣṭāntaḥ /	dRzwAnta alABaH / Aha / kasmAt sadarTaH eva na ucyate api tu dRzwAntaH /
   atrocyate / dṛṣṭāntavacanaṃ hi sadarthadyotanārtham /	atra ucyate / dRzwAnta vacanam hi sat arTa dyotana arTam /
   āha / bhavatā pūrvamuktam pṛthagjanānāmāryāṇāñca buddhisāmyadṛṣṭāntalābha	Aha / BavatA pUrvam uktam pRTagjanAnAm AryANAn ca budDi sAmya dRzwAnta lABa
   iti / kiṃ sāmyaṃ ko vā viśeṣaḥ / atrocyate / pūrvavat / vāyudṛṣṭāntasya	iti / kim sAmyam kaH vA viSezaH / atra ucyate / pUrvavat / vAyu dRzwAntasya
   sāmyamityucyate / (# Uh 6.#) āryāṇāṃ nirvāṇaprāptiḥ pṛthagjanānāṃ	sAmyam iti ucyate / (# Uh 6.#) AryANAm nirvANa prAptiH pRTagjanAnAm
   tvaprāptirayaṃ viśeṣa ityucyate /	tu aprAptiH ayam viSezaH iti ucyate /
   āha / uktaṃ dṛṣṭāntalakṣaṇam / kiṃ punaḥ siddhāntalakṣaṇam / atrocyate /	Aha / uktam dRzwAnta lakzaNam / kim punar sidDAnta lakzaNam / atra ucyate /
   sādhyasya hetubhirvistareṇa sthāpanaṃ nirṇayaśca / etatsiddhāntalakṣaṇam /	sADyasya hetuBiH vistareNa sTApanam nirNayaH ca / etad sidDAnta lakzaNam /
   āha / siddhāntadharmāḥ kiyantaḥ / atrocyate / catvāraḥ / sarvasamaḥ	Aha / sidDAnta DarmAH kiyantaH / atra ucyate / catvAraH / sarva samaH
   sarvabhinna ādau samaḥ paścādbhinna ādau bhinnaḥ paścātsamaśca / āha /	sarva BinnaH AdO samaH paScAt BinnaH AdO BinnaH paScAt samaH ca / Aha /
   adhunā bhavataitāni catvāri lakṣaṇāni vyākhyātavyāni /	aDunA BavatA etAni catvAri lakzaNAni vyAKyAtavyAni /
   atrocyate / arthasthāpanamicchatā caturvidhaṃ jñānamāśrayitavyam / kiṃ	atra ucyate / arTa sTApanam icCatA caturviDam jQAnam ASrayitavyam / kim
   taccaturvidham / pratyakṣamanumānamupamānamāgamaśca /	tat caturviDam / pratyakzam anumAnam upamAnam AgamaH ca /
   sarvasamo yathā, (vādī vadeda)ātmātmīyañca na vidyete, prativadyapi	sarva samaH yaTA, (vAdI vadet a)AtmA AtmIyaQca na vidyete, prativadi api
   vadedātmātmīyañca na vidyeta ityayaṃ sarvasamaḥ / sarvabhinno yathā, (vādī	vadet AtmA AtmIyaQca na vidyeta iti ayam sarva samaH / sarva BinnaH yaTA, (vAdI
   vadet) pṛthagiti prativādī tu vadedekamityayam sarvabhinnaḥ / ādau samaḥ	vadet) pRTak iti prativAdI tu vadet ekam iti ayam sarva BinnaH / AdO samaH
   paścādbhinno yathā, (vādī vadet) sarvaṃ dṛṣṭadharmaṃ sat / ātmā	paScAt BinnaH yaTA, (vAdI vadet) sarvam dRzwa Darmam sat / AtmA
   punarapratyakṣo 'pi sag / prativādī vadedyatpratyakṣadharmakaṃ tadeva	punar apratyakzaH api sac / prativAdI vadet yat pratyakza Darmakam tat eva
   saditi vaktavyam / ātmā cedapratyakṣaḥ kathaṃ san / anumānena cedātmā	sat iti vaktavyam / AtmA ced apratyakzaH kaTam san / anumAnena ced AtmA
   sanniti tarhi pratyakṣapūrvakamanumānamiti / apratyakṣadharmaka ātmā	san= iti tarhi pratyakza pUrvakam anumAnam iti / apratyakza DarmakaH AtmA
   kathamanumīyate / yadi punarupamānenātmā sanniti, atha	kaTam anumIyate / yadi punar upamAnena AtmA sanniti, aTa
   sādharmyapūrvakamupamānamityātmā kenopamīyate / yadi tvāgamenātmā siddha	sADarmya pUrvakam upamAnam iti AtmA kena upamIyate / yadi tu Agamena AtmA sidDa
   ityucyate tadayuktam / durbodhaṃ hi sūtram / kutracitsanniti	iti ucyate tat ayuktam / durboDam hi sUtram / kutracid san= iti
   kutracidasanniti kathaṃ tatpratītirityayamādau samaḥ paścādbhinnaḥ / ādau	kutracid asan= iti kaTam tad pratItiH iti ayam AdO samaH paScAt BinnaH / AdO
   bhinnaḥ (# Uh 7.#) paścātsamo yathā, (vādī vadeda)ātmātmīyañca na vidyete	BinnaH (# Uh 7.#) paScAt samaH yaTA, (vAdI vadet a)AtmA AtmIyaQca na vidyete
   / prativādī tu vadedastyātmā, asti puruṣaḥ /	/ prativAdI tu vadet asti AtmA, asti puruzaH /
   nirvāṇābhyupagamastrūbhayorvādinoḥ / ayamucyata bhinnaḥ paścātsamaḥ /	nirvANa aByupagama stru uBayoH vAdinoH / ayam ucyata BinnaH paScAt samaH /
   api cāparimitāni lakṣaṇāni siddhāntasya, tadyathā dvādaśa nidānāni,	api ca aparimitAni lakzaNAni sidDAntasya, tat yaTA dvAdaSa nidAnAni,
   duḥkhaṃ, samudayaḥ, nirodhaḥ, mārgaḥ saptatriṃśatpakṣāḥ, catvāri	duHKaM, samudayaH, niroDaH, mArgaH saptatriMSat pakzAH, catvAri
   śrāmaṇyaphalānītyādayo dharmā buddhasya samyagarthā ityucyante /	SrAmaNya PalAni ityAdayaH DarmAH budDasya samyak arTAH iti ucyante /
   sandhyāpūjā, balidānaṃ, dhūpadīpanaṃ, tailadīpanivedanamiti caturvidhā	sanDyA pUjA, bali dAnaM, DUpa dIpanan, tEla dIpa nivedanam iti caturviDA
   yājñikatīrthikānāṃ kriyā /	yAjQika tIrTikAnAm kriyA /
   triṣaṣṭyakṣarāṇāṃ caturṇāṃ ca padānāmartha iti śābdikāstīrthikāḥ /	trizazwi akzarANAm caturNAm ca padAnAm arTaH iti SAbdikAH tIrTikAH /
   oṣadhividyā ṣaḍvidhā / oṣadhināma, oṣadhiguṇaḥ, oṣadhirasaḥ, oṣadhivīryaṃ,	ozaDi vidyA zaxviDA / ozaDi nAma, ozaDi guNaH, ozaDi rasaH, ozaDi vIryaM,
   sannipātaḥ, vipākaśceti bhaiṣājyadharmāḥ /	sannipAtaH, vipAkaH ca iti BEzAjya DarmAH /
   ṣaṭpadārthā vaiśeṣikāṇām //	zaz padArTAH vESezikANAm //
   pradhanasyaikyaṃ puruṣā bahavaḥ / [teṣāṃ ca] vimuktiriti sāṃkhyāḥ /	praDanasya Ekyam puruzAH bahavaH / [tezAm ca] vimuktiH iti sAMKyAH /
   aṣṭau sūkṣmāṇi yathā / catvāri mahābhūtāni buddhirākāśo, vidyā, avidyā,	azwO sUkzmANi yaTA / catvAri mahABUtAni budDiH AkASo, vidyA, avidyA,
   aṣṭaiśvaryāṇi [tadyathā] aṇimā, mahimā, laghimā, prāptiḥ, prākāmyaṃ,	azwa ESvaryANi [tat yaTA] aNimA, mahimA, laGimA, prAptiH, prAkAmyaM,
   kāyavibhāgaḥ, īśitvaṃ tirobhāvaśca / iti yogatīrthikāḥ /	kAya viBAgaH, ISitvam tiroBAvaH ca / iti yoga tIrTikAH /
   jīvo 'jīvaḥ pāpaṃ puṇyamāśravaḥ, nirjarā, sambaraḥ, bandhaḥ, mokṣaḥ /	jIvaH ajIvaH pApam puNyam ASravaH, nirjarA, sambaraH, banDaH, mokzaH /
   pañcajñānāni [tadyathā] śrutajñānaṃ, matijñānaṃ, avadhijñānaṃ,	paQca jQAnAni [tat yaTA] Sruta jQAnaM, mati jQAnan, avaDi jQAnaM,
   manaḥparyāyajñānaṃ, kevalajñānam / ṣaḍāvaraṇāni, (# Uh 8.#)	manaH paryAya jQAnaM, kevala jQAnam / zaz AvaraNAni, (# Uh 8.#)
   darśanāvaraṇaṃ, duḥkhavedanīyāvaraṇaṃ, mohāvaraṇamāyurāvaraṇaṃ,	darSana AvaraNan, duHKa vedanIya AvaraNaM, moha AvaraNam AyuH AvaraNaM,
   gotrāvaraṇaṃ, nāmāvaraṇañca / catvāraḥ kaṣāyāḥ [tadyathā] krodhaḥ, mānaḥ,	gotra AvaraNaM, nAma AvaraNaQca / catvAraH kazAyAH [tat yaTA] kroDaH, mAnaH,
   lābhaḥ, māyā ceti nirgranthadharmāḥ /	lABaH, mAyA ca iti nirgranTa DarmAH /
   apare 'pi santi ye vadanti sarvamekaṃ sadbhāvājjñeyam / sarvadharmāṇāṃ ca	apare api santi ye vadanti sarvam ekam sadBAvAt jQeyam / sarva DarmANAm ca
   guṇavattvādaikyam, kiñca pradhānāt samutpannaṃ sarvamekaṃ jñeyamekamūlatvā	guNavat tvAt Ekyam, kiQca praDAnAt samutpannam sarvam ekam jQeyam eka mUla tvA
   ityevamekavādinastīrthikāḥ /	iti evam eka vAdinaH tIrTikAH /
   apare vadanti / sarvaṃ pṛthak / kuta iti cet / yathā śiraḥpadādi	apare vadanti / sarvam pRTak / kutas iti ced / yaTA SiraH pada Adi
   kāyātpṛthak / api ca lakṣaṇapṛthaktaṃ yathā vṛṣabho 'śvavilakṣaṇaḥ /	kAyAt pRTak / api ca lakzaNa pRTaktam yaTA vRzaBaH aSva vilakzaNaH /
   tasmātsarvaṃ pṛthagiti jñeyam / iti pṛthagvādinastīrthikāḥ /	tasmAt sarvam pRTak iti jQeyam / iti pRTak vAdinaH tIrTikAH /
   atha kathaṃ sarvamekaṃ sadbhāvāditi / yataḥ saddhi dvedhā	aTa kaTam sarvam ekam sadBAvAt iti / yatas sat hi dveDA
   cetanamacetanañca / tatkathamekaṃ hetuvaiṣamyāṃditi / evaṃ dharmāṇāṃ	cetanam acetanaQca / tat kaTam ekam hetu vEzamyAn= iti / evam DarmANAm
   samāsato dūṣaṇam /	samAsatas dUzaNam /
   yadi punaḥ	yadi punar 
   kaścidvadedduḥkhasamudayanirodhamārgadvādaśanidānasaṃskṛtādidharmāṇāmekatvaṃ	kaScid vadet duHKa samudaya niroDa mArga dvAdaSa nidAna saMskRta Adi DarmANAm eka tvam
   pṛthaktaṃ veti sarvametadasaddhetukam / kasmāt / yadyekatvaṃ tadā	pRTaktam vA iti sarvam etat asat hetukam / kasmAt / yadi eka tvam tadA
   duḥkhāntavādāpattiḥ / yadi pṛthaktaṃ tadā sukhāntavādāpattiḥ / tasmāduktaṃ	duHKa anta vAda ApattiH / yadi pRTaktam tadA suKa antavAda ApattiH / tasmAt uktam
   [ekatve pṛthakte vā]ntadvayavādāpattiḥ / naiṣa buddhadharmasyārtha iti /	[eka tve pRTak te vA a]nta dvaya vAda ApattiH / na eza budDa Darmasya arTaH iti /
   api ca yathā kecidvadanti nirvāṇabhāvaḥ na duḥkhaṃ na ca sukham / kathaṃ	api ca yaTA kecid vadanti nirvANa BAvaH na duHKam na ca suKam / kaTam
   jñātamiti cet / sarve hi dharmāścetanāḥ saduḥkhasukhā nirvāṇaṃ tvacetanaṃ	jQAtam iti ced / sarve hi DarmAH cetanAH sa duHKa suKAH nirvANam tu acetanam
   kathaṃ sukhaṃ syāt /	kaTam suKam syAt /
   api ca kecidvādinaḥ sukhaṃ vadanti / kuta iti cet / sukhaṃ trividham /	api ca kecid vAdinaH suKam vadanti / kutas iti ced / suKam triviDam /
   sukhavedanāsukhaṃ, anupaghātaḥ, anākāṅkṣā ca / nirvāṇa	suKa vedanA suKan, anupaGAtaH, anAkAFkzA ca / nirvANa
   ākāṅkṣābhāvānnirvāṇaṃ sukham /	AkAFkzA BAvAt nirvANam suKam /
   (# Uh 9.#)	(# Uh 9.#)
   api ca nirvāṇaṃ nityamiti mayā pūrvaṃ jñātam / idānīntu [vaktavyaṃ]	api ca nirvANam nityam iti mayA pUrvam jQAtam / idAnIntu [vaktavyaM]
   saṃskārebhyastat pṛthak na veti kecit / atrocyate / nirvāṇaṃ nityamiti	saMskAreByaH tat pRTak na vA iti kecid / atra ucyate / nirvANam nityam iti
   pūrvaṃ jñātaṃ kimucyate saṃksāraistattulyam / saṃskārāṇāṃ svabhāvaḥ	pUrvam jQAtam kim ucyate saMksArEH tad tulyam / saMskArANAm svaBAvaH
   pariṇāmaḥ pradhvaṃsaśca / nirvāṇabhāvasya tu nityatā sukhatvañca / kathaṃ	pariNAmaH praDvaMsaH ca / nirvANa BAvasya tu nityatA suKa tvaQca / kaTam
   vidvāṃstatsaṃskāraistulyaṃ vadet /	vidvAn= tad saMskArEH tulyam vadet /
   anyacca kecidāhuḥ / ātmabhāvasya rūpavattve nityo 'nityo vāyamiti na	anyat ca kecid AhuH / Atma BAvasya rUpavat tve nityaH anityaH vA ayam iti na
   niścīyate /	niScIyate /
   atrocyate / sarvaṃ mūrtamanityameva yathā murto ghaṭo vināśī / ātmāpi	atra ucyate / sarvam mUrtam anityam eva yaTA murtaH GawaH vinASI / AtmA api
   tadvaditi cettadānitya eva / ātmano mūrtatvantu sūtrairna samarthitaṃ,	tadvat iti ced tadA anityaH eva / AtmanaH mUrta tvantu sUtrEH na samarTitaM,
   yuktihīnañcaitat / yathā ratnabudhyā sikatopalādānaṃ tathā bhavato	yukti hInaQca etat / yaTA ratna buDyA sikatA upala AdAnam taTA BavataH 
   vacanamatīva mithyā / atha kasmādātmāmurta iti cenmayā pūrvamuktaṃ ghaṭo	vacanam atIva miTyA / aTa kasmAt AtmAmurtaH iti ced mayA pUrvam uktam Gawo
   mūrtatvādvināśīti / yadyātmaivaṃ syāt, tadā so 'pi vināśī bhavet /	mUrta tvAt vinASI iti / yadi AtmA evam syAt, tadA saH api vinASI Bavet /
   kathamidānīṃ bhavatā pṛcchyate `kasmādātmāmūrta' iti /	kaTam idAnIm BavatA pRcCyate `kasmAt Atma amUrta a iti /
   aparañca / aniyatasiddhāntalakṣaṇam, yathā kaścit pṛcchet / kiṃ śabdo	aparaQca / aniyata sidDAnta lakzaNam, yaTA kaScid pRcCet / kim SabdaH 
   vastu[bhūto] nityo 'nityo vā / atrocyate / yadvibhāganiṣpannaṃ	vastu[BUto] nityaH anityaH vA / atra ucyate / yad viBAga nizpannam
   tadanityameva / śabdo 'pi vibhāganiṣpannaḥ kathaṃ nityo bhavet /	tat anityam eva / SabdaH api viBAga nizpannaH kaTam nityaH Bavet /
   atha kiṃ nāma śabdo vastu[bhūtaḥ] / atrocyate / aniścaye kathaṃ praśnaḥ /	aTa kim nAma SabdaH vastu[BUtaH] / atra ucyate / aniScaye kaTam praSnaH /
   atha kiṃ kevala evātmānāgate 'dhvani sukhaduḥkhe vedayate saśarīro vā /	aTa kim kevalaH eva Atma anAgate aDvani suKa duHKe vedayate sa SarIraH vA /
   atrocyate / etasmiccharīre vinaṣṭa ātmano 'parasmiñcharīre vedanam /	atra ucyate / etasmic SarIre vinazwaH AtmanaH aparasmin SarIre vedanam /
   (# Uh 10.#)	(# Uh 10.#)
   nanu ka eṣa ātmā yo 'nāgate 'dhvani sukhaduḥkhe vedayate / atrocyate /	nanu kaH ezaH AtmA yaH anAgate aDvani suKa duHKe vedayate / atra ucyate /
   'ātmā, iti pūrvamuktaṃ bhavatā / kathaṃ punaḥ sannasan vātmā' iti	aAtmA, iti pUrvam uktam BavatA / kaTam punar sannasan vA AtmA a iti
   pṛcchyate / ayuktametat /	pRcCyate / ayuktam etat /
   atha siddhāntārtha uktaḥ / kiṃ punarvākyapraśaṃsālakṣaṇam / atrocyate /	aTa sidDAnta arTaH uktaH / kim punar vAkya praSaMsA lakzaNam / atra ucyate /
   yuktyaviruddhamanadhikamanyūnamadhigatapadārthaṃ vacanadharmanibaddhaṃ	yukti avirudDam anaDika manyUnam aDigata padArTam vacana Darma nibadDam
   prasiddhadṛṣṭāntāviruddhamananuyojyañca /	prasidDa dRzwAnta avirudDam ananuyojyaQca /
   ebhirhetubhirvākyapraśaṃsetyucyate /	eBiH hetuBiH vAkya praSaMsA iti ucyate /
   nanu kiṃ nāma yuktyaviruddham / atrocyate / vijñānamevātmeti kecinmanyante	nanu kim nAma yukti avirudDam / atra ucyate / vijQAnam eva AtmA iti kecid manyante
   sarvaskārāṇāṃ śūnyatvādanātmatvācca / na hi sarve saṃskārā vijñānamiti	sarvaskArANAm SUnya tvAt anAtma tvAt ca / na hi sarve saMskArAH vijQAnam iti
   tadayuktam / saṃskārā hi vijñānasya hetavaḥ / hetūnāṃ cānātmatvāt, kathaṃ	tat ayuktam / saMskArAH hi vijQAnasya hetavaH / hetUnAm ca anAtma tva at, kaTam
   vijñānamātmā /	vijQAnam AtmA /
   atha sarve dharmāṃ anityāḥ śabdastu naiva sarvaṃ, tasmācchabdo nitya iti /	aTa sarve DarmAm anityAH SabdaH tu na eva sarvan, tasmAt SabdaH nityaH iti /
   atrocyate / bhavatā sarvamityuktam, ko 'rthaḥ punaḥ śabdasya, yo naiva	atra ucyate / BavatA sarvam iti uktam, kaH arTaH punar Sabdasya, yaH na eva
   sarvam / etadahetukamayuktañca /	sarvam / etat ahetukam ayuj taQca /
   anyacca / sarve kṛtakadharmā anityā eva / agnisantānavat / śabdo 'pi tathā	anyat ca / sarve kRtaka DarmAH anityAH eva / agni santAna vat / SabdaH api taTA
   / tasmādanityaḥ / etadaviruddhalakṣaṇam /	/ tasmAt anityaH / etat avirudDa lakzaNam /
   atha kimanadhikamanyūnañca / atrocyate / ahikanyūnatvayorlakṣaṇaṃ	aTa kim anaDikam anyUnaQca / atra ucyate / ahika nyUna tvayoH lakzaNam
   pūrvamuktam / nyūnatvaṃ trividham hetunyūnatvaṃ vākyanyūnatvaṃ	pUrvam uktam / nyUna tvam triviDam hetu nyUna tvam vAkya nyUna tvam
   dṛṣṭāntanyūnatvañca / yadi kaścidvadet / ṣaḍvijñānanyanityāni ghaṭavat /	dRzwAnta nyUna tvaQca / yadi kaScid vadet / zaz vijQAnanya nityAni Gawa vat /
   kāraṇantu na vadettadā taddhetunyūnatvamityucyate / yadi kaścidvadeheho	kAraNantu na vadet tadA tad hetuni Una tvam iti ucyate / yadi kaScid vadeha ihaH 
   'yamanātmā sakāraṇatvāt / śabdo 'pyanātmā sakāraṇatvādetadṛṣṭāntanyūnatvam	ayam anAtmA sa kAraNa tvAt / SabdaH api anAtmA sa kAraNa tvAt etat Rzwa anta nyUna tvam
   (# Uh 11.#)	(# Uh 11.#)
   yadi kaścidvadedanityāni catvāri mahābhūtāni ghaṭavatkṛtakāni /	yadi kaScid vadedanityAni catvAri mahABUtAni Gawa vat kRtakAni /
   etadvākyanyūnatvam / etadvīparītaṃ tu sampannamityucyate /	etad vAkya nyUna tvam / etat vIparItam tu sampannam iti ucyate /
   sampannañca yathā / ātmavādyevaṃ praṣṭavyaḥ / yaduktaṃ bhavatātmeti sa	sampannaQca yaTA / Atma vAdi evam prazwavyaH / yat uktam BavatA AtmA iti sa
   nityo 'nityo vā / yadyanityastadā saṃskāravadvināśadharmā / nitya iti	nityaH anityaH vA / yadi anityaH tadA saMskAra vat vinASa DarmAH / nityaH iti
   cettarhi kathaṃ nirvāṇaspṛhā / etat sampannalakṣaṇam /	ced tarhi kaTam nirvANa spRhA / etat sampanna lakzaNam /
   atha kiṃ nāmādhikam / atrocyate / adhikaṃ trividham, hetvadhikaṃ,	aTa kim nAma aDikam / atra ucyate / aDikam triviDam, hetu aDikaM,
   dṛṣṭāntādhikaṃ, vākyādhikañca / yadi kaścidvadecchabdo 'nityaḥ samyogajaḥ	dRzwAnta aDikaM, vAkya aDikaQca / yadi kaScid vadet SabdaH anityaH samyoga jaH
   / yathā ghaṭaḥ kṛtako 'nityaśca / punarapi vadecchabda ākāśasya guṇaḥ /	/ yaTA GawaH kRtakaH anityaH ca / punar api vadet SabdaH AkASasya guNaH /
   ākāśo 'mūrtaḥ śabdastu rūpadharmā kathamanyonyasamāśrayaḥ /	AkASaH amUrtaH SabdaH tu rUpa DarmA kaTam anyonya samASrayaH /
   etaddhetvadhikam yadyucyate pañcendriyāṇyanityāni pratidhvanivatkṛtakatvāt	etat hetu aDikam yadi ucyate paQca indriyANi anityAni pratiDvani vat kRtaka tvAt 
   / śabdo 'pi tathā / kathaṃ tajjñāyate / oṣṭhamukhādisamudbhavatvāt /	/ SabdaH api taTA / kaTam tat jQAyate / ozWa muKa Adi samudBava tvAt /
   tadṛṣṭāntādhikam / yadyucyate 'ṇuḥ sūkṣma ākāśastu vyāpī / ubhāvapi nityau	tadRzwAnta aDikam / yadi ucyate aNuH sUkzmaH AkASaH tu vyApI / uBO= api nityO
   / śabdastu na tathā tasmādanitya etadṛṣṭāntādhikam / api ca śabdo 'nityaḥ	/ SabdaH tu na taTA tasmAt anityaH etat RzwAnta aDikam / api ca SabdaH anityaH
   sakāraṇatvāt / nitya iti cet, tadayuktam / kasmāt? dvābhyāṃ hetubhyām /	sa kAraNa tvAt / nityaH iti cet, tat ayuktam / kasmAt? dvAByAm hetuByAm /
   murtodbhavatvādaindriyakatvācca / kathaṃ nitya iti yacca samānadharmakaṃ	murta udBava tvAt Endriyaka tvAt ca / kaTam nityaH iti yat ca samAna Darmakam
   tatsarvamanityam / etadvākyādhikamucyate /	tat sarvam anityam / etat vAkya aDikam ucyate /
   atrāha / kīdṛśaṃ vākyaṃ laukikānāṃ pratipādanāya smartham / ucyate / yadi	atra Aha / kIdRSam vAkyam lOkikAnAm pratipAdanAya smarTam / ucyate / yadi
   mūrkhāya gambhīrārtha vadedyathā sarve dharmā śūnyāḥ śāntā nirātmāno	mUrKAya gamBIra arTa vadet yaTA sarve DarmAH SUnyAH SAntA nirAtmAnaH 
   niṣpugdalā māyāvat nirmāṇavattattvarahitā ityādi tadā taṃ gambhīrārthaṃ	nizpugdalA mAyA vat nirmANavat tattva rahitAH ityAdi tadA tam gamBIra arTam
   vidvāneva jñātuṃ śankoti pṛthagjanastu śrutvā bhrāntyāpanno bhavet / (# Uh	vidvAn eva jQAtum Sankoti pRTagjanaH tu SrutvA BrAnti ApannaH Bavet / (# Uh
   12.#) etadaprāptakālam / athocyate / asti dharmāṇāṃ karma, asti viṣākro	12.#) etat aprApta kAlam / aTa ucyate / asti DarmANAm karma, asti vizAkro
   'sti ca bandhamokṣaḍiḥ / yaḥ karoti so 'nubhuṅkta ityalpabuddhayo 'pi	asti ca banDa mokzaxiH / yaH karoti saH anuBuFktaH iti alpabudDayaH api
   śrutvāvagacchanti yathā vedhakāraṇisaṃyogenāgnerūtpattiḥ / yadabhidhīyate	SrutvA avagacCanti yaTA veDakAraNi saMyogena agneru utpattiH / yat aBiDIyate
   tadyadi sattvopayogi bhavet, tadā sarveṣāṃ [tatra] pratītiranumodanañca /	tat yadi sattva upayogi Bavet, tadA sarvezAm [tatra] pratItiH anumodanaQca /
   etat prāptakālam /	etat prApta kAlam /
   atha kiṃ pratipattiḥ / ucyate / abhihitasya bāhulye 'pi smaraṇasāmarthyam,	aTa kim pratipattiH / ucyate / aBihitasya bAhulye api smaraNa sAmarTyam,
   arthānāṃ gāmbhīrye 'pi tallakṣaṇopalabdhiḥ, janaprītikaraśca sādhyasāraḥ /	arTAnAm gAmBIrye api tad lakzaNa upalabDiH, jana prIti karaH ca sADya sAraH /
   yathā kaścidvadet sarve dharmāḥ śūnyā anīśvarāḥ sarvavastūnāṃ	yaTA kaScid vadet sarve DarmAH SUnyAH anISvarAH sarva vastUnAm
   pratītyasamutpannatvāditi pratipattiḥ /	pratItyasamutpanna tvAt iti pratipattiH /
   atha ke vākyadoṣāḥ / atrocyate / pūrvoktaviparītā vākyadoṣāḥ / vākyadoṣāḥ	aTa ke vAkya dozAH / atra ucyate / pUrva ukta viparItAH vAkya dozAH / vAkya dozAH
   punardvividhāḥ / kiñca taddvaividhyam / arthasyābhede punaruktiḥ /	punar dviviDAH / kiQca tat dvEviDyam / arTasya aBede punaruktiH /
   vākyasya cābhede punaruktiriti / kā nāmaikārthapunaruktiḥ / yathā kauśika	vAkyasya ca aBede punaruktiH iti / kA nAma eka arTa punaruktiH / yaTA kOSika
   ityuktvā punarvadeddevendraḥ śakraḥ purandaro veti / iyamucyata	iti uktvA punar vadet deva indraH SakraH purandaraH vA iti / iyam ucyata
   etasyaivārthasya nāmāntarapunaruktiḥ /	etasya eva arTasya nAma antara punaruktiH /
   nāmārthatulyatā yathā / indra ityuktvā punarapīndra iti vadet / iyaṃ	nAma arTa tulya tA yaTA / indraH iti uktvA punar api indraH iti vadet / iyam
   nāmārthābhede punaruktiḥ /	nAma arTa aBede punaruktiH /
   yadalaṅkṛtamasaṅgaṃ voktaṃ sa sarvo vākyadoṣa ityucyate / aparañca	yat alaFkRtam asaFgam vA uktam sa sarvaH vAkya dozaH iti ucyate / aparaQca
   yadyuktisamupetamapyakramam eṣo 'pi vākyadoṣa iti /	yat yukti samupetam api akramam ezaH api vAkya dozaH iti /
   yathā gāthayoktam /	yaTA gATayA uktam /
   yathā kaściddevānāmindrasya śakrasya bhāryāṃ praśaṃmayan suvarṇarūpiṇīm //	yaTA kaScid devAnAm indrasya Sakrasya BAryAm praSaMmayan suvarNa rUpiNIm //
   (# Uh 13.#)	(# Uh 13.#)
   komalapādahastāṃ paścācca śakro devānāmindro 'suratripuravināśīti tu	komala pAda hastAm paScAt ca SakraH devAnAm indraH asura tripura vinASI iti tu
   vadannityakramaṃ vacanamuktam /	vadat nitya kramam vacanam uktam /
   atha katividhaṃ pramāṇam / caturvidhaṃ pramāṇam /	aTa kativiDam pramANam / caturviDam pramANam /
   pratyakṣamanumānamupamānamāgamaśceti / caturṣu pramāṇeṣu pratyakṣa	pratyakzam anumAnam upamAnam AgamaH ca iti / caturzu pramANezu pratyakza
   śreṣṭham / kutaḥ punaḥ pratyakṣaṃ śreṣṭhamiti cedapareṣāṃ trayāṇāṃ	SrezWam / kutas punar pratyakzam SrezWam iti ced aparezAm trayANAm
   pramāṇānāṃ pratyakṣopajīvakatvācchreṣṭham / yathā dṛṣṭe dhūmavatyagnau	pramANAnAm pratyakza upajIvaka tvAt SrezWam / yaTA dRzwe DUmavati agnO
   paścāddhumadarśanādagneranumānam / tasmātpratyakṣaṃ viśiṣyate / yatha ca	paScAt huma darSanAt agneH anumAnam / tasmAt pratyakzam viSizyate / yaTa ca
   marīcidarśanenodakopamānam / tasmātpratyakṣe pūrvaṃ jñāte	marIci darSanena udaka upamAnam / tasmAt pratyakze pUrvam jQAte
   paścādupamānalābhaḥ / .....paścātpratyakṣakāle pūrvajñānaṃ satyam /	paScAt upamAna lABaH / .....paScAt pratyakza kAle pUrva jQAnam satyam /
   tataśca pratyakṣādeva [pramāṇa]trayaṃ jñānamiti jñātam / idānīntu	tatas ca pratyakzAt eva [pramANa] trayam jQAnam iti jQAtam / idAnIntu
   tatpratyakṣaṃ kathaṃ saditi / atrocyate / pañcendriyajñānaṃ kadācinmithyā	tad pratyakzam kaTam sat iti / atra ucyate / paQca indriya jQAnam kadAcid miTyA
   / yattu sādhyavasāyaṃ samyagdharmāvabodhakaṃ tatparamam / grīṣme	/ yat tu sADya vasAyam samyak Darma avaboDakam tat paramam / grIzme
   marīcīnāmalātacakragandharvanagarāṇāṃ ca pratyakṣe 'pi tadasat /	marIcInAm alAta cakra ganDarvanagarANAm ca pratyakze api tat asat /
   aparañca / lakṣaṇāspaṣṭatvāddarśanabhramaḥ / yathā rātrau sthāṇuṃ dṛṣṭvā	aparaQca / lakzaNa aspazwa tvAt darSana BramaH / yaTA rAtrO sTANum dRzwvA
   manuṣya eṣa ityucyate / aṅgulyā cakṣuḥpīḍanācca dvicandradarśanam /	manuzyaH ezaH iti ucyate / aFgulyA cakzuH pIxanAt ca dvi candra darSanam /
   śūnyatājñāne prāpte samyagdṛṣṭirucyate / jñāta pratyakṣaṃ tāvat / atha	SUnyatA jQAne prApte samyak dRzwiH ucyate / jQAta pratyakzam tAvat / aTa
   kimanumānalakṣaṇam / ucyate tatpūrvamuddiṣṭam / adhunā vyākhyāyate /	kim anumAna lakzaNam / ucyate tat pUrvam uddizwam / aDunA vyAKyAyate /
   anumānaṃ trividhaṃ pūrvavat, śeṣavat, sāmānyato [dṛṣṭaṃ] ca / yathā	anumAnam triviDam pUrvavat, Sezavat, sAmAnyatas [dRzwan] ca / yaTA
   ṣaḍaṅguliṃ sapiḍakamūrdhānaṃ bālaṃ dṛṣṭvā paṣcāddhṛddhaṃ bahuśrutaṃ	zaz aFgulim sa pixaka mUrDAnam bAlam dRzwvA pazcAt hRdDam bahu Srutam
   devadattaṃ dṛṣṭvā ṣaḍaṅgulismaraṇāt so 'yamiti pūrvavat /	devadattam dRzwvA zaz aFguli smaraNAt saH ayam iti pUrvavat /
   śeṣavat yathā, sāgarasalilaṃ pītvā tallavaṇarasamanubhūya (# Uh 14.#)	Sezavat yaTA, sAgara salilam pItvA tad lavaNa rasam anuBUya (# Uh 14.#)
   śeṣamapi salilaṃ tulyameva lavaṇamiti / etaccheṣavadanumānam /	Sezam api salilam tulyam eva lavaNam iti / etat Sezavat anumAnam /
   sāmānyato dṛṣṭaṃ yathā / kaścigdacchaṃstaṃ deśaṃ prāpnoti / gagane 'pi	sAmAnyatas dRzwam yaTA / kaScigdacCan= tam deSam prApnoti / gagane api
   sūryācandramasau pūrvasyāṃ diśyuditau paścimāyāñcāstaṃ gatau /	sUryAcandramasO pUrvasyAm diSi uditO paScima AyAQcAH tam gatO /
   tacceṣṭāyāmadṛṣṭāyāmapi tadgamanamanumīyate / etatsāmānyato dṛṣṭam / nanu	tad cezwA AyAm adRzwAyAm api tat gamanam anumIyate / etat sAmAnyatas dRzwam / nanu
   kā śrutiḥ / atrocyate,	kA SrutiH / atra ucyate,
   satyaprācīnavṛddhabuddhabodhisattvadarśanādāryasūtradharmaśravaṇagrahaṇayorjñānadarśanotpādasāmarthyameṣā	satya prAcIna vRdDa budDa boDisattva darSanA t Arya sUtra Darma SravaNa grahaNayoH jQAna darSana utpAda sAmarTyam ezA
   śrutirityucyate / yathā suvaidyako bheṣajakuśalo maitracittena śikṣakaḥ	SrutiH iti ucyate / yaTA su vEdyakaH Bezaja kuSalaH mEtra cittena SikzakaH
   suśruta ityucyate /	suSrutaH iti ucyate /
   evamapi yat kṛtasarvadharmasākṣātkārairmahājñānairāryaiḥ śrutaṃ tat	evam api yat kRta sarva Darma sAkzAtkArEH mahA jQAnEH AryEH Srutam tat 
   suśrutamucyate /	suSrutam ucyate /
   atha kimupamānalakṣaṇam / atrocyate / yathā sarve dharmā śūnyāḥ śāntā	aTa kim upamAna lakzaNam / atra ucyate / yaTA sarve DarmAH SUnyAH SAntA
   māyāvat nirmāṇavat / saṃjñādāntāśvavat, saṃskārāḥ kadalīvat, kāmalakṣaṇaṃ	mAyA vat nirmANa vat / saMjQA dAnta aSvavat, saMskArAH kadalIvat, kAma lakzaNam
   piḍakavat viṣavat / etadupamānamucyate / evaṃ catvāro hetavaḥ /	pixaka vat viza vat / etat upamAnam ucyate / evam catvAraH hetavaH /
   tadavagamanaṃ hetujñānamityuktam /	tad avagamanam hetu jQAnam iti uktam /
   atha ke hetvābhāsāḥ / atrācyate / hetvābhāsā eteṣu vādadharmesu mahādoṣā	aTa ke hetvABAsAH / atra acyate / hetvABAsAH etezu vAda Darmesu mahA dozA
   eva jñeyāḥ / śīghrañcāpahartavyāḥ / athedānīṃ hetvābhāsā vyākhyāsyante /	eva jQeyAH / SIGraQca apahartavyAH / aTa idAnIm hetvABAsAH vyAKyAsyante /
   hetvābhāsānāṃ lakṣaṇānyaparimitāni saṃkṣepatastvaṣṭāveva / vākchalaṃ,	hetvABAsAnAm lakzaNAni aparimitAni saMkzepataH tu azwO= eva / vAc CalaM,
   sāmānyachalaṃ, saṃśayasamaḥ, kālātītaḥ, prakaraṇasamaḥ, varṇyasamaḥ,	sAmAnya CalaM, saMSaya samaH, kAla atItaH, prakaraNa samaH, varNya samaH,
   savyabhicāraḥ, viruddhaḥ /	savyaBicAraH, virudDaH /
   nanvete 'ṣṭau dharmā vistareṇa vivektavyāḥ / ucyate / nava iti caturvidham	nanu ete azwO DarmAH vistareNa vivektavyAH / ucyate / navaH iti caturviDam
   / navaḥ, nava, na vaḥ, nava iti /	/ navaH, nava, na vaH, navaH iti /
   (# Uh 15.#)	(# Uh 15.#)
   yathā kaścidāha / yo maya parihitaḥ sa navakambalaḥ / atra dūṣaṇaṃ (vadet)	yaTA kaScid Aha / yaH maya parihitaH sa nava kambalaH / atra dUzaNam (vadet)
   yadbhavatā parihitaṃ tadekameva vastraṃ kathaṃ naveti / atra	yat BavatA parihitam tat ekam eva vastram kaTam navA iti / atra
   prativedenmayā nava ityuktaṃ tathāca navaḥ kambalaḥ natu naveti / atra	prativedet mayA navaH iti uktam taTA ca navaH kambalaH na tu nava iti / atra
   dūṣayetkathaṃ nava? navalomairnirmitatvānnava ityukte prativādī vadet	dUzayet kaTam nava? nava lomEH nirmita tvAt navaH iti ukte prativAdI vadet 
   tattvato 'parimitāni lomāni kathaṃ navalomānītyucyate /	tattvataH aparimitAni lomAni kaTam nava lomAni iti ucyate /
   atrāha / nava iti mayā pūrvamuktaṃ na tu navasaṃkhyā / atra dūṣaṇam /	atra Aha / navaH iti mayA pUrvam uktam na tu nava saMKyA / atra dUzaNam /
   tadvastraṃ yuṣmākameveti jñātaṃ kasmādetanna vaḥ kathyate / atrottaram /	tat vastram yuzmAkam eva iti jQAtam kasmAt etat na vaH kaTyate / atra uttaram /
   mayā nava ityuktaṃ kintu na va iti noktam / atra dūṣaṇam / bhavataḥ kāyaṃ	mayA navaH iti uktam kintu na vaH iti na uktam / atra dUzaNam / BavataH kAyam
   kambalo vasta iti pratyakṣametat / kathamucyate na vaḥkambalaḥ / ayaṃ	kambalaH vastaH iti pratyakzam etat / kaTam ucyate na vaHkambalaH / ayam
   hetvābhāsa ityucyate vākchalaṃ ca /	hetvABAsaH iti ucyate vAkCalam ca /
   aparañca vākchalam / yathā girirdahyata ityukte, dūṣaṇam /	aparaQca vAkCalam / yaTA giriH dahyate iti ukte, dUzaNam /
   tattvatastṛṇataravo dahyante kathaṃ girirdahyata ityuktam /	tattvataH tRNataravaH dahyante kaTam giriH dahyate iti uktam /
   etadvākchalamityucyate /	etat vAkCalam iti ucyate /
   api ca chalaṃ dvividhaṃ / pūrvavat sāmānyañceti / yathā / saṃskṛtā dharmāḥ	api ca Calam dviviDam / pUrvavat sAmAnyaQca iti / yaTA / saMskRtAH DarmAH
   śrūnyāḥ śāntā ākāśavadityukte, dūṣaṇam / yadyevaṃ, ubhayorapi	SrUnyAH SAntAH AkASa vat iti ukte, dUzaNam / yadi evaM, uBayoH api
   śūnyatvamabhāvaśca, tadā niḥsvabhāvā dharmā ākāśatulyā iti sāmānyachalam /	SUnya tvam aBAvaH ca, tadA niHsvaBAvAH DarmAH AkASa tulyAH iti sAmAnya Calam /
   kā tāvadutpattiriti / atrocyate / sata utpattiriti / yathā mṛdo	kA tAvat utpattiH iti / atra ucyate / sataH utpattiH iti / yaTA mRdaH 
   ghaṭatvattvāddhaṭotpādakatvam / yadi mṛdo ghaṭatvavattvaṃ tadā mṛdeva	Gawa tvat tvAt hawa utpAdaka tvam / yadi mRdaH Gawa tvavat tvam tadA mRdA iva
   ghaṭaḥ syāt / tadā tadutpattaye kṛtaṃ kumbhakārarajjucakrasaṃyogena / yadi	GawaH syAt / tadA tad utpattaye kRtam kumBakAra rajju cakra saMyogena / yadi
   mṛdaḥ sadbhāvena ghaṭotpādakatvaṃ, tadodakasyāpi sadbhāvena	mRdaH sadBAvena Gawa utpAdaka tvaM, tadA udakasya api sadBAvena
   ghaṭotpādakatvaṃ (# Uh 16.#) syāt / yadyudakasya sadbhāvena	Gawa utpAdaka tvam (# Uh 16.#) syAt / yadi udakasya sadBAvena
   ghaṭānutpādakatvaṃ kathaṃ tarhi mṛdo ghaṭotpādakatvam / iti sāmānyachalam	Gawa anutpAdaka tvam kaTam tarhi mRdaH Gawa utpAdaka tvam / iti sAmAnya Calam
   kiṃ nāma saṃśayahetvābhāsalakṣaṇam / ucyate / sthāṇormanuṣyasādṛśyāt,	kim nAma saMSaya hetu ABAsa lakzaNam / ucyate / sTANoH manuzya sAdRSyAt,
   rātrau taṃ dṛṣṭvā, eṣa sthāṇuḥ puruṣo veti vimarśaḥ / ayaṃ	rAtrO tam dRzwvA, eza sTANuH puruzaH vA iti vimarSaH / ayam
   saṃśayahetvābhāsa iti /	saMSaya hetvABAsaH iti /
   kaḥ punaḥ kālātītahetvābhāsaḥ / ucyate / yathā kaścidvadennityaḥ śabdaḥ /	kaH punar kAla atIta hetvABAsaH / ucyate / yaTA kaScid vadet nityaH SabdaH /
   śabdamayatvādvedo 'pi nitya iti / atra dūṣaṇam / idānīṃ bhavatā śabdasya	Sabda maya tvAt vedaH api nityaH iti / atra dUzaNam / idAnIm BavatA Sabdasya
   nityatākāraṇamapratiṣṭhāpya kathaṃ vedo nitya ityucyate /	nitya tA kAraNam apratizWApya kaTam vedaH nityaH iti ucyate /
   atra vadedyathākāśamarūpatvānnityaṃ tathā śabdo 'pyarūpatvānnityaḥ /	atra vadet yaTA AkASam arUpa tvAt nityam taTA SabdaH api arUpa tvAt nityaH /
   tadvacane paścādapyukte so 'rthaḥ sidhyati / atra dūṣaṇaṃ	tad vacane paScAt api ukte saH arTaH siDyati / atra dUzaNam
   kālatītametadvacanam / yathā gṛhe dagdha udākānveṣaṇaṃ bhavatopyevamiti	kAlatItam etat vacanam / yaTA gRhe dagDaH udAka anvezaNam BavatA upi evam iti
   kālātītaḥ /	kAla atItaH /
   atha ko nāma prakaraṇasamaḥ? (ātmanaḥ) śarīra bhinnatvādātmā nityaḥ /	aTa kaH nAma prakaraNa samaH? (a AtmanaH) SarIra Binna tvAt AtmA nityaH /
   yathā (ghaṭasya) ākaśabhinnatvādvaṭo 'nityaḥ / ayaṃ prakaraṇasama	yaTA (Gawasya) AkaSa Binna tvAt vawaH anityaH / ayam prakaraNa sama
   ityucyate /	iti ucyate /
   atra dūṣaṇam / yadyātmā śarīrabhinnatrvānnitya iti, tadā (ghaṭasya)	atra dUzaNam / yadi AtmA SarIraBid natrvAt nityaH iti, tadA (Gawasya)
   ākāśabhinnatvādvaṭo 'nityaḥ / ayam prakaraṇasama ityucyate / atra dūṣaṇam	AkASa Binna tvAt vawaH anityaH / ayam prakaraNa samaH iti ucyate / atra dUzaNam
   / yadyātmā śarīrabhinnatvānnitya iti, tadā (ghaṭasya) śarīrabhinnatvādvaṭo	/ yadi AtmA SarIra Binna tvAt nityaH iti, tadA (Gawasya) SarIra Binna tvAt vawaH 
   'pi nityaḥ syāt śarīrabhinnatve 'pi ghaṭo 'nitya iti cet, tarhyātmāpi	api nityaH syAt SarIra Binna tve api GawaH anityaH iti cet, tarhi AtmA api
   śarīrabhinnatvāt kathaṃ nityaḥ / iti prakaraṇasamaḥ /	SarIra Binna tvAt kaTam nityaH / iti prakaraNa samaH /
   ko nāma varṇyasamaḥ / ucyate / yathā nityamākāśamasparśatvāt /	kaH nAma varNya samaH / ucyate / yaTA nityam AkASam asparSa tvAt /
   manovijñānamapi tathā / ayaṃ varṇyasama ityucyate /	manaH vijQAnam api taTA / ayam varNya samaH iti ucyate /
   kaḥ savyabhicāraḥ / ucyate / yathā pañcaviṣayā anityā (# Uh 17.#)	kaH savyaBicAraH / ucyate / yaTA paQca vizayAH anityAH (# Uh 17.#)
   indriyagrāhyatvāt / catvāri mahābhūtānyapi tathā tasmādanityāni /	indriya grAhya tvAt / catvAri mahABUtAni api taTA tasmAt anityAni /
   atra dūṣaṇam / kūrmaroma lavaṇagandhaśca nirābhāsamātraṃ	atra dUzaNam / kUrma roma lavaNaganDaH ca nirABAsa mAtram
   manovijñānopalabhyatvātkimanityamiti savyabhicāraḥ /	manaH vijQAna upalaBya tvAt kim anityam iti savyaBicAraH /
   atha ko nāma viruddhaḥ / ucyate / viruddho dvividhaḥ / dṛṣṭāntaviruddho	aTa kaH nAma virudDaH / ucyate / virudDaH dviviDaH / dRzwAnta virudDaH 
   yuktiviruddhaśca / yathātmā nityo 'mūrtatvāt, vṛṣabhavat / ayaṃ	yukti virudDaH ca / yaTA AtmA nityaH amUrta tva at, vRzaBa vat / ayam
   dṛṣṭāntaviruddhaḥ /	dRzwAnta virudDaH /
   yuktiviruddho yathā, brāhmaṇasya kṣatrakarmānupālanaṃ mṛgayādiśikṣā ca,	yukti virudDaH yaTA, brAhmaNasya kzatra karma anupAlanam mRgayA Adi SikzA ca,
   kṣatriyasya dhyānasamāpattiriti yuktiviruddhaḥ / evambhūtau dharmāvajñā	kzatriyasya DyAna samApattiH iti yukti virudDaH / evamBUtO Darma avajQA
   abuddhaiva satyaṃ manyante /	abudDA eva satyam manyante /
   nanu kimaviruddham / atrocyate / etadbhinnamaviruddhamityabhidhīyate /	nanu kim avirudDam / atra ucyate / etat Binnam avirudDam iti aBiDIyate /
   iti hetvābhāsāḥ /	iti hetvABAsAH /
   // iti prathamaṃ prakaraṇam //	// iti praTamam prakaraNam //
   (# Uh 18.#)	(# Uh 18.#)
   atha dvitīyaṃ prakaraṇam /	aTa dvitIyam prakaraNam /
   pūrvamaṣṭavidhā vādadharmā uktāḥ / atha nigraha[sthāna]dharmān vakṣyāmaḥ /	pUrvam azwaviDAH vAdaDarmAH uktAH / aTa nigraha[ sTAna] DarmAn vakzyAmaH /
   nanu katame vādadharmāḥ / (atrocyate) yathā catvāri mahābhūtāni	nanu katame vAda DarmAH / (atra ucyate) yaTA catvAri mahABUtAni
   prajñaptireva / kasmāt / rūpādidharmatvādeva / aparaḥ punarāha / catvāri	prajQaptiH eva / kasmAt / rUpa Adi Darma tvAt eva / aparaH punar Aha / catvAri
   mahābhūtāni tattvataḥ santi / kathametajjñātam / kāṭhinyaṃ pṛthivīdharmo	mahABUtAni tattvataH santi / kaTam etat jQAtam / kAWinyam pRTivI DarmaH 
   yāvaccalatvaṃ vāyudharmaḥ / tatsaditi jñeyam / etacca prativiruddham /	yAvat cala tvam vAyu DarmaH / tad sat iti jQeyam / etat ca prativirudDam /
   tasmādvivādaḥ / yathā vā / pṛthivī śarīrakāraṇameva / aparāṇi	tasmAt vivAdaH / yaTA vA / pRTivI SarIra kAraNam eva / aparANi
   mahābhūtānyapi tathā / atra dūṣaṇam / pṛthivyādi	mahABUtAni api taTA / atra dUzaNam / pRTivI Adi
   sarvavastusādhanasamarthaṃ sat, kathaṃ śarīramātraṃ sādhayediti nātra	sarva vastu sADana samarTam sat, kaTam SarIra mAtram sADayet iti na atra
   vivādaḥ / yadyevaṃ na syāttadā vāda ityucyate /	vivAdaH / yadi evam na syAt tadA vAdaH iti ucyate /
   nanu kāni nigrahasthānāni / (atrocyate) yathā śabdo nityo	nanu kAni nigraha sTAnAni / (atra ucyate) yaTA SabdaH nityaH 
   'mūrtatvādākāśavat /	amUrta tvAt AkASa vat /
   atra dūṣaṇam / yadyapi śabdo 'mūrtaḥ / tathāpyaindriyakaḥ, saṃpratighaḥ,	atra dUzaNam / yadi api SabdaH amUrtaH / taTA api EndriyakaH, saMpratiGaH,
   ghaṭavatkṛtakaḥ / api tvākāśe 'kṛtake kathaṃ tadṛṣṭāntalābhaḥ /	Gawa vat kRtakaH / api tu A AkASe akRtake kaTam tadRzwa anta lABaH /
   etannigrahasthānamityucyate /	etat nigraha sTAnam iti ucyate /
   atha ghaṭo mūrta ityanityaḥ śabdasya tvamūrtatvāt kathaṃ tadṛṣṭāntalābhaḥ	aTa GawaH mUrtaH iti anityaH Sabdasya tu amUrta tvAt kaTam tadRzwa anta lABaH
   atra dūṣaṇam / śabdo ghaṭabhinno 'pyaindriyakaḥ śrāvaṇatvāt /	atra dUzaNam / SabdaH Gawa BinnaH api EndriyakaH SrAvaNa tvAt /
   tasmādanityaḥ /	tasmAt anityaH /
   nanu kasyārthasyānigrahasthānatvāpattiḥ / saṃskārā vijñānañca (# Uh 19.#)	nanu kasya arTasya anigraha sTAna tva ApattiH / saMskArAH vijQAnaQca (# Uh 19.#)
   kṛtakatvādanityam / nirvāṇamakṛtakatvānnityam / etadvākyaṃ samyakpadarasam	kRtaka tvAt anityam / nirvANam akRtaka tvAt nityam / etat vAkyam samyak pada rasam
   / etaducyate 'nigrahasthānam /	/ etat ucyate anigraha sTAnam /
   nanu kiṃ vacanaṃ dūṣayitavyam / cuayte / vākyavaiparītyaṃ,	nanu kim vacanam dUzayitavyam / cuayte / vAkya vEparIti aM,
   asaddhetusthāpanaṃ, udāharaṇavaiṣamyañcaitaddūṣayitavyam /	asat hetu sTApanan, udAharaNa vEzamyaQca etat dUzayitavyam /
   yatha saṃjñā saṃyojanocchedikā, ityukte kaścit pṛcchet / kathaṃ saṃjñā	yaTa saMjQA saMyojana ucCedikA, iti ukte kaScid pRcCet / kaTam saMjQA
   samyojanocchedikā / jñānasya saṃjñāta utpādaṃ pūrvamanutkā	samyojana ucCedikA / jQAnasya saMjQAtaH utpAdam pUrvam anutkA
   saṃjñāmātrakathanādvākyavaiparītyamitīdaṃ dūṣaṇīyam /	saMjQA mAtra kaTanAt vAkya vEparIti am iti idam dUzaNIyam /
   nanu kathaṃ punaretadvākyamucyate /	nanu kaTam punar etat vAkyam ucyate /
   asidvasthāpanānnigrahasthānāpattijñāpanārthamuktam /	asidvasTApanAt nigraha sTAna Apatti jQApana arTam uktam /
   aparañca / anuyojyānanuyogaḥ / prativaktavye 'prativaktavyata /	aparaQca / anuyojyAn anuyogaH / prativaktavye aprativaktavyata /
   trirabhihitasya parairavijñātam / trirabhihitasya svayamavijñānam / etāni	tris aBihitasya parEH avijQAtam / tris aBihitasya svayam avijQAnam / etAni
   nigrahasthānāni /	nigraha sTAnAni /
   anyacca / pareṇa vivadamānastadvikalatāṃ nāvagacchati / anyastu vadati /	anyat ca / pareNa vivadamAnaH tad vikala tAm na avagacCati / anyaH tu vadati /
   eṣo 'rthaḥ mithyaiva, kiṃ bhavānnopalabhate tadā nigrahasthānam /	ezaH arTaH miTyA eva, kim BavAn na upalaBate tadA nigraha sTAnam /
   anyacca / parasya samyagarthe doṣasamārope 'pi nigrahasthānam /	anyat ca / parasya samyak arTe doza samArope api nigraha sTAnam /
   anyacca / vādinoktaṃ sarvairvijñātamapyasāveva (prativādī) nāvagacchati	anyat ca / vAdinA uktam sarvEH vijQAtam api asO= eva (prativAdI) na avagacCati
   cettadapi nigrahasthānam / praśno 'pi tadvat / etāni nigrahasthānāni	ced tat api nigraha sTAnam / praSnaH api tadvat / etAni nigraha sTAnAni
   vādasya mahākaṇṭakāni gambhīraduḥkhāni jñeyāni, drutañca heyāni /	vAdasya mahA kaNwakAni gamBIra duHKAni jQeyAni, drutaQca heyAni /
   nanu praśnāḥ katividhāḥ / ucyate / trividhāḥ / yathā vacanasamaḥ,	nanu praSnAH kativiDAH / ucyate / triviDAH / yaTA vacana samaH,
   arthasamaḥ, hetusamaśca / yadi vādinastaistribhiḥ (# Uh 20.#)	arTa samaH, hetu samaH ca / yadi vAdinaH tEH triBiH (# Uh 20.#)
   praśnottarāṇi na kurvanti tadvibhrāntam / yadyeteṣāṃ	praSna uttarANi na kurvanti tad viBrAntam / yadi etezAm
   trayāṇāmuttarāṇāmanyatamaṃ nyūnaṃ syāttadasampannam /	trayANAm uttarANAm anyatamam nyUnam syAt tat asampannam /
   yadi vadedahamevamprakārān trīn praśnānnāvagacchāmi mama	yadi vadet aham evamprakArAn trIn praSnAn na avagacCAmi mama
   yathājñānamanyonyaṃ praṣṭavyaṃ, tadādoṣaḥ /	yaTAjQAnam anyonyam prazwavyan, tadAdozaH /
   vākyasamaḥ yathā / ātmā nāstītyukte tadvākyāśrayeṇa praśnaḥ / ayaṃ	vAkya samaH yaTA / AtmA na asti iti ukte tad vAkya ASrayeNa praSnaH / ayam
   vākyasama ityucyate /	vAkya samaH iti ucyate /
   arthasamaḥ tanmatopādānamevāyamarthasama ityucyate /	arTa samaH tad mata upAdAnam eva ayam arTa samaH iti ucyate /
   hetusamaḥ / paramanogaterutpādakasya hetorjñāmayaṃ hetusama ityucyate /	hetu samaH / para manogateH utpAdakasya hetoH jQA mayam hetu samaH iti ucyate /
   evaṃ sāmarthye satye nigrahasthānamityucyate /	evam sAmarTye satye nigraha sTAnam iti ucyate /
   yadyatidrutaṃ vadecchrotāraśca nāvagaccheyustadapi nigrahasthānam /	yadi atidrutam vadet SrotAraH ca na avagacCeyuH tat api nigraha sTAnam /
   athaitāvamātramaparāṇi vā santi / atrocyate / santyeva yathā nyūnaṃ,	aTa etAva mAtram aparANi vA santi / atra ucyate / santi eva yaTA nyUnaM,
   adhikam nirarthakaṃ, aprāptakālaṃ, punaruktaṃ pratijñāsannyāsa ityādīni	aDikam nirarTakaM, aprApta kAlaM, punaruktam pratijQAsannyAsaH ityAdIni
   nigrahasthānānītyucyante /	nigraha sTAnAni iti ucyante /
   yadyevamādi pūrvapakṣī vadet, tadā nigrahasthānāpattiḥ /	yadi evamAdi pUrva pakzI vadet, tadA nigraha sTAna ApattiH /
   atha pratijñāvirodhaḥ / yathā vijñānaṃ nityam / kasmāt / vijñānasya hi	aTa pratijQA viroDaH / yaTA vijQAnam nityam / kasmAt / vijQAnasya hi
   dvaividhyam / vijñānotpāttirvijñākriyā ca /	dvEviDyam / vijQAna utpAttiH vijQA kriyA ca /
   ghaṭasyāpi dvaividhyam, ghaṭotpattirghaṭakriyā ca / evaṃ	Gawasya api dvEviDyam, Gawa utpattiH Gawa kriyA ca / evam
   vijñānamutpādyamānameva sakriyaṃ tasmānnityam / ghaṭasya tūtpattyanantaraṃ	vijQAnam utpAdyamAnam eva sa kriyam tasmAt nityam / Gawasya tu utpatti anantaram
   sakriyatvam, tasmādanityatvam /	sa kriya tvam, tasmAt anitya tvam /
   atra dūṣaṇam / utpattāveva sakriyatvānnityamiti ceddīpasyāpyutpattāveva	atra dUzaNam / utpattO= eva sa kriyatvAt nityam iti ced dIpasya api utpattO= eva
   sakriyatvānnityatvaprasaṅgaḥ / atha dīpaścakṣuṣā dṛṣṭaḥ syāt, śabdaśca	sa kriya tvAt nitya tva prasaFgaH / aTa dIpaH cakzuzA dRzwaH syAt, SabdaH ca
   śravaṇena śrūyata iti kathaṃ dṛṣṭāntopapattiḥ /	SravaNena SrUyate iti kaTam dRzwAnta upapattiH /
   etatpratijñāsannyāsanigrahasthānam /	etad pratijQAsannyAsa nigraha sTAnam /
   (# Uh 21.#)	(# Uh 21.#)
   aparañca / kecidvadantyātmā nitya iti / kathaṃ jñātam / anaindriyakatvāt /	aparaQca / kecid vadanti AtmA nityaH iti / kaTam jQAtam / anEndriyaka tvAt /
   yathā ākāśo 'naindriyakatvānnityaḥ /	yaTA AkASaH anEndriyaka tvAt nityaH /
   atra dūṣaṇam / paramāṇavo 'nindriyakā api tvanityāḥ /	atra dUzaNam / paramANavaH anindriyakAH api tu anityAH /
   atrocyate / ātmākṛtakatvānnityaḥ paramāṇavastu kṛtakatvādanityāḥ /	atra ucyate / Atma akRtaka tvAt nityaH paramANavaH tu kRtaka tvAt anityAH /
   atra dūṣaṇam / anupalabdheriti bhavatā pūrvamuktam / adhunā	atra dUzaNam / anupalabDeH iti BavatA pUrvam uktam / aDunA
   cākṛtakatvādibyucyate / ayaṃ pratijñāvirodhaḥ /	ca akRtaka tva Adi bi ucyate / ayam pratijQA viroDaH /
   nanūcyate 'haṃ virodhīti cedbhavāṃstu mama vacanaṃ pratikūlayan katham	nanu ucyate aham viroDi iti ced BavAn= tu mama vacanam pratikUlayan kaTam
   virodhau na syāt /	viroDO na syAt /
   kiñca kathametadyuktisaham / yadvi viruddhamityucyate mayā, sā bhavata eva	kiQca kaTam etat yukti saham / yat vi virudDam iti ucyate mayA, sA BavataH eva
   vacanasya pūrvoktenārthan pratikūlatā / tasmādviruddhamityuktam /	vacanasya pUrva uktena arTan pratikUla tA / tasmAt virudDam iti uktam /
   anyacca / bhavatā pūrvamuktamaspaṣṭatvānme saṃśaya utpanna iti / nāhaṃ	anyat ca / BavatA pUrvam uktam aspazwa tvAt me saMSayaH utpannaH iti / na aham
   bhavadvirodhītyevaṃ saṃśayena virodhaḥ / etadapi nigrahasthānamiti /	Bavat viroDI iti evam saMSayena viroDaH / etat api nigraha sTAnam iti /
   // iti dvitīyaṃ prakaraṇam //	// iti dvitIyam prakaraNam //
   (# Uh 22.#)	(# Uh 22.#)
   atha tṛtīyaṃ prakaraṇam /	aTa tRtIyam prakaraNam /
   vādī prāha / yadi kaścidvadedasti sattvo yāvatsanti prāṇā asti jīva ityādi	vAdI prAha / yadi kaScid vadet asti sattvaH yAvat santi prANAH asti jIvaH ityAdi
   / kathaṃ jñātam / aindriyakatvāt / yathā	/ kaTam jQAtam / Endriyaka tvAt / yaTA
   nirupadhiśeṣanirvāṇasyendriyairanupalabdherabhāvaḥ sattvānāntu na tathā /	nirupaDi Seza nirvANasya indriyEH anupalabDeH aBAvaH sattva anAntu na taTA /
   tasmātsantyeva iti jñātam /	tasmAt santi eva iti jQAtam /
   atmā nityaḥ / yathārhattvaphalaṃ kasmiṃścideva kāle vidyamānamapi pūrvaṃ	atmA nityaH / yaTArhat tva Palam kasmiMScid eva kAle vidyamAnam api pUrvam
   paścāccāvidyamānatvādabhāva iti jñāyate / yathā ca dvītīyo mūrdhā tṛtīyo	paScAt ca avidyamAna tvAt aBAvaH iti jQAyate / yaTA ca dvItIyaH mUrDA tRtIyaH 
   hastaśca / abhūtvā bhāvāt prāgabhāvaḥ / bhūtvā tu vināśātpradhvaṃsābhāva	hastaH ca / aBUtvA BAvAt prAc aBAvaH / BUtvA tu vinASAt praDvaMsa aBAva
   iti jñāyate / ātmā tu na tathā tasmānnityaḥ /	iti jQAyate / AtmA tu na taTA tasmAt nityaH /
   atra dūṣaṇam / yathā mūla[kīla]odakānyadṛśyatvānna sadityuktam /	atra dUzaNam / yaTA mUla[kIla]a udakAni adRSya tvAt na sat iti uktam /
   arhattva[phalasyāpi] tathātvameva na tvabhāvaḥ / etattu na bhavatā	arhat tva[ Palasya api] taTA atvam eva na tu aBAvaH / etat tu na BavatA
   sākṣātkriyate /	sAkzAtkriyate /
   nanu maivam / udakasya pṛthivyāvaraṇādadṛśyatvam / arhattva[phalasya tu]	nanu mA evam / udakasya pRTivI AvaraNAt adRSya tvam / arhat tva[ Palasya tu]
   kenāvaraṇenādṛśyatvam / tasmāttadasaditi jñāyate /	kena AvaraNena adRSya tvam / tasmAt tat asat iti jQAyate /
   atra dūṣaṇam / yadbhavatoktaṃ [yathā] dvitīyasya mūrdhnastṛtīyasya	atra dUzaNam / yat BavatA uktam [yaTA] dvitIyasya mUrDnaH tRtIyasya
   hastasya cādṛśyatvāda[bhāvaḥ] arhattva[phalasyāpya]bhāvaḥ iti spaṣṭam /	hastasya ca adRSya tvAt a[BAvaH] arhat tva[ Palasya api a]BAvaH iti spazwam /
   tadayuktam / dvitīyasya mūrdhno nāstitve 'pi tarhi na prathamasya	tat ayuktam / dvitIyasya mUrDnaH na astitve api tarhi na praTamasya
   nāstitvam / arhattva[phalaṃ] tu nāstyeveti tasyaivātyantābhāvaḥ / kathaṃ	nAstitvam / arhat tva[ PalaM] tu na asti eva iti tasya eva atyanta aBAvaH / kaTam
   dṛṣṭāntatopapattiḥ / yacca bhavatoktamanupalabdhernirvāṇābhāvaḥ siddha iti	dRzwAntatA upapattiH / yat ca BavatA uktam anupalabDeH nirvANa aBAvaH sidDaH iti
   tadapyayuktam / kiṃ nāma (mahā)śāgarodakasya	tat api ayuktam / kim nAma (mahA)SAgara udakasya
   binduparimāṇasyāśakyajñānatvāttadasaditi (# Uh 23.#) vaktuṃ śakyate /	bindu parimANasya aSakya jQAna tvAt tat asat iti (# Uh 23.#) vaktum Sakyate /
   yadyapi binduparimāṇaṃ na jñāyate tathāpyastyeva sāgaraḥ / nirvāṇasyāpi	yadi api bindu parimANam na jQAyate taTA api asti eva sAgaraH / nirvANasya api
   tathātvam / anupalabdhāvapi tattattvataḥ sadeva / asaditi cedvaktavyam	taTAtvam / anupalabDO= api tat tattvataH sat eva / asat iti ced vaktavyam
   tasya kāraṇam / yadi na śakyate vaktaṃ tadā bhavata evārthahāniḥ /	tasya kAraNam / yadi na Sakyate vaktam tadA BavataH eva arTa hAniH /
   ayamucyate yathādharmavādaḥ /	ayam ucyate yaTA Darma vAdaH /
   anyacca yadyanupalabdhernirvāṇasyāsattvaṃ, tadā parasya saṃśayaḥ / yathā	anyat ca yadi anupalabDeH nirvANasya asattvaM, tadA parasya saMSayaH / yaTA
   rātrau taruṃ dṛṣṭvā citte saṃśayaḥ / eṣa sthāṇurvā manuṣyo veti / na khalū	rAtrO tarum dRzwvA citte saMSayaH / eza sTANuH vA manuzyaH vA iti / na KalU
   taruḥ sthāṇoḥ puruṣasya vo[palabdhau] niyato hetuḥ / anupalabdhireva	taruH sTANoH puruzasya vA u[palabDO] niyataH hetuH / anupalabDiH eva
   nirvāṇasyābhāve niyato heturiti cennātra saṃśayasambhavaḥ /	nirvANasya aBAve niyataH hetuH iti ced na atra saMSaya samBavaH /
   anyacca karmavipākāvināśāt, sadeva nirvāṇam / kuta iti cet / yathā davena	anyat ca karma vipAka avinASAt, sat eva nirvANam / kutas iti ced / yaTA davena
   girestarudāhe 'gnistadvināśahetuḥ / kaḥ punastasya karmavipākasya	gireH taru dAhe agniH tad vinASa hetuH / kaH punar tasya karma vipAkasya
   vināśaheturyena tadvinaśyate / nirvāṇalābhe tadā prahāniḥ /	vinASa hetuH yena tat vinaSyate / nirvANa lABe tadA prahAniH /
   atrocyate / asti tattvato vināśahetuḥ / āvaraṇāttvanupalabdhaḥ /	atra ucyate / asti tattvataH vinASa hetuH / AvaraNAt tu anupalabDaH /
   atra dūṣaṇam / nirvāṇamapi sadāvaraṇāttvanupalabdham /	atra dUzaNam / nirvANam api sat AvaraNAt tu anupalabDam /
   kiñca yadi vipākasya vināśaheturvartata iti cennocyate / tadā bhavato	kiQca yadi vipAkasya vinASa hetuH vartate iti ced na ucyate / tadA BavataH 
   'rthahāniḥ / yadyabhāvādvināśaheturanuktastadāvaraṇābhāvo 'pi kathamuktaḥ	arTa hAniH / yadi aBAvAt vinASa hetuH anuktaH tad AvaraNa aBAvaH api kaTam uktaH
   / evaṃ kāraṇairkarmāṇāmavināśo jñāyate /	/ evam kAraNEH karmANAm avinASaH jQAyate /
   eṣa yathādharmavāda ityucyate /	eza yaTADarma vAdaH iti ucyate /
   pūrvapakṣī vadati / yadi sāgarodakasadbhāvānnirvāṇasadbhāvaḥ siddhastadā	pUrva pakzI vadati / yadi sAgara udaka sadBAvAt nirvANa sadBAvaH sidDaH tadA
   kiṃ dvitīyasyāpi mūrdhnaḥ sadbhāvo na sidhyati / dvitīyasyāpi mūrdhnaḥ	kim dvitIyasya api mUrDnaH sadBAvaH na siDyati / dvitIyasya api mUrDnaH
   sadbhāvo na siddha iti cet (# Uh 24.#) kathaṃ nirvāṇasya sadbhāvaḥ /	sadBAvaH na sidDaH iti ced (# Uh 24.#) kaTam nirvANasya sadBAvaH /
   tasmādbhavatoktaḥ sāgarodakadṛṣṭāntaḥ nirvāṇasadbhāvaṃ sādhayituṃ na	tasmAt BavatA uktaH sAgara udaka dRzwAntaH nirvANa sadBAvam sADayitum na
   samarthaḥ / kiṃ dvitīyasya mūrdhnaḥ sadbhāvaṃ sādhayet /	samarTaH / kim dvitIyasya mUrDnaH sadBAvam sADayet /
   atra dūṣaṇam / kiṃ nirvāṇamasaditi bhavadabhipretam / asataḥ sattā vāsato	atra dUzaNam / kim nirvANam asat iti Bavat aBipretam / asataH sattA vAsataH 
   'sattā vā / asato 'satteti cet kathaṃ nirvāṇamasaditi pratijñāyate / yadi	asattA vA / asataH asatta iti ced kaTam nirvANam asat iti pratijQAyate / yadi
   tvasataḥ sattā kathaṃ bhavatāsattocyate /	tvasataH sattA kaTam BavatA asattA ucyate /
   yadyasato nirvāṇasya sattā tadā svato 'sato 'sattvamapi saditi cet, kathaṃ	yadi asataH nirvANasya sattA tadA svatas asataH asattvam api sat iti cet, kaTam
   na nirvāṇasadbhāvalāba ityatra heturvaktavyaḥ / yadi vaktuṃ na śakyate,	na nirvANa sadBAva lAbaH iti atra hetuH vaktavyaH / yadi vaktum na Sakyate,
   tadā niścitameva nirvāṇaṃ saditi jñeyam / etadapi yathādharmavāda	tadA niScitam eva nirvANam sat iti jQeyam / etat api yaTADarma vAda
   ityucyate /	iti ucyate /
   nanvātmā nityo 'nityo vā / atmā 'kṛtakatvānnityaḥ, ghaṭādiṣṭu	nanu AtmA nityaH anityaH vA / atmA akRtaka tvAt nityaH, Gawa At izwu
   kṛtakatvādanityaḥ /	kRtaka tvAt anityaH /
   atra dūṣaṇam / akṛtakatvādātmā nitya iti cettadayuktam / kasmāt /	atra dUzaNam / akRtaka tvAt AtmA nityaH iti ced tat ayuktam / kasmAt /
   puruṣāṇāṃ saṃśayajanakatvāt / yadyakṛtakatvānnitya evātmeti tadā nityo	puruzANAm saMSaya janaka tvAt / yadi akRtaka tvAt nityaH eva AtmA iti tadA nityaH 
   'nitya veti saṃśayasyāsambhavaḥ / saṃśayajanakatvāddoṣaḥ /	anitya vA iti saMSayasya asamBavaH / saMSaya janaka tvAt dozaH /
   vādī / iyaṃ doṣāpattirna mamaivāpi tu sarveṣāmeva vādināṃ yathā śabdo	vAdI / iyam doza ApattiH na mama eva api tu sarvezAm eva vAdinAm yaTA SabdaH 
   nityo 'mūrtatvāt / atītaḥ kāyo 'styeva pūrvanivāsānusmaraṇādityādipratijñā	nityaH amUrta tvAt / atItaH kAyaH asti eva pUrva nivAsa anusmaraNAt itya Adi pratijQA
   pūrvavatsaṃśayamutpādayatīti / tasmatsarvatraiva doṣāpattiḥ /	pUrvavat saMSayam utpAdayati iti / tasmat sarvatra eva doza ApattiH /
   atra dūṣaṇam / dṛṣṭānta eva saṃśayaṃ nirdhārayati / bhavatāṃ tūdāhṛto	atra dUzaNam / dRzwAntaH eva saMSayam nirDArayati / BavatAm tu udAhRtaH 
   dṛṣṭānto mama saṃśayamutpādayati tasmādasiyo 'yaṃ dṛṣṭāntaḥ / dṛṣṭānte	dRzwAntaH mama saMSayam utpAdayati tasmAt asiyaH ayam dRzwAntaH / dRzwAnte
   'siddhe 'rthahāniḥ / tadeva nigrahasthānam /	asidDe arTa hAniH / tat eva nigraha sTAnam /
   yatpunarbhavatoktaṃ sarveṣāmeva doṣāpattirna tu mamaivetyeṣa (# Uh 25.#)	yat punar BavatA uktam sarvezAm eva doza ApattiH na tu mama eva iti eza (# Uh 25.#)
   svadoṣa eva na tu paradoṣaḥ / kuta iti cet / yathā kaścidabhiyukta	sva dozaH eva na tu para dozaH / kutas iti ced / yaTA kaScid aBiyukta
   ātmānamaprakāśya sarva eva taskarā iti vadettadāsau puruṣa ātmānamapi	AtmAnam aprakASya sarve eva taskarAH iti vadet tadA asO puruzaH AtmAnam api
   taskaraṃ manyata iti jñeyam / bhavānapi tathā tasmānnigrāhyaḥ /	taskaram manyate iti jQeyam / BavAn api taTA tasmAt nigrAhyaH /
   idānīṃ yadi bhavānātmānaṃ prakāśayitumiḥcchu pūrvayuktimatikramya	idAnIm yadi BavAn AtmAnam prakASayitum iHcCu pUrva yuktim atikramya
   punarvaktumicchennūnaṃ bahudoṣāpattiḥ syāt / bhavataḥ prathamaḥ pakṣo	punar vaktum icCet nUnam bahu doza ApattiH syAt / BavataH praTamaH pakzaH 
   dvitīyena [pakṣeṇa] dūṣitaḥ / tṛtīyaścārtho mayā dūṣitaḥ / pañcamena	dvitIyena [pakzeNa] dUzitaH / tRtIyaH ca arTaH mayA dUzitaH / paQcamena
   doṣāvadhimicchan pūrvaṃ nātikrāmedataḥ bhavato 'ntyaḥ pakṣaḥ punaruktaṃ	doza avaDim icCan pUrvam na atikrAmet atas BavataH antyaH pakzaH punaruktam
   bhavet / punaruktaṃ ca nigrahasthānam /	Bavet / punaruktam ca nigraha sTAnam /
   nanvanuyojyaḥ ṣaṣṭho 'pi?	nanu anuyojyaH zazWaH api?
   atrocyate / sidvastāvatpañcamasya doṣaḥ / tatkathaṃ ṣaṣṭho 'nuyojyaḥ /	atra ucyate / sidvaH tAvat paQcamasya dozaH / tat kaTam zazWaH anuyojyaH /
   asmin hi pratyukte pūrvadoṣatulyatā / anuyoktuḥ sadoṣatve pratipakṣeṇa	asmin hi pratyukte pUrva doza tulya tA / anuyoktuH sa doza tve pratipakzeNa
   tūṣṇīmbhaviṃtavyam /	tUzNImBaviMtavyam /
   aparañca / ṣaṣṭhasya doṣaḥ pañcamenāparyanuyojyaḥ / kuta iti cet /	aparaQca / zazWasya dozaH paQcamena aparyanuyojyaH / kutas iti ced /
   pañcamenaiva hyeṣa ṣaṣṭho 'nuyuktaḥ / ato 'yaṃ svayame sadoṣaḥ kathaṃ taṃ	paQcamena eva hi eza zazWaH anuyuktaH / atas ayam svayame sa dozaH kaTam tam
   dūṣayet / evaṃ saddharmavādaḥ /	dUzayet / evam sat Darma vAdaH /
   // iti tṛtīyaṃ prakaraṇam //	// iti tRtIyam prakaraNam //
   (# Uh 26.#)	(# Uh 26.#)
   athe caturthaṃ prakaraṇam /	aTe caturTam prakaraNam /
   nanu bhavatā vyākhyāto yathādharmasadvādaḥ / kaḥ punaḥ sambandhaḥ /	nanu BavatA vyAKyAtaH yaTADarma sadvAdaH / kaH punar sambanDaH /
   atrocyate / praśnottarasambandho viṃśatividhaḥ / yadi kaścittena	atra ucyate / praSna uttara sambanDaH viMSativiDaH / yadi kaScid tena
   viṃśatividhenārthena samyagnyāyamārabhate sa sadvādasya jñātetyucyate /	viMSati viDena arTena samyak nyAyam AraBate sa sadvAdasya jQAtA iti ucyate /
   yadi naivaṃ tadā nāyaṃ vivādadharmāvagantā / eṣāṃ viṃśatividhānāṃ sāro	yadi na evam tadA na ayam vivAda Darma avagantA / ezAm viMSati viDAnAm sAraH 
   dvividhaḥ / vaidharmyaṃ sādharmyañca / sajātīyatvātsādharmyaṃ	dviviDaH / vEDarmyam sADarmyaQca / sajAtIya tvAt sADarmyam
   vijātīyatvādvaidharmyam / arthasya hi tatsamāśrayatvātte viṃśatidharmān	vijAtIya tvAt vEDarmyam / arTasya hi tad samASraya tvAt te viMSati DarmAn
   vyāpnuvataḥ /	vyApnuvataH /
   kiṃ sādharmyam / yathā kleśakṣayo nirābhāsa eva, ākāśabhāvo 'pi nirābhāsa	kim sADarmyam / yaTA kleSa kzayaH nirABAsaH eva, AkASa BAvaH api nirABAsa
   iti sādharmyam /	iti sADarmyam /
   kiṃ vaidharmyam / yathā nirvāṇamakṛtakatvānnityaṃ tathā sarve saṃskārāḥ	kim vEDarmyam / yaTA nirvANam akRtaka tvAt nityam taTA sarve saMskArAH
   kṛtakatvādanityāḥ / iti vaidharmyam /	kRtaka tvAt anityAH / iti vEDarmyam /
   nanu sādharmyavaidharmyābhyāṃ kathaṃ dūṣaṇam /	nanu sADarmya vEDarmyAByAm kaTam dUzaNam /
   atrocyate / sādharmyadūṣaṇamicchatā evaṃ vaktavyam / rūpaṃ cakṣuṣā dṛṣṭaṃ,	atra ucyate / sADarmya dUzaNam icCatA evam vaktavyam / rUpam cakzuzA dRzwaM,
   śabdastu śravaṇena śruta iti, kathaṃ tayoḥ sādharmyam / yadi rūpādbhinnaḥ	SabdaH tu SravaNena SrutaH iti, kaTam tayoH sADarmyam / yadi rUpAt BinnaH
   śabdastadā rūpasyānityatvācchabdo nityo bhavet /	SabdaH tadA rUpasya anitya tvAt SabdaH nityaH Bavet /
   vaidharmyadūṣaṇam / yatha rūpasyaindriyakatvādanityatā, ātmano	vEDarmya dUzaNam / yaTa rUpasya Endriyaka tvAt anitya tA, AtmanaH 
   'naindriyakatvānnityatā /	anEndriyaka tvAt nitya tA /
   ghaṭasyātmanaśca sadbhāvaḥ / sadbhāvasādharmye ghaṭasyānityatvādātmano 'pi	Gawasya AtmanaH ca sadBAvaH / sadBAva sADarmye Gawasya anitya tvAt AtmanaH api
   tathātvāpattiḥ / ghaṭasadbhāva ātmasadbhāvādbhinnastataścātmā (# Uh 27.#)	taTA tva ApattiH / Gawa sadBAvaH Atma sadBAvAt BinnaH tatas ca AtmA (# Uh 27.#)
   nityo ghātastvanitya iti cet / nityatāsādharmyada[pya]ātmanā nityena	nityaH GAtaH tu anityaH iti ced / nitya tA sADarmyat a[pya]a AtmanA nityena
   bhavitavyam /	Bavitavyam /
   evaṃ dūṣaṇaṃ viṃśatividhaṃ yathā 1 utkarṣa[sama]m, 2 apakarṣa[sama]m, 3	evam dUzaNam viMSativiDam yaTA 1 utkarza[ sama]m, 2 apakarza[ sama]m, 3
   bhedābheda[sama]m, 4 praśnabāhulyamuttarālpatā, 5	Beda aBeda[ sama]m, 4 praSna bAhulyam uttara alpatA, 5
   praśnālpatottarabāhulyam, 6 hetusamam, 7 kāryasamam, 8 vyāptisamam, 9	praSna alpatA uttara bAhulyam, 6 hetu samam, 7 kArya samam, 8 vyApti samam, 9
   avyāptisamam, 10 kālasamam, 11 prāptisamam, 12 aprāptisamam, 13 viruddham,	avyApti samam, 10 kAla samam, 11 prApti samam, 12 aprApti samam, 13 virudDam,
   14 aviruddham, 15 saṃśaya[sama]m, 16 asaṃśaya[sama]m, 17	14 avirudDam, 15 saMSaya[ sama]m, 16 asaMSaya[ sama]m, 17
   pratidṛṣṭānta[sama]m, 18 śrutisamam, 19 śrutibhinnam, 20	pratidRzwAnta[sama]m, 18 Sruti samam, 19 Sruti Bid nam, 20
   anupapatti[sama]ñceti praśnottaradharmā viṃśatidhā /	anupapatti[ sama]Qca iti praSna uttara DarmA viMSatiDA /
   1. utkarṣa[sama]m / yathā (kaścidvaded), ātmā nitya indriyānupalabdheḥ /	1. utkarza[ sama]m / yaTA (kaScid vadet ), AtmA nityaH indriya anupalabDeH /
   ākāśo hyanupalabdhernityaḥ / sarvamanupalabhyaṃ nityameva /	AkASaH hi anupalabDeH nityaH / sarvam anupalaByam nityam eva /
   ātmāpyanupalabhyaḥ kathaṃ tadanityatāprāptiḥ /	AtmA api anupalaByaH kaTam tat anitya tA prAptiH /
   atra dūṣaṇam / ākāśo 'cetanatvānnityaḥ / ātmā tu cetanaḥ kathaṃ nityaḥ /	atra dUzaNam / AkASaH acetana tvAt nityaH / AtmA tu cetanaH kaTam nityaH /
   ākāśaścetana ityanyāyyam / yadyātmācetanastadaivākāśena sadharmā / evaṃ	AkASaH cetanaH iti anyAyyam / yadi Atma acetanaH tadA eva AkASena saDarmA / evam
   vidvāṃsaḥ so 'nitya iti manyante / etadutkarṣa[sama]m /	vidvAMsaH saH anityaH iti manyante / etad utkarza[ sama]m /
   2. apakarṣa[sama]m / yathākāśo 'cetana ātmā tu cetanaḥ / kathamākāśa	2. apakarza[ sama]m / yaTA AkASaH acetanaH AtmA tu cetanaH / kaTam AkASa
   ātmano dṛṣṭāntaḥ / etadapakarṣa[sama]m /	AtmanaH dRzwAntaH / etad apakarza[ sama]m /
   3. bhedābheda[sama]m / yathātmanityatāsthāpana ākāśa udāharaṇam / [atra	3. Beda aBeda[ sama]m / yaTA Atma nitya tA sTApanaH AkASaH udAharaNam / [atra
   dūṣaṇaṃ] ātmā ākāśaścābhinnau iti cedaikadharmyāt kathamākāśasyātmano	dUzaNan] AtmA AkASaH ca aBinnO iti ceda eka DarmyAt kaTam AkASasya AtmanaH 
   dṛṣṭāntatā / (# Uh 28.#) bhinnau iti cedanyānyasādharmyāprāptiḥ /	dRzwAnta tA / (# Uh 28.#) BinnO iti ced anyAni asADarmyA prAptiH /
   etaducyate bhedābheda[sama]m /	etat ucyate Beda aBeda[ sama]m /
   4. anyacca / ātmā nityo 'naindriyakatvāt / yathākāśo 'nindriyakatvānnitya	4. anyat ca / AtmA nityaH anEndriyaka tvAt / yaTA AkASaH anindriyaka tvAt nitya
   iti bhavataḥ sthāpanā /	iti BavataH sTApanA /
   atha yadanaindriyakaṃ tannāvaśyaṃ nityam / tatkathaṃ siddham / etaducyate	aTa yat anEndriyakam tat na avaSyam nityam / tat kaTam sidDam / etat ucyate
   praśnabāhulyamuttarālpatā ca /	praSna bAhulyam uttara alpa tA ca /
   5. anyacca / ātmā nityonaindriyakatvāditi bhavatsthāpanā / anaindriyakasya	5. anyat ca / AtmA nityonEndriyaka tvAt iti Bavat sTApanA / anEndriyakasya
   dvaividhyam / yathā paramāṇavo 'nupalabhyā anityāḥ /	dvEviDyam / yaTA paramANavaH anupalaByAH anityAH /
   ākāśastvindriyānupalabhyo nityaśca / kathaṃ bhavatocyate	AkASaH tu indriya anupalaByaH nityaH ca / kaTam BavatA ucyate
   yadanupalabhyatvānnitya ityucyate praśnālpatottarabāhulyañca /	yat anupalaBya tvAt nityaH iti ucyate praSna alpatA uttara bAhulyaQca /
   6. anyacca / anupalabdhihetunātmā nitya iti bhavatā pratijñātam /	6. anyat ca / anupalabDi hetunA AtmA nityaH iti BavatA pratijQAtam /
   ākāśaścātmā ca bhinnauḥ kathamubhayoranupalabhyatvaṃ heturbhavet / iti	AkASaH ca AtmA ca BinnOH kaTam uBayoH anupalaBya tvam hetuH Bavet / iti
   hetusamam /	hetu samam /
   7. anyacca / yatpañcamahābhūtamayaṃ tadanityam / ākāśa ātmā ca	7. anyat ca / yat paQca mahABUta mayam tat anityam / AkASaH AtmA ca
   pañcamahābhūtamayau kathaṃ nityāvuktau / iti kāryasamam /	paQca mahABUta mayO kaTam nityO= uktO / iti kArya samam /
   8. anyacca / anupalabhyatvānnitya ākāśa iti bhavataḥ sthāpanā / ākāśaśca	8. anyat ca / anupalaBya tvAt nityaH AkASaH iti BavataH sTApanAH / AkASaH ca
   sarvavyāpī [tataśca] kiṃ sarvāṇi bastūnyanupalabhyāni / etadyāptisamam /	sarva vyApI [tataH ca] kim sarvANi bastUni anupalaByAni / etat i Apti samam /
   9. anyacca / paramāṇuravyāpyanaindriyako 'pyanityaḥ / ātmā tvanaindriyakaḥ	9. anyat ca / paramANuH avyApi anEndriyakaH api anityaH / AtmA tu anEndriyakaH
   kathaṃ nityaḥ / iti avyāptisamam /	kaTam nityaH / iti avyApti samam /
   10. anyacca / ātmā nityo 'nindriyakatvāditi bhavatsthāpanā / so	10. anyat ca / AtmA nityaH anindriyaka tvAt iti Bavat sTApanA / saH 
   'yaṃ[hetu]rvartamāne 'tīte 'nāgate vā / atīta iti cedatītatvānnaṣṭāḥ /	ayaM[hetu]rvartamAne atIte anAgate vA / atItaH iti ced atIta tvAt nazwAH /
   anāgata iti cedabhāvaḥ / vartamāna (# Uh 29.#) iti cettadāhetuḥ / yathā	anAgataH iti ced aBAvaH / vartamAnaH (# Uh 29.#) iti ced tadA hetuH / yaTA
   śṛṅge yugapadeva jātatvānnānyonyahetuke / iti kālasamam /	SRFge yugapad eva jAta tvAt na anyonya hetuke / iti kAla samam /
   11. anyacca / ātmā nityo 'naindriyakatvāditi bhavatsthāpanā / atha	11. anyat ca / AtmA nityaH anEndriyaka tvAt iti Bavat sTApanAH / aTa
   prāpyāprāpya vā heturiti / aprāpya cedasiddho hetuḥ / yathāgniraprāpya	prApya aprApya vA hetuH iti / aprApya ced asidDaH hetuH / yaTA agniH aprApya
   dahanāsamarthaḥ, asiścāprāpya chedanāsamarthaḥ / ātmānamaprāpya kathaṃ	dahana asamarTaH, asiH ca aprApya CedanA samarTaH / AtmAnam aprApya kaTam
   heturbhavet / ityaprāpti[samam] /	hetuH Bavet / iti aprApti[samam] /
   12. anyacca / prāpya iti cet, prāpterahetutvam / iti prāptisamam /	12. anyat ca / prApya iti cet, prApteH ahetu tvam / iti prApti samam /
   13. anyacca / sarvamanityam / na tvātmā sarvaṃ, tato nitya iti	13. anyat ca / sarvam anityam / na tu AtmA sarvan, tatas nityaH iti
   bhavatpratijñā ātmā ca tadbhāvādanitya iti vaktavyaḥ, kiñciddagdho hi	Bavat pratijQA AtmA ca tad BAvAt anityaH iti vaktavyaH, kiQcid dagDaH hi
   kambalaḥ prāyeṇādagdhatvādadagdha ityucyate / etadviruddham /	kambalaH prAyeNa adagDa tvAt adagDaH iti ucyate / etat virudDam /
   14. anyacca / ātmānaindriyakatvādākāśatulya iti bhavatsthāpanā /	14. anyat ca / AtmA nEndriyaka tvAt AkASa tulyaH iti Bavat sTApanA /
   ākāśasyānupalabdhirātmano 'pi tathātvam / ātmana upalabdhiriti cettadākāśo	AkASasya anupalabDiH AtmanaH api taTAtvam / AtmanaH upalabDiH iti ced tat AkASaH 
   'pi sukhadūḥkhadikamupalabheta / ātmana ākāśasya cābhinnatvāt /	api suKa dUHKadikam upalaBeta / AtmanaH AkASasya ca aBinna tvAt /
   etadaviruddham /	etat avirudDam /
   15. anyacca / ātmanaḥ sadbhāvavannityatāniyatā / laukikānāṃ	15. anyat ca / AtmanaH sadBAva vat nitya tA niyatA / lOkikAnAm
   saṃśayasambhavo nityo 'nityo veti / etat saṃśayasamam /	saMSaya samBavaH nityaH anityaH vA iti / etat saMSaya samam /
   16. anyacca / astyātmānaindriyakatvāditi bhavadvacanam atha vimarśaḥ	16. anyat ca / asti AtmA nEndriyaka tvAt iti Bavat vacanam aTa vimarSaH
   kenāvaraṇenānupalabdhiḥ / kāraṇamatra vaktavyam / yadi kāraṇaṃ na vidyata	kena AvaraNena anupalabDiH / kAraNam atra vaktavyam / yadi kAraNam na vidyata
   ātmārthasya hāniḥ / ityasaṃśayasamam /	Atma arTasya hAniH / iti asaMSaya samam /
   (# Uh 30.#)	(# Uh 30.#)
   17. anyacca / ātmānaindriyakatrvānnitya iti bhavatā pratijñātam / atha	17. anyat ca / AtmAnEndriya katrvAt nityaH iti BavatA pratijQAtam / aTa
   mūlakilodakānyanaindriyakānyapyanityānyātmā tu kathaṃ nityaḥ / iti	mUla kila udakAni anEndriyakAni api anityAni AtmA tu kaTam nityaH / iti
   pratidṛṣṭānta[sama]m /	pratidRzwAnta[ sama]m /
   18. anyacca / sūtreṣu ātmano 'nupalabdhiruktā tasmāttasya nityatā jñāteti	18. anyat ca / sUtrezu AtmanaH anupalabDiH uktA tasmAt tasya nityatA jQAtA iti
   bhavataḥ [sthāpanā] / (parantu) nāstyātmā nāstyātmīyamityapi sūtreṣūktam /	BavataH [sTApanA] / (parantu) na asti AtmA na asti AtmIyam iti api sUtrezu uktam /
   nirgranthadharme cātmānityatoktā / ātmanityatve niyate sati sūtrāṇāṃ	nirgranTa Darme ca Atma anitya tA uktA / Atma nitya tve niyate sati sUtrANAm
   vaiṣamyānupapattiḥ / iti śrutisamam /	vEzamya anupapattiH / iti Sruti samam /
   19. anyacca / yadi bhavatā ekameva sūtramadhigacchatātmā nitya iti manyate	19. anyat ca / yadi BavatA ekam eva sUtram aDigacCata AtmA nityaH iti manyate
   / athānyeṣāmapi sūtrāṇāṃ pratīterātmānityo mantavyaḥ / ubhayathā	/ aTa anyezAm api sUtrANAm pratIteH Atma anityaH mantavyaH / uBayaTA
   pratītiriti cedekasyaivātmano nityatvānityatvaprasaṅgaḥ / iti śrutibhinnam	pratItiH iti ced ekasya eva AtmanaH nitya tva anitya tva prasaFgaH / iti Sruti Binnam
   20. anyacca / yadi sadbhāvāditi hetunātmāstīti / atha śālasya	20. anyat ca / yadi sadBAvAt iti hetunA AtmA asti iti / aTa SAlasya
   sadbhāvāttāla utpadyate / yadyabhāvānnāstīti tadā tālabījeṣu	sadBAvAt tAlaH utpadyate / yadi aBAvAt na asti iti tadA tAla bIjezu
   vṛkṣākārābhāvāttadutpattyaprāptiḥ / sadbhāve 'nutpattiḥ / abhāve	vRkza AkAra aBAvAt tad utpatti aprAptiH / sadBAve anutpattiH / aBAve
   'pyanutpattiḥ / ātmano 'pi tathātvam /	api anutpattiH / AtmanaH api taTAtvam /
   yadi kiṃcitsadeva na tadānaindriyakatvaṃ hetutvena prayoktavyam / yadi ca	yadi kiMcid sat eva na tadA anEndriyaka tvam hetu tvena prayoktavyam / yadi ca
   sadeva tadā nānaindriyakatvena tasya sattā sādhyā / ityanutpattisamam /	sat eva tadA na anEndriyaka tvena tasya sattA sADyAH / iti anutpatti samam /
   yadi punaḥ kaścicchabdanityatāṃ sthāpayet,	yadi punar kaScid Sabda nitya tAm sTApayet ,
   tadaivamvidhairuktapūrvairviśatiṃdharmaistadvadeva dūṣayet /	tadA evamviDEH ukta pUrvEH viSatiMDarmEH tadvat eva dUzayet /
   nanvātmasadbhāvādeva bhavānātmānaṃ dūṣayati / ātmano 'bhāve kiṃ bhavatā	nanu Atma sadBAvAt eva BavAn AtmAnam dUzayati / AtmanaH aBAve kim BavatA
   dūṣaṇīyam / dūṣaṇāddhyasti dūṣayitavyam /	dUzaNIyam / dUzaNAt hi asti dUzayitavyam /
   atra dūṣaṇam / yuktito nāsyātmā / bhavatā tu (# Uh 31.#) tatsadbhāvasya	atra dUzaNam / yuktitaH na asya AtmA / BavatA tu (# Uh 31.#) tad sadBAvasya
   vikalpānmayā bhavato dūṣaṇaṃ kṛtam / yadbhavatoktaṃ	vikalpAn mayA BavataH dUzaNam kRtam / yat BavatA uktam
   dūṣayitavyabhavādastyātmeti / tato dūṣaṇānnāstyātmeti jñātam / bhavata	dUzayita vyaBavAt asti AtmA iti / tatas dUzaNAt na asti AtmA iti jQAtam / Bavata
   ātmaparigraha ātmābhāvadyotanarthamiti cettadayuktam / bhavadarthāprayogāt	Atma parigrahaH AtmA aBAvadyotanarTam iti ced tat ayuktam / Bavat arTa aprayogAt 
   / idānīntu svayaṃ bhavatā mama siddhāntaḥ prayuktaḥ /	/ idAnIntu svayam BavatA mama sidDAntaH prayuktaH /
   nanu kathaṃ bhavatā jñātaṃ yanmayā bhavadarthaḥ parigṛhītaḥ / atra kāraṇaṃ	nanu kaTam BavatA jQAtam yat mayA Bavat arTaH parigRhItaH / atra kAraNam
   vaktavyamiti cenmayā khalu pūrvamuktaṃ yatsvārthamaparigṛṇhatā bhavatā	vaktavyam iti ced mayA Kalu pUrvam uktam yat sva arTam aparigRNhatA BavatA
   parasthāpanā parigṛhītā kathamidānīṃ punaridaṃ pṛcchyate / kathaṃ jñātaṃ	para sTApanA parigRhItA kaTam idAnIm punar idam pRcCyate / kaTam jQAtam
   yadbhavato 'rtho maya parigṛhīta iti / yato bhavadvacanaṃ viruddhaṃ	yat BavataH arTaH maya parigRhItaH iti / yatas Bavat vacanam virudDam
   tasmānnigrahasthānāpattiḥ /	tasmAt nigraha sTAna ApattiH /
   anyacca / anaindriyakatvātsannevātmeti bhavatā pūrvaṃ pratijñātaṃ paścāttu	anyat ca / anEndriyaka tvAt san= A iva AtmA iti BavatA pUrvam pratijQAtam paScAt tu
   dharmabāhulyena sādhitam / sthāpitahetoraniyatatvātpratijñāvirodhācca	Darma bAhulyena sADitam / sTApita hetoH aniyata tvAt pratijQA viroDAt ca
   nigrahasthānam / tasmādbhavadarthanāhau yadi punarahaṃ kiṃcibdravīmi,	nigraha sTAnam / tasmAt Bavat arTa nAhO yadi punar aham kiMcibdravImi,
   [yanmayā] pūrvamuktaṃ tasmādetanna bhidyate / tadā vacanasya	[yat mayA] pUrvam uktam tasmAt etat na Bidyate / tadA vacanasya
   bahudoṣaprasaṅgaḥ / pakṣapratipakṣayoḥ pratipakṣamaryādā pañcame /	bahu doza prasaFgaH / pakza pratipakzayoH pratipakza maryAdA paQcame /
   tadatikramyoktaṃ vacanaṃ doṣaḥ / yadi vidvān gambhīraṃ nyāyaṃ	tat atikramya uktam vacanam dozaH / yadi vidvAn gamBIram nyAyam
   bhāvayatyuktena dṛṣṭāntenārthāvagamasamarthaśca syāttadā tasya vāda	BAvayati uktena dRzwAntena arTa avagama samarTaH ca syAt tadA tasya vAda
   evaṃvidhaṃ dharmaṃ nātikrāmati /	evaMviDam Darmam na atikrAmati /
   vādī prāha / evamukto vadadharmāṇāṃ sāraḥ / eṣa vādasāraḥ sarvavādānāṃ	vAdI prAha / evam uktaH vada DarmANAm sAraH / eza vAdasAraH sarva vAdAnAm
   mūlam / etasmādvādātpakṣapratipakṣayoḥ paramotkarṣajñānaṃ jāyate / yathā	mUlam / etasmAt vAdAt pakza pratipakzayoH parama utkarza jQAnam jAyate / yaTA
   bīje sukṣetra upte mūlāṅkurāḥ samṛddhāḥ / kukṣetre tūpte phalabhāva eva /	bIje su kzetre upte mUla aFkurAH samRdDAH / kukzetre tu upte Pala BAvaH eva /
   etasya dharmasyāpi tathātvam /	etasya Darmasya api taTAtvam /
   (# Uh 32.#)	(# Uh 32.#)
   yadi vidvān kaścit pramāṇavicārakuśalastadā vādānutpādayati /	yadi vidvAn kaScid pramANa vicAra kuSalaH tadA vAdAn utpAdayati /
   mūrkhastvalpabuddhiretadvādābhyāsenāpi tadavagamāsamarthastattvato vidvān	mUrKaH tu alpabudDiH etat vAda aByAsena api tad avagamA samarTaH tattvataH vidvAn
   nocyate / tasmādye ye sañjñānotpattiṃ subhāśubhavivekañcecchanti	na ucyate / tasmAt ye ye san jQAna utpattim suBa aSuBa vivekaQca icCanti
   taistaireva saddharmavāda āśrayitavyaḥ /	tEH tEH eva sat Darma vAdaH ASrayitavyaH /
   // iti caturthaṃ prakaraṇam //	// iti caturTam prakaraNam //
   samāptaścāyaṃ granthaḥ /	samAptaH ca ayam granTaH /
