   Haribhadrasūrikṛtā Nyāyapraveśapravṛttiḥ /	HariBadra sUrikRtA NyAya praveSa pravRttiH /
   śrīsarvajñāya namaḥ //	SrI sarvajQAya namaH //
   samyagjñānasya vaktāraṃ praṇipatya jineśvaram /	samyak jQAnasya vaktAram praNipatya jineSvaram /
   nyāyapraveśakavyākhyāṃ sphuṭārthāṃ racayāmyaham //	nyAya praveSa kavyAKyAm sPuwa arTAm racayAmi aham //
   racitāmapi satprajñairvistareṇa samāsataḥ /	racitAm api sat prajQEH vistareNa samAsatas /
   asatprajño 'pi saṃkṣiptaruciḥ sattvānukampayā //	asat prajQaH api saMkzipta ruciH sattva anukampayA //
   tatra ca 	tatra ca 
   sādhanaṃ dūṣaṇaṃ caiva sābhāsaṃ parasaṃvide /	sADanam dUzaNam ca eva sa ABAsam para saMvide /
   pratyakṣamanumānaṃ ca sābhāsaṃ tvātmasaṃvide //	pratyakzam anumAnam ca sa ABAsam tu Atma saMvide //
   ityādāveva ślokaḥ / āhāsya kimādāvupanyāsa iti / ucyate / iha	iti AdO= eva SlokaH / Aha asya kim AdO= upanyAsaH iti / ucyate / iha
   prekṣāpūrvakāriṇaḥ prayojanādiśūnye na kvacitpravartanta ityato	prekzA pUrva kAriNaH prayojana Adi SUnye na kvacid pravartantaH iti atas 
   'dhikṛtaśāstrasya prayojanādipradarśanena prekṣāvatāṃ pravṛttyarthamiti /	aDikRta SAstrasya prayojana Adi pradarSanena prekzAvatAm pravRtti arTam iti /
   śāstrārthakathanakālopasthitaparasaṃbhāvyamānānupanyāsahetunirākaraṇārthaṃ	SAstra arTa kaTana kAla upasTita para saMBAvyamAna anupanyAsa hetu nirAkaraNa arTam
   ca nyāyapraveśakākhyaṃ śāstramārabhyate ityukte saṃbhavatyevaṃvādī paraḥ 	ca nyAya praveSaka AKyam SAstram AraByate iti ukte saMBavati evaMvAdI paraH 
   nārabdhavyamidaṃ prayojanarahitatvāt unmattakavākyavat / tathā	na arabDavyam idam prayojana rahita tvAt unmattaka vAkya vat / taTA
   nirabhidheyatvāt kākadantaparīkṣāvat / tathā asaṃbaddhatvāt daśa dāḍimāni	niraBiDeya tvAt kAka danta parIkzA vat / taTA asaMbadDa tvAt daSa dAximAni
   ṣaḍapūpāḥ kuṇḍamajājinaṃ palalapiṇḍaṃ sara kīṭiketyādivākyavat / tadamīṣāṃ	zaz apUpAH kuNxamaja ajinam palala piNxam sara kIwikA ityAdi vAkya vat / tat amIzAm
   hetūnāmasiddhatodbhāvayiṣayā prayojanādipratipādanārthamādau ślokopanyāsa	hetUnAm asidDa tA udBA vayizayA prayojana Adi pratipAdana arTam AdO Sloka upanyAsa
   / ayaṃ cābhidheyaprayojane eva darśayati sākṣāt saṃbandhaṃ tu sāmarthyena	/ ayam ca aBiDeya prayojane eva darSayati sAkzAt saMbanDam tu sAmarTyena
   / yathā caitadevaṃ tathā sukhapratipattyarthamevameva leśato vyākhyāya	/ yaTA ca etat evam taTA suKa pratipatti arTam evam eva leSataH vyAKyAya
   darśayiṣyāmaḥ // vyākhyā ca padavākyasaṃgateti / uktaṃ ca 	darSayizyAmaH // vyAKyA ca pada vAkya saMgata iti / uktam ca 
   śāsraprakaraṇādīnāṃ yathārthāvagamaḥ kutaḥ /	SAsra prakaraNa AdInAm yaTArTa avagamaH kutas /
   vyākhyāṃ vihāya tattvajñaiḥ sā coktā padavākyayoḥ //	vyAKyAm vihAya tattva jQEH sA ca uktA pada vAkyayoH //
   tatrāpi padasamudāyātmakatvādvākyasyādau padārthagamanikā nyāyyā /	tatra api pada samudAya Atmaka tvAt vAkyasya AdO padArTa gamanikA nyAyyAH /
   sā ca padavibhāgapūrvetyataḥ padavibhāgaḥ /	sA ca pada viBAga pUrvA iti atas pada viBAgaH /
   sādhanam dūṣaṇam ca eva sābhāsam parasaṃvide pratyakṣam anumānam ca	sADanam dUzaNam ca eva sa ABAsam para saMvide pratyakzam anumAnam ca
   sābhāsam tu ātmasaṃvide iti padāni //	sa ABAsam tu Atma saMvide iti padAni //
   adhunā padārtha ucyate / sādhyate aneneti siddhirvā sādhayatīti vā	aDunA padArTaH ucyate / sADyate anena iti sidDiH vA sADayati iti vA
   sādhanam / tacca pakṣādivacanajātam / vakṣyati ca / pakṣādivacanāni	sADanam / tat ca pakza Adi vacana jAtam / vakzyati ca / pakza Adi vacanAni
   sādhanam / viṣayaścāsya dharmaviśiṣṭo dharmī /	sADanam / vizayaH ca asya Darma viSizwaH DarmI /
   tathā dūṣyate 'nena dūṣayatīti vā dūṣaṇam /	taTA dUzyate anena dUzayati iti vA dUzaNam /
   tacca sādhanadoṣodbhāvanaṃ vacanajātameva /	tat ca sADana doza udBAvanam vacana jAtam eva /
   vakṣyati ca sādhanadoṣodbhāvanāni dūṣaṇāni / viṣayaścāsya sādhanābhāsaḥ na	vakzyati ca sADana doza udBAvanAni dUzaNAni / vizayaH ca asya sADana ABAsaH na
   samyaksādhanam / tasya duṣayitumaśakyatvāt /	samyak sADanam / tasya duzayitum aSakya tvAt /
   nanu vakṣyati sādhanadoṣodbhāvanāni dūṣaṇānīti tadetatkatham / ucyate /	nanu vakzyati sADana doza udBAvanAni dUzaNAni iti tat etat kaTam / ucyate /
   sādhanābhāsa eva kiṃcitsāmyena sādhanopacārādadoṣaḥ ityetacca tatraiva	sADana ABAsaH eva kiMcid sAmyena sADana upacArAt adozaH iti etat ca tatra eva
   nirloṭhayiṣyāmaḥ / caśabdaḥ samuccaye / evakāro 'vadhāraṇe / sa	nirloWayizyAmaH / caSabdaH samuccaye / eva kAraH avaDAraNe / sa
   cānyayogavyavacchedārtha ityetaddarśayiṣyāmaḥ / tathā ābhāsanamābhāsaḥ /	ca anya yoga vyavacCeda arTaH iti etat darSayizyAmaH / taTA ABAsanam ABAsaH /
   saha ābhāsena vartate sābhāsam / sābhāsaśabdaḥ pratyekamabhisaṃbadhyate /	saha ABAsena vartate sa ABAsam / sa ABAsa SabdaH pratyekam aBisaMbaDyate /
   sādhanaṃ sābhāsaṃ dūṣaṇaṃ sābhāsam / tatra sādhanābhāsaṃ pakṣābhāsādi /	sADanam sa ABAsam dUzaNam sa ABAsam / tatra sADana ABAsam pakza ABAsa Adi /
   vakṣyati ca / sādhayitumiṣṭo 'pi pratyakṣādiviruddhaḥ pakṣābhāsa ityādi /	vakzyati ca / sADayitum izwaH api pratyakza Adi virudDaH pakza ABAsaH ityAdi /
   dūṣaṇābhāsaṃ cābhūtasādhanadoṣodbhāvanāni /	dUzaNa ABAsam ca aBUta sADana doza udBAvanAni /
   vakṣyati ca abhūtasādhanadoṣodbhāvanāni dūṣaṇābhāsānīti // parasaṃvide	vakzyati ca aBUta sADana doza udBAvanAni dUzaNa ABAsAni iti // para saMvide
   ityatra pare prāśnikāḥ saṃvedanaṃ saṃvid avabodha ityarthaḥ / pareṣāṃ	iti atra pare prASnikAH saMvedanam saMvid avaboDaH iti arTaH / parezAm
   saṃvit parasaṃvit tasyai parasaṃvide parāvabodhāya / iyaṃ tādarthye	saMvid para saMvid tasyE para saMvide para avaboDAya / iyam tAdarTye
   caturthī / yathā yūpāya dāruḥ / iti padārthaḥ // vākyarthastvayam /	caturTI / yaTA yUpAya dAruH / iti padArTaH // vAki arTaH tu ayam /
   sādhanadūṣaṇe eva sābhāse parasaṃvide parāvabodhāya na pratyakṣānumāne /	sADana dUzaNe eva sa ABAse para saMvide para avaboDAya na pratyakza anumAne /
   parasaṃvitphalatvāttayoḥ / yathā pārtha eva dhanurdharaḥ pārthe	para saMvid Pala tvAt tayoH / yaTA pArTaH eva DanurDaraH pArTe
   dhanurdhārayati sati ko 'nyo dhanurdhārayati iti // pratyakṣam ityatra	DanuH DArayati sati kaH anyaH DanuH DArayati iti // pratyakzam iti atra
   akṣamindriyaṃ tataśca pratigatamakṣaṃ pratyakṣaṃ kāryatvenendriyaṃ prati	akzam indriyam tatas ca pratigatam akzam pratyakzam kArya tvena indriyam prati
   gatamityarthaḥ / idaṃ ca vakṣyati pratyakṣaṃ kalpanāpoḍham ityādi / tathā	gatam iti arTaH / idam ca vakzyati pratyakzam kalpanA apoXam ityAdi / taTA
   mīyate aneneti mānaṃ paricchedyata ityarthaḥ / anuśabdaḥ paścādarthe /	mIyate anena iti mAnam paricCedyate iti arTaH / anuSabdaH paScAt arTe /
   paścānmānaṃ anumānam /	paScAt mAnam anumAnam /
   pakṣadharmagrahaṇasaṃbandhasmaraṇapūrvakamityarthaḥ / vakṣyati ca	pakza Darma grahaNa saMbanDa smaraNa pUrvakam iti arTaH / vakzyati ca
   trirūpālliṅgālliṅgini jñānamanumānam / caśabdaḥ pūrvavat / sābhāsam ityādi	trirUpAt liFgAt liFgini jQAnam anumAnam / caSabdaH pUrvavat / sa ABAsam ityAdi
   / vakṣyati ca kalpanājñānamarthāntare pratyakṣābhāsam ityādi / tathā	/ vakzyati ca kalpanA jQAnam arTa antare pratyakza ABAsam ityAdi / taTA
   hetvābhāsapūrvakaṃ jñānamanumānābhāsam ityādi ca / tu śabdastvevakārārthaḥ	hetvABAsa pUrvakam jQAnam anumAna ABAsam ityAdi ca / tu SabdaH tu evakAra arTaH
   / sa cāvadhāraṇa iti darśayiṣyāmaḥ // ātmasaṃvide iti / atatītyātmā jīvaḥ	/ sa ca avaDAraNaH iti darSayizyAmaH // Atma saMvide iti / atati iti AtmA jIvaH
   / saṃvedanaṃ saṃvit / ātmanaḥ saṃvit ātmasaṃvit / tasyai ātmasaṃvide	/ saMvedanam saMvid / AtmanaH saMvid Atma saMvid / tasyE Atma saMvide
   ātmāvabodhāya / ātmā ceha cittacaittasaṃtānarūpaḥ parigṛhyate na tu	Atma avaboDAya / AtmA ca iha citta cEtta saMtAna rUpaH parigRhyate na tu
   paraparikalpito nittyatvādidharmā /	para parikalpitaH nittya tva Adi DarmA /
   tatpratipādakapramāṇābhāvāt / iti padārthaḥ // vākyārthastvayam /	tad pratipAdaka pramANa aBAvAt / iti padArTaH // vAkya arTaH tu ayam /
   pratyakṣānumāne eva sābhāse ātmasaṃvide ātmāvabodhāya na sādhanadūṣaṇe	pratyakza anumAne eva sa ABAse Atma saMvide AtmA avaboDAya na sADana dUzaNe
   ātmasaṃvitphalatvāt tayoḥ / āha nanu sādhanamapi vastuto 'numānameva	Atma saMvid Pala tvAt tayoH / Aha nanu sADanam api vastutas anumAnam eva
   tataścānumānamityādyukte sādhanābhidhānaṃ na yujyate asminvā prāgukte	tatas ca anumAnam iti Adi ukte sADana aBiDAnam na yujyate asmin vA prAk ukte
   anumānābhidhānamiti / naiṣa doṣaḥ / svārthaparārthabhedanābhidhānāt /	anumAna aBiDAnam iti / na eza dozaH / sva arTa para arTa Bedana aBiDAnAt /
   tatra sādhanaṃ parārthamanumānamidaṃ punaḥ svārtham / aparastvāha / ādau	tatra sADanam para arTam anumAnam idam punar sva arTam / aparaH tu Aha / AdO
   sādhanadūṣaṇābhidhānamayuktaṃ pratyakṣānumānapuraḥsarattvāttatprayogasya /	sADana dUzaNa aBiDAnam ayuktam pratyakza anumAna puraHsarat tvAt tad prayogasya /
   ucyate / satyapi tatpuraḥsaratve śāstrārambhasya	ucyate / sati api tad puraHsara tve SAstra AramBasya
   parasaṃvitpradhānatvātsādhanadūṣaṇayorapi	para saMvid praDAna tvAt sADana dUzaNayoH api
   tatphalatvātpratyāsatterādāvupanyāsaḥ / parārthanibandhanaḥ svārtha iti	tad Pala tvAt pratyAsatteH AdO= upanyAsaH / para arTa nibanDanaH sva arTaH iti
   nyāyapradarśanārthamanye //	nyAya pradarSana arTam anye //
   kṛtaṃ prasaṅgena / prakṛtaṃ prastumaḥ // iha ca sādhanādayo 'ṣṭau	kRtam prasaFgena / prakRtam prastumaH // iha ca sADana AdayaH azwO
   padārthāḥ abhidheyatayā uktāḥ / parasaṃvittyātmasaṃvittyoratra	padArTAH aBiDeya tayA uktAH / para saMvitti Atma saMvittyoH atra
   prayojanatvena saṃbandhaśca sāmarthyagamya eva / sa ca kāryakāraṇalakṣaṇaḥ	prayojana tvena saMbanDaH ca sAmarTya gamyaH eva / sa ca kArya kAraNa lakzaNaH
   / kāraṇaṃ vacanarūpāpannaprakaraṇameva / kāryaṃ tu prakaraṇārthaparijñānam	/ kAraNam vacana rUpa Apanna prakaraNam eva / kAryam tu prakaraNa arTa parijQAnam
   / tathāhīdamasya kāryamiti saṃbandhalakṣaṇā ṣaṣṭhī / āha  yadyevaṃ	/ taTA ahi idam asya kAryam iti saMbanDa lakzaNA zazWI / Aha yadi evam
   parasaṃvittyātmasaṃvittyoḥ prakaraṇārthaparijñānena	para saMvitti Atma saMvittyoH prakaraNa arTa parijQAnena
   vyavahitatvādaprayojanatvamiti / na / vyavahitasyaiva vivakṣitatvāt /	vyavahita tvAt aprayojana tvam iti / na / vyavahitasya eva vivakzita tvAt /
   kimarthaṃ vyavahitameva vivakṣitamiti / ucyate / uttarottaraprayojanānāṃ	kimarTam vyavahitam eva vivakzitam iti / ucyate / uttarottara prayojanAnAm
   prādhānyakhyāpanārtham / tathā cehānuttaraprayojanaṃ paramagatiprāptireva	prADAnya KyApana arTam / taTA ca iha anuttara prayojanam parama gati prAptiH eva
   / tathā coktam /	/ taTA ca uktam /
   samyaṅnyāyaparijñānāddheyopādeyavedinaḥ /	samyak nyAya parijQAnAt heya upAdeya vedinaH /
   upādeyamupādāya gacchanti paramāṃ gatim //	upAdeyam upAdAya gacCanti paramAm gatim //
   āha  yadyevamihānuttaramevedaṃ kasmānnopanyastamiti / ucyate / avyutpannaṃ	Aha yadi evam iha anuttaram eva idam kasmAt na upanyastam iti / ucyate / avyutpannam
   vineyagaṇamadhikṛtya tatprathamatayaiva tasyāprayojakatvāt // aparastvāha	vineya gaNam aDikRtya tad praTama tayA eva tasya aprayojaka tvAt // aparaH tu Aha
   / idamiha śrotaṇāṃ prayojanamuktaṃ kartustarhi kiṃ prayojanamiti vācyam /	/ idam iha SrotaNAm prayojanam uktam kartuH tarhi kim prayojanam iti vAcyam /
   ucyate / tasyāpyanantaraparabhedabhinnamidameva / anantaraṃ	ucyate / tasya api anantara para Beda Binnam idam eva / anantaram
   tāvatsattvānugrahaḥ / paraṃparaṃ tu paramagatiprāptireva / tathā coktam /	tAvat sattva anugrahaH / paraMparam tu parama gati prAptiH eva / taTA ca uktam /
   samyaṅnyāyopadeśena yaḥ sattvānāmanugraham /	samyak nyAya upadeSena yaH sattvAnAm anugraham /
   karoti nyāyabāhyānāṃ sa prāpnotyacirācchivam //	karoti nyAya bAhyAnAm sa prApnoti acirAt Sivam //
   alaṃ vistareṇa //	alam vistareNa //
   iti śāstrasaṃgrahaḥ / itiśabdaḥ parisamāptivācakaḥ / etāvāneva / śiṣyate	iti SAstra saMgrahaH / iti SabdaH parisamApti vAcakaH / etAvAn eva / Sizyate
   'nena tattvamiti śāstramadhikṛtameva; arya(rthya)ta ityarthaḥ /	anena tattvam iti SAstram aDikRtam eva; arya(rTya)te iti arTaH /
   śāstrasyārthaḥ śāstrārthaḥ / tasya sagrahaḥ śāstrārthasaṃgrahaḥ /	SAstrasya arTaH SAstra arTaH / tasya sa grahaH SAstra arTa saMgrahaH /
   saṃgrahaṇaṃ saṃgrahaḥ / etāvānevādhikṛtaśāstrārthasaṃkṣepa ityarthaḥ /	saMgrahaNam saMgrahaH / etAvAn eva aDikRta SAstra arTa saMkzepaH iti arTaH /
   śāstrato cāsyālpagranthasyāpi viśvavyāpakanyāyānuśāsanāditi vṛddhavādaḥ //	SAstrataH ca asya alpa granTasya api viSva vyApakanyAya anuSAsanAt iti vRdDa vAdaH //
   tatra yathoddeśastathā nirdeśa iti kṛtvā sādhanasvarūpāvadhāraṇāyāha //	tatra yaTA uddeSaH taTA nirdeSaH iti kRtvA sADana svarUpa avaDAraNAya Aha //
   tatra pakṣādivacanāni sādhanam / tatraśabdo nirdhāraṇārthaḥ / tatra teṣu	tatra pakza Adi vacanAni sADanam / tatraSabdaH nirDAraNa arTaH / tatra tezu
   sādhanādiṣu sādhanaṃ tāvannirdhāryate iti / nirdhāraṇaṃ ca	sADana Adizu sADanam tAvat nirDAryate iti / nirDAraNam ca
   jātiguṇakriyānimittamiti / atra guṇanimittaṃ sādhanatvena guṇena	jAti guNa kriyA nimittam iti / atra guNa nimittam sADana tvena guNena
   nirdhāryate iti / gomaṇḍalādiva gauḥ kṣīrasaṃpannatvena guṇena // pacyate	nirDAryate iti / go maNxalAt iva gOH kzIra saMpanna tvena guNena // pacyate
   iti pakṣaḥ / paca vyaktīkaraṇe / pacyate vyaktīkriyate yo 'rthaḥ sa pakṣaḥ	iti pakzaH / paca vyaktIkaraNe / pacyate vyaktIkriyate yaH arTaH sa pakzaH
   / sādhya ityarthaḥ / sa ca dharmaviśiṣṭo dharmī / pakṣa ādiryeṣāṃ te	/ sADyaH iti arTaH / sa ca Darma viSizwaH DarmI / pakzaH AdiH yezAm te
   pakṣādayaḥ / ayaṃ bahubrīhiḥ samāsaḥ /	pakza AdayaH / ayam bahu brIhiH samAsaH /
   ayaṃ ca tadguṇasaṃvijñānaśca bhavati / tatra tadguṇasaṃvijñāno yathā	ayam ca tad guNa saMvijQAnaH ca Bavati / tatra tad guNa saMvijQAnaH yaTA
   lambakarṇa ityādi / lambau karṇau yasyāsau lambakarṇaḥ / lambakarṇatvaṃ ca	lambakarNaH ityAdi / lambO karNO yasya asO lambakarNaH / lamba karNa tvam ca
   tasyaiva guṇa ityarthaḥ / atadguṇasaṃvijñāno yathā parvatādikaṃ	tasya eva guNaH iti arTaH / atad guNa saMvijQAnaH yaTA parvata Adikam
   kṣetramityādi / parvata ādiryasya tatparvatādikaṃ kṣetram / na parvataḥ	kzetram ityAdi / parvataH AdiH yasya tad parvata Adikam kzetram / na parvataH
   kṣetraguṇaḥ / kiṃ tarhi / upalakṣaṇamātramiti bhāvanā /	kzetra guNaH / kim tarhi / upalakzaNa mAtram iti BAvanA /
   ayamiha tadguṇasaṃvijñāno bahuvrīhirveditavyaḥ / yathā parvatādikaṃ	ayam iha tad guNa saMvijQAnaH bahuvrIhiH veditavyaH / yaTA parvata Adikam
   kṣetraṃ nadyādikaṃ vanamiti / na punaryathā lambakarṇaḥ brāhmaṇādayo varṇā	kzetram nadI Adikam vanam iti / na punar yaTA lambakarNaH brAhmaNa AdayaH varNA
   iti / pakṣādivacanāni sādhanamityādiśabda upalakṣaṇārthaḥ / asya	iti / pakza Adi vacanAni sADanam ityAdi SabdaH upalakzaNa arTaH / asya
   cāyamarthaḥ / ādīyate 'smādityādiḥ yathā parvatādikaṃ kṣetramityādau / na	ca ayam arTaH / AdIyate asmAt ityAdiH yaTA parvata Adikam kzetram ityAdO / na
   punarādīyate ityādiḥ yathā brāhmaṇādayo varṇā ityadāviti / tataḥ	punar AdIyate ityAdiH yaTA brAhmaNa AdayaH varNAH iti adO= iti / tatas 
   susthitamidaṃ pakṣaḥ ādiryeṣāṃ te pakṣādayaḥ // te ca pakṣopalakṣitā	susTitam idam pakzaH AdiH yezAm te pakza AdayaH // te ca pakza upalakzitA
   hetudṛṣṭāntāḥ / teṣāṃ vacanānyuktayaḥ // kiṃ sādhanamiti /	hetu dRzwAntAH / tezAm vacanAni uktayaH // kim sADanam iti /
   iha ca yadā sādhyate 'neneti sādhanaṃ karaṇābhidhānārthaḥ	iha ca yadA sADyate anena iti sADanam karaNa aBiDAna arTaH
   sādhanaśabdastadā pakṣopalakṣitāni hetutvādivacanāni sādhanam / yatastaiḥ	sADana SabdaH tadA pakza upalakzitAni hetu tva Adi vacanAni sADanam / yatas tEH
   karaṇabhūtairvivakṣito 'rthaḥ parasaṃtāne pratipādyate / yadā	karaNa BUtEH vivakzitaH arTaH para saMtAne pratipAdyate / yadA
   punarbhāvasādhanaḥ siddhiḥ sādhanamiti tadā pakṣādivacanajanyaṃ	punarBAva sADanaH sidDiH sADanam iti tadA pakza Adi vacana janyam
   pratipādyagataṃ jñānameva sādhanam / tatphalatvātpakṣādivacanānām / kārye	pratipAdya gatam jQAnam eva sADanam / tad Pala tvAt pakza Adi vacanAnAm / kArye
   kāraṇopacārāt / yathedaṃ me śarīraṃ paurāṇāṃ karmeti / yadā tu	kAraNa upacArAt / yaTA idam me SarIram pOrANAm karma iti / yadA tu
   kartṛsādhanaḥ sādhayatīti sādhanaṃ tadā pakṣādivacanānyeva kartṛtvena	kartR sADanaH sADayati iti sADanam tadA pakza Adi vacanAni eva kartR tvena
   vivakṣyante pratipādyasaṃtāne jñānotpādakatvāt iti / tadevaṃ	vivakzyante pratipAdya saMtAne jQAna utpAdaka tvAt iti / tat evam
   pakṣādivacanāni sādhanam / tadyathā vṛkṣā vanaṃ hastyādayaḥ senā / āha /	pakza Adi vacanAni sADanam / tat yaTA vRkzAH vanam hasti AdayaH senA / Aha /
   ekavacananirdeśaḥ kimarthamucyate / samuditānāmeva pakṣādivacanānāṃ	eka vacana nirdeSaH kim arTam ucyate / samuditAnAm eva pakza Adi vacanAnAm
   sādhanatvakhyāpanārtham / uktaṃ ca diṅnāgācāryeṇa sādhanamiti	sADana tva KyApana arTam / uktam ca diFnAga AcAryeNa sADanam iti
   caikavacananirdeśaḥ samastasādhanatvakhyāpanārthaḥ / ityalaṃ vistareṇa //	ca eka vacana nirdeSaH samasta sADana tva KyApana arTaH / iti alam vistareNa //
   evaṃ tāvatsāmānyena sādhanamuktam / idaṃ ca na jñāyate kiṃ kārakamuta	evam tAvat sAmAnyena sADanam uktam / idam ca na jQAyate kim kArakam uta
   vyañjakam / sādhanasya dvaividhyadarśanāt / tatra kārakaṃ vījādyaṅkurādeḥ	vyaQjakam / sADanasya dvEviDya darSanAt / tatra kArakam vIja Adi aFkura AdeH
   / vyañjakaṃ pradīpādi tamasi ghaṭādīnām / ato vyañjakatvapratipādanāyāha /	/ vyaQjakam pradIpa Adi tamasi Gawa AdInAm / atas vyaQjaka tva pratipAdanAya Aha /
   pakṣahetudṛṣṭāntavacanairhi prāśnikānāmapratīto 'rthaḥ pratipādyate iti //	pakza hetu dRzwAnta vacanEH hi prASnikAnAm apratItaH arTaH pratipAdyate iti //
   asya gamanikā / pacyate iti pakṣaḥ / hinotīti hetuḥ / hi gatau / sarve	asya gamanikA / pacyate iti pakzaH / hinoti iti hetuH / hi gatO / sarve
   gatyarthāḥ jñānārthāḥ / tathā dṛṣṭamarthamantaṃ nayatīti dṛṣṭāntaḥ / sa ca	gati arTAH jQAna arTAH / taTA dRzwam arTam antam nayati iti dRzwAntaH / sa ca
   dvidhā sādharmyevaidharmyabhedāt / tataścaivaṃ samāsaḥ / dṛṣṭāntaśca	dviDA sADarmyevEDarmya BedAt / tatas ca evam samAsaH / dRzwAntaH ca
   dṛṣṭāntaśca dṛṣṭāntau / hetuśca dṛṣṭāntau ca hetudṛṣṭāntāḥ / pakṣasya	dRzwAntaH ca dRzwAntO / hetuH ca dRzwAntO ca hetu dRzwAntAH / pakzasya
   hetudṛṣṭāntāḥ pakṣahetudṛṣṭāntāḥ / teṣāṃ vacanāni	hetu dRzwAntAH pakza hetu dRzwAntAH / tezAm vacanAni
   pakṣahetudṛṣṭāntavacanāni / taiḥ pakṣahetudṛṣṭāntavacanaiḥ / hiśabdo	pakza hetu dRzwAnta vacanAni / tEH pakza hetu dRzwAnta vacanEH / hi SabdaH 
   yasmādarthe / praśneniyuktāḥ prāśnikā vidvāṃsaḥ /	yasmAt arTe / praSneni yuktAH prASnikAH vidvAMsaH /
   svasamayaparasamayavedinaḥ / uktaṃ ca 	sva samaya para samaya vedinaH / uktam ca 
   svasamayaparasamayajñāḥ kulajāḥ pakṣadvayasthitāḥ kṣamiṇaḥ /	sva samaya para samaya jQAH kula jAH pakza dvaya sTitAH kzamiNaH /
   vādapatheṣvabhiyuktāstulāsamāḥ prāśnikāḥ proktāḥ //	vAda paTezu aBiyuktAH tulA samAH prASnikAH proktAH //
   teṣāṃ prāśnikānāmapratīto 'navagato 'navabuddho 'rthaḥ pratipādyate / āha	tezAm prASnikAnAm apratItaH anavagataH anavabudDaH arTaH pratipAdyate / Aha
   / ye yathoktāḥ prāśnikāḥ kathaṃ teṣāṃ kaścidapratīto 'rtha iti / ucyate /	/ ye yaTA uktAH prASnikAH kaTam tezAm kaScid apratItaH arTaH iti / ucyate /
   na tatparijñānamaṅgīkṛtyāpratītaḥ / kiṃtu	na tad parijQAnam aFgIkRtya apratItaH / kiMtu
   vādiprativādipakṣaparigrahasamarthanāsahastadantargata ityato 'pratīto	vAdi prativAdi pakza parigraha samarTana asahastad antargataH iti atas apratItaH 
   'rthaḥ pratipādyate / nanu cātra cāturthyā kriyayā ceti vaktavyalakṣaṇayā	arTaH pratipAdyate / nanu ca atra cAturTyA kriyayA ca iti vaktavya lakzaNayA
   bhavitavyaṃ tatkimartha ṣaṣṭhyatrocyate / kārakāṇāmavivakṣā śeṣa iti	Bavitavyam tat kim arTa zazWI atra ucyate / kArakANAm avivakzA SezaH iti
   śeṣalakṣaṇā ṣaṣṭhī / keṣāṃ pratipādyate / sāmarthyādyeṣāmapratītaḥ	Seza lakzaNA zazWI / kezAm pratipAdyate / sAmarTya Adi ezAm apratItaH
   anyeṣāmaśrutatvātteṣāmeva pratipādyate /	anyezAm aSruta tvAt tezAm eva pratipAdyate /
   itiśabdastasmādarthe / yasmādevaṃ tasmādvyañjakamidaṃ	iti SabdaH tasmAt arTe / yasmAt evam tasmAt vyaQjakam idam
   sādhanamapratītārthapratipādakatvāt pradīpavat / vyatireke bījādi // tatra	sADanam apratIta arTa pratipAdaka tvAt pradIpa vat / vyatireke bIja Adi // tatra
   pakṣādivacanāni sādhanam ityuiktam // adhunā yathoddeśaṃ nirdeśa	pakza Adi vacanAni sADanam iti uiktam // aDunA yaToddeSam nirdeSa
   itinyāyamāśritya pakṣalakṣaṇapratipādanāyāha / tatra pakṣaḥ prasiddho	itinyAyam ASritya pakza lakzaNa pratipAdanAya Aha / tatra pakzaH prasidDaH 
   dharmī / asya gamanikā / tatraśabdo nirdhāraṇārthaḥ / nirdhāraṇaṃ ca	DarmI / asya gamanikA / tatraSabdaH nirDAraNa arTaH / nirDAraNam ca
   prasiddhadharmitvādiguṇato 'vaseyamiti / pakṣa iti lakṣyanirdeśaḥ /	prasidDa Darmi tva Adi guNataH avaseyam iti / pakzaH iti lakzya nirdeSaH /
   dharmīti / dharmāḥ kṛtakatvādayaste 'sya vidyante iti dharmī śabdādiḥ /	DarmI iti / DarmAH kRtaka tva AdayaH te asya vidyante iti DarmI Sabda AdiH /
   kathaṃ prasiddha ityata āha / prasiddhaviśeṣaṇaviśiṣṭatayā svayaṃ	kaTam prasidDaH iti atas Aha / prasidDa viSezaNa viSizwa tayA svayam
   sādhyatvenepsitaḥ / tatra prasiddhaṃ vādiprativādibhyāṃ pramāṇabalena	sADya tvena IpsitaH / tatra prasidDam vAdi prativAdiByAm pramANa balena
   pratipannam / viśiṣyate 'neneti viśeṣaṇam / tena viśiṣṭaḥ	pratipannam / viSizyate anena iti viSezaNam / tena viSizwaH
   prasiddhaviśeṣaṇaviśiṣṭaḥ /	prasidDa viSezaNa viSizwaH /
   tadbhāvaḥ prasiddhaviśeṣaṇaviśiṣṭatatā / tayā prasiddhaviśeṣaṇaviśiṣṭatayā	tad BAvaH prasidDa viSezaNa viSizwa tatA / tayA prasidDa viSezaNa viSizwa tayA
   hetubhūtayā prasiddhaḥ / atrāha / iha dharmiṇastāvatprasiddhatā yuktā	hetu BUtayA prasidDaH / atra Aha / iha DarmiNaH tAvat prasidDa tA yuktA
   viśeṣaṇasya tvanityatvāderna yujyate / sādhyatvāt / anyathā vivādābhāvena	viSezaNasya tu anitya tva AdeH na yujyate / sADya tvAt / anyaTA vivAda aBAvena
   sādhanaprayogānupapatteḥ / naitadevam / samyagarthānavabodhāt / iha	sADana prayoga anupapatteH / na etat evam / samyak arTa anavaboDAt / iha
   prasiddhatā viśeṣaṇasya na tasminneva dharmiṇi samāśrīyate kiṃtu	prasidDa tA viSezaNasya na tasmin= eva DarmiNi samASrIyate kiMtu
   dharmyantare ghaṭādau / tataśca yathoktadoṣānupapattiḥ / tathā	Darmi antare Gawa AdO / tatas ca yaTA ukta doza anupapattiH / taTA
   svayamityanenābhyupagamasiddhāntaparigrahaḥ // sādhyatvenepsita iti /	svayam iti anena aByupagama sidDAnta parigrahaH // sADya tvena IpsitaH iti /
   sādhanīyaḥ sādhayitavyaḥ sādhanamarhatīti vā sādhyaḥ / tasya bhāvaḥ	sADanIyaH sADayitavyaH sADanam arhati iti vA sADyaH / tasya BAvaH
   sādhyatvama / tena sādhyatvena / īpsitaḥ abhimataḥ iṣṭa icchāyā vyāpta	sADya tvama / tena sADya tvena / IpsitaH aBimataH izwaH icCAyAH vyApta
   ityarthaḥ / iha ca viśeṣaṇasya vyavacchedakatvātprasiddho	iti arTaH / iha ca viSezaNasya vyavacCedaka tvAt prasidDaH 
   dharmītyanenāprasiddhaviśeṣaṇasya pakṣābhāsasya vyavacchedo draṣṭavyaḥ /	Darmi iti anena aprasidDa viSezaNasya pakza ABAsasya vyavacCedaH drazwavyaH /
   prasiddhaviśepaṇaviśiṣṭayetyanena tvaprasiddhaviśeṣaṇasya ubhayena	prasidDa viSepaNa viSizwayA iti anena tu aprasidDa viSezaNasya uBayena
   cāprasiddhobhayasya svayamityanena cābhyupagamasiddhāntaparigraheṇa	ca aprasidDa uBayasya svayam iti anena ca aByupagama sidDAnta parigraheNa
   sarvatantrapratitantrādhikaraṇasiddhāntānāṃ vyavacchedo draṣṭavyaḥ / iha	sarva tantra pratitantra aDikaraNa sidDAntAnAm vyavacCedaH drazwavyaH / iha
   tu śastranirapekṣavādinorlokaprasiddhayordharmadharmiṇoḥ	tu Sastra nirapekza vAdinoH loka prasidDayoH Darma DarmiNoH
   parigrahavacanamabhyupagamasiddhāntastaṃ svayamityanenāha / tataścayadapi	parigraha vacanam aByupagama sidDAntaH tam svayam iti anena Aha / tatas cayat api
   svayamiti vādinā yastadā sādhanamāha / etena yadyapi kvacicchāstre sthtiaḥ	svayam iti vAdinA yaH tadA sADanam Aha / etena yadi api kvacid SAstre sTtiaH
   sādhanamāha tacchāstrakāreṇa tasmindharmiṇyanekadharmābhyupagame 'pi	sADanam Aha tad SAstra kAreNa tasmin DarmiNI aneka Darma aByupagame api
   yastadānena vādinā dharmaḥ sādhayitumiṣṭaḥ sa eva sādhyo netara ityuktaṃ	yaH tadA anena vAdinA DarmaH sADayitum izwaH saH eva sADyaH na itaraH iti uktam
   bhavatīti yaduktaṃ vādimukhyena tadapi saṃgatameva / sādhyatveneti	Bavati iti yat uktam vAdi muKyena tat api saMgatam eva / sADya tvena iti
   sādhyatvenaiva na sādhanatvenāpi / anena ca sādhyahetudṛṣṭāntābhāsānāṃ	sADya tvena eva na sADana tvena api / anena ca sADya hetu dRzwAnta ABAsAnAm
   pakṣatvavyudāsaḥ / īpsita ityanena ca noktamātrasyaivetyuktaṃ bhavati /	pakza tva vyudAsaH / IpsitaH iti anena ca na ukta mAtrasya eva iti uktam Bavati /
   icchayāpi vyāptaḥ pakṣaḥ / ityetacca parārthāścakṣurādaya ityatra	icCayA api vyAptaH pakzaH / iti etat ca para arTAH cakzuH AdayaH iti atra
   darśayiṣyāmaḥ / ityanena dharmaviśiṣṭo dharmī pakṣa ityāveditaṃ bhavati /	darSayizyAmaH / iti anena Darma viSizwaH DarmI pakzaH iti Aveditam Bavati /
   tataśca na dharmamātraṃ na dharmī kevalaḥ na svatantramubhayaṃ na ca tayoḥ	tatas ca na Darma mAtram na DarmI kevalaH na svatantram uBayam na ca tayoH
   saṃbandhaḥ kiṃtu dharmadharmiṇorviśeṣaṇaviśeṣyabhāva iti bhāvārthaḥ //	saMbanDaH kiMtu Darma DarmiNoH viSezaNa viSezya BAvaH iti BAva arTaH //
   iha coktalakṣaṇayoge satyapyaśrāvaṇaḥ śabda ityevamādīnāmapi	iha ca ukta lakzaNa yoge sati api aSrAvaNaH SabdaH iti evamAdInAm api
   pratyakṣāviruddhānāṃ pakṣatvaprāptyātivyāptirnāma lakṣaṇadoṣaḥ	pratyakza avirudDAnAm pakzatvaprAptyA ativyAptiH nAma lakzaNa dozaH
   prāpnotītyastannivṛttyarthamāha / pratyakṣādyaviruddha iti vākyaśeṣaḥ /	prApnoti ityaH tad nivRtti arTam Aha / pratyakza Adi avirudDaH iti vAkya SezaH /
   pratyakṣādibhiraviruddhaḥ / ādiśabdādanuktānumānādiparigrahaḥ / ityayaṃ	pratyakza AdiBiH avirudDaH / Adi SabdAt anukta anumAna Adi parigrahaH / iti ayam
   vākyaśeṣo vākyādhyāhāro draṣṭavya iti / udāharaṇopadarśanāyāha tadyathā /	vAkya SezaH vAkya aDyAhAraH drazwavyaH iti / udAharaNa upadarSanAya Aha tat yaTA /
   anityaḥ śabdo nityo veti / tadyathetyudāharaṇopanyāsārtham / tatra	anityaH SabdaH nityaH vA iti / tat yaTA iti udAharaNa upanyAsa arTam / tatra
   bauddhāderanityaḥ śabdo vaiyākaraṇādernitya iti / ukta sodāharaṇaḥ pakṣaḥ	bOdDa AdeH anityaH SabdaH vEyAkaraNa AdeH nityaH iti / ukta sa udAharaNaH pakzaH
   sāṃprataṃ hetumabhidhitsurāha hetustrirūpaḥ / tatra hinoti gamayati	sAMpratam hetum aBiDitsurAha hetuH trirUpaH / tatra hinoti gamayati
   jijñāsitadharmaviśiṣṭānarthāniti hetuḥ / sa ca trirūpaḥ / trīṇi rūpāṇi	jijQAsita Darma viSizwAn arTAn iti hetuH / sa ca trirUpaH / trINi rUpANi
   yasyāsau trirūpaḥ trisvabhāva ityarthaḥ / ekasya vastuno nānātvamapaśyan	yasya asO trirUpaH tri svaBAvaH iti arTaH / ekasya vastunaH nAnAtvam apaSyan
   pṛcchaka āha kiṃ punastrirūpyam / kimiti paripraśne / punariti vitarke /	pRcCakaH Aha kim punar trirUpyam / kim iti paripraSne / punar iti vitarke /
   trirūpasya bhāvastrairūpyam / evaṃ pṛcchakena pṛṣṭaḥ sannāhācāryaḥ	trirUpasya BAvaH trErUpyam / evam pRcCakena pRzwaH san= Aha AcAryaH
   pakṣadharmatvaṃ sapakṣe sattvaṃ vipakṣe cāsattvameva / asya gamanikā /	pakza Darma tvam sa pakze sattvam vipakze ca asattvam eva / asya gamanikA /
   uktalakṣaṇaḥ pakṣatasya dharmaḥ pakṣadharmastadbhāvaḥ pakṣadharmatvam /	ukta lakzaNaH pakzatasya DarmaH pakza DarmaH tad BAvaH pakza Darma tvam /
   pakṣaśabdena cātra kevalo dharmyeva 'bhidhīyate / avayave samudāyopacārāt	pakza Sabdena ca atra kevalaH DarmI A iva aBiDIyate / avayave samudAya upacArAt
   / idamekaṃ rūpam / tathā sapakṣe sattvam / sapakṣo vakṣyamāṇalakṣaṇaḥ /	/ idam ekam rUpam / taTA sa pakze sattvam / sa pakzaH vakzyamANa lakzaNaH /
   tasminsattvamastitvaṃ sāmānyena bhāva ityarthaḥ / idaṃ dvitīyaṃ rūpam /	tasmin sattvam astitvam sAmAnyena BAvaH iti arTaH / idam dvitIyam rUpam /
   tathā vipakṣe cāsattvamiti tṛtīyaṃ rūpam / vipakṣo	taTA vipakze ca asattvam iti tRtIyam rUpam / vipakzaH 
   vakṣyamāṇalakṣaṇastasminpunarasattvamevāvidyamānataiva / caśabdaḥ	vakzyamANa lakzaNaH tasmin punar asattvam eva avidyamAna tA eva / caSabdaH
   punaḥśabdārthaḥ / sa ca viśeṣārtha iti darśitameva / āha ihaivāvadhāraṇe	punar Sabda arTaH / sa ca viSeza arTaH iti darSitam eva / Aha iha eva avaDAraNe
   'bhidhānaṃ kimartham / ucyate / atraivaikāntāsattvapratipādanārtham /	aBiDAnam kim arTam / ucyate / atra eva ekAntA sattva pratipAdana arTam /
   sapakṣe tvekadeśe 'pi sattvamaduṣṭameveti / tathā ca satyekāntato	sa pakze tu eka deSe api sattvam aduzwam eva iti / taTA ca sati ekAntataH 
   vipakṣavyāvṛttāḥ sapakṣaikadeśavyāpino 'pi prayatnānantarīyakatvādayaḥ	vipakza vyAvRttAH sa pakza eka deSa vyApinaH api prayatna AnantarIyaka tva AdayaH
   samyagghetava evetyāveditaṃ bhavati // sapakṣe sattvamityādi yaduktaṃ	samyak hetavaH eva iti Aveditam Bavati // sa pakze sattvam ityAdi yat uktam
   tatra sapakṣavipakṣayoḥ svarūpamajānāno vineyaḥ pṛcchati / kaḥ punaḥ	tatra sa pakza vipakzayoH sva rUpam ajAnAnaH vineyaH pRcCati / kaH punar 
   sapakṣaḥ ko vā vipakṣa iti / ayaṃ tu praśno nigadasiddha eva / nirvacanaṃ	sa pakzaH kaH vA vipakzaH iti / ayam tu praSnaH nigada sidDaH eva / nirvacanam
   tvidaṃ sādhyadharmetyādi / asya gamanikā / ihopacāravṛttyā dharme	tu idam sADya Darma ityAdi / asya gamanikA / iha upacAra vRttyA Darme
   sādhyatvamadhikṛtyocyate / sādhyaścāsau dharmaśca sādhyadharmaḥ /	sADya tvam aDikRtya ucyate / sADyaH ca asO DarmaH ca sADya DarmaH /
   anityatvādiḥ / samānaḥ sadṛśastasya bhāvaḥ sāmānyaṃ tulyatā /	anitya tva AdiH / samAnaH sadRSaH tasya BAvaH sAmAnyam tulya tA /
   sādhyadharmasya sādhyadharmeṇa vā sāmānyaṃ sādhyadharmasāmānyam / tena	sADya Darmasya sADya DarmeNa vA sAmAnyam sADya Darma sAmAnyam / tena
   samāno 'rthaḥ sapakṣa iti / samaṃ tulyaṃ mānamasyeti samānaḥ /	samAnaH arTaH sa pakzaH iti / samam tulyam mAnam asya iti samAnaH /
   tulyamānaparicchedya iti bhāvanā / artho ghaṭādiḥ / na tu vacanamātram /	tulya mAna paricCedyaH iti BAvanA / arTaH Gawa AdiH / na tu vacana mAtram /
   samānaḥ pakṣaṃ sapakṣa iti / athavā upacāravṛttyā dharmiṇi	samAnaH pakzam sa pakzaH iti / aTavA upacAra vRttyA DarmiNi
   sādhyatvamadhikriyate /	sADya tvam aDikriyate /
   tataśca / sādhyasya dharmaḥ sādhyadharmaḥ / śeṣaṃ pūrvavat / anupacaritaṃ	tatas ca / sADyasya DarmaH sADya DarmaH / Sezam pUrvavat / anupacaritam
   tu sādhyam / dharmaviśiṣṭo dharmīti bhāvārthaḥ // sāṃprataṃ sapakṣasyaiva	tu sADyam / Darma viSizwaH DarmI iti BAva arTaH // sAMpratam sa pakzasya eva
   udāharaṇamupadarśayannāha / tadyathā anitye śabde sādhye ityādi /	udAharaNam upadarSayan= Aha / tat yaTA anitye Sabde sADye ityAdi /
   tadyathetyudāharaṇopanyāsārthaḥ / anitye śabde sādhye kim? /	tat yaTA iti udAharaNa upanyAsa arTaH / anitye Sabde sADye kim? /
   ghaṭādiranityaḥ padārthasaṃghātaḥ sapakṣaḥ / sādhyānityātvasamānatvāt //	Gawa AdiH anityaH padArTa saMGAtaH sa pakzaH / sADya anityAtva samAna tvAt //
   adhunā vipalakṣaṇapratipādanāyāha / vipakṣo yatra sādhyaṃ nāsti /	aDunA vipalakzaNa pratipAdanAya Aha / vipakzaH yatra sADyam na asti /
   visadṛśaḥ pakṣo vipakṣaḥ / sa kīdṛgiti svarūpato darśayati / yatra	visadRSaH pakzaH vipakzaH / sa kIdRS iti svarUpataH darSayati / yatra
   yasminnarthe / sādhanīyaṃ sādhyam / nāsti na vidyate / iha ca	yasmin= arTe / sADanIyam sADyam / na asti na vidyate / iha ca
   sādhyapratibandhatvāt sādhanasya tadapi nāstīti gamyate / udāharaṇaṃ	sADya pratibanDa tvAt sADanasya tat api na asti iti gamyate / udAharaNam
   darśayati / yathā yannityamityādi / tatra yannityamiti kimuktaṃ bhavati? /	darSayati / yaTA yat nityam ityAdi / tatra yat nityam iti kim uktam Bavati? /
   yadanityaṃ na bhavati tadakṛtakaṃ dṛṣṭamiti / tatkṛtakamapi na dṛṣṭam	yat anityam na Bavati tat akRtakam dRzwam iti / tat kRtakam api na dRzwam
   yathākāśamiti / tatra hi sādhyabhāvāt sādhanābhāvaḥ / sāṃprataṃ	yaTA AkASam iti / tatra hi sADya BAvAt sADana aBAvaH / sAMpratam
   vicitratvādavadhāraṇavidheḥ vipakṣadharmatvādiṣu tamupadarśayannāha /	vicitra tvAt avaDAraNa viDeH vipakza Darma tva Adizu tam upadarSayan= Aha /
   tatra kṛtakatvamityādi / tatreti pūrvavat / kṛtakatvaṃ	tatra kRtaka tvam ityAdi / tatra iti pUrvavat / kRtaka tvam
   prayatnānantarīyakatvaṃ vā anityādau heturiti yogaḥ / tatra kriyate iti	prayatna AnantarIyaka tvam vA anitya AdO hetuH iti yogaH / tatra kriyate iti
   kṛtakaḥ / apekṣitaparavyāpāro hi bhāvaḥ svabhāvaniṣpattau kṛtaka iti /	kRtakaH / apekzita para vyApAraH hi BAvaH svaBAva nizpattO kRtakaH iti /
   tadbhāvaḥ kṛtakatvam / prayatnāntarīyakatvaṃ vā iti / prayatnaścetanāvato	tad BAvaH kRtaka tvam / prayatna antarIyaka tvam vA iti / prayatnaH cetanAvataH 
   vyāpāraḥ / tasya prayatnānantaraṃ tatra bhāvo jāta iti vā	vyApAraH / tasya prayatna anantaram tatra BAvaH jAtaH iti vA
   prayatnānantarīyaḥ / sa eva prayatnānantarīyakaḥ / tadbhāvaḥ	prayatna AnantarIyaH / saH eva prayatna AnantarIyakaH / tad BAvaH
   prayatnānantarīyakatvam /	prayatna AnantarIyaka tvam /
   vāśabdaḥ caśabdārthaḥ / sa ca samuccaye / dvitīyahetvabhidhānaṃ	vA SabdaH caSabda arTaH / sa ca samuccaye / dvitIya hetu aBiDAnam
   vipakṣavyāvṛttaḥ / sapakṣaikadeśavṛttirapi samyaggheturyathā / yameveti	vipakza vyAvRttaH / sa pakza eka deSa vRttiH api samyak hetuH yaTA / yam eva iti
   darśanārthatvādaduṣṭamiti / ayaṃ ca hetuḥ kiṃ pakṣadharma eva na tu	darSana arTa tvAt aduzwam iti / ayam ca hetuH kim pakza DarmaH eva na tu
   pakṣasyaiva dharmaḥ / ayogavyavacchedamātraphalatvādavadhāraṇasya / yathā	pakzasya eva DarmaH / ayoga vyavacCeda mAtra Pala tvAt avaDAraNasya / yaTA
   caitro dhanurdhara eva / anena cāsiddhānāṃ caturṇāmasādhāraṇasya ca	cEtraH DanurDaraH eva / anena ca asidDAnAm caturNAm asADAraNasya ca
   vyāvṛttiḥ / tathā saphala evāstvanyayogavyavacchedaḥ yathā pārtha eva	vyAvRttiH / taTA saPale eva astu anya yoga vyavacCedaH yaTA pArTaH eva
   dhanurdharaḥ / anena tu sādhāraṇādīnāṃ navānāmapi hetvābhāsānāṃ vyāvṛttiḥ	DanurDaraH / anena tu sADAraNa AdInAm navAnAm api hetvABAsAnAm vyAvRttiH
   / āha / yadi sapakṣa evāsti tataśca tadvyatirekeṇānyatra pakṣe 'pyabhāvāt	/ Aha / yadi sa pakzaH eva asti tatas ca tad vyatirekeNa anyatra pakze api aBAvAt 
   dharmatvānupapattiḥ / na anavadhṛtāvadhāraṇāt /	Darma tva anupapattiH / na anavaDRta avaDAraNAt /
   pakṣadharmatvasyāvadhāritvāt / āha / yadyevaṃ vipakṣe nāsti eveti	pakza Darma tvasya avaDAri tvAt / Aha / yadi evam vipakze na asti eva iti
   tṛtīyamavadhāraṇaṃ kimartham? / ucyate / prayogopadarśanārtham / uktaṃ ca	tRtIyam avaDAraNam kim arTam? / ucyate / prayoga upadarSana arTam / uktam ca
   / anvayavyatirekayorekamapi rūpamuktaṃ kathaṃ nu nāma dvitīyasyākṣepakaṃ	/ anvaya vyatirekayoH ekam api rUpam uktam kaTam nu nAma dvitIyasya Akzepakam
   syāditi / prabhūtamatra vaktavyaṃ tattu nocyate / granthavistarabhayāt /	syAt iti / praBUtam atra vaktavyam tat tu na ucyate / granTa vistara BayAt /
   gamanikāmātnametat / anityādau heturityatrādigrahaṇāt duḥkhādiparigrahaḥ /	gamanikA mAtnam etat / anitya AdO hetuH iti atra Adi grahaNAt duHKa Adi parigrahaH /
   ityukto hetuḥ // sāṃprataṃ dṛṣṭāntamabhidhitsurāha / dṛṣṭānta ityādi /	iti uktaH hetuH // sAMpratam dRzwAntam aBiDitsuH Aha / dRzwAntaH ityAdi /
   dṛṣṭaṃ tatrārthaṃ antaṃ nayatīti dṛṣṭāntaḥ / pramāṇopalabdhameva	dRzwam tatra arTam antam nayati iti dRzwAntaH / pramANa upalabDam eva
   vipratipattau saṃvedananiṣṭhāṃ nayatītyarthaḥ / sa ca dvividhaḥ / dve	vipratipattO saMvedana nizWAm nayati iti arTaH / sa ca dviviDaH / dve
   vidhe yasya sa dvividhastadeva dvaividhyam / darśayati sādharmyeṇa	viDe yasya sa dviviDaH tat eva dvEviDyam / darSayati sADarmyeNa
   vaidharmyeṇa ca / samāno dharmo yasyāsau sadharmā sadharmaṇo bhāvaḥ	vEDarmyeNa ca / samAnaH DarmaH yasya asO saDarmA saDarmaNaH BAvaH
   sādharmyaṃ tena / visadṛśo dharmo yasyāsau vidharmā vidharmaṇo bhāvaḥ	sADarmyam tena / visadRSaH DarmaH yasya asO viDarmA viDarmaNaH BAvaH
   vaidharmyaṃ tena / caśabdaḥ samuccaye / tatra sādharmyeṇa tāvaditi /	vEDarmyam tena / caSabdaH samuccaye / tatra sADarmyeNa tAvat iti /
   tāvacchabdaḥ kramārthaḥ / yatreti / abhidheyahetoruktalakṣaṇasya sapakṣa	tAvat SabdaH krama arTaH / yatra iti / aBiDeya hetoH ukta lakzaNasya sa pakza
   evāstitvaṃ khyāpyate / sapakṣa uktalakṣaṇastasmiṃścāstitvaṃ vidyamānatvaṃ	eva astitvam KyApyate / sa pakzaH ukta lakzaNaH tasmin= ca astitvam vidyamAna tvam
   khyāpyate pratipādyate vacanena / taccedam / yatkṛtakaṃ tadanityaṃ yathā	KyApyate pratipAdyate vacanena / tat ca idam / yat kRtakam tat anityam yaTA
   ghaṭādiḥ iti sugamam / anena sādhanadṛṣṭāntābhāsaḥ / vaidharmyeṇāpi /	Gawa AdiH iti sugamam / anena sADana dRzwAnta ABAsaH / vEDarmyeNa api /
   yatra sādhyābhāve hetorabhāva eva kathyate / yatretyabhidheye / sādhyaṃ	yatra sADya aBAve hetoH aBAvaH eva kaTyate / yatra iti aBiDeye / sADyam
   anityatvādi tasyābhāve hetoḥ kṛtakatvādeḥ / kim? / abhāva eva kathyate	anitya tva Adi tasya aBAve hetoH kRtaka tva AdeH / kim? / aBAvaH eva kaTyate
   pratipādyate vacanena / taccedamudāharaṇaṃ darśayati / yannityaṃ	pratipAdyate vacanena / tat ca idam udAharaNam darSayati / yat nityam
   tadakṛtakaṃ dṛṣṭaṃ yathākāśamiti sugamam / āha / na saugatānāṃ nityaṃ nāma	tat akRtakam dRzwam yaTA AkASam iti sugamam / Aha / na sOgatAnAm nityam nAma
   kiṃcidasti / tadabhāvāt kathaṃ vaidharmyadṛṣṭānta ityucyate? /	kiMcid asti / tad aBAvAt kaTam vEDarmya dRzwAntaH iti ucyate? /
   nityaśabdenātranityatvasyābhāva ucyate / atreti prayoge dṛṣṭāntavākye vā /	nitya Sabdena atra nitya tvasya aBAvaH ucyate / atra iti prayoge dRzwAnta vAkye vA /
   kiṃ nityaśabdena anityasvasyābhāva ucyate? / anityo na bhavatīti nityaḥ /	kim nitya Sabdena anitya svasya aBAvaH ucyate? / anityaH na Bavati iti nityaH /
   akṛtakaśabdenāpi kṛtakatvasyābhāvaḥ ucyate / iti ca vartate / kṛtakau na	akRtaka Sabdena api kRtaka tvasya aBAvaH ucyate / iti ca vartate / kRtakO na
   bhavatītyakṛtakaḥ / na tu vastu sannityamakṛtakaṃ vāsti /	Bavati iti akRtakaH / na tu vastu sannityam akRtakam vA asti /
   atraivodāharaṇamāha / yathā bhāvābhāvo 'bhāvaḥ / yathetyaupamye / bhāvaḥ	atra eva udAharaNam Aha / yaTA BAva aBAvaH aBAvaH / yaTA iti Opamye / BAvaH
   sattā tasyābhāvo bhāvābhāvaḥ / asāvabhāva ucyate / na tu bhāvādanyo 'bhāvo	sattA tasya aBAvaH BAva aBAvaH / asO= aBAvaH ucyate / na tu BAvAt anyaH aBAvaH 
   nāma vastusvarūpo 'sti evaṃ nityaśabdenātretyādi dārṣṭāntike 'pi	nAma vastu svarUpaH asti evam nitya Sabdena atra ityAdi dArzwa antike api
   bhāvitameva // uktāḥ pakṣādayaḥ //	BAvitam eva // uktAH pakza AdayaH //
   saha pakṣeṇa viṣayabhūtena hetudṛṣṭāntā ityarthaḥ / eṣāṃ vacanāni /	saha pakzeNa vizaya BUtena hetu dRzwAntAH iti arTaH / ezAm vacanAni /
   eṣāmiti pakṣopalakṣitānāṃ hetudṛṣṭāntānām / vacanāni ye vācakāḥ śabdāḥ /	ezAm iti pakza upalakzitAnAm hetu dRzwAntAnAm / vacanAni ye vAcakAH SabdAH /
   kim? / parapratyāyanakāle prāsnikapratyāyanakāle sādhanam / yathā	kim? / para pratyAyana kAle prAsnika pratyAyana kAle sADanam / yaTA
   prayogato darśayati / yathā anityaḥ śabdaḥ iti pakṣavacanam /	prayogataH darSayati / yaTA anityaH SabdaH iti pakza vacanam /
   kṛtakatvāditi pakṣadharmavacanam / yat kṛtakaṃ tadanityaṃ dṛṣṭaṃ yathā	kRtaka tvAt iti pakza Darma vacanam / yat kRtakam tat anityam dRzwam yaTA
   ghaṭādiriti sapakṣānugamavacanam / yannityaṃ tadakṛtakaṃ dṛṣṭaṃ	GawAdiH iti sa pakza anugama vacanam / yat nityam tat akRtakam dRzwam
   yathākāśamiti vyatirekavacanam / iti nigadasiddham / yāvat etānyeva trayo	yaTA AkASam iti vyatireka vacanam / iti nigada sidDam / yAvat etAni eva trayaH 
   'vayavā ityucyante / etānyeva pakṣahetudṛṣṭāntānāṃ vacanāni / traya iti	avayavAH iti ucyante / etAni eva pakza hetu dRzwAntAnAm vacanAni / trayaH iti
   saṃkhyā / avayavā ityucyante / pūrvācāryāṇāṃ saṃjñāntarametat / yathoktaṃ	saMKyAH / avayavAH iti ucyante / pUrva AcAryANAm saMjQA antaram etat / yaTA uktam
   sādhanamavayavāḥ //	sADanam avayavAH //
   uktaṃ sādhanam / adhunā tadābhāsa ucyate / tatrāpi pakṣādivacanāni	uktam sADanam / aDunA tad ABAsaH ucyate / tatra api pakza Adi vacanAni
   sādhanamiti pakṣasyopalakṣaṇatvātprathamaṃ pakṣa uktaḥ / ihāpi pakṣābhāsa	sADanam iti pakzasya upalakzaNa tvAt praTamam pakzaH uktaH / iha api pakza ABAsa
   evocyate sādhayitumityadi / sādhayitumiṣṭo 'pi pakṣādiviruddhaḥ	eva ucyate sADayitum ityadi / sADayitum izwaH api pakza Adi virudDaH
   pakṣābhāsaḥ / sisādhayiṣayā vāñchitaḥ apiśabdātprasiddho dharmītyādi	pakza ABAsaH / sisA DayizayA vAQCitaH api SabdAt prasidDaH DarmI ityAdi
   tadanyalakṣaṇayukto 'pi / kim? / pratyakṣādiviruddhaḥ / virudhyate sa	tad anya lakzaNa yuktaH api / kim? / pratyakza Adi virudDaH / viruDyate sa
   viruddhaḥ / pratyakṣādayo vakṣyamāṇalakṣaṇāstairviruddho nirākṛtaḥ	virudDaH / pratyakza AdayaH vakzyamANa lakzaNAH tEH virudDaH nirAkRtaH
   pratyakṣādiviruddhaḥ / kim? / pakṣābhāsaḥ / tasyātroktalakṣaṇaḥ pakṣaḥ	pratyakza Adi virudDaH / kim? / pakza ABAsaH / tasya atra ukta lakzaNaH pakzaH
   ābhāsanamābhāsaḥ ākāramātram / pakṣasyevābhāso yasyāsau pakṣābhāsaḥ	ABAsanam ABAsaH AkAra mAtram / pakzasya iva ABAsaH yasya asO pakza ABAsaH
   pakṣākāramātram / na tu samyak pakṣa ityarthaḥ /	pakza AkAra mAtram / na tu samyak pakzaH iti arTaH /
   tadyathetyudāharaṇopanyāsārthaḥ / pratyakṣaviruddha ityādi / pratyakṣaṃ	tat yaTA iti udAharaNa upanyAsa arTaH / pratyakza virudDaH ityAdi / pratyakzam
   vakṣyamāṇalakṣaṇam / iha punaḥ pratyakṣaśabdena tatparicchinno dharmaḥ	vakzyamANa lakzaNam / iha punar pratyakza Sabdena tad paricCinnaH DarmaH
   parigṛhyate śālikuḍavanyāyāt / tataśca prasiddharmadharmaśabdalopāt	parigRhyate SAli kuxava nyAyAt / tatas ca prasidDarma Darma Sabda lopAt 
   pratyakṣaprasiddhadharmaviruddhaḥ pratyakṣaviruddhaḥ /	pratyakza prasidDa Darma virudDaH pratyakza virudDaH /
   evamanumānaviruddhaḥ āgamalokasvavacanaviruddhāśceti bhāvanīyamiti /	evam anumAna virudDaH Agama loka sva vacana virudDAH ca iti BAvanIyam iti /
   aprasiddhiviśeṣaṇādiśabdārthamudāharaṇanirūpaṇāyāmeva vakṣyāmaḥ /	aprasidDi viSezaNa Adi Sabda arTam udAharaNa nirUpaNAyAm eva vakzyAmaH /
   sāṃpratamudāharaṇāni darśayati / tatra pratyakṣaviruddhaḥ ityuddeśaḥ /	sAMpratam udAharaNAni darSayati / tatra pratyakza virudDaH iti uddeSaH /
   yathā aśrāvaṇaḥ śabdaḥ ityudāharaṇam / atra śabdo dharmī / aśrāvaṇatvaṃ	yaTA aSrAvaNaH SabdaH iti udAharaNam / atra SabdaH DarmI / aSrAvaNa tvam
   sādhyadharmaḥ / ayaṃ ca sādhyamānastatraiva dharmiṇi pratyakṣaprasiddhena	sADya DarmaH / ayam ca sADyamAnaH tatra eva DarmiNi pratyakza prasidDena
   śrāvaṇatvena virudhyate iti pratyakṣaviruddhaḥ / āha / śrāvaṇatvaṃ	SrAvaNa tvena viruDyate iti pratyakza virudDaH / Aha / SrAvaNa tvam
   sāmānyalakṣaṇatvātpratyakṣagamyameva na bhavati kathaṃ	sAmAnya lakzaNa tvAt pratyakza gamyam eva na Bavati kaTam
   pratyakṣaprasiddhadharmaviruddhaḥ? iti / atrocyate / bhāvapratyayena	pratyakza prasidDa Darma virudDaH? iti / atra ucyate / BAva pratyayena
   svarūpamātrābhidhānātsāmānyalakṣaṇatvānupapatteradoṣa iti / atra ca bahu	sva rUpa mAtra aBiDAnAt sAmAnya lakzaNa tva anupapatteH adozaH iti / atra ca bahu
   vaktavyaṃ tattu nocyate / akṣaragamanikāmāphalatvātprayāsasya //	vaktavyam tat tu na ucyate / akzara gama nikAmA Pala tvAt prayAsasya //
   anumānaviruddho yathā / nityo ghaṭa iti / atra ghaṭo dharmī / nityatvaṃ	anumAna virudDaH yaTA / nityaH GawaH iti / atra GawaH DarmI / nitya tvam
   sādhyadharmaḥ / sa cānumānaprasiddhenānityatvena tatraiva dharmiṇi	sADya DarmaH / sa ca anumAna prasidDena anitya tvena tatra eva DarmiNi
   bādhyate / anumānaṃ cedam / anityo ghaṭaḥ kāraṇādhīnātmalābhatvāt	bADyate / anumAnam ca idam / anityaH GawaH kAraNa aDIna Atma lABa tvAt 
   pradipavat // āgamaviruddho yathā / vaiśeṣikasya nityaḥ śabda iti	pradipa vat // Agama virudDaH yaTA / vESezikasya nityaH SabdaH iti
   sādhayataḥ / vaiśeṣiko 'hamityevaṃ pakṣaparigrahaṃ kṛtvā yadā śabdasya	sADayataH / vESezikaH aham iti evam pakza parigraham kRtvA yadA Sabdasya
   nityatvaṃ pratijānite tadāgamavirūddhaḥ / yatastasyāgame śabdasyānityatvaṃ	nitya tvam pratijAnite tad Agama virUdDaH / yatas tasya Agame Sabdasya anitya tvam
   prasiddham / uktaṃ ca buddhimatpūrvā vākyakṛtirvede tadvacanādāmnāyasya	prasidDam / uktam ca budDimat pUrvA vAkya kRtiH vede tad vacanAt AmnAyasya
   prāmāṇyamityādi // lokaviruddho yathā / śuci naraśiraḥkapālaṃ	prAmANyam ityAdi // loka virudDaH yaTA / Suci nara SiraH kapAlam
   prāṇyaṅgatvāt śaṅkhaśuktivat iti / atra naraśiraḥkapālaṃ	prANi aFga tvAt SaFKa Sukti vat iti / atra nara SiraH kapAlam
   dharmitvenopādayite / śucitvaṃ sādhyadharmaḥ / sa ca sādhyamānastatraiva	Darmi tvena upAdayite / Suci tvam sADya DarmaH / sa ca sADyamAnaH tatra eva
   dharmiṇi lokaprasiddhaśucitvena nirākriyata iti / āha / iha	DarmiNi loka prasidDa Suci tvena nirAkriyate iti / Aha / iha
   hetudṛṣṭāntopādānaṃ kimarthamucyate? / lokasthiterbalīyastvakhyāpanārtham	hetu dRzwAnta upAdAnam kim arTam ucyate? / loka sTiteH balIyaH tu aKyApana arTam
   / nānumānenāpi lokaprasiddhirbādhyata ityarthaḥ // svavacanaviruddho yathā	/ na anumAnena api loka prasidDiH bADyate iti arTaH // sva vacana virudDaH yaTA
   / mātā me vandhyā iti / iha ca mātā sādhyadharmitvenopāttā / vandhyeti ca	/ mAtA me vanDyAH iti / iha ca mAtA sADya Darmi tvena upAttA / vanDyA iti ca
   sādhyadharmaḥ / sa ca sādhyamānastatraiva dharmiṇi svavacanaprasiddhena	sADya DarmaH / sa ca sADyamAnaH tatra eva DarmiNi sva vacana prasidDena
   mātṛtvena viruddhyate / virodhaśca mātṛśabdena prasavadharmiṇī vanitocyate	mAtR tvena virudDyate / viroDaH ca mAtR Sabdena prasava DarmiNI vanitA ucyate
   vandhyāśabdena tadviparītā / tataśca yadi mātā kathaṃ vandhyā? vandhyā	vanDyA Sabdena tad viparItA / tatas ca yadi mAtA kaTam vanDyA? vanDyA
   cetkathaṃ māteti? // tathā aprasiddhaviśeṣaṇo yathā / bauddhasya sāṃkhyaṃ	ced kaTam mAtA iti? // taTA aprasidDa viSezaNaH yaTA / bOdDasya sAMKyam
   prati vināśī śabde iti / na prasiddhamaprasiddham / viśiṣyate aneneti	prati vinASI Sabde iti / na prasidDam aprasidDam / viSizyate anena iti
   viśeṣaṇaṃ sādhyadharmalakṣaṇam / tataścāprasiddhaṃ viśeṣaṇaṃ yasmin sa	viSezaNam sADya Darma lakzaNam / tatas ca aprasidDam viSezaNam yasmin sa
   tathāvidhaḥ / evaṃ śeṣepyakṣaragamanikā kāryeti / atra ca śabda iti	taTAviDaH / evam Sezepi akzara gamanikA kAryA iti / atra ca SabdaH iti
   nirdeśaḥ / vināśīti sādhyadharmaḥ / ayaṃ ca bauddhasya sāṃkhyaṃ prati	nirdeSaH / vinASI iti sADya DarmaH / ayam ca bOdDasya sAMKyam prati
   aprasiddhiviśeṣaṇaḥ / na hi tasya siddhānte kiṃcidvinaśvaramasti / yata	aprasidDi viSezaNaH / na hi tasya sidDAnte kiMcid vinaSvaram asti / yata
   uktam  tadetatrailokyaṃ vyakterapaiti nityatvapratiṣedhāt / apetamapyasti	uktam tat etatrElokyam vyakteH apEti nitya tva pratizeDAt / apetam api asti
   vināśapratiṣedhādityādi [yāgasūtra  3, 13 vyāsabhāṣya] / āha / yadyevaṃ na	vinASa pratizeDAt ityAdi [yAga sUtra 3, 13 vyAsa BAzya] / Aha / yadi evam na
   kaścitpakṣābhāso nāmāsti / tathāhi  vipratipattau iṣṭārthasiddhye	kaScid pakza ABAsaH nAma asti / taTA hi vipratipattO izwa arTa sidDye
   'numānaprayogaḥ / vipratipattireva caitaddoṣakartrīti kṛto 'numānam /	anumAna prayogaH / vipratipattiH eva ca etat dozakartrI iti kRtaH anumAnam /
   atrocyate / na vipratipattimātraṃ taddoṣakartṛ yuktiviruddhatvāt /	atra ucyate / na vipratipatti mAtram tad doza kartR yukti virudDa tvAt /
   tathāhi  upapattibhirdṛṣṭāntasādhane kṛte 'numānaprayogaḥ iṣṭārthasiddhaye	taTA hi upapattiBiH dRzwAnta sADane kRte anumAna prayogaH izwa arTa sidDaye
   bhavati / nānyathā / punaḥ sādhanāpekṣatvāt / ato dṛṣṭāntaṃ prasādhya	Bavati / na anyaTA / punar sADana apekza tvAt / atas dRzwAntam prasADya
   prayogaḥ kartavya iti / aprasādhite tu pakṣābhāsaḥ / iti kṛta prasaṅgena	prayogaH kartavyaH iti / aprasADite tu pakza ABAsaH / iti kRta prasaFgena
   // tathā aprasiddhaviśeṣyo yathā sāṃkhyasya bauddhaṃ prati cetana ātmeti /	// taTA aprasidDa viSezyaH yaTA sAMKyasya bOdDam prati cetanaH AtmA iti /
   tatra viśeṣyo dharmītyanarthāntaram / iha cātmā dharmī / cetanatvaṃ	tatra viSezyaH DarmI iti anarTa antaram / iha ca AtmA DarmI / cetana tvam
   sādhyadharmaḥ / iti pakṣaḥ sāṃkhyasya bauddhaṃ prati aprasiddhaviśeṣyaḥ /	sADya DarmaH / iti pakzaH sAMKyasya bOdDam prati aprasidDa viSezyaH /
   ātmano 'prasiddhatvāt / sarve dharmā nirātmāna ityabhyupagamāt /	AtmanaH aprasidDa tvAt / sarve DarmAH nirAtmAnaH iti aByupagamAt /
   ākṣepaparihārau pūrvavat // tathā aprasiddhobhayo yathā / vaiśeṣikasya	Akzepa parihArO pUrvavat // taTA aprasidDa uBayaH yaTA / vESezikasya
   bauddhaṃ prati sukhādisamavāyikāraṇamātmā iti / ubhayaṃ dharmadharmiṇau /	bOdDam prati suKa Adi samavAyi kAraNam AtmA iti / uBayam Darma DarmiNO /
   tatrātmā dharmī / sukhādisamavāyikāraṇatvaṃ sādhyadharmaḥ / vaiśeṣikasya	tatra AtmA DarmI / suKa Adi samavAyi kAraNa tvam sADya DarmaH / vESezikasya
   hi kāraṇatrayātkāryaṃ bhavati / tadyathā  samavāyikāraṇāt asamavāyikāraṇāt	hi kAraNa trayAt kAryam Bavati / tat yaTA samavAyi kAraNAt asamavAyi kAraNAt
   nimittakāraṇācca / tathāhi  tantavaḥ paṭasya samacāyikāraṇaṃ tantusaṃyogo	nimitta kAraNAt ca / taTA hi tantavaH pawasya sama cAyi kAraNam tantu saMyogaH 
   'samavāyikāraṇaṃ turīvemādayastu nimittakāraṇam / itthamātmā	asamavAyi kAraNam turI vema AdayaH tu nimitta kAraNam / itTam AtmA
   sukhaduḥkhecchādīnāṃ samavāyikāraṇam / ātmamanaḥsaṃyogo 'samavāyikāraṇam /	suKa duHKa icCA AdInAm samavAyi kAraNam / Atma manaH saMyogaH asamavAyi kAraNam /
   srakcandanādayo nimittakāraṇam / ityevaṃ vaiśeṣikasya bauddhaṃ prati	sraj candana AdayaH nimitta kAraNam / iti evam vESezikasya bOdDam prati
   aprasiddhobhayaḥ / na tasyātmā viśeṣyaḥ siddho nāpi samavāyikāraṇaṃ	aprasidDa uBayaH / na tasya AtmA viSezyaH sidDaH na api samavAyi kAraNam
   viśeṣaṇam / sāmagryā eva janakatvābhyupagamāt / ākṣepaparihārau pūrvavat	viSezaNam / sAmagryAH eva janakatvA aByupagamAt / Akzepa parihArO pUrvavat 
   // tathā prasiddhasaṃbandho yathā śrāvaṇaḥ śabda iti / prasiddho	// taTA prasidDa saMbanDaH yaTA SrAvaNaH SabdaH iti / prasidDaH 
   vādiprativādinoravipratipattyā sthitaḥ saṃbandho dharmadharmilakṣaṇo	vAdi prativAdinA UH avipratipattyA sTitaH saMbanDaH Darma Darmi lakzaNaH 
   yasmin sa tathāvidhaḥ / iha śabdo dharmī śrāvaṇatvaṃ sādhyadharmaḥ /	yasmin sa taTAviDaH / iha SabdaH DarmI SrAvaNa tvam sADya DarmaH /
   ubhayaṃ caitat vādiprativādinoḥ prasiddham / eṣāṃ vacanāni ityādi /	uBayam ca etat vAdi prativAdinoH prasidDam / ezAm vacanAni ityAdi /
   eṣāmiti navānāmapi paramārśaḥ / vacanāni / pratijñādoṣā iti saṃbandhaḥ	ezAm iti navAnAm api paramArSaH / vacanAni / pratijQA dozAH iti saMbanDaH
   kāraṇamāha / dharmasvarūpanirākaraṇamukhena pañcānāmādyānām / svaṃ ca	kAraNam Aha / Darma svarUpa nirAkaraNa muKena paQcAnAm AdyAnAm / svam ca
   tadrūpaṃ ca svarūpamityarthaḥ / nirākriyate 'neneti nirākarotīti vā	tad rUpam ca svarUpam iti arTaH / nirAkriyate anena iti nirAkaroti iti vA
   nirākaraṇam / pratiṣedhanamityarthaḥ / dharmasvarūpasya nirākaraṇaṃ	nirAkaraNam / pratizeDanam iti arTaH / Darma svarUpasya nirAkaraNam
   tattathā mukhamiva mukhaṃ dvāramiti bhāvaḥ / dharmasvarūpanirākaraṇameva	tat taTA muKam iva muKam dvAram iti BAvaH / Darma svarUpa nirAkaraNam eva
   mukhaṃ tena dharmasvarūpanirākaraṇamukhena	muKam tena Darma svarUpa nirAkaraNa muKena
   dharmayāthātmyapratiṣedhadvāreṇetyarthaḥ / pratiṣidhyate cāśrāvaṇaḥ śabdaḥ	Darma yATAtmya pratizeDa dvAreNa iti arTaH / pratiziDyate ca ASrAvaNaH SabdaH
   / ityevamādiṣu pañcasu pratyakṣādiprasiddhaṃ dharmayāthātmyamiti bhāvanā /	/ iti evamAdizu paQcasu pratyakza Adi prasidDam Darma yATAtmyam iti BAvanA /
   tathā pratipādanāsaṃbhavatastrayāṇām / tatra pratipādyate 'nena	taTA pratipAdana asaMBavataH trayANAm / tatra pratipAdyate anena
   pratipādayatīti vā pratipādanam / paramapratyāyanamiti hṛdayam /	pratipAdayati iti vA pratipAdanam / parama pratyAyanam iti hRdayam /
   tasyāsaṃbhavaḥ pratipādanāsaṃbhavaḥ tasmāt pratipādanāsaṃbhavataḥ / na ca	tasya asaMBavaH pratipAdana asaMBavaH tasmAt pratipAdana asaMBavataH / na ca
   dṛṣṭāntādyapratipattau pratipādanaṃ saṃbhavati / tathā	dRzwAnta Adya pratipattO pratipAdanam saMBavati / taTA
   sādhanavaiphalyataścaikasya / viphalasya bhāvo vaiphalyaṃ sādhanasya	sADana vEPalyataH ca ekasya / viPalasya BAvaH vEPalyam sADanasya
   vaiphalyaṃ sādhanavaiphalyaṃ tasmātsādhanavaiphalyataḥ / ca samuccaye /	vEPalyam sADana vEPalyam tasmAt sADana vEPalyataH / ca samuccaye /
   tataśca eṣāṃ vacanāni / pratijñādoṣāḥ / pratijñāpakṣa ityanarthāntaram /	tatas ca ezAm vacanAni / pratijQA dozAH / pratijQA pakzaH iti anarTAntaram /
   doṣābhāsa iti ca tulyam / ityabhihitāḥ pakṣābhāsāḥ //	doza ABAsaH iti ca tulyam / iti aBihitAH pakza ABAsAH //
   sāṃprataṃ hetvābhāsānabhidhitsurāha / asiddhānaikāntikaviruddhā	sAMpratam hetvABAsAn aBiDi tsuH Aha / asidDa anEkAntika virudDA
   hetvābhāsāḥ / asiddhaśca anaikāntikaśca viruddhaśca	hetvABAsAH / asidDaH ca anEkAntikaH ca virudDaH ca
   asiddhānaikāntikaviruddhāḥ / hetuvadābhāsante iti hetvābhāsāḥ /	asidDa anEkAntika virudDAH / hetu vat ABAsante iti hetvABAsAH /
   yathoddeśaṃ nirdeśa iti nyāyamaṅgīkṛtyāsiddhapratipipādayiṣayāha /	yaToddeSam nirdeSaH iti nyAyam aFgIkRtya asidDa pratipipAdayizayA Aha /
   tatrāsiddhaścatuḥprakāraḥ / tatra eṣu asiddhādiṣu / asiddhaḥ sidhyati sa	tatra asidDaH catur prakAraH / tatra ezu asidDa Adizu / asidDaH siDyati sa
   siddhaḥ pratītaḥ na siddhaḥ asiddhaḥ apratītaḥ / catuḥprakāraścaturbhedaḥ	sidDaH pratItaH na sidDaH asidDaH apratItaH / catur prakAraH catur BedaH
   / prakārāndarśayati / tadyathā / ubhayāsiddha ityādi / tadyatheti pūrvavat	/ prakArAn darSayati / tat yaTA / uBaya asidDaH ityAdi / tat yaTA iti pUrvavat 
   / ubhayorvādiprativādinoḥ asiddha ubhayāsiddhaḥ // anyatarasya vādinaḥ	/ uBayoH vAdi prativAdinoH asidDaH uBaya asidDaH // anyatarasya vAdinaH
   prativādino vā asiddha anyatarāsiddhaḥ // saṃdihyate sa saṃdigdhaḥ /	prativAdinaH vA asidDa anyatara asidDaH // saMdihyate sa saMdigDaH /
   saṃdigdhatvādevāsiddhaḥ saṃdigdhasiddhaḥ // āśrayo dharmī so 'siddho	saMdigDa tvAt eva asidDaH saMdigDa sidDaH // ASrayaH DarmI saH asidDaH 
   yasyāsau āśrayāsiddhaḥ / ca samuccaye / itiśabdaḥ parisamāptyarthaḥ //	yasya asO ASraya asidDaH / ca samuccaye / iti SabdaH parisamApti arTaH //
   idānīmudāharaṇānyāha / tatra śabdānityatve ityādi / tatreti pūrvavat /	idAnIm udAharaNAni Aha / tatra Sabda anitya tve ityAdi / tatra iti pUrvavat /
   śabdānityatve sādhye anityaḥ śabdaḥ ityetasmin cākṣuṣatvāditi /	Sabda anitya tve sADye anityaH SabdaH iti etasmin cAkzuza tvAt iti /
   cakṣurindriyagrāhyaścākṣuṣastadbhāvaścākṣuṣatvam / tasmādityayaṃ	cakzuH indriya grAhyaH cAkzuzaH tad BAvaH cAkzuza tvam / tasmAt iti ayam
   heturubhayāsiddhaḥ / tathāhi  cākṣuṣatvaṃ na vādinaḥ prasiddhaṃ nāpi	hetuH uBaya asidDaH / taTA hi cAkzuza tvam na vAdinaH prasidDam na api
   prativādinaḥ / śrotrendriyagrāhyatvācchabdasya // kṛtakatvāditi	prativAdinaH / Srotra indriya grAhya tvAt Sabdasya // kRtaka tvAt iti
   śabdābhivyaktivādinaṃ prati anyatarāsiddhaḥ / śabdanityatve sādhye iti /	Sabda aBivyakti vAdinam prati anyatara asidDaH / Sabda nitya tve sADye iti /
   vartate kṛtakatvādityayaṃ hetuḥ śabdābhivyaktivādinaṃ mīmāṃsakaṃ kāpilaṃ	vartate kRtaka tvAt iti ayam hetuH Sabda aBivyakti vAdinam mImAMsakam kApilam
   vā pratyanyatarāsiddhaḥ / tathāhi  na tasya tālvoṣṭhapuṭādibhiḥ kriyate	vA pratyanyatara asidDaH / taTA hi na tasya tAlu ozWa puwa AdiBiH kriyate
   śabdaḥ kiṃtvabhivyajyata iti // tathā bāṣpādibhāvenetyādi / bāṣpo	SabdaH kiMtu aBivyajyate iti // taTA bAzpa Adi BAvena ityAdi / bAzpaH 
   jalādiprabhavaḥ sa ādiryasya reṇuvartyādeḥ sa bāṣpādistasya bhāvaḥ sattā	jala Adi praBavaH saH AdiH yasya reNu varti AdeH sa bAzpa AdiH tasya BAvaH sattA
   tena bāṣpādibhāvena / saṃdihyamānaḥ kimayaṃ dhūma uta bāṣpa uta	tena bAzpa Adi BAvena / saMdihyamAnaH kim ayam DUmaH uta bAzpaH uta
   reṇuvartiriti saṃdehamāpadyamānaḥ / bhūtasaṃghātaḥ sūkṣmaḥ kṣityādisamūhaḥ	reNuvartiH iti saMdeham ApadyamAnaH / BUta saMGAtaH sUkzmaH kziti Adi samUhaH
   / kim? / agneḥ siddhiragnisiddhistasyāmagnisiddhau / agniratra thūmāditi	/ kim? / agneH sidDiH agni sidDiH tasyAm agni sidDO / agniH atra TUmAt iti
   upadiśyamānaḥ procyamānaḥ saṃdigdhāsiddhaḥ / niścito hi dhūmo dhūmatvena	upadiSyamAnaH procyamAnaH saMdigDa asidDaH / niScitaH hi DUmaH DUma tvena
   hutavahaṃ gamayati nāniścita iti / tathā dravyamākāśamityādi / ākāśa iti	hutavaham gamayati na aniScitaH iti / taTA dravyam AkASam ityAdi / AkASaH iti
   dharminirdeśaḥ / dravyamiti sādhyo dharmaḥ / guṇāścāsya ṣaṭ / tadyathā /	Darmi nirdeSaH / dravyam iti sADyaH DarmaH / guNAH ca asya zaw / tat yaTA /
   saṃkhyā parimāṇaṃ pṛthaktvaṃ saṃyogo vibhāgaḥ śabdeśceti //	saMKyA parimANam pRTaktvam saMyogaH viBAgaH SabdeH ca iti //
   tatra guṇānāmāśrayaḥ guṇāśrayastadbhāvastattvaṃ tasmāt guṇāśrayatvāditi /	tatra guNAnAm ASrayaH guNa ASrayaH tad BAvaH tattvam tasmAt guNa ASraya tvAt iti /
   ayaṃ heturākāśāsattvavādinaṃ bauddhaṃ pratyāśrayāsiddhaḥ / dharmiṇa	ayam hetuH AkASA sattva vAdinam bOdDam pratyASraya asidDaH / DarmiNa
   evāsiddhatvāt / tathā ca tasyāyaṃ siddhāntaḥ / pañca imāni bhikṣavaḥ	eva asidDa tvAt / taTA ca tasya ayam sidDAntaH / paQca imAni BikzavaH
   saṃjñāmātraṃ saṃvṛtimātraṃ pratijñāmātraṃ vyavahāramātraṃ kalpanāmātram /	saMjQA mAtram saMvRti mAtram pratijQA mAtram vyavahAra mAtram kalpanA mAtram /
   katamāni pañca / atītaḥ addhā anāgataḥ addhā pratisaṃkhyānirodhaḥ ākāśaṃ	katamAni paQca / atItaH adDA anAgataH adDA pratisaMKyA niroDaH AkASam
   pugdala iti / nanu cānyo 'pyasti asiddhaḥ sa ca dvidhā /	pugdalaH iti / nanu ca anyaH api asti asidDaH sa ca dviDA /
   pratijñārthaikadeśāsiddhaḥ / yathā anityaḥ śabdo 'nityatvāt /	pratijQA arTa eka deSa asidDaH / yaTA anityaH SabdaH anitya tvAt /
   avyāpakāsiddhaśceti / yathā sacetanāstaravaḥ svāpāt / sa kasmānnoktaḥ /	avyApaka asidDaH ca iti / yaTA sa cetanAH taravaH svApAt / sa kasmAt na uktaH /
   ācārya āha / antarbhāvāt / kva punarantarbhāva iti cait ubhayāsiddhe /	AcAryaH Aha / antarBAvAt / kva punar antarBAvaH iti cEt uBaya asidDe /
   tasmādadoṣaḥ / āha / yadyevamasiddhabhedadvayamevāstu ubhayāsiddho	tasmAt adozaH / Aha / yadi evam asidDa Beda dvayam eva astu uBaya asidDaH 
   'nyatarāsiddhaśceti / śeṣadvayasyātraivāntarbhāvāt / tathā	anyatara asidDaH ca iti / Seza dvayasya atra eva antarBAvAt / taTA
   cānyairapyuktam 	ca anyEH api uktam 
   asiddhabhedau dvāveva dvayoranyatarasya vā //	asidDa BedO dvO= eva dvayoH anyatarasya vA //
   ityādi / naitadevam / dharmyasiddhihetusaṃdehopādhidvāreṇa bhedaviśeṣasya	ityAdi / na etat evam / Darmya sidDi hetu saMdeha upADi dvAreNa Beda viSezasya
   siddheḥ / vineyavyutpattiphalatvācca śastrārambhasya / paryāptaṃ	sidDeH / vineya vyutpatti Pala tvAt ca Sastra AramBasya / paryAptam
   vistareṇokto 'siddhaḥ // sāṃpratam anaikāntikaḥ ucyate / sa ca ṣaṭprakāraḥ	vistareNa uktaH asidDaH // sAMpratam anEkAntikaH ucyate / sa ca zaz prakAraH
   ṣaḍvidhaḥ / ekānte bhava aikāntikaḥ / na aikāntikau 'naikāntikaḥ / ṣaṭ	zaxviDaH / ekAnte Bava EkAntikaH / na EkAntikO anEkAntikaH / zax 
   prakārā asyeti ṣaṭprakāraḥ ṣaḍ vidhaityarthaḥ // bhedānevāha / sādhāraṇa	prakArAH asya iti zaz prakAraH zaw viDA eti arTaH // BedAn eva Aha / sADAraNa
   ityādi / anvartham / ityudāharaṇameva vakṣyāmaḥ / tatra sādhāraṇaḥ	ityAdi / anvarTam / iti udAharaNam eva vakzyAmaH / tatra sADAraNaH
   prabheyatvānnitya iti / tatreti pūrvavat / dvayorbahūnāṃ vā yaḥ sāmānyaḥ	praBeya tvAt nityaH iti / tatra iti pUrvavat / dvayoH bahUnAm vA yaH sAmAnyaH
   sa sādhāraṇaḥ / pramīyate iti prameyo jñeya ityarthaḥ tadbhāvaḥ	sa sADAraNaH / pramIyate iti prameyaH jQeyaH iti arTaH tad BAvaH
   prameyatvaṃ tasmātprameyatvāt pramāṇaparicchedyatvāt / nitya ityatra	prameya tvam tasmAt prameya tvAt pramANa paricCedya tvAt / nityaH iti atra
   śabdākhyo dharmī gamyate / idaṃ ca sapakṣetarākāśaghaṭādibhāvena	Sabda AKyaH DarmI gamyate / idam ca sa pakza itara AkASa Gawa Adi BAvena
   sādhāraṇatvāt saṃśayanimittamiti / āha ca / taddhi nityānityetyādi / tat	sADAraNa tvAt saMSaya nimittam iti / Aha ca / tat hi nitya anitya ityAdi / tat 
   prameyatvaṃ dharmaḥ / hi rūpapradarśane / nityaścānityaśca nityānityau	prameya tvam DarmaH / hi rUpa pradarSane / nityaH ca anityaH ca nitya anityO
   nityānityau ca tau pakṣau ca nityānityapakṣau /	nitya anityO ca tO pakzO ca nitya anitya pakzO /
   tayornityānityapakṣayorityarthaḥ / kim? / sādhāraṇatvāt	tayoH nitya anitya pakzayoH iti arTaH / kim? / sADAraNa tvAt 
   tulyavṛttitvādanaikāntikam / prayoga eva darśayati / kiṃ ghaṭavat	tulya vRtti tvAt anEkAntikam / prayogaH eva darSayati / kim Gawa vat 
   prameyatvādanityaḥ śabdaḥ āhosvidākāśavat prameyatvānnitya iti	prameya tvAt anityaH SabdaH Ahosvit AkASa vat prameya tvAt nityaH iti
   prakaṭārthaṃ darśayati / aho nāyaṃ saṃśayahetuḥ / etatprayogamantareṇa	prakawa arTam darSayati / aho na ayam saMSaya hetuH / etad prayogam antareNa
   prāgeva saṃśayasya bhāvāt / tadbhāvabhāvitvānupapatteḥ / uktaṃ ca /	prAk eva saMSayasya BAvAt / tad BAva BAvi tva anupapatteH / uktam ca /
   anaikāntikabhedāśca naiva saṃśītikāraṇam /	anEkAntika BedAH ca na eva saMSIti kAraNam /
   saṃdehe sati hetūkte sadbhāvasyāviśeṣataḥ //	saMdehe sati hetu ukte sadBAvasya aviSezatas //
   ityādi / naitadevam / saṃśayasyāvivakṣitatvāt / tamantareṇāpi	ityAdi / na etat evam / saMSayasya avivakzita tvAt / tam antareNa api
   prayogopapatteśca / kriyate ca viparyastamatiprabhṛtipratipattyarthamapi	prayoga upapatteH ca / kriyate ca viparyastam ati praBRti pratipatti arTam api
   prayogaḥ / tatrāpi saṃśayahetutvādanaikāntikāmiti // asādhāraṇaḥ	prayogaH / tatra api saMSaya hetu tvAt anEkAntikAm iti // asADAraNaH
   śrāvaṇatvānnitya ityādi / sādhāraṇavilakṣaṇaḥ asādhāraṇaḥ asāmānyaḥ	SrAvaNa tvAt nityaH ityAdi / sADAraNa vilakzaNaH asADAraNaH asAmAnyaH
   pakṣadharmaḥ san sapakṣavipakṣābhyāṃ vyāvṛtta ityarthaḥ / udāharaṇamāha /	pakza DarmaH san sa pakza vipakzAByAm vyAvRttaH iti arTaH / udAharaNam Aha /
   śrāvaṇatvānnitya iti / śravaṇendriyagrāhyaḥ śrāvaṇastadbhāvaḥ śrāvaṇatvaṃ	SrAvaNa tvAt nityaH iti / SravaNa indriya grAhyaH SrAvaNaH tad BAvaH SrAvaNa tvam
   tasmāt / nityaḥ avināśī / śabda iti gamyate / tatredaṃ śrāvaṇatvaṃ	tasmAt / nityaH avinASI / SabdaH iti gamyate / tatra idam SrAvaNa tvam
   svadharmiṇaṃ vihāya na sapakṣe ākāśādau nāpi vipakṣe ghaṭādau vartata iti	svaDarmiNam vihAya na sa pakze AkASa AdO na api vipakze Gawa AdO vartate iti
   saṃśayanimittam / ata evāha / taddhītyādi / tat śrāvaṇatvam / hi	saMSaya nimittam / atas eva Aha / tat hi ityAdi / tat SrAvaNa tvam / hi
   rūpapradarśane nityānityapakṣābhyāṃ vyāvṛttatvāt / saṃśayaheturiti yogaḥ /	rUpa pradarSane nitya anitya pakzAByAm vyAvRtta tvAt / saMSaya hetuH iti yogaH /
   anyatra vartiṣyata itīdamapi nirākurvannāha / nityānityavinirmuktasya	anyatra vartizyate iti idam api nirAkurvan= Aha / nitya anitya vinirmuktasya
   cānyasya cāsaṃbhavāt / yadasti tena nityena vā bhavitavyamanityena vā	ca anyasya ca asaMBavAt / yat asti tena nityena vA Bavitavyam anityena vA
   nānyathā / virodhādatiprasaṃgācca / ataḥ saṃśayahetuḥ saṃśayakāraṇam /	na anyaTA / viroDAt ati prasaMgAt ca / atas saMSaya hetuH saMSaya kAraNam /
   kathamityāha / kiṃbhūtasyetyādi / kiṃprakārasya kiṃ	kaTam iti Aha / kiMBUtasya ityAdi / kiMprakArasya kim
   nityasyāhosvidanityasyāsyeti / prastutasya śabdasya	nityasya Ahosvida nityasya asya iti / prastutasya Sabdasya
   śrāvaṇatvamityetaduktaṃ bhavati / yadi tadanyatra nitye vānitye	SrAvaNa tvam iti etat uktam Bavati / yadi tat anyatra nitye vA anitye
   vopalabdhaṃ bhavati tatastabdalenetaratrāpi niścayo yujyate nānyathā /	vA upalabDam Bavati tatas tabdalena itaratra api niScayaH yujyate na anyaTA /
   viparyakalpanāyā apyanyanivāritaprasaratvāt / ityatra bahu vaktavyam /	viparyakalpanAyAH api anya nivArita prasara tvAt / iti atra bahu vaktavyam /
   alaṃ prasaṅgena / ākṣepaparihārau pūrvavat / evaṃ śeṣeṣvapi bhāvanīyamiti	alam prasaFgena / Akzepa parihArO pUrvavat / evam Sezezu api BAvanIyam iti
   // sapakṣaikadeśavṛttirityādi / samānaḥ pakṣaḥ sapakṣaḥ tasyaikadeśaḥ	// sa pakza eka deSa vRttiH ityAdi / samAnaH pakzaH sa pakzaH tasya eka deSaH
   sapakṣaikadeśaḥ tasminvṛttirasyeti sapakṣaikadeśavṛttiḥ / tathā visadṛśaḥ	sa pakza eka deSaH tasmin vRttiH asya iti sa pakza eka deSa vRttiH / taTA visadRSaH
   pakṣo vipakṣastaṃ vyāptuṃ śīlamasyeti vipakṣavyāpī / udāharaṇamāha / yathā	pakzaH vipakzaH tam vyAptum SIlam asya iti vipakza vyApI / udAharaNam Aha / yaTA
   / aprayatnānantarīyakaḥ śabdo nityatvāditi / śabdo dharmī /	/ aprayatna anantarIyakaH SabdaH nitya tvAt iti / SabdaH DarmI /
   aprayatnānantarīyakatvaṃ sādhyo dharmaḥ / anityatvāditi hetuḥ / tatra	aprayatna AnantarIyaka tvam sADyaH DarmaH / anitya tvAt iti hetuH / tatra
   aprayatnānantarīyakaḥ pakṣaḥ / aprayatnānantarīyako 'rthaḥ / asya	aprayatna AnantarIyakaH pakzaH / aprayatna anantarIyakaH arTaH / asya
   sādhyavidyudākāśādipadārthasaṃghātaḥ kim? / sapakṣaḥ / tatraikadeśe	sADya vidyut AkASa Adi padArTa saMGAtaH kim? / sa pakzaH / tatra eka deSe
   vidyudādau vartate 'nityatvaṃ nākāśādau / nityatvāttasya / tathā	vidyut AdO vartate anitya tvam na AkASa AdO / nitya tvAt tasya / taTA
   aprayatnānantarīyakaḥ pakṣo 'sya ghaṭādirvipakṣaḥ / tatra sarvatra	aprayatna anantarIyakaH pakzaH asya Gawa AdiH vipakzaH / tatra sarvatra
   ghaṭādau vidyate 'nityatvam / prayatnāntarīyakasyānityatvāt / yasmādevaṃ	Gawa AdO vidyate anitya tvam / prayatna AntarIyakasya anitya tvAt / yasmAt evam
   tasmādetadapi anityatvaṃ vidyudghatasādharmyeṇa	tasmAt etat api anitya tvam vidyut Gata sADarmyeNa
   vidyudghatulyatayānikāntikam / bhāvanikāmāha / kiṃ ghaṭavat anityatvāt	vidyut Ga tulya tayA nika antikam / BAvanikAm Aha / kim Gawa vat anitya tvAt 
   prayatnānantarīyakaḥ / śabdaḥ	prayatna AnantarIyakaH / SabdaH
   āhosvidvidyudādivadanityatvādaprayatnānantarīyaka iti /	Ahosvit vidyut Adi vat anitya tvAt aprayatna anantarIyakaH iti /
   prakaṭārtham // vipakṣaikadeśavṛtiḥ sapakṣavyāpī / samāsaḥ sukara eva /	prakawa arTam // vipakza eka deSa vRtiH sa pakza vyApI / samAsaH sukaraH eva /
   udāharaṇamāha / yathā prayatnānantarīyakaḥ śabdo 'nityatvāt /	udAharaNam Aha / yaTA prayatna AnantarIyakaH SabdaH anitya tvAt /
   prayatnānantarīyakaḥ pakṣo 'sya ghaṭādiḥ sapakṣaḥ / tatra sarvatra	prayatna anantarIyakaH pakzaH asya Gawa AdiH sa pakzaH / tatra sarvatra
   ghaṭādau vidyate 'nityatvam / prayatnānantarīyakaḥ pakṣo 'sya	Gawa AdO vidyate anitya tvam / prayatna AnantarIyakaH pakzaH asya
   vidyudākāśādirvipakṣaḥ / tatraikadeśe vidyudādau vidyate 'nityatvam /	vidyut AkASa AdiH vipakzaH / tatra eka deSe vidyut AdO vidyate anitya tvam /
   nākāśādau / tasmādetadapi vidyudghaṭasādharmyeṇa pūrvavadanaikāntikam iti	na AkASa AdO / tasmAt etat api vidyut Gawa sADarmyeNa pUrvavat anEkAntikam iti
   sūtrārthaḥ / uktavaiparītyena svadhiyā bhāvanīyamiti //	sUtra arTaH / ukta vEparItyena sva DiyA BAvanIyam iti //
   ubhayapakṣaikadeśavṛttiḥ / ubhayapakṣayoḥ	uBaya pakza eka deSa vRttiH / uBaya pakzayoH
   sapakṣavipakṣayorekadeśavṛttirasyeti ubhayapakṣaikadeśavṛttiḥ /	sa pakza vipakzayoH eka deSa vRttiH asya iti uBaya pakza eka deSa vRttiH /
   udāharaṇamāha / yathā nityaḥ śabdo 'mūrtatvāditi // nityaḥ pakṣo	udAharaNam Aha / yaTA nityaH SabdaH amUrta tvAt iti // nityaH pakzaH 
   'syākāśaparamāṇvādiḥ sapakṣaḥ / tatraikadeśa ākāśārdo vidyate 'mūrtatvaṃ	asya AkASa paramANu AdiH sa pakzaH / tatra eka deSaH AkASArdaH vidyate amUrta tvam
   na paramāṇvādau / anityaḥ pakṣo 'sya ghaṭasukhādirvipakṣaḥ / tatraikadeśe	na paramANu AdO / anityaH pakzaH asya Gawa suKa AdiH vipakzaH / tatra eka deSe
   sukhādau vidyate 'mūrtatvaṃ na ghaṭādau / tasmādetadapi	suKa AdO vidyate amUrta tvam na Gawa AdO / tasmAt etat api
   sukhākāśasādharmyeṇānaikāntikam / etadapi sūtraṃ nigadasiddham / tathā	suKa AkASa sADarmyeNa anEkAntikam / etat api sUtram nigada sidDam / taTA
   viruddhāvyabhicārī / adhikṛtahetvanumeyaviruddhārthasādhako viruddhaḥ /	virudDa avyaBicArI / aDikRta hetu anumeya virudDa arTa sADakaH virudDaH /
   viruddhaṃ na vyabhicaratīti viruddhāvyabhicārī / upanyastaḥ san	virudDam na vyaBicarati iti virudDa avyaBicArI / upanyastaH san
   tathāvidhārthānirākṛteḥ pratiyoginaṃ na vyabhicaratīti bhāvaḥ /	taTAviDa arTa anirAkRteH pratiyoginam na vyaBicarati iti BAvaH /
   tataścānena pratiyogisādhyamapākṛtya hetuprayogaḥ kartavya ityetadāha /	tatas ca anena pratiyogi sADyam apAkRtya hetu prayogaH kartavyaH iti etat Aha /
   anye tu viruddhaścāsāvavyabhicārī ca viruddhāvyabhicārīti vyācakṣate /	anye tu virudDaH ca asO= avyaBicArI ca virudDa avyaBicArI iti vyAcakzate /
   idaṃ punarayuktameva / virodhādanekāntavādāpatteśca / udāharaṇamāha /	idam punar ayuktam eva / viroDAt anekAntavAda ApatteH ca / udAharaNam Aha /
   yathānityaḥ śabdaḥ kṛtakatvād ghaṭavat / nityaḥ śabdaḥ śrāvaṇatvāt	yaTA anityaH SabdaH kRtaka tvAt Gawa vat / nityaH SabdaH SrAvaNa tvAt 
   śabdatvavat / ubhayoḥ saṃśayahetutvāt dvāvapyetāveko 'naikāntikaḥ	Sabda tva vat / uBayoH saMSaya hetu tvAt dvO= api etO= ekaH anEkAntikaH
   samuditāveva / anityaḥ śabdaḥ kṛtakatvādghaṭavaditi vaiśeṣikeṇokte	samuditO= eva / anityaH SabdaH kRtaka tvAt Gawa vat iti vESezikeNa ukte
   mīmāṃsaka āha / nityaḥ śabdaḥ śrāvaṇatvāt śabdatvavat / śabdatvaṃ hi nāma	mImAMsakaH Aha / nityaH SabdaH SrAvaNa tvAt Sabda tva vat / Sabda tvam hi nAma
   veṇuvīṇāmṛdaṅgapaṇavādibhedabhinneṣu sarvaśabdeṣu śabda	veNu vINA mRdaFga paNava Adi Beda Binnezu sarva Sabdezu Sabda
   ityabhinnābhidhānapratyayanibandhanaṃ sāmānyaviśeṣasaṃjñitaṃ nityamiti /	iti aBinna aBiDAna pratyaya nibanDanam sAmAnya viSeza saMjQitam nityam iti /
   ubhayoḥ saṃśayahetutvāditi / ekatra dharmiṇi ubhayoḥ	uBayoH saMSaya hetu tvAt iti / ekatra DarmiNi uBayoH
   kṛtakatvaśrāvaṇatvayoḥ saṃśayahetutvāt saṃdehahetutvā / tathā caikatra	kRtaka tva SrAvaNa tvayoH saMSaya hetu tvAt saMdeha hetutvA / taTA ca ekatra
   dharmiṇi kṛtakatvaśrāvaṇatvākhyau hetu saṃdehaṃ kurutaḥ kiṃ	DarmiNi kRtaka tva SrAvaNa tva AKyO hetu saMdeham kurutaH kim
   kṛtakatvādghaṭavadanityaḥ āhosvicchrāvaṇatvācchabdatvavannityaḥ iti / evaṃ	kRtaka tvAt Gawa vat anityaH Ahosvit SrAvaNa tvAt Sabda tva vat nityaH iti / evam
   saṃdehahetutve pratipādite paraścodayati kiṃ samastayoḥ saṃdehahetutvam	saMdeha hetu tve pratipAdite paraH codayati kim samastayoH saMdeha hetu tvam
   uta vyastayoḥ /	uta vyastayoH /
   yadi samastayoḥ saṃdehahetutvaṃ tadāsādhāraṇānna bhidyate / śrāvaṇatvaṃ	yadi samastayoH saMdeha hetu tvam tadA asADAraNAt na Bidyate / SrAvaNa tvam
   cāsādhāraṇatvenoktam / atha vyastayostadapi na / vyastayoḥ samyagdhetutvāt	ca asADAraNa tvena uktam / aTa vyastayoH tat api na / vyastayoH samyak hetu tvAt 
   / atrocyate / samastayoreva saṃdehahetutvam / nanūktam asādhāraṇānna	/ atra ucyate / samastayoH eva saMdeha hetu tvam / nanu uktam asADAraNAt na
   bhidyate / tanna / yato bhidyata eva / parasparasāpekṣo viruddhāvyabhicārī	Bidyate / tat naH / yatas Bidyate eva / paraspara sApekzaH virudDa avyaBicArI
   ceti / ekakaḥ asahāyo 'sādhāraṇaḥ / sa cānenāṃśenācāryeṇa bhinna upātta	ca iti / ekakaH asahAyaH asADAraNaH / sa ca anena aMSena AcAryeNa BinnaH upAtta
   iti tasmādadoṣaḥ / uktaṃ ca mūlagranthe dvāvapyetāveko 'naikāntikaḥ	iti tasmAt adozaH / uktam ca mUla granTe dvO= api etO= ekaH anEkAntikaH
   samuditāveva / anudbhāvite tu tadabhāva iti / atra bahu vaktavyam / tattu	samuditO= eva / anudBAvite tu tad aBAvaH iti / atra bahu vaktavyam / tat tu
   nocyate / saṃkṣeparucisattvānugrahārtho 'yamārambhaḥ / ityukto	na ucyate / saMkzepa ruci sattva anugraha arTaH ayam AramBaH / iti uktaH 
   'naikāntikaḥ // sāṃprataṃ viruddhamāhaḥ viruddhaścatuḥprakāra ityādi /	anEkAntikaH // sAMpratam virudDa mAhaH virudDaH catur prakAraH ityAdi /
   virudhyate sa viruddhaḥ / tathā hyayaṃ	viruDyate sa virudDaH / taTA hi ayam
   dharmasvarūpādiviparītasādhanārddharmeṇa dharmiṇā vā virudhyata eveti	Darma svarUpa Adi viparIta sADana ArdDarmeNa DarmiNA vA viruDyate eva iti
   catuḥprakāraścaturbhedaḥ / tadyathā / dharmasvarūpaviparītasādhana ityādi	catur prakAraH catur BedaH / tat yaTA / Darma svarUpa viparIta sADanaH ityAdi
   / tadyatheti bhedopanyāsārthaḥ / śabdārthamudāharaṇādhikāra eva vakṣyāmaḥ	/ tat yaTA iti Beda upanyAsa arTaH / Sabda arTam udAharaNa aDikAraH eva vakzyAmaH
   / tatra dharmetyādi / tatra dharmasvarūpaviparītasādhano yathā nityeti	/ tatra Darma ityAdi / tatra Darma svarUpa viparIta sADanaH yaTA nitya iti
   pūrvavat / dharmaḥ paryāya ityanarthāntaram / tasya	pUrvavat / DarmaH paryAyaH iti anarTAntaram / tasya
   svarūpamasādhāraṇāmātmalakṣaṇa dharmasvarūpaṃ tasya viparītasādhana iti	sva rUpam asADAraNAm Atma lakzaNa Darma svarUpam tasya viparIta sADanaH iti
   samāsaḥ / evaṃ śeṣeṣvapi draṣṭavyamiti / adhunodāharaṇamāha / yathā nitya	samAsaH / evam Sezezu api drazwavyam iti / aDunA udAha raNam Aha / yaTA nitya
   śabdaḥ kṛtakatvāt prayatnānantarīyakatvādvā ityayaṃ heturvipakṣa eva	SabdaH kRtaka tvAt prayatna AnantarIyaka tvAt vA iti ayam hetuH vipakzaH eva
   bhāvadviruddhaḥ / atra dharmasvarūpanityatvam / ayaṃ ca	BAva dvirudDaH / atra Darma svarUpa nitya tvam / ayam ca
   hetuviparītamanityatvaṃ sādhayati / tenaivāvinābhūtatvāt / tathā cāha /	hetu viparItam anitya tvam sADayati / tena eva avinA BUta tvAt / taTA ca Aha /
   vipakṣa eva bhāvādviruddhaḥ / āha ayamapakṣadharmatvādasiddhānna viśiṣyate	vipakzaH eva BAvAt virudDaH / Aha ayamapakza Darma tvAt asidDAn na viSizyate
   kathaṃ viruddha iti? / atrocyate / nāvaśyaṃ pakṣadharma eva viruddhatā	kaTam virudDaH iti? / atra ucyate / na avaSyam pakza DarmaH eva virudDa tA
   anyathāpyācāryapravṛtteḥ / adhikṛtayogajñāpakāt / na cāyamasiddhānna	anyaTA api AcArya pravRtteH / aDikRta yoga jQApakAt / na ca ayam asidDAn na
   viśiṣyate iti /	viSizyate iti /
   viparyayasādhakatvenāsiddheḥ / etatpradhānatvāccopanyāsasya /	viparyaya sADaka tvena asidDeH / etad praDAna tvAt ca upanyAsasya /
   anyathānaikāntikasyāpyasiddhatvaprasaṅgaḥ / nityatvādisādhanatvena	anyaTA anEkAntikasya api asidDa tva prasaFgaH / nitya tva Adi sADana tvena
   prameyatvādīnāmapi asiddhatvāt / ityalaṃ prasaṅgena / gamanikāmātrametat /	prameya tva AdInAm api asidDa tvAt / iti alam prasaFgena / gamanikA mAtram etat /
   dharmaviśeṣaviparītasādhana ityasyodāharaṇaṃ yathā parārthāścakṣurādayaḥ	Darma viSeza viparIta sADanaH iti asya udAharaNam yaTA para arTAH cakzuH AdayaH
   saṃghātatvāt śayanāsanādyaṅgavat iti / kaḥ punarevamāha? / sāṃkhyo	saMGAta tvAt Sayana Asana Adi aFga vat iti / kaH punar evam Aha? / sAMKyaH 
   bauddhaṃ prati / iha cakṣurādayo dharmiṇaḥ / ādiśabdāt	bOdDam prati / iha cakzuH AdayaH DarmiNaH / Adi SabdAt 
   śeṣendiyamahadahaṃṅkārādiparigrahaḥ / pārārthyaṃ sādhyadharma / asya ca	Seza indiya mahat ahaMFkAra Adi parigrahaH / pArArTyam sADya DarmaH / asya ca
   viśeṣo 'saṃhataparārthatvamiṣṭam / anyathā siddhasādhyatāpattyā	viSezaH asaMhata para arTa tvam izwam / anyaTA sidDa sADya tA ApattyA
   prayogavaikalyaprasaṅgaḥ / saṃghātatvāditi hetuḥ / tatra dvayorbahūnāṃ vā	prayoga vEkalya prasaFgaH / saMGAta tvAt iti hetuH / tatra dvayoH bahUnAm vA
   melakaḥ saṃghātastasya bhāvaḥ saṃghātatvaṃ tasmātsaṃghātatvāt /	melakaH saMGAtaH tasya BAvaH saMGAta tvam tasmAt saMGAta tvAt /
   śayanāsanādyaṅgavaditi dṛṣṭāntaḥ / śayanaṃ palyaṅkādi / āsanamāsandakādi /	Sayana Asana Adi aFga vat iti dRzwAntaH / Sayanam palI aFka Adi / Asanam Asandaka Adi /
   tadaṅgāni pratītānyeva / yathaitadaṅgāni saṃghātatvāddevadattādiparārthāni	tad aFgAni pratItAni eva / yaTA etat aFgAni saMGAta tvAt devadatta Adi para arTAni
   vartante evaṃ cakṣurādayo 'pīti bhāvārthaḥ / adhunā viruddhamāha /	vartante evam cakzuH AdayaH api iti BAva arTaH / aDunA virudDam Aha /
   ayamityādi / ayaṃ hetuḥ saṃghātatvalakṣano yathā yena prakāreṇa pārārthyaṃ	ayam ityAdi / ayam hetuH saMGAta tva lakzanaH yaTA yena prakAreNa pArArTyam
   parārthabhāvaṃ cakṣurādīnāṃ sādhayati tathā tenaiva prakāreṇa	para arTa BAvam cakzuH AdInAm sADayati taTA tena eva prakAreNa
   saṃhatatvamapi sāvayavatvamapi parasyātmanaḥ sādhayati /	saMhata tvam api sAvayava tvam api parasya AtmanaH sADayati /
   tenāpyavinābhūtatvāt / tathā cāha / ubhayatrāvyabhicārāt / ubhayatreti	tena api avinABUta tvAt / taTA ca Aha / uBayatra avyaBicArAt / uBayatra iti
   parārthe saṃhatatve ca avyabhicārād gamakatvādityarthaḥ / tathā caivamapi	para arTe saMhata tve ca avyaBicArAt gamaka tvAt iti arTaH / taTA ca evam api
   vaktuṃ śakyata eva saṃhataparārthāścakṣurādayaḥ saṃghātatvāt	vaktum SakyataH eva saMhata para arTAH cakzuH AdayaH saMGAta tvAt 
   śayanāsanādyaṅgavaditi / śayanāsaṇādyaṅgāni hi saṃhatasya	Sayana Asana Adi aFga vat iti / Sayana AsaNa Adi aFgAni hi saMhatasya
   karacaraṇorugrīvādimata evārthaṃ kurvanti nānyasya / tathopalabdheriti /	kara caraNa uru grIva AdimataH eva arTam kurvanti na anyasya / taTA upalabDeH iti /
   āha vipakṣa eva bhāvādviruddha iti sāmānyaṃ viruddhalakṣaṇaṃ	Aha vipakzaH eva BAvAt virudDaH iti sAmAnyam virudDa lakzaNam
   tatkathamihopapadyate? iti / ucyate / asaṃhataparavipakṣo hi saṃhata iti	tat kaTam iha upapadyate? iti / ucyate / asaMhata para vipakzaH hi saMhataH iti
   tatraiva vṛttidarśanāt / kiṃ nopapadyate? / ākṣepaparihārau pūrvavat //	tatra eva vRtti darSanAt / kim na upapadyate? / Akzepa parihArO pUrvavat //
   dharmisvarūpaviparītetyādi / dharmā asya vidyante iti dharmī / udāharaṇaṃ	Darmi svarUpa viparIta ityAdi / DarmAH asya vidyante iti DarmI / udAharaNam
   tu yathā na dravyamityādi / kaḥ punarevamāha? / vaiśeṣiko bauddhānprati /	tu yaTA na dravyam ityAdi / kaH punar evam Aha? / vESezikaH bOdDAn prati /
   kena punaḥ saṃbandhena? iti / ucyate / tasya siddhānto	kena punar saMbanDena? iti / ucyate / tasya sidDAntaH 
   dravyaguṇakarmasāmānyaviśeṣasamavāyāḥ ṣaṭpadārthāḥ /	dravya guNa karma sAmAnya viSeza samavAyAH zawpadArTAH /
   tataḥ pṛthvyāpastejovāyurākāśaṃ kālo digātmā mana iti dravyāṇi /	tatas pRTvI ApaH tejaH vAyuH AkASam kAlaH diS AtmA manaH iti dravyANi /
   guṇāścaturviśatiḥ / rūparasagandhasparśasaṃkhyāparimāṇāni pṛthaktvaṃ	guNAH catur viSatiH / rUpa rasa ganDa sparSa saMKyA parimANAni pRTaktvam
   saṃyogavibhāgau paratvāparatve buddhiḥ sukhaduḥkhecchādveṣāḥ prayatnaśceti	saMyoga viBAgO paratva aparatve budDiH suKa duHKa icCA dvezAH prayatnaH ca iti
   sūtroktāḥ / caśabdāt dravatvaṃ gurutvaṃ saṃskāraḥ sneho dharmādharmau	sUtra uktAH / caSabdAt drava tvam guru tvam saMskAraH snehaH Darma aDarmO
   śabdaśceti / evaṃ caturviśati rguṇāḥ / pañca karmāṇi / tadyathā	SabdaH ca iti / evam caturviSati rguNAH / paQca karmANi / tat yaTA
   utkṣepaṇamavakṣepaṇamākuñcanaṃ prasāraṇaṃ gamanamiti karmāṇi /	utkzepaNam avakzepaNam AkuQcanam prasAraNam gamanam iti karmANi /
   gamanagrahaṇābdhramaṇarecanaspandanādyavarodhaḥ / sāmānyaṃ dvividhaṃ	gamana grahaNa abDra maNa recana spandana Adi avaroDaH / sAmAnyam dviviDam
   paramaparaṃ ceti / tatra paraṃ sattā bhāvo mahāsāmānyamiti cocyate /	parama param ca iti / tatra param sattA BAvaH mahAsAmAnyam iti ca ucyate /
   aparaṃ dravyatvādi / tatra sattā dravyaguṇakarmabhyo 'rthāntaram /	aparam dravya tva Adi / tatra sattA dravya guNa karmaByaH arTa antaram /
   kathāpunaryuktyā? ityatrāha / na dravyaṃ bhāvaḥ ekadravyavattvāditi hetuḥ	kaTA punar yuktyA? iti atra Aha / na dravyam BAvaH eka dravyavat tvAt iti hetuH
   / sāmānyaviśeṣavaditi dṛṣṭāntaḥ / adhunā bhāvārtha ucyate / na dravyaṃ	/ sAmAnya viSeza vat iti dRzwAntaH / aDunA BAva arTaH ucyate / na dravyam
   bhāvaḥ / dravyādanya ityarthaḥ / ekadravyavattvādityatra ekaṃ ca	BAvaH / dravyAt anyaH iti arTaH / eka dravyavat tvAt iti atra ekam ca
   taddravyaṃ ca ekadravyamasyāstīti āśrayabhūtamiti ekadravyavān /	tat dravyam ca eka dravyam asya asti iti ASraya BUtam iti eka dravyavAn /
   samānādhikaraṇābdahuvrīhiḥ kadācitkarmadhārayaḥ sarvadhanādyartha iti	samAna aDikaraNa abda huvrIhiH kadAcid karmaDArayaH sarva Dana Adi arTaH iti
   vacanāt / tadbhāvastattvaṃ tasmādekadravyavattvāt / ekasmindravye	vacanAt / tad BAvaH tattvam tasmAt eka dravyavat tvAt / ekasmin dravye
   vartamānatvādityarthaḥ / vaiśeṣikasya hi adravyaṃ dravyaṃ anekadravyaṃ ca	vartamAna tvAt iti arTaH / vESezikasya hi adravyam dravyam aneka dravyam ca
   dravyam / tatrādravyaṃ dravyamākāśakāladigātmanaḥ paramāṇavaḥ /	dravyam / tatra adravyam dravyam AkASa kAla diS AtmanaH paramANavaH /
   anekadravyaṃ tu dvayaṇukādiskandhāḥ / ekadravyaṃ tu dravyameva nāsti /	aneka dravyam tu dvayaNuka Adi skanDAH / eka dravyam tu dravyam eva na asti /
   ekadravyavāṃśca bhāvaḥ / ityato dravyalakṣaṇavilakṣaṇatvāt na dravyaṃ	eka dravyavAn= ca BAvaH / iti atas dravya lakzaNa vilakzaNa tvAt na dravyam
   bhāva iti / dṛṣṭāntaḥ sāmānyaviśeṣaḥ / sa ca	BAvaH iti / dRzwAntaH sAmAnya viSezaH / sa ca
   dravyatvaguṇatvakarmatvalakṣaṇaḥ / dravyatvaṃ hi navasu dravyeṣu	dravya tva guNa tva karma tva lakzaNaH / dravya tvam hi navasu dravyezu
   vartamānatvātsāmānyaṃ guṇakarmabhyo vyāvartamānatvādviśeṣaḥ / evaṃ	vartamAna tvAt sAmAnyam guNa karmaByaH vyAvartamAna tvAt viSezaH / evam
   guṇatvakarmatvayorapi bhāvanā kāryeti / tataśca sāmānyaṃ ca tadviśeṣaśca	guNa tva karma tvayoH api BAvanA kAryA iti / tatas ca sAmAnyam ca tad viSezaH ca
   sa iti sāmānyaviśeṣastena tulyaṃ vartata iti sāmānyaviśeṣavat /	saH iti sAmAnya viSezaH tena tulyam vartate iti sAmAnya viSeza vat /
   dravyatvavadityarthaḥ / tataścaitadukte bhavati / yathā navasu dravyeṣu	dravya tva vat iti arTaH / tatas ca etat ukte Bavati / yaTA navasu dravyezu
   pratyekaṃ vartamānaṃ dravyaṃ na bhavati kiṃtu sāmānyaviśeṣalakṣaṇaṃ	pratyekam vartamAnam dravyam na Bavati kiMtu sAmAnya viSeza lakzaNam
   dravyatvameva evaṃ bhāvo 'pītyabhiprāyaḥ / āha yadi nāma dravyaṃ na	dravya tvam eva evam BAvaH api iti aBiprAyaH / Aha yadi nAma dravyam na
   bhavati tathāpi guṇobhaviṣyati karma ca ityetadapi nirācikīrṣurāha /	Bavati taTA api guNa uBavizyati karma ca iti etat api nirAcikIrzuH Aha /
   guṇakarmasu ca bhāvāt / tataśca na guṇo bhāvaḥ guṇeṣu bhāvād guṇatvavat /	guNa karmasu ca BAvAt / tatas ca na guNaH BAvaH guNezu BAvAt guNa tva vat /
   yadi ca bhāvo guṇaḥ syānna tarhi guṇeṣu varteta nirguṇatvād guṇānām /	yadi ca BAvaH guNaH syAt na tarhi guNezu varteta nirguNa tvAt guNAnAm /
   vartate ca guṇeṣu bhāvaḥ / san guṇa iti pratīteḥ / tathā na karma bhāvaḥ	vartate ca guNezu BAvaH / san guNaH iti pratIteH / taTA na karma BAvaH
   karmasu bhāvātkarmatvavat / yadi ca bhāvaḥ karma syāt na tarhi karmasu	karmasu BAvAt karma tva vat / yadi ca BAvaH karma syAt na tarhi karmasu
   varteta niṣkarmakatvātkarmaṇām / vartate ca karmasu bhāvaḥ / satkarmeti	varteta nizkarmaka tvAt karmaNAm / vartate ca karmasu BAvaH / satkarma iti
   pratīteḥ / vyatyayopanyāsastu pratijñāhetvorvicitranyāyapradarśanārtham /	pratIteH / vyatyaya upanyAsaH tu pratijQA hetvoH vicitra nyAya pradarSana arTam /
   ityevaṃ vaiśeṣikeṇokte bauddha āha / ayaṃ ca hetustriprakāro 'pi yathā	iti evam vESezikeNa ukte bOdDaH Aha / ayam ca hetuH tri prakAraH api yaTA
   dravyādipratiṣedhaṃ sādhayati tathā bhāvasya dharmiṇo 'bhāvatvamapi	dravya Adi pratizeDam sADayati taTA BAvasya DarmiNaH aBAva tvam api
   sādhayati /	sADayati /
   tenāpyavinābhūtatvāt / tathā cāha / ubhayatrāvyabhicārāt / ubhayatra	tena api avinABUta tvAt / taTA ca Aha / uBayatra avyaBicArAt / uBayatra
   dravyādipratiṣedhe bhāvābhāve ca gamakatvāt / tathā ca / yatathaidbaktuṃ	dravya Adi pratizeDe BAva aBAve ca gamaka tvAt / taTA ca / yataTA Edbaktum
   śakyate na dravyaṃ bhāvaḥ ekadravyatvāt dravyatvavat evamidamapi śakyate	Sakyate na dravyam BAvaH eka dravya tvAt dravya tva vat evam idam api Sakyate
   bhāvo bhāva eva na bhavati ekadravyatvāt dravyatvavat / na ca dravyatvaṃ	BAvaH BAvaH eva na Bavati eka dravya tvAt dravya tva vat / na ca dravya tvam
   bhāvaḥ sāmānyaviśeṣatvāt / evaṃ na guṇaḥ guṇeṣu bhāvāt guṇatvavat / atrāpi	BAvaH sAmAnya viSeza tvAt / evam na guNaH guNezu BAvAt guNa tva vat / atra api
   bhāvo bhāva eva na bhavati guṇeṣu bhāvāt guṇatvavat / na ca guṇatvaṃ	BAvaH BAvaH eva na Bavati guNezu BAvAt guNa tva vat / na ca guNa tvam
   bhāvaḥ sāmānyaviśeṣatvādeva / evaṃ na karma bhāvaḥ karmasu bhāvāt	BAvaH sAmAnya viSeza tvAt eva / evam na karma BAvaH karmasu BAvAt 
   karmatvavat atrāpi bhāvo bhāva eva na bhavati karmasu bhāvāt karmatvavat /	karma tva vat atra api BAvaH BAvaH eva na Bavati karmasu BAvAt karma tva vat /
   na ca karmatvaṃ bhāvaḥ sāmānyaviśeṣatvāt / sāmānyaviruddhalakṣaṇayojanā tu	na ca karma tvam BAvaH sAmAnya viSeza tvAt / sAmAnya virudDa lakzaNa yojanA tu
   bhāvavipakṣatvātsāmānyaviśeṣasya sukaraiva / āha ayamasiddhānna viśiṣyate	BAva vipakza tvAt sAmAnya viSezasya sukarA eva / Aha ayam asidDAn na viSizyate
   iti kathaṃ viruddhaḥ? / tathāhi / na bhāvo nāma dravyādivyatiriktaḥ	iti kaTam virudDaH? / taTA hi / na BAvaH nAma dravya Adi vyatiriktaH
   kaścidasti saugatānām / tadabhāvāccaśrayāsiddha eva heturiti / atrocyate	kaScid asti sOgatAnAm / tad aBAvAt caSrayA asidDaH eva hetuH iti / atra ucyate
   satyametat / kiṃtu paraprasiddho 'pi vipakṣamātravyāpī viruddha iti	satyam etat / kiMtu para prasidDaH api vipakza mAtra vyApI virudDaH iti
   nidarśanārthatvāt / ekasminnapi cānekadoṣajātyupanipātanāt	nidarSana arTa tvAt / ekasmin= api ca aneka doza jAti upanipAtanAt
   tadbhedadarśanārthatvānna doṣa iti / āha evamaviruddhabhāvaḥ sarvatra	tad Beda darSana arTa tvAt na dozaH iti / Aha evam avirudDa BAvaH sarvatra
   viśeṣaviruddhabhāvāditi / na / virodhino	viSeza virudDa BAvAt iti / na / viroDinaH 
   'dhikṛtahetvanvitadṛṣṭāntabalenaiva nivṛteḥ / tathāpyanityaḥ śabdaḥ	aDikRta hetu anvita dRzwAnta balena eva nivRteH / taTA api anityaH SabdaH
   pākyatvādghatavat pākyaḥ śabda iti viruddhapreraṇāyāṃ	pAkya tvAt Gata vat pAkyaH SabdaH iti virudDa preraNAyAm
   kṛtakatvānvitāpākyapaṭādidṛṣṭāntāntarasāmarthyāttannivṛttyā na viruddhatā	kRtaka tva anvitA pAkya pawa Adi dRzwAnta antara sAmarTyAt tad nivRttyA na virudDa tA
   / anivṛttau cābhyupagamyata eva /	/ anivRttO ca aByupagamyate eva /
   aśakyā ceha tannivṛttirekadravyavatvasya tadvyatirekeṇānyatrāvṛtteriti /	aSakyA ca iha tad nivRttiH eka dravyavatu asya tad vyatirekeNa anyatra AvRtteH iti /
   atra bahu vaktavyam / alaṃ prasaṅgena // dharmiviśeṣaviparītasādhano yathā	atra bahu vaktavyam / alam prasaFgena // Darmi viSeza viparIta sADanaH yaTA
   / dharmī bhāva eva tadviśeṣaḥ satpratyayakartṛtvam / yata uktaṃ saditi	/ DarmI BAvaH eva tad viSezaH sat pratyaya kartR tvam / yatas uktam sat iti
   yato dravyaguṇakarmasu sā sattā / tadviparītasādhano yathā / ayameva	yatas dravya guNa karmasu sA sattA / tad viparIta sADanaH yaTA / ayam eva
   heturekadravyavattvākhyaḥ asminneva pūrvapakṣe na dravyaṃ bhāva	hetuH eka dravyavat tva AKyaH asmin= eva pUrva pakze na dravyam BAva
   ityādilakṣaṇe asyaiva dharmiṇo bhāvākhyasya yo viśeṣo dharmaḥ	ityAdi lakzaNe asya eva DarmiNaH BAva AKyasya yaH viSezaH DarmaH
   satpratyayakartṛtvaṃ nāma tadviparitamasatpratyayakartṛtvamapi sādhayati /	sat pratyaya kartR tvam nAma tad viparitama sat pratyaya kartR tvam api sADayati /
   tenāpi vyāpyatvāt / tathā hyetadapi vaktuṃ śakyata eva bhāvaḥ	tena api vyApya tvAt / taTA hi etat api vaktum SakyataH eva BAvaH
   satpratyayakartā na bhavati ekadravyavattvādravyatvat / na ca dravyatvaṃ	sat pratyaya kartA na Bavati eka dravyavat tva adravya tvat / na ca dravya tvam
   satpratyayakartṛ dravyapratyayakartṛtvāt / evaṃ guṇakarmabhāvahetvorapi	sat pratyaya kartR dravya pratyaya kartR tvAt / evam guNa karma BAva hetvoH api
   vācyam / ata evamuktam  ubhayatrāvyabhicārāditi / bhāvitārthameva /	vAcyam / atas evam uktam uBayatra avyaBicArAt iti / BAvitArTam eva /
   ākṣepaparihārau pūrvavat //	Akzepa parihArO pUrvavat //
   uktā hetvābhāsāḥ / sāṃprataṃ dṛṣṭāntābhāsānāmavasaraḥ / te ucyante / tatra	uktAH hetvABAsAH / sAMpratam dRzwAnta ABAsAnAm avasaraH / te ucyante / tatra
   yathā dṛṣṭānto dvividhaḥ evaṃ mūlabhedavyapekṣayā tadābhāso 'pi tathā /	yaTA dRzwAntaH dviviDaH evam mUla Beda vyapekzayA tad ABAsaH api taTA /
   āha / dṛṣṭāntābhaso dvividhaḥ / sādharmyeṇa vaidharmyeṇa ca / dṛṣṭānta	Aha / dRzwAnta ABasaH dviviDaH / sADarmyeNa vEDarmyeNa ca / dRzwAnta
   uktalakṣaṇaḥ / dṛṣṭāntavadābhāsa iti dṛṣṭāntābhāsaḥ / dṛṣṭāntapratirūpaka	ukta lakzaNaH / dRzwAntavat ABAsaH iti dRzwAnta ABAsaH / dRzwAnta pratirUpaka
   ityarthaḥ / tatra sādharmyeṇa tāvaddṛṣṭāntābhāsaḥ pañcaprakāraḥ	iti arTaH / tatra sADarmyeNa tAvat dRzwAnta ABAsaH paQca prakAraH
   pañcabhedaḥ tadyathā / sādhanadharmāsiddha ityādi / tadyatheti	paQca BedaH tat yaTA / sADana Darma asidDaH ityAdi / tat yaTA iti
   bhedopadarśanārthaḥ / sādhanadharmo heturasiddho nāstītyucyate / tataśca	Beda upadarSana arTaH / sADana DarmaH hetuH asidDaH na asti iti ucyate / tatas ca
   sādhanadharmo 'siddho 'smin so 'yaṃ sādhanadharmāsiddhaḥ / na tu	sADana DarmaH asidDaH asmin saH ayam sADana Darma asidDaH / na tu
   bahubrīhau niṣṭhāntaṃ pūrvaṃ nipatatīti kṛtvāsiddhasādhanadharmā iti / na	bahu brIhO nizWA antam pUrvam nipatati iti kRtvA asidDa sADana DarmAH iti / na
   vāhitāgnyādiṣu vacanāt / āhitāgnyādeścākṛtigaṇatvādvikalpavṛtteriti / anye	vAhitAgni Adizu vacanAt / AhitAgni AdeH ca AkRti gaNa tvAt vikalpa vRtteH iti / anye
   tu sādhanadharmeṇa rahitatvādasiddhaḥ sādhanadharmāsiddhaḥ iti vyācakṣate	tu sADana DarmeNa rahita tvAt asidDaH sADana Darma asidDaH iti vyAcakzate
   / na caitadatiśobhanam / evaṃ sādhyobhayadharmāsiddhayorapi bhāvanīyam /	/ na ca etat ati SoBanam / evam sADya uBaya Darma asidDayoH api BAvanIyam /
   anvayādiśabdārthaṃ tūdāharaṇādhikāre vakṣyāmaḥ / sa cāvasaraḥ prāpta eveti	anvaya Adi Sabda arTam tu udAharaNa aDikAre vakzyAmaH / sa ca avasaraH prAptaH eva iti
   yathākramaṃ nirdiśyate / tatra sādhanadharmāsiddho yathā / nityaḥ śabdo	yaTAkramam nirdiSyate / tatra sADana Darma asidDaH yaTA / nityaH SabdaH 
   'mūrtatvāt / yathetyudāharaṇopanyasārthaḥ / nityaḥ śabda iti pratijñā	amUrta tvAt / yaTA iti udAharaNa upanyasa arTaH / nityaH SabdaH iti pratijQA
   pakṣaḥ / amūrtatvāditi hetuḥ / anvayamāha /	pakzaH / amUrta tvAt iti hetuH / anvayam Aha /
   yadamūrtaṃ vastu tannityaṃ dṛṣṭaṃ yathā paramāṇuriti sādharmyadṛṣṭāntatvam	yat amUrtam vastu tat nityam dRzwam yaTA paramANuH iti sADarmya dRzwAnta tvam
   / etadābhāsānāmeva prakrāntatvāt / nārtho vaidharmyeṇeti na pradarśitaḥ /	/ etad ABAsAnAm eva prakrAnta tvAt / na arTaH vEDarmyeNa iti na pradarSitaH /
   ayaṃ ca sādhyasādhanadharmānugata iṣyate / iha tu sādhyadharmo 'sti na	ayam ca sADya sADana Darma anugataH izyate / iha tu sADya DarmaH asti na
   sādhanadharmaḥ / tathā cāha / paramāṇau hi sādhyaṃ nityatvamasti /	sADana DarmaH / taTA ca Aha / paramANO hi sADyam nitya tvam asti /
   antyakāraṇatvena nityatvāt / sādhanadharmo 'mūrtatvaṃ nāsti / kutaḥ /	antyakAraNa tvena nitya tvAt / sADana DarmaH amUrta tvam na asti / kutas /
   mūrtatvāt paramāṇunām / mūrtatvaṃ ca mūrtimatkāryaghaṭādyupalabdheḥ	mUrta tvAt paramANunAm / mUrta tvam ca mUrtimat kArya Gawa Adi upalabDeH
   siddhamiti // sādhyadharmāsiddho yathā / nityaḥ śabdo 'mūrtatvād	sidDam iti // sADya Darma asidDaH yaTA / nityaH SabdaH amUrta tvAt 
   buddhivaditi / yadamūrtaṃ vastu tannityaṃ dṛṣṭaṃ yathā buddhiḥ / buddhau	budDi vat iti / yat amUrtam vastu tat nityam dRzwam yaTA budDiH / budDO
   hi sādhanadharmo 'mūrtatvasti sādhyadharmo nityatvaṃ nāsti	hi sADana DarmaH amUrta tu asti sADya DarmaH nitya tvam na asti
   anityatvādbuddhoriti sūtraprayogaḥ sugama eva / vyāptiṃ darśayati /	anitya tvAt budDoH iti sUtra prayogaH sugamaH eva / vyAptim darSayati /
   yadamūrtaṃ vastu tannityaṃ dṛṣṭaṃ yathā buddhiḥ / āha kathamayaṃ	yat amUrtam vastu tat nityam dRzwam yaTA budDiH / Aha kaTam ayam
   sādhyadharmāsiddha? iti / atrāha / buddhau hi sādhanadharmo 'mūrtatvamasti	sADya Darma asidDa? iti / atra Aha / budDO hi sADana DarmaH amUrta tvam asti
   / tadamūrtatvapratīteḥ / sādhyadharmo nityatvaṃ nāsti / kutaḥ? /	/ tad amUrta tva pratIteH / sADya DarmaH nitya tvam na asti / kutas ? /
   anityatvādbuddheriti // ubhayāsiddho dvividhaḥ / katham? ityatrāha /	anitya tvAt budDeH iti // uBaya asidDaH dviviDaH / kaTam? iti atra Aha /
   sannasaṃśceti / sanniti vidyamānobhayāsiddhaḥ / tataśca asanniti	sannasan= ca iti / san= iti vidyamAna uBaya asidDaH / tatas ca asan= iti
   avidyamānobhayāsiddhaḥ / prayogo maula eva draṣṭavyaḥ / yata āha / tatra	avidyamAna uBaya asidDaH / prayogaH mOlaH eva drazwavyaH / yatas Aha / tatra
   ghaṭavadīti vidyamānobhayāsiddhaḥ / tataśca nityaḥ śabdo	Gawavadi iti vidyamAna uBaya asidDaH / tatas ca nityaH SabdaH 
   'mūrtatvādghaṭavadityatra na sādhyadharmo nityatvalakṣaṇaḥ nāpi	amUrta tvAt Gawa vat iti atra na sADya DarmaH nitya tva lakzaNaH na api
   sādhanadharmo 'mūrtatvalakṣaṇo 'sti anityatvānmūrtatvādghaṭasyeti /	sADana DarmaH amUrta tva lakzaNaH asti anitya tvAt mUrta tvAt Gawasya iti /
   tathāākāśavadityavidyamānobhayāsiddhaḥ / tataśca nityaḥ śabdo	taTA AAkASa vaditi avidyamAna uBaya asidDaH / tatas ca nityaH SabdaH 
   'mūrtatvādākāśavaditi /	amUrta tvAt AkASa vat iti /
   nanvayamubhayasabdhāvātkathamubhayāsiddha ityāśaṅkayāha /	nanu ayam uBaya sabDAvAt kaTam uBayA sidDaH iti ASaFkayA Aha /
   tadasattvavādinaṃ prati / ākāśāsattvavādinaṃ bauddhaṃ prati /	tat asattva vAdinam prati / AkASa asattva vAdinam bOdDam prati /
   sāṃkhyasyetyarthaḥ / sati hi tasminnityatvādidharmacintā nānyatheti //	sAMKyasya iti arTaH / sati hi tasmin nitya tva Adi Darma cintA na anyaTA iti //
   ananvaya ityādi / avidyamāno 'nvayo 'nanvayaḥ / apradarśitānvaya ityarthaḥ	ananvayaH ityAdi / avidyamAnaH anvayaH ananvayaH / apradarSita anvayaH iti arTaH
   / anvayo 'nugamo vyāptiriti anarthāntaram / lakṣaṇamāha / yatretyādi /	/ anvayaH anugamaH vyAptiH iti anarTa antaram / lakzaNam Aha / yatra ityAdi /
   yatretyabhidheyamāha / vinānvayena vinā vyāptidarśanena sādhyasādhanayoḥ	yatra iti aBiDeyam Aha / vinA anvayena vinA vyApti darSanena sADya sADanayoH
   sādhyahetvorityarthaḥ / sahabhāva ekavṛttimātram / pradarśyate kathyate	sADya hetvoH iti arTaH / sahaBAvaH eka vRtti mAtram / pradarSyate kaTyate
   ākhyāyate / na vīpsayā sādhyānugateṣu heturiti / udāharaṇamāha / yathā	AKyAyate / na vIpsayA sADya anugatezu hetuH iti / udAharaNam Aha / yaTA
   ghaṭe kṛtakatvamanityaṃ ca dṛṣṭamiti / ghaṭaḥ kṛtakatvānityatvayorāśraya	Gawe kRtaka tvam anityam ca dRzwam iti / GawaH kRtaka tva anitya tvayoH ASraya
   iti / evaṃ sati āśrayāśrayibhāvamātrābhidhānādanyatra	iti / evam sati ASraya ASrayi BAva mAtra aBiDAnAt anyatra
   vyabhicārasaṃbhavādiṣṭārthasādhakatvānupapattiḥ / viparītānvaya ityādi /	vyaBicAra saMBava At izwa arTa sADaka tva anupapattiH / viparIta anvayaH ityAdi /
   viparīto viparyayavṛttiranvayo 'nugamo yasmin tathāvidhaḥ / udāharaṇamāha	viparItaH viparyaya vRttiH anvayaH anugamaH yasmin taTAviDaH / udAharaNam Aha
   / yatkṛtakaṃ tadanityaṃ dṛṣṭamiti vaktavye yadanityaṃ tatkṛtakaṃ dṛṣṭamiti	/ yat kRtakam tat anityam dRzwam iti vaktavye yat anityam tat kRtakam dRzwam iti
   bravīti / evaṃ prāksādhanadharmamanuccārya sādhyadharmamuccārayati / āha /	bravIti / evam prAc sADana Darmam anuccArya sADya Darmam uccArayati / Aha /
   evamapi ko doṣaḥ? iti / ucyate / nyāyamudrāvyatikramaḥ / anyatra	evam api kaH dozaH? iti / ucyate / nyAya mudrA vyatikramaH / anyatra
   vyāptivyabhicārāt / yathā hyanityaḥ śabdaḥ prayatnāntarīyakatvādiyatra	vyApti vyaBicArAt / yaTA hi anityaH SabdaH prayatna AntarIyaka tva Adi yatra
   yadyadanityaṃ tattatprayatnāntarīyakam / anityānāmapi	yat yat anityam tad tad prayatna AntarIyakam / anityAnAm api
   vidyudādīnāmaprayatnānantarīyakatvāt / ityalaṃ prasaṅgena / ayaṃ	vidyut AdInAm aprayatna anantarIyaka tvAt / iti alam prasaFgena / ayam
   sādharmyadṛṣṭāntābhāsaḥ samāptaḥ // vaidharmyeṇāpi / na kevalaṃ	sADarmya dRzwAnta ABAsaH samAptaH // vEDarmyeNa api / na kevalam
   sādharmyeṇaiva / kim? / dṛṣṭāntābhāsaḥ / prāṅnirūpitaśabdārthaḥ /	sADarmyeNa eva / kim? / dRzwAnta ABAsaH / prAc nirUpita Sabda arTaH /
   pañcaprakāraḥ / tadyathā sādhyāvyāvṛtta ityādi / tatra sādhyaṃ pratītaṃ	paQca prakAraH / tat yaTA sADya avyAvRttaH ityAdi / tatra sADyam pratItam
   tadavyāvṛttasmāditi sādhyāvyāvṛttaḥ / ākṣepaparihārau pūrvavat / evaṃ	tat avyAvRttasmAt iti sADya avyAvRttaH / Akzepa parihArO pUrvavat / evam
   sādhanobhayāvyāvṛttayorapi vaktavyam / avyatirekādiśabdārthaṃ	sADana uBaya avyAvRttayoH api vaktavyam / avyatireka Adi Sabda arTam
   tūdāharaṇādhikāra eva vakṣyāmaḥ / sa cāvasaraḥ prāpta eva // tatra	tu udAharaNa aDikAraH eva vakzyAmaH / sa ca avasaraH prAptaH eva // tatra
   sādhyāvyāvṛttaḥ yathā nityaḥ śabdo 'mūrtatvātparamāṇuvat /	sADya avyAvRttaH yaTA nityaH SabdaH amUrta tvAt paramANu vat /
   yathetyudāharaṇopanyāsārthaḥ / nityaḥ śabda iti pratijñā / amūrtatvāditi	yaTA iti udAharaNa upanyAsa arTaH / nityaH SabdaH iti pratijQA / amUrta tvAt iti
   hetuḥ / vaidharmyadṛṣṭāntābhāsasya prakrāntatvātsādharmyadṛṣṭānto noktaḥ /	hetuH / vEDarmya dRzwAnta ABAsasya prakrAnta tvAt sADarmya dRzwAntaH na uktaH /
   abhyūhyaścākāśādiḥ /	aByUhyaH ca AkASa AdiH /
   vaidharmyadṛṣṭāntastu paramāṇuḥ / ayaṃ ca sādhyasādhanobhayadharmavikalaḥ	vEDarmya dRzwAntaH tu paramANuH / ayam ca sADya sADana uBaya Darma vikalaH
   samyagiṣyate / yata uktam / sādhyābhāve hetorabhāva eva kathyate ityādi /	samyak izyate / yatas uktam / sADya aBAve hetoH aBAvaH eva kaTyate ityAdi /
   na cāyaṃ tathetyāha ca / paramāṇorhi sakāśāt / sādhanadharmo hetuḥ /	na ca ayam taTA iti Aha ca / paramANoH hi sakASAt / sADana DarmaH hetuH /
   tameva darśayati amūrtatvamiti / vyāvṛttaṃ nivṛttam / kutaḥ? /	tam eva darSayati amUrta tvam iti / vyAvRttam nivRttam / kutas ? /
   mūrtatvātparamāṇunām / sādhyadharmo nityatvaṃ tanna vyāvṛttam / kutaḥ? /	mUrta tvAt paramANunAm / sADya DarmaH nitya tvam tat na vyAvRttam / kutas ? /
   nityatvātparamāṇūnām / āha / sādharmyadṛṣṭāntābhāseṣvādau	nitya tvAt paramANUnAm / Aha / sADarmya dRzwAnta ABAsezu AdO
   sādhanadharmāsiddha uktaḥ iha sādhyāvyāvṛtta iti kimarthamucyate? /	sADana Darma asidDaH uktaH iha sADya avyAvRttaH iti kim arTam ucyate? /
   tasyānvayapradhānatvāt / anvayasya ca	tasya anvaya praDAna tvAt / anvayasya ca
   sādhanadharmapuraḥsarasādhyadharmoccāraṇarūpatvāt / vyatirekastu	sADana Darma puraHsara sADya Darma uccAraNa rUpa tvAt / vyatirekaH tu
   ubhayavyāvṛttirūpaḥ sādhyābhāve ca hetorabhāva iti / ataḥ sādhyāvyāvṛttaḥ	uBaya vyAvRtti rUpaH sADya aBAve ca hetoH aBAvaH iti / atas sADya avyAvRttaH
   // tathā sādhanāvyāvṛttaḥ karmavat / prayogaḥ pūrvavadeva /	// taTA sADana avyAvRttaH karma vat / prayogaH pUrvavat eva /
   vaidharmyadṛṣṭāntastu karma / tacca utkṣepaṇādi gṛhyate / tatra karmaṇaḥ	vEDarmya dRzwAntaH tu karma / tat ca utkzepaNa Adi gRhyate / tatra karmaNaH
   sādhyaṃ nityatvaṃ vyāvṛttam / anityatvātkarmaṇaḥ / sādhanadharmo hetuḥ /	sADyam nitya tvam vyAvRttam / anitya tvAt karmaNaH / sADana DarmaH hetuH /
   tameva darśayati amūrtatvamiti / tanna vyāvṛttam / amūrtatvātkarmaṇa iti	tam eva darSayati amUrta tvam iti / tat na vyAvRttam / amUrta tvAt karmaNaH iti
   // ubhayāvyāvṛttaḥākāśavaditi / nityatvasādhakaḥ prayogaḥ	// uBaya avi AvRttaH AkASa vat iti / nitya tva sADakaH prayogaH
   paramāṇvādisādharmyadṛṣṭāntayuktaḥ pūrvavat /	paramANu Adi sADarmya dRzwAnta yuktaH pUrvavat /
   vaidharmyadṛṣṭāntastvākāśamiti / tato hi ākāśāt / na nityatvaṃ vyāvṛttaṃ	vEDarmya dRzwAntaH tu AkASam iti / tatas hi AkASAt / na nitya tvam vyAvRttam
   nāpyamūrtatvam / kutaḥ? / nityatvādamūrtatvādākāśasyeti // avyatireka	na api amUrta tvam / kutas ? / nitya tvAt amUrta tvAt AkASasya iti // avyatireka
   ityādi / avidyamānavyātirekaḥ avyatirekaḥ anidarśitavyatireka ityarthaḥ /	ityAdi / avidyamAna vyAtiH ekaH avyatirekaH anidarSita vyatirekaH iti arTaH /
   lakṣaṇamāha / yatra vinā sādhyasādhananivṛttyā tadvipakṣabhāvo nidarśyate	lakzaNam Aha / yatra vinA sADya sADana nivRttyA tad vipakza BAvaH nidarSyate
   / yatretyabhidheyamāha / vinā sādhyasādhananivṛttyā prastutaprayoge	/ yatra iti aBiDeyam Aha / vinA sADya sADana nivRttyA prastuta prayoge
   yadanityaṃ tanmūrtaṃ dṛṣṭamityādilakṣaṇayā / tadvipakṣabhāvaḥ	yat anityam tat mUrtam dRzwam ityAdi lakzaNayA / tad vipakza BAvaH
   sādhyasādhanavipakṣabhāvamātram / nidarśyate pratipādyate iti yāvat /	sADya sADana vipakza BAva mAtram / nidarSyate pratipAdyate iti yAvat /
   dṛṣṭāntamāha / yathā ghaṭe 'nityatvaṃ ca murtatvaṃ ca dṛṣṭamiti / itthaṃ	dRzwAntam Aha / yaTA Gawe anitya tvam ca murta tvam ca dRzwam iti / itTam
   hyekatrābhidheyamātrābhidhānādvaidharmyāpratipādanādarthāpattyāpi gamyate	hi ekatra aBiDeya mAtra aBiDAnAt vEDarmya apratipAdanAt arTa ApattyA api gamyate
   pratipattigauravādiṣṭārthasādhakatvamiti // viparitavyatireka ityādi /	pratipatti gOrava Adizwa arTa sADaka tvam iti // viparitavyatirekaH ityAdi /
   viparīto viparyasto vyatireka uktalakṣaṇo yasmin sa tathāvidhaḥ / tameva	viparItaH viparyastaH vyatirekaH ukta lakzaNaH yasmin sa taTAviDaH / tam eva
   darśayati / yadanityamityādi / prastutaprayoga eva	darSayati / yat anityam ityAdi / prastuta prayogaH eva
   tathāvidhasādharmyadṛṣṭāntayukte vyatirekamupadeśayan yadanityaṃ tanmūrtaṃ	taTAviDa sADarmya dRzwAnta yukte vyatirekam upadeSayan yat anityam tat mUrtam
   dṛṣṭa miti vaktavye yanmūrta tadanityaṃ dṛṣṭamiti bravīti / āha / evamapi	dRzwa miti vaktavye yat mUrta tat anityam dRzwam iti bravIti / Aha / evam api
   ko doṣaḥ? iti / ucyate / anyatra vyabhicāraḥ / tathā hyanityaḥ śabdaḥ	kaH dozaH? iti / ucyate / anyatra vyaBicAraH / taTA hi anityaH SabdaH
   prayatnānantarīyakatvādityatra yadaprayatnānantarīyakaṃ tannityamiti /	prayatna anantarIyaka tvAt iti atra yat aprayatna AnantarIyakam tat nityam iti /
   vyatireko vidyutā vyabhicāraḥ // nigamayannāha / eṣāmityādi /	vyatirekaH vidyutA vyaBicAraH // nigamayan= Aha / ezAm ityAdi /
   yathoktarūpāṇāṃ pakṣahetudṛṣṭāntābhāsānāṃ vacanāni / kiṃ na sādhanam? /	yaTA ukta rUpANAm pakza hetu dRzwAnta ABAsAnAm vacanAni / kim na sADanam? /
   ābhāsatvādeva / kiṃ tarhi? / sādhanābhāsamiti // uktaṃ sādhanābhāsam //	ABAsa tvAt eva / kim tarhi? / sADana ABAsam iti // uktam sADana ABAsam //
   adhunā dūṣaṇasyāvasaraḥ / taccātikramya	aDunA dUzaNasya avasaraH / tat ca atikramya
   bahutaravaktavyatvātpratyakṣānumāne tāvadāha / ātmapratyāyanārthaṃ punaḥ	bahutara vaktavya tvAt pratyakza anumAne tAvat Aha / Atma pratyAyana arTam punar 
   pratyakṣamanumānaṃ ca dve eva pramāṇe / pratyakṣaṃ vakṣyamāṇalakṣaṇaṃ	pratyakzam anumAnam ca dve eva pramANe / pratyakzam vakzyamANa lakzaNam
   anumānaṃ ca / asamāsakaraṇaṃ vibhinnaviṣayajñāpanārtham /	anumAnam ca / asamAsa karaNam viBinna vizaya jQApana arTam /
   svalakṣaṇaviṣayameva pratyakṣam / sāmānyalakṣaṇaviṣayamevānumānam / ca	sva lakzaNa vizayam eva pratyakzam / sAmAnya lakzaNa vizayam eva anumAnam / ca
   samuccaye / dve eva pramāṇe ityanena saṃkhyāniyamamāha / tathāhi	samuccaye / dve eva pramANe iti anena saMKyA niyamam Aha / taTA hi
   bauddhānāṃ dve eva pramāṇe pratyakṣānumāne /	bOdDAnAm dve eva pramANe pratyakza anumAne /
   śeṣapramāṇānāmatraivāntarbhāvāt / antarbhāvaśca pramāṇasamuccayādiṣu	Seza pramANAnAm atra eva antarBAvAt / antarBAvaH ca pramANa samuccaya Adizu
   carcitatvānneha pratanyate / adhunā pratyakṣaṇirūpaṇāyāha / tatra	carcita tvAt na iha pratanyate / aDunA pratyakzaNi rUpaNAya Aha / tatra
   pratyakṣamityādi / tatreti nirdhāraṇārthaḥ / pratyakṣamiti lakṣyanirdeśaḥ	pratyakzam ityAdi / tatra iti nirDAraNa arTaH / pratyakzam iti lakzya nirdeSaH
   / kalpanāpoḍhamiti lakṣaṇam / ayaṃ lakṣyalakṣaṇapravibhāgaḥ / tatra	/ kalpanA apoXam iti lakzaNam / ayam lakzya lakzaNa praviBAgaH / tatra
   pratigatamakṣaṃ pratyakṣam / kalpanāpoḍhamiti / kalpanā vakṣyamāṇalakṣaṇā	pratigatam akzam pratyakzam / kalpanA apoXam iti / kalpanA vakzyamANa lakzaNA
   sā apoḍhā apetā yasmāt tat kalpanāpoḍham / samāsākṣepaparihārau pūrvavat /	sA apoXAH apetAH yasmAt tat kalpanA apoXam / samAsa Akzepa parihArO pUrvavat /
   kalpanayāpoḍhaṃ kalpanāyā vāpoḍhaṃ kalpanāpoḍham / yat iti	kalpanayA apoXam kalpanAyAH vA apoXam kalpanA apoXam / yat iti
   tatsvarūpanirdeśaḥ / evaṃbhūtaṃ cārthe svalakṣaṇamapi bhavati / āha /	tad svarUpa nirdeSaH / evaMBUtam ca arTe sva lakzaNam api Bavati / Aha /
   jñānaṃ saṃvedanam / tacca nirviṣayamapi bhavati ata āha arthe viṣaye / sa	jQAnam saMvedanam / tat ca nirvizayam api Bavati atas Aha arTe vizaye / sa
   ca dvidhā svalakṣaṇasāmānyalakṣaṇabhedāt / ata āha / rūpādau svalakṣaṇe	ca dviDA sva lakzaNa sAmAnya lakzaNa BedAt / atas Aha / rUpa AdO sva lakzaNe
   ityarthaḥ / iha yaduktaṃ kalpanāpoḍhamiti tatsvarūpābhidhānata eva	iti arTaH / iha yat uktam kalpanA apoXam iti tad svarUpa aBiDAnataH eva
   vyācaṣṭe nāmajātyādikalpanārahitam / tadakṣamakṣaṃ prati vartate iti	vyAcazwe nAma jAti Adi kalpanA rahitam / tat akzam akzam prati vartate iti
   pratyakṣam / tatra nāmakalpanā yathā ḍitthā iti / jātikalpanā yathā	pratyakzam / tatra nAma kalpanA yaTA xitTAH iti / jAti kalpanA yaTA
   gauriti / ādiśabdena guṇakriyādravyaparigrahaḥ / tatra guṇakalpanā śukla	gOH iti / Adi Sabdena guNa kriyA dravya parigrahaH / tatra guNa kalpanA Sukla
   iti / kriyākalpanā pācaka iti / dravyakalpanā daṇḍīti / ābhiḥ kalpanābhī	iti / kriyA kalpanA pAcakaH iti / dravya kalpanA daNxI iti / ABiH kalpanABI
   rahitaṃ śabdarahitam / svalakṣaṇahetutvāt / uktaṃ ca / na hyarthe śabdāḥ	rahitam Sabda rahitam / sva lakzaNa hetu tvAt / uktam ca / na hi arTe SabdAH
   anti tadātmāno vā yena tasminpratibhāsamāne te 'pi pratibhāserannityādi /	anti tad AtmAnaH vA yena tasmin pratiBAsamAne te api pratiBAseran= ityAdi /
   tadakṣamityādi / tadityanena yannirdiṣṭasya parāmarśaḥ / akṣāṇīndriyāṇi /	tat akzam ityAdi / tat iti anena yat nirdizwasya parAmarSaH / akzANi indriyANi /
   tataścākṣamakṣaṃ pratīndriyamindriyaṃ prativartata iti pratyakṣam / āha /	tatas ca akzam akzam pratIndriyam indriyam prativartate iti pratyakzam / Aha /
   yathendriyasāmarthyājjñānamutpadyate tathā viṣayasāmarthyādapi	yaTA indriya sAmarTyAt jQAnam utpadyate taTA vizaya sAmarTyAt api
   tatkasmādindriyeṇaiva vyapadeśo na viṣayeṇeti? / atrocyate /	tat kasmAt indriyeNa eva vyapadeSaH na vizayeNa iti? / atra ucyate /
   asādhāraṇatvādindriyasya sādharaṇatvāccārthasyeti / tathā hi /	asADAraNa tvAt indriyasya sADaraNa tvAt ca arTasya iti / taTA hi /
   indriyamindriyavijñānasyaiva heturityasādharaṇam / arthastu	indriyam indriya vijQAnasya eva hetuH iti asADaraNam / arTaH tu
   manovijñānasyāpīti sādhāraṇaḥ / asādhāraṇena ca loke	manaH vijQAnasya api iti sADAraNaH / asADAraNena ca loke
   vyapadeśapravṛttiryathā bherīśabdo yavāṅkura iti / uktaṃ ca bhadantena /	vyapadeSa pravRttiH yaTA BerI SabdaH yava aFkuraH iti / uktam ca Badantena /
   asādhāraṇahetutvādakṣaistadyapariśyate ityādi / āha / manovijñānādyapi	asADAraNa hetu tvAt akzEH tadi apariSyate ityAdi / Aha / manaH vijQAna Adi api
   pratyakṣamityuktaṃ na ca tadanena saṃgṛhītamiti kathaṃ vyāpitā lakṣaṇasya	pratyakzam iti uktam na ca tat anena saMgRhItam iti kaTam vyApitA lakzaNasya
   / ucyate / kalpanāpoḍhaṃ yattajjñānarthe rūpādau	/ ucyate / kalpanA apoXam yat tat jQAnarTe rUpa AdO
   ityanenārthasākṣātkāritvagrahaṇānmanovijñānaderapi	iti anena arTa sAkzAt kAritva grahaNAt manaH vijQAna deH api
   tadavyabhicārātsaṃgṛhītameva tanmānasam / laukikaṃ tu	tat avyaBicArAt saMgRhItam eva tad mAnasam / lOkikam tu
   pratyakṣamadhikṛtyāvyayībhāvaḥ / iti kṛtaṃ prasaṅgeṇa / gamanikāmātrametat	pratyakzam aDikRtya avyayIBAvaH / iti kRtam prasaFgeNa / gamanikA mAtram etat 
   // anumānamityādi / anumitiramumānam / tacca liṅgādarthadarśanamāliṅgaṃ	// anumAnam ityAdi / anumitiH amu mAnam / tat ca liFgAt arTa darSanam AliFgam
   punastrirūpamuktam / pakṣadharmatvādi / tasmātrirūpālliṅgādyadanumeye	punar tri rUpam uktam / pakza Darma tva Adi / tasmAtri rUpAt liFgAt yat anumeye
   'rthe dharmaviśiṣṭe dharmiṇi jñānamutpadyate kiṃviśiṣṭam? agniratra dhūmāt	arTe Darma viSizwe DarmiNi jQAnam utpadyate kiMviSizwam? agniH atra DUmAt 
   anityaḥ śabdaḥ kṛtakatvāt tadanumānamiti / udāharaṇadvayaṃ tu	anityaH SabdaH kRtaka tvAt tad anumAnam iti / udAharaNa dvayam tu
   vastusādhanakāryasvabhāvākhyahetudvayakhyāpanārtham / adhunā phalamāha /	vastu sADana kArya svaBAva AKya hetu dvaya KyApana arTam / aDunA Palam Aha /
   ubhayatretyādi / ubhatra pratyekṣe 'numāne ca / tadeva jñānaṃ	uBayatra ityAdi / uBatra pratyekze anumAne ca / tat eva jQAnam
   pratyakṣanumānalakṣaṇam / phalaṃ kāryam / kutaḥ? / adhigamarūpatvāt /	pratyakza numAna lakzaNam / Palam kAryam / kutas ? / aDigama rUpa tvAt /
   adhigamaḥ paricchedastadrūpatvāt / tathāhi paricchedarūpameva	aDigamaH paricCedaH tad rUpa tvAt / taTA hi paricCeda rUpam eva
   jñānamutpadyate / na ca paricchedādṛte anyajjñānaṃ phalam /	jQAnam utpadyate / na ca paricCedAt Rte anyat jQAnam Palam /
   bhinnādhikaraṇatvāt / ityatra bahu vaktavyam alaṃ prasaṅgena / sarvathā na	Binna aDikaraNa tvAt / iti atra bahu vaktavyam alam prasaFgena / sarvaTA na
   pratyakṣānumānābhyāmanyadvibhinnaṃ phalamastīti / āha / yadyevaṃ	pratyakza anumAnAByAm anyat viBinnam Palam asti iti / Aha / yadi evam
   pramāṇābhāvaprasaṅgaḥ / tabdhāvābhimatayoḥ pratyakṣānumānayoḥ phalatvāt /	pramANa aBAva prasaFgaH / tabDAva aBimatayoH pratyakza anumAnayoH PalatvAt /
   pramāṇābhāve ca tatphalasyāpyabhāvaḥ iti /	pramANa aBAve ca tad Palasya api aBAvaH iti /
   tatra pramāṇābhāvanirācikīrṣayāha / savyāpāravatkhyāteḥ pramāṇatvamiti	tatra pramANa aBAva nirAcikIrzayA Aha / savya apAravat KyAteH pramANa tvam iti
   saha vyāpāreṇa viṣayagrahaṇalakṣaṇena vartate iti savyāpāram / pramāṇamiti	saha vyApAreNa vizaya grahaNa lakzaNena vartate iti sa vya apAram / pramANam iti
   gamyate / savyāpāramasyā vidyata iti savyāpāravatī / khyātiriti gamyate /	gamyate / savya apAram asyAH vidyate iti savyApAravatI / KyAtiH iti gamyate /
   savyāpāravatī cāsau khyātiśca savyāpāravatkhyātiḥ pratītiḥ / tasyāḥ	savyApAravatI ca asO KyAtiH ca sa vya apAravat KyAtiH pratItiH / tasyAH
   savyāpāravattyāḥ khyāteḥ pramāṇatvamiti / etaduktaṃ bhavati / viṣayākāraṃ	savya apAravattyAH KyAteH pramANa tvam iti / etat uktam Bavati / vizaya AkAram
   jñānamutpadyamānaṃ viṣayaṃ gṛṇhadevotpadyate iti pratīteḥ grāhakākārasya	jQAnam utpadyamAnam vizayam gRNhadeva utpadyate iti pratIteH grAhaka AkArasya
   pramāṇateti / anye tu saṃścāsau vyāpāraḥ sadvyāpāraḥ	pramANa tA iti / anye tu san= ca asO vyApAraH sat vyApAraH
   pramāṇavyavasthākāritvātsannityucyate / so 'syā vidyata iti sadyāpāravatī	pramANa vyavasTA kAri tvAt san= iti ucyate / saH asyAH vidyate iti sadyA pAravatI
   śeṣaṃ pūrvavat vyācakṣate / ityukte pratyakṣānumāne // adhunā	Sezam pUrvavat vyAcakzate / iti ukte pratyakza anumAne // aDunA
   pratyekṣābhāsamāha / kalpanājñānamarthāntare pratyakṣābhāsam / etadeva	pratyekza ABAsam Aha / kalpanA jQAnam arTa antare pratyakza ABAsam / etat eva
   grahaṇavākyaṃ vyācikhyāsurāha / yajjñānaṃ ghaṭaḥ paṭa iti vā vikalpayataḥ	grahaNa vAkyam vyAciKyAsurA Aha / yat jQAnam GawaH pawaH iti vA vikalpayataH
   śabdāropitamutpadyate / arthāntare sāmānyalakṣaṇe /	Sabda Aropitam utpadyate / arTa antare sAmAnya lakzaNe /
   tadarthasvalakṣaṇāviṣayatvāt / sāmānyalakṣaṇaviṣayatvādityarthaḥ / uktaṃ	tad arTa sva lakzaNa avizaya tvAt / sAmAnya lakzaNa vizaya tvAt iti arTaH / uktam
   pratyakṣābhāsam //	pratyakza ABAsam //
   sāṃpratamanumānābhāsamāha / hetvābhāsapūrvakaṃ hetvābhāsanimittaṃ	sAMpratam anumAna ABAsam Aha / hetvABAsa pUrvakam hetvABAsa nimittam
   jñānamanumānābhāsam / vyabhicārāt / etadeva vyācaṣṭe / hetvābhāso hi	jQAnam anumAna ABAsam / vyaBicArAt / etat eva vyAcazwe / hetvABAsaH hi
   bahuprakāra uktaḥ asti vādibhedena / tasmāt hetvābhāsāt yadanumeye 'rthe	bahu prakAraH uktaH asti vAdi Bedena / tasmAt hetvABAsAt yat anumeye arTe
   dharmaviśiṣṭe dharmiṇi jñānam avyutpannasya asiddhādisvarūpānabhijñasya	Darma viSizwe DarmiNi jQAnam avyutpannasya asidDa Adi svarUpa anaBijQasya
   bhavati tadanumānābhāsam / ityuktaṃ pratyakṣādicatuṣṭayam //	Bavati tad anumAna ABAsam / iti uktam pratyakza Adi catuzwayam //
   idānīmuktaśeṣaṃ duṣaṇamabhidhātukāma āha / sādhanadoṣodbhāvanāni dūṣaṇāni	idAnIm ukta Sezam duzaNam aBiDAtu kAmaH Aha / sADana doza udBAvanAni dUzaNAni
   / pramāṇadoṣaprakaṭanānītyarthaḥ / bahuvacananirdeśaḥ pratyekamapi	/ pramANa doza prakawanAni iti arTaH / bahuvacana nirdeSaH pratyekam api
   pratijñādidoṣāṇāṃ dūṣaṇatvāt / etānyeva daśayīrta / sādhanadoṣo nyūnatvam	pratijQa Adi dozANAm dUzaNa tvAt / etAni eva daSa yIrta / sADana dozaH nyUna tvam
   / sāmānyena viśeṣamāha / pakṣadoṣaḥ pratyakṣadiviruddhatvam /	/ sAmAnyena viSezam Aha / pakza dozaH pratyakza divi rudDa tvam /
   pratyakṣādiviruddhā pratijñetyevamādi / hetudoṣaḥ	pratyakza Adi virudDA pratijQA iti evamAdi / hetu dozaH
   asiddhānaikāntikaviruddhatvam / asiddho heturityevamādi / evaṃ	asidDa anEkAntika virudDa tvam / asidDaH hetuH iti evamAdi / evam
   dṛṣṭāntadoṣāḥ sādhanadharmādyasiddhatvam / tasyodbhāvanamiti / tasya	dRzwAnta dozAH sADana Darma Adi asidDa tvam / tasya udBAvanam iti / tasya
   pratyakṣaviruddhahetvādeḥ prakāśanaṃ prāśnikapratyāyanaṃ na	pratyakza virudDa hetu AdeH prakASanam prASnika pratyAyanam na
   tudbhāvanamātrameva / dūṣaṇamiti sāmānyena	tudBAvana mAtram eva / dUzaNam iti sAmAnyena
   dūṣaṇajātyanatikramādekavacanamiti / uktaṃ dūṣaṇam // adhunā	dUzaNa jAti anatikramAt eka vacanam iti / uktam dUzaNam // aDunA
   dūṣāṇābhāsamāha / abhūtasādhanadoṣodbhāvanāni dūṣaṇābhāsāni /	dUzANABAsam Aha / aBUta sADana doza udBAvanAni dUzaNa ABAsAni /
   abhūtamavidyamānameva tadyataḥ sādhanadoṣaṃ sāmānyanodbhāvayanti	aBUtam avidyamAnam eva tat yatas sADana dozam sAmAnyana udBAvayanti
   prakāśayanti yāni tāni jātidūṣaṇābhāsāni / etadeva darśayati / saṃpūrṇe	prakASayanti yAni tAni jAti dUzaNa ABAsAni / etat eva darSayati / saMpUrNe
   sādhane avayave nyūnatvavacanam / nyūnamidamityevaṃbhūtam / aduṣṭapakṣe	sADane avayave nyUna tva vacanam / nyUnam idam iti evaMBUtam / aduzwa pakze
   pakṣa doṣavacanam ityādi nigadasiddham / yāvad etāni duṣaṇābhāsāni kim? /	pakza doza vacanam ityAdi nigada sidDam / yAvat etAni duzaNa ABAsAni kim? /
   ityata āha / nahyebhiḥ parapakṣo dūṣyate / kutaḥ? /	iti atas Aha / na hi eBiH para pakzaH dUzyate / kutas ? /
   niravadyatvātparapakṣasya / ityuparamyate śāstrakaraṇāt //	niravadya tvAt para pakzasya / iti uparamyate SAstra karaNAt //
   śāstraparisamāptau tatsvarūpapratipādanāyaivāha / padārthamātramityādi /	SAstra parisamAptO tad svarUpa pratipAdanAya eva Aha / padArTa mAtram ityAdi /
   padārthamātramiti sādhanādipadoddeśamātrama / ākhyātaṃ kathitam / ādau	padArTa mAtram iti sADana Adi pada uddeSa mAtramaH / AKyAtam kaTitam / AdO
   prathamam / diṅmātrasiddhaye nyāyadiṅmātrasiddhayartham / yātra	praTamam / diS mAtra sidDaye nyAya diS mAtra sidDayarTam / yAtra
   yuktiranvayavyatirekalakṣaṇā / ayuktirvā asiddhādibhedā / sānyatra	yuktiH anvaya vyatireka lakzaNA / ayuktiH vA asidDa Adi BedAH / sA anyatra
   pramāṇasamuccayādau / suvicāritā prapañcena nirūpitetyarthaḥ //	pramANa samuccaya AdO / su vicAritA prapaQcena nirUpitA iti arTaH //
   nyāyapraveśakaṃ yadyākhyāyāvāptamiha mayā puṇyam /	nyAya praveSakam yadi AKyAya avAptam iha mayA puNyam /
   nyāyādigamasukhadaṃ saṃlabhatā bhavyo janastena //	nyAya Adi gama suKa dam saMlaBatA BavyaH janaH tena //
   samāptā ceyaṃ śiṣyahitā nāma nyāyapraveśakaṭīkā //	samAptA ca iyam Sizya hitA nAma nyAya praveSa kawIkAH //
   kṛtiriyaṃ haribhadrasūreḥ //	kRtiH iyam hariBadra sUreH //
