   (Dhs, Vaidya 329)	(Dhs, VEdyaH 329)
   Dharmasaṃgrahaḥ / (Dhs)	Dharma saMgrahaH / (Dhs)
   // namo ratnatrayāya //	// namaH ratnatrayAya //
   ratnatrayaṃ namaskṛtya sarvasattvahitodayam /	ratna trayam namaskRtya sarva sattva hita udayam /
   kathyate mohanāśāya dharmasārasamuccayaḥ //	kaTyate moha nASAya DarmasAra samuccayaH //
   1. tatra prathamaṃ tāvat trīṇi ratnāni / tathadyā   buddho dharmaḥ	1. tatra praTamam tAvat trINi ratnAni / taTadyAH  budDaH DarmaH
   saṃghaśceti //	saMGaH ca iti //
   2. trīṇi yānāni /[tadyathā  ] śrāvakayānam, pratyekabuddhayānam, mahāyānaṃ	2. trINi yAnAni /[tat yaTA  ] SrAvaka yAnam, pratyekabudDa yAnam, mahAyAnam
   ceti //	ca iti //
   3. pañca buddhāḥ / tadyathā   vairocanaḥ, akṣobhyaḥ, ratnasaṃbhavaḥ,	3. paQca budDAH / tat yaTA  vErocanaH, akzoByaH, ratna saMBavaH,
   amitābhaḥ, amoghasiddhiśceti //	amita ABaH, amoGa sidDiH ca iti //
   4. catasro devyaḥ / tadyathā   rocanī, māmakī, pāṇḍurā, tārā ceti //	4. catasraH devyaH / tat yaTA  rocanI, mAmakI, pANxurA, tArA ca iti //
   5. pañca rakṣā / tadyathā   pratisarā, sāhasrapramardanī, mārīcī,	5. paQca rakzA / tat yaTA  pratisarA, sAhasra pramardanI, mArIcI,
   mantrānusāriṇī, śīlavatī ceti //	mantra anusAriNI, SIlavatI ca iti //
   6. sapta tathāgatāḥ / tadyathā   vipaśyī, śikhī, viśvabhūḥ, krakucchandaḥ,	6. sapta taTAgatAH / tat yaTA  vipaSyI, SiKI, viSvaBUH, krakucCandaH,
   kanakamuniḥ, kāśyapaḥ, śākyamuniśceti //	kanaka muniH, kASyapaH, SAkya muniH ca iti //
   7. catvāro lokapālāḥ / tadyathā   dhṛtarāṣṭraḥ, virūpākṣaḥ, virūḍhakaḥ,	7. catvAraH lokapAlAH / tat yaTA  DRtarAzwraH, virUpAkzaH, virUXakaH,
   kuberaśceti //	kuberaH ca iti //
   8. aṣṭau lokapālāḥ / tadyathā   indraḥ, yamaḥ, varaṇaḥ, kuberaḥ, īśānaḥ,	8. azwO lokapAlAH / tat yaTA  indraH, yamaH, varaNaH, kuberaH, ISAnaH,
   agniḥ, nairṛtaḥ, vāyuriti //	agniH, nErRtaH, vAyuH iti //
   9. daśa lokapālāḥ / aṣṭalokapālādhikamūrdhvaṃ brahmā adhaḥ kṛṣṇaḥ //	9. daSa lokapAlAH / azwa lokapAla aDikam UrDvam brahmA aDas kRzNaH //
   10. caturdaśa lokapālāḥ / tadyathā   daśalokapālasakalam, candraḥ, sūryaḥ,	10. caturdaSa lokapAlAH / tat yaTA  daSa lokapAla sakalam, candraH, sUryaH,
   pṛthvī, asuraḥ //	pRTvI, asuraH //
   11. daśa krodhāḥ / tadyathā   yamāntakaḥ, prajñāntakaḥ, padmāntakaḥ,	11. daSa kroDAH / tat yaTA  yamAntakaH, prajQA antakaH, padmAntakaH,
   vighnāntakaḥ, acaraṭarkirājaḥ, nīladaṇḍaḥ, mahābalaḥ, uṣṇīṣaḥ, cakravartī,	viGnAntakaH, acarawarki rAjaH, nIladaNxaH, mahA balaH, uzNIzaH, cakravartI,
   sambharājaśceti //	samBarA jaH ca iti //
   12. aṣṭau bodhisattvāḥ / tadyathā   maitreyaḥ, gaganagañjaḥ,	12. azwO boDisattvAH / tat yaTA  mEtreyaH, gagana gaQjaH,
   samantabhadraḥ, vajrapāṇiḥ, mañjuśrīḥ, sarvanivaraṇaviṣkambhī,	samantaBadraH, vajrapANiH, maQjuSrIH, sarva nivaraNa vizkamBI,
   kṣitigarbhaḥ, khagarbhaśceti //	kzitigarBaH, KagarBaH ca iti //
   13. ṣaḍyoginyaḥ / tadyathā   vajravārāhī, yāminī, saṃcāraṇī, saṃtrāsanī,	13. zaz yoginyaH / tat yaTA  vajra vArAhI, yAminI, saMcAraNI, saMtrAsanI,
   cāṇḍikā ceti //	cANxikA ca iti //
   (Dhs, Vaidya 330)	(Dhs, VEdyaH 330)
   14. saptavidhā anuttarapūjā / tadyathā   vandanā, pūjanā, pāpadeśanā,	14. saptaviDA anuttara pUjA / tat yaTA  vandanA, pUjanA, pApa deSanA,
   anumodanā, adhyeṣaṇā, bodhicittotpādaḥ, pariṇāmanā ceti //	anumodanA, aDyezaNA, boDi citta utpAdaH, pariNAmanA ca iti //
   15. trīṇi kuśalamūlāni / bodhicittotpādaḥ, āśayaviśuddhiḥ,	15. trINi kuSala mUlAni / boDi citta utpAdaH, ASaya viSudDiH,
   ahaṃkāramamakāraparityāgaśceti //	ahaMkAra mamakAra parityAgaH ca iti //
   16. catvāro brahmavihārāḥ / maitrī, karuṇā, muditā, upekṣā ceti //	16. catvAraH brahma vihArAH / mEtrI, karuNA, muditA, upekzA ca iti //
   17. ṣaṭ pāramitāḥ / dānapāramitā, śīlapāramitā, kṣāntipāramitā,	17. zaw pAramitAH / dAna pAramitA, SIla pAramitA, kzAnti pAramitA,
   vīryapāramitā, dhyānapāramitā, prajñāpāramitā ceti //	vIrya pAramitA, DyAna pAramitA, prajQApAramitA ca iti //
   18. daśa pāramitāḥ / ṣaṭpāramitāsakalam, upāyam, praṇidhiḥ, balam, jñānaṃ	18. daSa pAramitAH / zaz pAra mitA sakalam, upAyam, praNiDiH, balam, jQAnam
   ceti //	ca iti //
   19. catvāri saṃgrahavastūnī / dānam, priyavacanam, arthacaryā,	19. catvAri saMgraha vastUnI / dAnam, priya vacanam, arTa caryA,
   samānārthatā ceti //	samAna arTa tA ca iti //
   20. pañcābhijñāḥ / divyacakṣuḥ, divyaśrotram, paracittajñānam,	20. paQca aBijQAH / divya cakzuH, divya Srotram, para citta jQAnam,
   pūrvanivāsānusmṛtiḥ, ṛddhiśceti //	pUrva nivAsa anusmRtiH, RdDiH ca iti //
   21. catvāryāryasatyāni / tadyathā   duḥkham, samudayaḥ, nirodhaḥ	21. catvAri Arya satyAni / tat yaTA  duHKam, samudayaH, niroDaH
   mārgaśceti //	mArgaH ca iti //
   22. pañca skandhāḥ / rūpam, vedanā, saṃjñā, saṃskārā, vijñānaṃ ceti //	22. paQca skanDAH / rUpam, vedanA, saMjQA, saMskArA, vijQAnam ca iti //
   23. lokottarapañcaskandhāḥ /	23. loka uttara paQca skanDAH /
   śīlasamādhiprajñāvimuktivimuktijñānadarśanaskandhā iti //	SIla samADi prajQA vimukti vimukti jQAna darSana skanDAH iti //
   24. dvādaśāyatanāni / cakṣuḥśrotraghrāṇajihvākāyamanaāyatanāni	24. dvAdaSa AyatanAni / cakzuH Srotra GrANa jihvA kAya manaA AyatanAni
   rūpagandhaśabdarasasparśadharmāyatanāni ceti //	rUpa ganDa Sabda rasa sparSa Darma AyatanAni ca iti //
   25. aṣṭādaśa dhātavaḥ //	25. azwAdaSa DAtavaH //
   cakṣuḥśrotraghrāṇajihvākāyamanorūpagandhaśabdarasasparśadharmadhātavaḥ	cakzuH Srotra GrANa jihvA kAya manaH rUpa ganDa Sabda rasa sparSa Darma DAtavaH
   cakṣurvijñānaśrotravijñānaghrāṇavijñānajihvāvijñānakāyavijñānamanovijñānaghātavaśceti	cakzuH vijQAna Srotra vijQAna GrANa vijQAna jihvA vijQAna kAya vijQAna manaH vijQAna GAtavaH ca iti
   26. tatraikādaśa rūpaskandhāḥ // cakṣuḥ, śrotram, ghrāṇam, jihvā, kāyaḥ,	26. tatra ekAdaSa rUpa skanDAH // cakzuH, Srotram, GrANam, jihvA, kAyaH,
   rūpam, śabdaḥ, gandhaḥ, rasaḥ, sparśaḥ vijñaptiśceti //	rUpam, SabdaH, ganDaH, rasaH, sparSaH vijQaptiH ca iti //
   27. vedanā trividhā / sukhāḥ, duḥkhā, aduḥkhāsukhā ceti //	27. vedanA triviDA / suKAH, duHKA, aduHKa asuKA ca iti //
   28. saṃjñāskandhaḥ / nimittodgahaṇātmikā //	28. saMjQA skanDaH / nimitta udgahaNa AtmikAH //
   29. saṃskārā dvividhāḥ / tatra cittasaṃprayuktasaṃskārāḥ,	29. saMskArAH dviviDAH / tatra citta saMprayukta saMskArAH,
   cittaviprayuktasaṃskārāśceti //	citta viprayukta saMskArAH ca iti //
   30. cittasaṃprayuktasaṃskārāścatvāriṃśat / tadyathā   vedanā, saṃjñā,	30. citta saMprayukta saMskArAH catvAriMSat / tat yaTA  vedanA, saMjQA,
   cetanā, chandaḥ, sparśaḥ, matiḥ, smṛtiḥ, manaskāraḥ, adhimokṣaḥ, samādhiḥ,	cetanA, CandaH, sparSaH, matiH, smRtiH, manaskAraH, aDimokzaH, samADiH,
   śraddhā, apramādaḥ, prasrabdhiḥ, upekṣā, hrīḥ, apatrapā, alobhaḥ, adveṣaḥ,	SradDA, apramAdaH, prasrabDiH, upekzA, hrIH, apatrapA, aloBaH, advezaH,
   ahiṃsā, vīryam, mohaḥ, pramādaḥ, kausīdyam, aśrāddhyam, styānam,	ahiMsA, vIryam, mohaH, pramAdaH, kOsIdyam, aSrAdDyam, styAnam,
   auddhatyam, ahrīkatā, anapatrapā, krodhaḥ, upanāhaḥ, śāṭhyam, īrṣyā,	OdDatyam, ahrIka tA, anapatrapA, kroDaH, upanAhaH, SAWyam, IrzyA,
   pradānaḥ, mrakṣaḥ, mātsaryam, māyā, madaḥ, vihiṃsā, vitarkaḥ, vicāraśceti	pradAnaH, mrakzaH, mAtsaryam, mAyA, madaH, vihiMsA, vitarkaH, vicAraH ca iti
   31. tatra cittaviprayuktasaṃskārāsrayodaśa / prāptiḥ, aprāptiḥ, sabhāgatā,	31. tatra citta viprayukta saMskAra asrayodaSa / prAptiH, aprAptiH, saBA gatA,
   asaṃjñikam, samāptiḥ, jīvitam, jātiḥ, jarā, sthitiḥ, anityatā, nāmakāyaḥ,	asaMjQikam, samAptiH, jIvitam, jAtiH, jarA, sTitiH, anitya tA, nAma kAyaH,
   padakāyaḥ, vyañjanakāyaśceti //	padakAyaH, vyaQjana kAyaH ca iti //
   32. trīṇyasaṃskṛtāni / tadyathā   ākāśaḥ, pratisaṃkhyānirodhaḥ,	32. trINi asaMskRtAni / tat yaTA  AkASaH, pratisaMKyA niroDaH,
   apratisaṃkhyānirodhaśceti //	apratisaMKyA niroDaH ca iti //
   33. ṣaḍ viṣayāḥ / tadyathā   rūpam, śabdaḥ, gandhaḥ, rasaḥ, sparśaḥ,	33. zaw vizayAH / tat yaTA  rUpam, SabdaH, ganDaH, rasaH, sparSaH,
   dharmaśceti //	DarmaH ca iti //
   (Dhs, Vaidya 331)	(Dhs, VEdyaH 331)
   34. tatra rūpaṃ viṣayasvabhāvam / nīlam, pītam, lohitam, avadātam,	34. tatra rUpam vizaya svaBAvam / nIlam, pItam, lohitam, avadAtam,
   haritam, dīrgham, hrasvam, parimaṇḍalam, unnatam, avanatam, sātam,	haritam, dIrGam, hrasvam, parimaNxalam, unnatam, avanatam, sAtam,
   visātam, accham, dhūmaḥ, rajaḥ, mahikā, chāyā, ātapaḥ, ālokaḥ,	visAtam, acCam, DUmaH, rajaH, mahikA, CAyA, AtapaH, AlokaH,
   andhakāraśceti //	anDakAraH ca iti //
   35. aṣṭāviṃśatividhaḥ śabdaḥ / sapta puruṣavākśabdāḥ, sapta	35. azwAviMSativiDaH SabdaH / sapta puruza vAc SabdAH, sapta
   puruṣahastādiśabdāḥ / eta eva(manojñā)manojñabhedenāṣṭāviṃśatiḥ //	puruza hasta Adi SabdAH / ete eva( manojQA)manojQa Bedena azwAviMSatiH //
   36. rasaḥ ṣaḍvidhaḥ / tadyathā   madhuraḥ, amlaḥ, lavaṇaḥ, kaṭuḥ, tiktaḥ,	36. rasaH zaxviDaH / tat yaTA  maDuraH, amlaH, lavaNaH, kawuH, tiktaH,
   kaṣāyaśceti //	kazAyaH ca iti //
   37. catvāro gandhāḥ / tadyathā   sugandhaḥ, durgandhaḥ, samagandhaḥ,	37. catvAraH ganDAH / tat yaTA  suganDaH, durganDaH, sama ganDaH,
   viṣamagandhaśceti //	vizama ganDaH ca iti //
   38. ekādaśa spraṣṭavyāni / pṛthvī, āpaḥ, tejaḥ, vāyuḥ, ślakṣṇatvam,	38. ekAdaSa sprazwavyAni / pRTvI, ApaH, tejaH, vAyuH, SlakzNa tvam,
   karkaśatvam, laghutvam, gurutvam, śītam, jighatsā pipāsā ceti //	karkaSa tvam, laGu tvam, guru tvam, SItam, jiGatsA pipAsA ca iti //
   39. pañca mahābhūtāni / pṛthvī, āpaḥ, tejaḥ, vāyuḥ, ākāśceti //	39. paQca mahABUtAni / pRTvI, ApaH, tejaH, vAyuH, AkAH ca iti //
   40. pañca bhautikāni / rūpam, śabdaḥ, gandhaḥ, rasaḥ, sparśaśceti //	40. paQca BOtikAni / rUpam, SabdaH, ganDaH, rasaH, sparSaH ca iti //
   41. viṃśatiḥ śūnyatāḥ / tadyathā   adhyātmaśūnyatā, bahirdhāśūnyatā,	41. viMSatiH SUnyatAH / tat yaTA  aDyAtma SUnyatA, bahirDA SUnyatA,
   adhyātmabahirdhāśūnyatā, śūnyatāśūnyatā, mahāśūnyatā, paramārthaśūnyatā,	aDyAtma bahirDA SUnyatA, SUnyatA SUnyatA, mahA SUnyatA, parama arTa SUnyatA,
   saṃskṛtaśūnyatā, asaṃskṛtaśūnyatā, atyantaśūnyatā, anavarāgraśūnyatā,	saMskRta SUnyatA, asaMskRta SUnyatA, atyanta SUnyatA, anavara agra SUnyatA,
   anavakāraśūnyatā, prakṛtiśūnyatā, sarvadharmaśūnyatā, lakṣaṇaśūnyatā,	anavakAra SUnyatA, prakRti SUnyatA, sarva Darma SUnyatA, lakzaNa SUnyatA,
   alakṣaṇaśūnyatā, bhāvaśūnyatā, abhāvaśūnyatā, svabhāvaśūnyatā,	alakzaNa SUnyatA, BAva SUnyatA, aBAva SUnyatA, svaBAva SUnyatA,
   abhāvasvabhāvaśūnyatā, parabhāvaśūnyatā ceti //	aBAva svaBAva SUnyatA, para BAva SUnyatA ca iti //
   42. dvādaśāṅgapratītyasamutpādaḥ / avidyā, saṃskārāḥ, vijñānam, nāmarūpam,	42. dvAdaSa aFga pratItyasamutpAdaH / avidyA, saMskArAH, vijQAnam, nAma rUpam,
   ṣaḍāyatanam, sparśaḥ, vedanā, tṛṣṇā, upādānam, bhavaḥ, jātiḥ, jarāmaraṇam,	zaz Ayatanam, sparSaH, vedanA, tRzNA, upAdAnam, BavaH, jAtiH, jarA maraNam,
   śokaparidevaduḥkhadaurmanasyopāyāsāśceti //	Soka parideva duHKa dOrmanasya upAyAsAH ca iti //
   43. saptatriṃśadbodhipākṣikā dharmāḥ / catvāri smṛtyupasthānāni // 4 //	43. saptatriMSat boDi pAkzikAH DarmAH / catvAri smRti upasTAnAni // 4 //
   catvāri samyakprahāṇāni // 8 // catvāra ṛddhipādāḥ // 12 // pañcendriyāṇi	catvAri samyak prahANAni // 8 // catvAraH RdDi pAdAH // 12 // paQca indriyANi
   // 17 // pañca balāni // 22 // sapta bodhyaṅgāni // 29 //	// 17 // paQca balAni // 22 // sapta boDi aFgAni // 29 //
   āryāṣṭāṅgikamārgaśceti // 37 //	Arya azwa AFgika mArgaH ca iti // 37 //
   44. tatra katamāni smṛtyupasthānāni? tadyathā   kāye	44. tatra katamAni smRti upasTAnAni? tat yaTA  kAye
   kāyānudarśasmṛtyupasthānam, vedanāyāṃ vedanānudarśasmṛtyupasthānam, citte	kAya anudarSa smRti upasTAnam, vedanAyAm vedanA anudarSa smRti upasTAnam, citte
   cittānudarśasmṛtyupasthānam, dharme dharmānudarśasmṛtyupasthānam //	citta anudarSa smRti upasTAnam, Darme Darma anudarSa smRti upasTAnam //
   45. katamāni catvāri samyakprahāṇāni? tadyathā   utpannānāṃ kuśalamūlānāṃ	45. katamAni catvAri samyak prahANa ani? tat yaTA  utpannAnAm kuSala mUlAnAm
   saṃrakṣaṇam / anutpannānāṃ samutpādaḥ / utpannānāmakuśalānāṃ dharmāṇāṃ	saMrakzaNam / anutpannAnAm samutpAdaH / utpannAnAm akuSalAnAm DarmANAm
   prahāṇam / anutpannānāṃ punaranutpādaśceti //	prahANam / anutpannAnAm punar anutpAdaH ca iti //
   46. catvāraḥ ṛddhipādāḥ / tadyathā   chandasamādhiprahāṇāya	46. catvAraH RdDi pAdAH / tat yaTA  Canda samADi prahANAya
   saṃskārasamanvāgata ṛddhipādaḥ / evaṃ cittaṛddhipādaḥ / vīryaṛddhipādaḥ /	saMskAra samanvAgataH RdDipAdaH / evam citta RdDi pAdaH / vIrya RdDipAdaH /
   mīmāṃsāsamādhiprahāṇāya saṃskārasamanvāgataṛddhipādaśceti //	mImAMsA samADi prahANAya saMskAra samanvAgata RdDipAdaH ca iti //
   (Dhs, Vaidya 332)	(Dhs, VEdyaH 332)
   47. pañcendriyāṇi / tadyathā   śraddhāsamādhivīryasmṛtiprajñendriyaṃ ceti	47. paQca indriyANi / tat yaTA  SradDA samADi vIrya smRti prajQA indriyam ca iti
   48. pañca balāni / śraddhāvīryasmṛtisamādhiprajñābalaṃ ceti //	48. paQca balAni / SradDA vIrya smRti samADi prajQA balam ca iti //
   49. sapta bodhyaṅgāni / tadyathā   smṛtisaṃbodhyaṅgam,	49. sapta boDi aFgAni / tat yaTA  smRti saMboDi aFgam,
   dharmavicayasaṃbodhyaṅgam, vīryasaṃbodhyaṅgam, prītisaṃbodhyaṅgam,	Darma vicaya saMboDi aFgam, vIrya saMboDi aFgam, prIti saMboDi aFgam,
   prasrabdhisaṃbodhyaṅgam, samādhisaṃbodhyaṅgam, upekṣāsaṃbodhyaṅgamiti //	prasrabDi saMboDi aFgam, samADi saMboDi aFgam, upekzA saMboDi aFgam iti //
   50. āryāṣṭāṅgikamārgaḥ // samyagdṛṣṭiḥ, samyaksaṃkalpaḥ, samyagvāk,	50. Arya azwAFgika mArgaH // samyak dRzwiH, samyak saMkalpaH, samyak vAc ,
   samyakkarmāntaḥ, samyagvyāyāmaḥ, samyaksmṛtiḥ, samyaksamādhiśceti / ete	samyak karmAntaH, samyak vyAyAmaH, samyak smRtiH, samyak samADiH ca iti / ete
   saptatriṃśabdodhipākṣikā dharmāḥ //	saptatriMSabdoDi pAkzikAH DarmAH //
   51. catasraḥ pratisaṃvidaḥ / tadyathā   dharmapratisaṃvit,	51. catasraH pratisaMvidaH / tat yaTA  Darma pratisaMvit,
   arthapratisaṃvit, niruktipratisaṃvit, pratibhānapratisaṃvicceti //	arTa pratisaMvit, nirukti pratisaMvit, pratiBAna pratisaMvid ca iti //
   52. catasro dhāraṇyaḥ / tadyathā   ātmadhāraṇī, granthadhāraṇī,	52. catasraH DAraNyaH / tat yaTA  Atma DAraNI, granTa DAraNI,
   dharmadhāraṇī, mantradhāraṇī ceti //	DarmaDAraNI, mantra DAraNI ca iti //
   53. catvāri pratiśaraṇāni / tadyathā   arthapratiśaraṇatā na	53. catvAri pratiSaraNAni / tat yaTA  arTa pratiSaraNa tA na
   vyañjanapratiśaraṇatā / jñānapratiśaraṇatā na vijñānapratiśaraṇatā /	vyaQjana pratiSaraNa tA / jQAna pratiSaraNa tA na vijQAna pratiSaraNa tA /
   nītārthapratiśaraṇatā na neyārthapratiśaraṇatā / dharmapratiśaraṇatā na	nIta arTa pratiSaraNa tA na neya arTa pratiSaraNa tA / Darma pratiSaraNa tA na
   pudgalapratiśaraṇatā ceti //	pudgala pratiSaraNa tA ca iti //
   54. ṣaḍanusmṛtayaḥ / buddhānusmṛtiḥ, dharmānusmṛtiḥ, saṃghānusmṛtiḥ,	54. zaz anusmRtayaH / budDa anusmRtiH, Darma anusmRtiH, saMGa anusmRtiH,
   tyāgānusmṛtiḥ, śīlānusmṛtiḥ, devānusmṛtiśceti //	tyAga anusmRtiH, SIla anusmRtiH, deva anusmRtiH ca iti //
   55. catvāri dharmapadāni / tadyathā   anityāḥ sarvasaṃskārāḥ / duḥkhāḥ	55. catvAri Darma padAni / tat yaTA  anityAH sarva saMskArAH / duHKAH
   sarvasaṃskārāḥ / nirātmānaḥ sarvasaṃskārāḥ / śāntaṃ nirvāṇaṃ ceti //	sarva saMskArAH / nirAtmAnaH sarva saMskArAH / SAntam nirvANam ca iti //
   56. daśākuśalāni / tadyathā   prāṇātipātaḥ, adattādānam, kāmamithyācāraḥ,	56. daSa akuSalAni / tat yaTA  prANa atipAtaH, adatta AdAnam, kAma miTyA AcAraH,
   mṛṣāvādaḥ, paiśunyam, pāruṣyam, saṃbhinnapralāpaḥ, abhidhyā, vyāpādaḥ,	mRzAvAdaH, pESunyam, pAruzyam, saMBinna pralApaH, aBiDyA, vyApAdaH,
   mithyādṛṣṭiśceti //	miTyAdRzwiH ca iti //
   57. gatayaḥ ṣaṭ / tadyathā   narakaḥ, tiryak, pretaḥ, asuraḥ, manuṣyaḥ,	57. gatayaH zaw / tat yaTA  narakaH, tiryak, pretaH, asuraH, manuzyaH,
   devaśceti //	devaH ca iti //
   58. ṣaḍ dhātavaḥ / pṛthvī, āpaḥ, tejaḥ, vāyuḥ, ākāśaḥ, vijñānaṃ ceti //	58. zaw DAtavaH / pRTvI, ApaH, tejaH, vAyuH, AkASaH, vijQAnam ca iti //
   59. aṣṭau vimokṣāḥ / tadyathā   rūpī rūpāṇī paśyati śūnyam /	59. azwO vimokzAH / tat yaTA  rUpI rUpANI paSyati SUnyam /
   ādhyātmārūpasaṃjñī bahirdhārūpāṇi paśyati śūnyam / ākāśānantyāyatanaṃ	ADyAtmA rUpa saMjQI bahirDA rUpANi paSyati SUnyam / AkASAnantya Ayatanam
   paśyati śūnyam / vijñānānantyāyatanaṃ paśyati śūnyam / ākiṃcanyāyatanaṃ	paSyati SUnyam / vijQAna Ananti Ayatanam paSyati SUnyam / AkiMcanya Ayatanam
   paśyati śūnyam / naivasaṃjñānāsaṃjñāyatanaṃ paśyati śūnyam /	paSyati SUnyam / na eva saMjQAna asaMjQA yatanam paSyati SUnyam /
   saṃjñāvedayitanirodhaṃ paśyati śūnyaṃ ceti //	saMjQA vedayita niroDam paSyati SUnyam ca iti //
   60. pañcānantaryāṇi / tadyathā   mātṛvadhaḥ, pitṛvadhaḥ arhadvadhaḥ,	60. paQca AnantaryANi / tat yaTA  mAtR vaDaH, pitR vaDaH arhat vaDaH,
   tathāgataduṣṭacittarudhirotpādaḥ, saṃghabhedaśceti //	taTAgata duzwa citta ruDira utpAdaH, saMGa BedaH ca iti //
   61. aṣṭau lokadharmāḥ // lābhaḥ, alābhaḥ, sukham, duḥkham, yaśaḥ, ayaśaḥ,	61. azwO loka DarmAH // lABaH, alABaH, suKam, duHKam, yaSaH, ayaSaH,
   nindā, praśaṃsā ceti //	nindA, praSaMsA ca iti //
   62. navāṅgapravacanāni / tadyathā   sūtram, geyam, vyākaraṇam, gāthā,	62. nava aFga pravacanAni / tat yaTA  sUtram, geyam, vyAkaraNam, gATA,
   udānam, jātakam, vaipulyam, adbhutadharmaḥ, upadeśaśceti //	udAnam, jAtakam, vEpulyam, adButa DarmaH, upadeSaH ca iti //
   (Dhs, Vaidya 333)	(Dhs, VEdyaH 333)
   63. dvādaśa dhūtaguṇāḥ / paiṇḍapātikaḥ, traicīvarikaḥ,	63. dvAdaSa DUta guNAH / pENxapAtikaH, trEcIvarikaH,
   khalupaścādbhaktikaḥ, naiṣadyikaḥ, yathāsaṃstarikaḥ, vṛkṣamūlikaḥ,	Kalu paScAt BaktikaH, nEzadyikaH, yaTA AsaM= tarikaH, vRkzamUlikaH,
   ekāsanikaḥ, ābhyavakāśikaḥ, āraṇyakaḥ, śmāśānikaḥ, pāṃśūkūlikaḥ,	eka AsanikaH, AByavakASikaH, AraNyakaH, SmASAnikaH, pAMSUkUlikaH,
   nāmantikaśceti //	nAmantikaH ca iti //
   64. daśa bhūmayaḥ / pramuditā, vimalā, prabhākarī, arciṣmatī, sudurjayā,	64. daSa BUmayaH / pramuditA, vimalA, praBAkarI, arcizmatI, su durjayA,
   abhimukhī, dūraṃgamā, acalā, sādhumatī, dharmameghā ceti //	aBimuKI, dUraMgamA, acalA, sADumatI, Darma meGA ca iti //
   65. samantaprabhā, nirupamā, jñānavatī / etāḥ sahitāsrayodaśa bhūmayaḥ //	65. samanta praBA, nirupamA, jQAnavatI / etAH sahita asrayodaSa BUmayaH //
   66. pañca cakṣūṃṣī / māṃsacakṣuḥ, dharmacakṣuḥ, prajñācakṣuḥ, divyacakṣuḥ,	66. paQca cakzUMzI / mAMsacakzuH, Darma cakzuH, prajQAcakzuH, divya cakzuH,
   buddhacakṣuśceti //	budDacakzuH ca iti //
   67. ṣaṭ kleśāḥ / rāgaḥ, pratighaḥ, mānaḥ, avidyā, kudṛṣṭiḥ, vicikitsā ceti	67. zaw kleSAH / rAgaH, pratiGaH, mAnaH, avidyA, kudRzwiH, vicikitsA ca iti
   68. pañca dṛṣṭayaḥ / satkāyadṛṣṭiḥ, antagrāhadṛṣṭiḥ, mithyādṛṣṭiḥ,	68. paQca dRzwayaH / sat kAya dRzwiH, anta grAha dRzwiH, miTyAdRzwiH,
   dṛṣṭiparāmarśaḥ, śīlaparāmarśaḥ //	dRzwi parAmarSaH, SIla parAmarSaH //
   69. catuviṃśatirupakleśāḥ / tadyathā   krodhaḥ, upanāhaḥ, mrakṣaḥ,	69. catuviMSatiH upakleSAH / tat yaTA  kroDaH, upanAhaH, mrakzaH,
   pradāśaḥ, īrṣyāḥ, mātsaryam, śāṭhyam, māyā, madaḥ, vihiṃsā, hrīḥ,	pradASaH, IrzyAH, mAtsaryam, SAWyam, mAyA, madaH, vihiMsA, hrIH,
   anapatrapā, styānam, aśrāddhyam, kausīdyam, pramādaḥ, muṣitasmṛtiḥ,	anapatrapA, styAnam, aSrAdDyam, kOsIdyam, pramAdaH, muzita smRtiH,
   vikṣepaḥ, asaṃprajanyam, kaukṛtyam, middham, vitarkaḥ, vicāraśceti //	vikzepaH, asaMprajanyam, kOkRtyam, midDam, vitarkaH, vicAraH ca iti //
   70. pañcāhārāḥ / dhyānāhārāḥ, kavalīkārāhārāḥ, pratyāhārāḥ, sparśāhārāḥ,	70. paQca AhArAH / DyAna AhArAH, kavalIkAra AhArAH, pratyAhArAH, sparSa AhArAH,
   saṃcetanikāhārāśceti //	saMcetanikA AhArAH ca iti //
   71. pañca bhayāni / ājīvikābhayam, śokabhayam, maraṇabhayam,	71. paQca BayAni / AjIvika aBayam, Soka Bayam, maraNa Bayam,
   durgatibhayam, parṣadasādyabhayaṃ ceti //	durgati Bayam, parzada sa Adi aBayam ca iti //
   72. catvāri dhyānāni / tadyathā   savitarkaṃ savicāraṃ vivekajaṃ	72. catvAri DyAnAni / tat yaTA  sa vitarkam sa vicAram viveka jam
   prītisukhamiti prathamadhyānam / adhyātmapramodanātprītisukhamiti dvitīyam	prIti suKam iti praTama DyAnam / aDyAtma pramodanAt prIti suKam iti dvitIyam
   / upekṣāsmṛtisaṃprajanyaṃ sukhamiti tṛtīyam /	/ upekzA smRti saMprajanyam suKam iti tRtIyam /
   upekṣāsmṛtipariśuddhiraduḥkhāsukhā vedaneti caturthaṃ dhyānamiti //	upekzA smRti pariSudDiH aduHKa asuKA vedanA iti caturTam DyAnam iti //
   73. trayo vimokṣāḥ / śūnyatā, animittaḥ, apraṇihitaśceti //	73. trayaH vimokzAH / SUnyatA, animittaH, apraNihitaH ca iti //
   74. bodhisattvānāṃ daśa vaśitāḥ / āyurvaśitā, cittavaśitā,	74. boDisattvAnAm daSa vaSitAH / AyuH vaSitA, citta vaSitA,
   pariṣkāravaśitā, dharmavaśitā, ṛddhivaśitā, janmavaśitā, adhimuktivaśitā,	parizkAra vaSitA, Darma vaSitA, RdDi vaSitA, janma vaSitA, aDimukti vaSitA,
   praṇidhānavaśitā, karmavaśitā, jñānavaśitā ceti //	praNiDAna vaSitA, karma vaSitA, jQAna vaSitA ca iti //
   75. bodhisattvānāṃ daśa balāni / tadyathā   adhimuktibalam,	75. boDisattvAnAm daSa balAni / tat yaTA  aDimukti balam,
   pratisaṃkhyānabalam, bhāvabalam, kṣāntibalam, jñānabalam, prahāṇabalam,	pratisaMKyAna balam, BAva balam, kzAnti balam, jQAna balam, prahANa balam,
   samādhibalam, pratibhānabalam, puṇyabalam, pratipattibalaṃ ceti //	samADi balam, pratiBAna balam, puNya balam, pratipatti balam ca iti //
   76. tathāgatasya daśa balāni / tadyathā   sthānāsthānajñānabalam,	76. taTAgatasya daSa balAni / tat yaTA  sTAna AsTAna jQAna balam,
   karmavipākajñānabalam, nānādhātujñānabalam, nānadhimuktijñānabalam,	karma vipAka jQAna balam, nAnA DAtu jQAna balam, na anaDi mukti jQAna balam,
   sattvendriyaparāparajñānabalam, sarvatragāminīpratipattijñānabalam,	sattva indriya para apara jQAna balam, sarvatra gAminI pratipatti jQAna balam,
   dhyānavimokṣasamādhisamāpattisaṃkleśavyavadānavyutthānajñānabalam,	DyAna vimokza samADi samApatti saMkleSa vyavadAna vyutTAna jQAna balam,
   pūrvanivāsānusmṛtijñānabalam, cyutyutpattijñānabalam,	pUrva nivAsa anusmRti jQAna balam, cyuti utpatti jQAna balam,
   āsravakṣayajñānabalaṃ ceti //	Asrava kzaya jQAna balam ca iti //
   (Dhs, Vaidya 334)	(Dhs, VEdyaH 334)
   77. catvāri vaiśāradyāni / tadyathā   abhisaṃbodhivaiśāradyam,	77. catvAri vESAradyAni / tat yaTA  aBisaMboDi vESAradyam,
   āsravakṣayajñānavaiśāradyam,	Asrava kzaya jQAna vESAradyam,
   nairvāṇikamārgāvataraṇavaiśāradyam[antarāyikadharmānanyathātvaniścitavyākaraṇavaiśāradyaṃ]	nErvANika mArga avataraNa vESAradyam [antarAyika DarmAn anyaTAtva niScita vyAkaraNa vESAradyaM]
   ceti //	ca iti //
   78. pañca mātsaryāṇi / dharmamātsaryam, lābhamātsaryam, āvāsamātsaryam,	78. paQca mAtsaryANi / DarmamAtsaryam, lABamAtsaryam, AvAsa mAtsaryam,
   kuśalamātsaryam, varṇamātsaryaṃ ceti //	kuSala mAtsaryam, varNa mAtsaryam ca iti //
   79. aṣṭādaśāveṇikā buddhadharmāḥ / tadyathā   nāsti tathāgatasya skhalitam	79. azwAdaSa AveNikAH budDa DarmAH / tat yaTA  na asti taTAgatasya sKalitam
   / nāsti ravitam / nāsti muṣitasmṛtitā / nāstyasamāhitacittam / nāsti	/ na asti ravitam / na asti muzita smRti tA / na asti asamAhita cittam / na asti
   nānātvasaṃjñā / nāstyapratisaṃkhyāyopekṣā / nāsti chandaparihāṇiḥ / nāsti	nAnAtva saMjQA / na asti apratisaMKyAya upekzAH / na asti Canda parihANiH / na asti
   vīryaparihāṇiḥ / nāsti smṛtiparihāṇiḥ / nāsti samādhiparihāṇiḥ / nāsti	vIrya parihANiH / na asti smRti parihANiH / na asti samADi parihANiH / na asti
   prajñāparihāṇiḥ / nāsti vimuktiparihāṇiḥ / nāsti	prajQA parihANiH / na asti vimukti parihANiH / na asti
   vimuktijñānadarśanaparihāṇiḥ /	vimukti jQAna darSana parihANiH /
   sarvakāyakarmajñānapūrvagamajñānānuparivṛttiḥ /	sarva kAya karma jQAna pUrva gama jQAna anuparivRttiH /
   sarvavākkarmajñānapūrvaṃgamajñānānuparivṛttiḥ /	sarva vAkkarma jQAna pUrvaMgama jQAna anuparivRttiH /
   sarvamanaskarmajñānapūrvaṃgamajñānānuparivṛttiḥ / atīte	sarva manaskarma jQAna pUrvaMgama jQAna anuparivRttiH / atIte
   'dhvanyasaṅgamapratihatajñānam / pratyutpanne	aDvanya saFgam apratihata jQAnam / pratyutpanne
   'dhvanyasaṅgamapratihatajñānadarśanaṃ ceti //	aDvanya saFgam apratihata jQAna darSanam ca iti //
   80. catvāro mārāḥ / tadyathā   skandhamāraḥ, kleśamāraḥ, devaputramāraḥ,	80. catvAraH mArAH / tat yaTA  skanDamAraH, kleSa mAraH, deva putra m AraH,
   mṛtyumāraśceti //	mRtyumAraH ca iti //
   81. catvāri śraddhāṅgāni / tadyathā   āryasatyam, triratnam, karma,	81. catvAri SradDA aFgAni / tat yaTA  Arya satyam, tri ratnam, karma,
   karmaphalaṃ ceti //	karma Palam ca iti //
   82. navānupūrvasamādhisamāpattayaḥ / tadyathā   catvāri dhyānāni, catasra	82. nava anupUrva samADi samApattayaH / tat yaTA  catvAri DyAnAni, catasra
   ārūpyasamāpattayaḥ, nirodhasamāpattiśceti //	ArUpya samApattayaH, niroDa samApattiH ca iti //
   83. dvātriṃśallakṣaṇāni / tadyathā   cakrāṅkitapāṇipādatalatā /	83. dvAtriMSat lakzaNAni / tat yaTA  cakra aFkita pANi pAda tala tA /
   supratiṣṭhitapāṇipādatalatā / jālābalabaddhā(vanaddhā?)ṅgulipāṇipādatalatā	su pratizWita pANi pAda tala tA / jAla abala badDa a(vanadDA? )Fguli pANi pAda tala tA
   / mṛdutaruṇahastapādatalatā / saptotsadatā / dīrghāṅgulitā / āyatapārṣṇitā	/ mRdu taruNa hasta pAda tala tA / sapta utsadatA / dIrGa aFgulitA / Ayata pArzNitA
   / ṛjugātratā / utsaṅgapādatā / urdhvāgraromatā / aiṇejayaṅghatā /	/ Rju gAtra tA / utsaFga pAda tA / urDva agra romatA / ENejayaFGa tA /
   pralambabāhutā / koṣagatabastiguhyatā / suvarṇavarṇatā / śuklacchavitā /	pralamba bAhutA / koza gata basti guhyatA / suvarNa varNa tA / Sukla= CavitA /
   pradakṣiṇāvartaikaromatā / ūrṇālaṃkṛtamukhatā / siṃhapūrvāntakāyatā /	pradakziNa Avarta eka romatA / UrNA alaMkRta muKa tA / siMha pUrva anta kAyatA /
   susaṃvṛttaskandhatā / citāntarāṃsatā / rasarasāgratā /	su saMvRtta skanDa tA / citA antara aMsatA / rasa rasa agra tA /
   nyagrodhaparimaṇḍalatā / uṣṇīṣaśiraskatā / prabhūtajivhatā / siṃhahanutā /	nyagroDa parimaNxala tA / uzNIza SiraskatA / praBUta jivhatA / siMha hanu tA /
   śuklahanutā / samadantatā / haṃsavikrāntagāmitā / aviraladantatā /	Sukla hanu tA / samadanta tA / haMsa vikrAnta gAmitA / avirala danta tA /
   samacatvāriṃśaddantatā / abhinīlanetratā / gopakṣanetratā ceti //	samacatvAriMSat dantatA / aBinIla netra tA / gopakza netra tA ca iti //
   84. aśītyanuvyañjanāni / tadyathā   tāmranakhatā / srigdhanakhatā /	84. aSIti anuvyaQjanAni / tat yaTA  tAmra naKa tA / srigDa naKa tA /
   tuṅganakhatā / chatrāṅgulitā / citrāṅgulitā / anupūrvāṅgulitā /	tuFga naKa tA / Catra aFgulitA / citra aFgulitA / anupUrva aFgulitA /
   gūḍhaśiratā / nigranthiśiratā / gūḍhagulphatā / aviṣamapādatā /	gUXa SiratA / nigranTi Sira tA / gUXa gulPa tA / avizama pAda tA /
   siṃhavikrāntagāmitā / nāgavikrāntagāmitā / haṃsavikrāntagāmitā /	siMha vikrAnta gAmitA / nAga vikrAnta gAmitA / haMsa vikrAnta gAmitAH /
   vṛṣabhavikrāntagāmitā / pradakṣiṇagāmitā / cārugāmitā / avakragāmitā /	vRzaBa vikrAnta gAmitA / pradakziNa gAmitA / cAru gAmitA / avakra gAmitAH /
   vṛttagātratā / mṛṣṭagātratā / anupūrvagātratā / śucigātratā / mṛdugātratā	vRtta gAtra tA / mRzwa gAtra tA / anupUrva gAtra tA / Suci gAtra tA / mRdu gAtra tA
   / viśuddhagātratā / paripūrṇavyañjanatā / pṛthucārumaṇḍalagātratā /	/ viSudDa gAtra tA / paripUrNa vyaQjana tA / pRTu cAru maNxala gAtra tA /
   samakramatā / viśuddhanetratā / sukumāragātratā / adīnagātratā /	samakramatA / viSudDa netra tA / sukumAra gAtra tA / adIna gAtra tA /
   utsāhagātratā / gambhīrakukṣitā / prasannagātratā /	utsAha gAtra tA / gamBIra kukzitA / prasanna gAtra tA /
   suvibhaktāṅgapratyaṅgatā / vitimiraśuddhālokatā / vṛttakukṣitā /	suviBakta aFga pratyaFga tA / vitimira SudDa AlokatA / vRtta kukzitAH /
   mṛṣṭakukṣitā / abhugnakukṣitā / kṣāmakukṣitā / (Dhs, Vaidya 335)	mRzwa kukzitA / aBugna kukzitA / kzAma kukzitAH / (Dhs, VEdyaH 335)
   pradakṣiṇāvartanābhitā / samantaprāsādikatā / śucisamudāratā /	pradakziNa Avartana aBitA / samantaprAsa Adika tA / Suci samudAra tA /
   vyapagatatilakagātratā / tūlasadṛśasukumārapāṇitā / snigdhapāṇilekhatā /	vyapagata tilaka gAtra tA / tUla sadRSa sukumAra pANitA / snigDa pANi leKatA /
   gambhīrapāṇilekhatā / āyatapāṇilekhatā / nātyāyatavacanatā /	gamBIra pANi leKatA / Ayata pANi leKatA / na ati Ayata vacana tA /
   bimbapratibimboṣṭhatā / mṛdujivhatā / tanujivhatā / raktajihvatā /	bimba pratibimba uzWa tA / mRdu jivhatA / tanu jivhatA / rakta jihvatA /
   meghagarjitaghoṣatā / madhuracārumañjusvaratā / vṛttadaṃṣṭratā /	meGa garjita Goza tA / maDura cAru maQju svara tA / vRtta daMzwra tA /
   tīkṣṇaṃdaṃṣṭratā / śūkladaṃṣṭratā / samadaṃṣṭratā / anupūrvadaṃṣṭratā /	tIkzNaMdaMzwra tA / SUkla daMzwra tA / samadaMzwra tA / anupUrva daMzwra tA /
   tuṅganāsatā / śucināsatā / viśālanayanatā / citrapakṣmatā /	tuFga nAsatA / SucinA asatA / viSAla nayana tA / citra pakzma tA /
   sitāsitakamaladalanayanatā / āyatabhrūkatā / śuklabhrūkatā /	sita asita kamala dala nayana tA / Ayata BrUka tA / Sukla BrUka tA /
   susnigdhabhrūkatā / pīnāyatabhujalatā / samakarṇatā /	su snigDa BrUka tA / pIna Ayata Buja latA / sama karNa tA /
   anupahatakarṇendriyatā / avimlānalalāṭatā / pṛthulalāṭatā /	anupahata karNa indriya tA / avimlAna lalAwa tA / pRTu lalAwa tA /
   suparipūrṇottamāṅgatā / bhramarasadṛśakeśatā / citrakeśatā / guḍākeśatā /	su paripUrNa uttamA aFga tA / Bramara sadRSa keSa tA / citra keSatA / guxAkeSa tA /
   asaṃmuṇitakeśatā / aparuṣakeśatā / surabhikeśatā /	asaMmuNita keSa tA / aparuza keSatA / suraBi keSa tA /
   śrīvatsamuktikanandyāvartalakṣitapāṇipādatalatā ceti //	SrIvatsa muktika nandi Avarta lakzita pANi pAda tala tA ca iti //
   85. cakravartināṃ sapta ratnāni / tadyathā   cakraratnam, aśvaratnam,	85. cakravartinAm sapta ratnAni / tat yaTA  cakra ratnam, aSva ratnam,
   hastiratnam, maṇiratnam, strīratnam, khaṅgaratnam, pariṇāyakaratnaṃ ceti	hasti ratnam, maNi ratnam, strI ratnam, KaFga ratnam, pariNAyaka ratnam ca iti
   86. tatra trayo 'dhvānaḥ / tadyathā   atīto 'dhvā, anāgato 'dhvā,	86. tatra trayaH aDvAnaH / tat yaTA  atItaH aDvA, anAgataH aDvA,
   pratyutpanno 'dhvā ceti //	pratyutpannaH aDvA ca iti //
   87. catvāraḥ kalpāḥ / tadyathā   antarakalpāḥ, mahākalpāḥ, śūnyakalpāḥ,	87. catvAraH kalpAH / tat yaTA  antara kalpAH, mahA kalpAH, SUnya kalpAH,
   sārakalpāśceti //	sAra kalpAH ca iti //
   88. catvāri yugāni / tadyathā   kṛtayugam, tretāyugam, dvāparam, kaliyugaṃ	88. catvAri yugAni / tat yaTA  kRta yugam, tretA yugam, dvAparam, kali yugam
   ceti //	ca iti //
   89. lokadvayam / tadyathā   sattvalokaḥ, bhājanalokaśceti //	89. loka dvayam / tat yaTA  sattva lokaH, BAjana lokaH ca iti //
   90. catvāro yonayaḥ / tadyathā   aṇḍajaḥ, saṃsvedajaḥ, jarāyujaḥ,	90. catvAraH yonayaH / tat yaTA  aNxa jaH, saMsveda jaH, jarAyu jaH,
   upapādukaśceti //	upapAdukaH ca iti //
   91. pañca kaṣāyāḥ / tadyathā   kleśakaṣāyaḥ, dṛṣṭikaṣāyaḥ, sattvakaṣāyaḥ,	91. paQca kazAyAH / tat yaTA  kleSa kazAyaH, dRzwi kazAyaH, sattva kazAyaH,
   āyuḥkaṣāyaḥ, kalpakaṣāyaśceti //	AyuH kazAyaH, kalpa kazAyaH ca iti //
   92. trayaḥ sattvādhyāḥ / tadyathā   pūrvāntakoṭiparijñāyāḥ,	92. trayaH sattva aDyAH / tat yaTA  pUrva anta kowi parijQAyAH,
   aparāntakoṭiparijñāyāḥ, caturmārakoṭiparijñāyāśceti //	apara anta kowi parijQAyAH, catur mAra kowi parijQAyAH ca iti //
   93. daśa jñānāni / tadyathā   duḥkhajñānam, samudayajñānam, nirodhajñānam,	93. daSa jQAnAni / tat yaTA  duHKa jQAnam, samudaya jQAnam, niroDa jQAnam,
   mārgajñānam, dharmajñānam, anvayajñānam, saṃvṛtijñānam, paracittajñānam,	mArga jQAnam, Darma jQAnam, anvaya jQAnam, saMvRti jQAnam, para citta jQAnam,
   kṣayajñānam, anutpādajñānaṃ ceti //	kzaya jQAnam, anutpAda jQAnam ca iti //
   94. pañca jñānāni / tadyathā   ādarśanajñānam, samatājñānam,	94. paQca jQAnAni / tat yaTA  AdarSana jQAnam, samatA jQAnam,
   pratyavekṣaṇājñānam, kṛtyānuṣṭhānajñānam, suviśuddhadharmadhātujñānaṃ ceti	pratyavekzaNa ajQAnam, kRtya anuzWAna jQAnam, su viSudDa Darma DAtu jQAnam ca iti
   95. dve satye / tadyathā   saṃvṛtisatyam, paramārthasatyaṃ ceti //	95. dve satye / tat yaTA  saMvRti satyam, parama arTa satyam ca iti //
   96. caturāryasatyeṣu ṣoḍaśa kṣāntijñānalakṣaṇāḥ / tadyathā   duḥkhe	96. catur Arya satyezu zoxaSa kzAnti jQAna lakzaNAH / tat yaTA  duHKe
   dharmajñānakṣāntiḥ, duḥkhe dharmajñānam, duḥkhe 'nvayajñānakṣāntiḥ, duḥkhe	Darma jQAna kzAntiH, duHKe Darma jQAnam, duHKe anvaya jQAna kzAntiH, duHKe
   'nvayajñānam / samudaye dharmajñānakṣāntiḥ, (Dhs, Vaidya 336) samudaye	anvaya jQAnam / samudaye Darma jQAna kzAntiH, (Dhs, VEdyaH 336) samudaye
   dharmajñānam, samudaye 'nvayajñānakṣāntiḥ, samudaye 'nvayajñānam / nirodhe	Darma jQAnam, samudaye anvayajQAna kzAntiH, samudaye anvaya jQAnam / niroDe
   dharmajñānakṣāntiḥ, nirodhe dharmajñānam, nirodhe 'nvayajñānakṣāntiḥ,	Darma jQAna kzAntiH, niroDe Darma jQAnam, niroDe anvaya jQAna kzAntiH,
   nirodhe 'nvayajñānam / mārge dharmajñānakṣāntiḥ, mārge dharmajñānam, mārge	niroDe anvaya jQAnam / mArge Darma jQAna kzAntiH, mArge Darma jQAnam, mArge
   'nvayajñānakṣāntiḥ, mārge 'nvayajñānaṃ ceti //	anvaya jQAna kzAntiH, mArge anvaya jQAnam ca iti //
   97. tatra duḥkhasatye catvāra ākārāḥ / tadyathā   anityataḥ, duḥkhataḥ,	97. tatra duHKa satye catvAraH AkArAH / tat yaTA  anityataH, duHKataH,
   śūnyataḥ, anātmataśceti //	SUnyataH, anAtmataH ca iti //
   98. samudayasatye catvāra ākārāḥ / tadyathā   hetutaḥ, samudayataḥ,	98. samudaya satye catvAraH AkArAH / tat yaTA  hetutaH, samudayataH,
   prabhavataḥ, pratyayataśceti //	praBavataH, pratyayataH ca iti //
   99. nirodhasatye catvāra ākārāḥ / tadyathā   nirodhataḥ, śāntataḥ,	99. niroDa satye catvAraH AkArAH / tat yaTA  niroDataH, SAntataH,
   praṇītataḥ, niḥsaraṇataśceti //	praNItataH, niHsaraNataH ca iti //
   100. mārgasatye catvāra ākārāḥ / tadyathā   mārgataḥ, nyāyataḥ,	100. mArga satye catvAraH AkArAH / tat yaTA  mArgataH, nyAyataH,
   pratipattitaḥ, nairyāṇika(ta)śceti //	pratipattitaH, nEryANika(ta)H ca iti //
   101. catvāraḥ samādhayaḥ / tadyathā   ālokasamādhiḥ, vṛtāsamādhiḥ,	101. catvAraH samADayaH / tat yaTA  Aloka samADiH, vRtA samADiH,
   ekādaśapratiṣṭhasamādhiḥ, ānantaryasamādhiśceti //	ekAdaSa pratizWa samADiH, Anantarya samADiH ca iti //
   102. tatrāṣṭau[puruṣa]   pugdalāḥ / tadyathā  	102. tatra azwO[puruza]  pugdalAH / tat yaTA  
   srotaāpannaphalapratipannakaḥ, srotaāpannaḥ, sakṛdāgāmiphalapratipannakaḥ,	srotaApanna Pala pratipannakaH, srotaApannaH, sakRdAgAmi Pala pratipannakaH,
   sakṛdāgāmī, anāgāmiphalapratipannakaḥ, anāgāmī, arhatphalapratipannakaḥ,	sakRdAgAmI, anAgAmi Pala pratipannakaH, anAgAmI, arhat Pala pratipannakaH,
   arhaṃśceti //	arhan= ca iti //
   103. tathāṣṭau pratipugdalāḥ / tadyathā   śraddhānusārī, dharmānusārī,	103. taTA azwO prati pugdalAH / tat yaTA  SradDA anusArI, Darma anusArI,
   srotaāpannaḥ, devakulaṃkulaḥ, manuṣyakulaṃkulaḥ, sakṛdāgāmiphalaḥ,	srotaApannaH, devakulaMkulaH, manuzya kulaMkulaH, sakRdAgAmi PalaH,
   śraddhavimuktirdṛṣṭiprāpta ekavīcīko 'nāgāmyantarāparinirvāyī	SradDa vimuktiH dRzwi prAptaH ekavIcIkaH anAgAmi antara aparinirvAyI
   upahatyaparinirvāyī abhisaṃskāraparinirvāyī pluto 'rddhaplutaḥ	upahatyaparinirvAyI aBisaMskAra parinirvAyI plutaH ardDa plutaH
   sarvāstānapluto dṛṣṭadharmasamaḥ kāyasākṣī khaṅgaśceti //	sarva astAn aplutaH dRzwa Darma samaH kAya sAkzI KaFgaH ca iti //
   104. [tadanu dvādaśākaradharmacakrapravartakaṃ(naṃ) katamat? tadyathā  	104. [tadanu dvAdaSa akara Darma cakra pravartakaM(nan) katamat? tat yaTA  
   idaṃ duḥkhamāryasatyamiti bhikṣavaḥ pūrvamanuśrutya teṣu dharmeṣu yoniśo	idam duHKam Arya satyam iti BikzavaH pUrvam anuSrutya tezu Darmezu yoni So
   manasiṃgavataḥ(?) cakṣurudapādi / jñānamutpādi cintotpādi / cutrirudapādi	mana siMgavataH(?) cakzuH udapAdi / jQAnam utpAdi cintA utpAdi / cutriH udapAdi
   / ityekaparicatakaḥ 1 idaṃ duḥkhamārya sa tatra khalvabhijñātaṃ iti	/ iti eka paricatakaH 1 idam duHKam Arya sa tatra Kalu aBijQAtam iti
   bhikṣavaḥ / ityādi pūrvavaditiyaḥ // idaṃ duḥkhasamudayamāryasatvaṃ tava	BikzavaH / ityAdi pUrvavat itiyaH // idam duHKa samudayam Arya satvam tava
   khalvabhijñāya prahīṇamiti hityādi tṛtīyaḥ / tathā idaṃ duḥkhanirodha	Kalu aBijQAya prahINam iti hityAdi tRtIyaH / taTA idam duHKa niroDa
   āryasatyamiti hipratyekaḥ // idaṃ duḥkhanirodhaāryyasatyaṃ tatra	Arya satyam iti hiprati ekaH // idam duHKa niroDa Aryya satyam tatra
   khalvabhijñāya śākṣāt kartavyamiti hitya dvitīyaḥ / idaṃ	Kalu aBijQAya SAkzAt kartavyam iti hitya dvitIyaH / idam
   duḥkhanirodhaāryasatya tatra khalu bhijñāya śākṣāt dvitīya / tadyathā idaṃ	duHKa niroDa Arya satya tatra Kalu BijQAya SAkzAt dvitIya / tat yaTA idam
   duḥkhamārgagāminī pratipadāryasatyemiti tyeka // idaṃ duḥkhamokṣagāmini	duHKa mArga gAminI pratipadArya satyem iti ti ekaH // idam duHKa mokza gAmini
   pratipa ityāryyasatyaṃ tatra khalu bhijñāya bhāvayitavyamiti hi bhikṣava	pratipaH iti Aryya satyam tatra Kalu BijQAya BAvayitavyam iti hi Bikzava
   ityādi tṛtīyaḥ / parivarta ityeva dvādaśākāradharmacakrapravarttanamiti //	ityAdi tRtIyaH / parivarte iti eva dvAdaSa AkAra Darma cakra pravarttanam iti //
   (Dhs, Vaidya 337)	(Dhs, VEdyaH 337)
   Ms. C.	Ms. C.
   tadanu dvādaśākāradharmacakrapravartakaḥ / katamat / idaṃ	tadanu dvAdaSa AkAra Darma cakra pravartakaH / katamat / idam
   duḥkhamāryasatyamiti bhikṣavaḥ / pūrvamanuśrutya teṣu dharmeṣu yoniśo	duHKam Arya satyam iti BikzavaH / pUrvam anuSrutya tezu Darmezu yoni So
   manasigavataḥ cakṣurudapādi / jñānamutpādi cittotpādi / cutrirutpādi //	manasi gavataH cakzuH udapAdi / jQAnam utpAdi citta utpAdi / cutriH utpAdi //
   ityekaparivartaka idaṃ duḥkhamāryasatyaṃ tatra khalvabhijñāya	iti eka parivartakaH idam duHKam Arya satyam tatra Kalu aBijQAya
   parijñātamiti hi bhikṣavaḥ / pūrvamanuśruya teṣu yoniso manasiṅgarvutaḥ //	parijQAtam iti hi BikzavaH / pUrvam anuSruya tezu yonisaH manasiFgarvutaH //
   iti dvitīyaḥ // idamāryasatyaṃ tatra khalvabhijñātaṃ iti bhikṣavaḥ /	iti dvitIyaH // idam Arya satyam tatra Kalu aBijQAtam iti BikzavaH /
   ityādi pūrvavaditi yaḥ //	ityAdi pUrvavat iti yaH //
   idaṃ duḥkhasamudayamāryasatyaṃ tava khalvabhijñāya prahīṇamiti hītyādi	idam duHKa samudayam Arya satyam tava Kalu aBijQAya prahINam iti hi ityAdi
   tṛtīyam //	tRtIyam //
   tathā idaṃ duḥkhanirodha āryasatyamiti hi pratyekaḥ // idaṃ duḥkhanirodha	taTA idam duHKa niroDaH Arya satyam iti hi pratyekaH // idam duHKa niroDa
   āryasatyaṃ tatra khalvabhijñāya sākṣāt kartavyamiti hityādi / dvitīyaḥ /	Arya satyam tatra Kalu aBijQAya sAkzAt kartavyam iti hityAdi / dvitIyaH /
   idaṃ duḥkhanirodha āryasatyaṃ tatra khalvabhijñāya sākṣāt kṛtamiti	idam duHKa niroDaH Arya satyam tatra Kalu aBijQAya sAkzAt kRtam iti
   dvitīyaḥ /	dvitIyaH /
   tathā idaṃ duḥkhamārgagāmini pratipadāryasatyamiti pratyeka / idaṃ	taTA idam duHKa mArga gAmini pratipad Arya satyam iti pratyeka / idam
   duḥkhamokṣagāminī pratipat // ityāryasatyaṃ tatra khalvabhijñāya	duHKa mokza gAminI pratipad // iti Arya satyam tatra Kalu aBijQAya
   bhātavyamiti hi bhikṣavaḥ ityādi tṛtīyaḥ / parivartta ityevaṃ	BAtavyam iti hi BikzavaH ityAdi tRtIyaH / parivarttaH iti evam
   dvādaśākāradharmacakrapravartanamiti // //	dvAdaSa AkAra Darma cakra pravartanam iti // //
   Restored Text.	ReH toret Text.
   tadatra dvādaśākāradharmacakrapravartakaṃ(naṃ?) katamat? idaṃ	tat atra dvAdaSa AkAra Darma cakra pravartakaM(naM?) katamat? idam
   duḥkhamāryasatyamiti(me) bhikṣavaḥ pūrvamananuśruteṣu dharmeṣu yoniśo	duHKam Arya satyam iti(me) BikzavaH pUrvam ananuSrutezu Darmezu yoni So
   manasikurvataḥ cakṣurudapādi jñānamudapādi vidyodapādi bhūrirudapādītyekaṃ	manasikurvataH cakzuH udapAdi jQAnam udapAdi vidyA udapAdi BUriH udapAdi iti ekam
   parivartakam / idaṃ duḥkhamāryasatyaṃ tatra khalvabhijñāya parijñātamiti	parivartakam / idam duHKam Arya satyam tatra Kalu aBijQAya parijQAtam iti
   hi (me) bhikṣavaḥ pūrvamananuśruteṣu dharmeṣu yoniśo manasikurvata iti	hi (me) BikzavaH pUrvam ananuSrutezu Darmezu yoniSas manasikurvataH iti
   dvitīyam / idaṃ duḥkhamāryasatyaṃ tatra khalvabhijñāya parijñātamiti	dvitIyam / idam duHKam Arya satyam tatra Kalu aBijQAya parijQAtam iti
   bhikṣavaḥ ityādi pūrvavaditi tṛtīyam //	BikzavaH ityAdi pUrvavat iti tRtIyam //
   [tathedaṃ duḥkhasamudayamāryasatyamiti pratyekam / idaṃ	[taTA idam duHKa samudayam Arya satyam iti pratyekam / idam
   duḥkhasamudayamāryasatyaṃ tatra khalvabhijñāya prahātavyamiti dvitīyam /]	duHKa samudayam Arya satyam tatra Kalu aBijQAya prahAtavyam iti dvitIyam /]
   idaṃ duḥkhasamudayamāryasatyaṃ tatra khalvabhijñāya prahīṇamiti hītyādi	idam duHKa samudayam Arya satyam tatra Kalu aBijQAya prahINam iti hi ityAdi
   tṛtīyam /	tRtIyam /
   tathedaṃ duḥkhanirodhamāryasatyamiti hi pratyekam / idaṃ	taTA idam duHKa niroDam Arya satyam iti hi pratyekam / idam
   duḥkhanirodhamāryasatyaṃ tatra khalvabhijñāya sākṣātkartavyamiti hītyādi	duHKa niroDam Arya satyam tatra Kalu aBijQAya sAkzAtkartavyam iti hi ityAdi
   dvitīyam / idaṃ duḥkhanirodhamāryasatyaṃ tatra khalvabhijñāya	dvitIyam / idam duHKa niroDam Arya satyam tatra Kalu aBijQAya
   sākṣātkṛtamiti tṛtīyam //	sAkzAtkRtam iti tRtIyam //
   tatheyaṃ duḥkhamārgagāminī pratipadityāryasatyamiti pratyekam / iyaṃ	taTA iyam duHKa mArga gAminI pratipad iti Ari asatyam iti pratyekam / iyam
   duḥkhamokṣagāminī pratipadityāryasatyaṃ tatra khalvabhivijñāya	duHKa mokza gAminI pratipad iti Ari a satyam tatra Kalu aBivijQAya
   bhāvayitavyamiti hi bhikṣava ityādi dvitīyam /	BAvayitavyam iti hi BikzavaH ityAdi dvitIyam /
   [idaṃ duḥkhamokṣagāminī pratipadityāryasatyaṃ tatra khalvabhijñāya	[idam duHKa mokza gAminI pratipad iti Ari a satyam tatra Kalu aBijQAya
   bhāvitamiti tṛtīyam // ]	BAvitam iti tRtIyam // ]
   105. tatra dānaṃ trividham / tadyathā   dharmadānam, āmiṣadānam,	105. tatra dAnam triviDam / tat yaTA  Darma dAnam, Amiza dAnam,
   maitrīdānaṃ ceti //	mEtrI dAnam ca iti //
   106. śīlaṃ trividham / tadyathā   saṃbhāraśīlam, kuśalasaṃgrāhaśīlam,	106. SIlam triviDam / tat yaTA  saMBAra SIlam, kuSala saMgrAha SIlam,
   sattvārthakriyāśīlaṃ ceti //	sattva arTa kriyA SIlam ca iti //
   107. kṣāntistrividhā / tadyathā   dharmanidhyānakṣāntiḥ,	107. kzAntiH triviDA / tat yaTA  Darma niDyAna kzAntiH,
   duḥkhādhivāsanākṣāntiḥ, paropakāradharmakṣāntiśceti //	duHKa aDivAsana AkzAntiH, para upakAra Darma kzAntiH ca iti //
   (Dhs, Vaidya 338)	(Dhs, VEdyaH 338)
   108. vīryaṃ trividham / tadyathā   saṃnāhavīryam, prayogavīryam,	108. vIryam triviDam / tat yaTA  saMnAha vIryam, prayoga vIryam,
   para(ri)niṣṭhāvīryaṃ ceti //	para(ri)nizWA vIryam ca iti //
   109. dhyānaṃ trividham / tadyathā   sadoṣāpakarṣadhyānam,	109. DyAnam triviDam / tat yaTA  sa doza apakarza DyAnam,
   sukhavaihārikadhyānam, aśeṣavaibhūṣitadhyānaṃ ceti //	suKa vEhArika DyAnam, aSeza vEBUzita DyAnam ca iti //
   110. prajñā trividhā / tadyathā   śrutamayī, cintāmayī, bhāvanāmayī ceti	110. prajQA triviDA / tat yaTA  Sruta mayI, cintA mayI, BAvanA mayI ca iti
   111. upāyastrividhaḥ / tadyathā   sarvasattvāvabodhakaḥ,	111. upAyaH triviDaH / tat yaTA  sarva sattva avaboDakaH,
   sattvārthābhāvakaḥ, kṣiprasukhābhisaṃbodhiśceti //	sattva arTa aBAvakaH, kzipra suKa aBisaMboDiH ca iti //
   112. praṇidhānaṃ trividham / tadyathā   susthānaprābandhikam,	112. praNiDAnam triviDam / tat yaTA  su sTAna prAbanDikam,
   sattvārthaprabandhikam, buddhakṣetrapariśodhakaṃ ceti //	sattva arTa prabanDikam, budDa kzetra pariSoDakam ca iti //
   113. balaṃ trividham / tadyathā   karmavyāvartakam, kleśāpakarṣakam,	113. balam triviDam / tat yaTA  karma vyAvartakam, kleSa apakarzakam,
   mānapramādādivyāvartakaṃ ceti //	mAna pramAda Adi vyAvartakam ca iti //
   114. jñānaṃ trividham / tadyathā   avikalpakam, vikalpasamabhāvabodhakam,	114. jQAnam triviDam / tat yaTA  avikalpa kam, vikalpa sama BAva boDakam,
   satyārthopāyaparokṣaṃ ceti //	satya arTa upAya parokzam ca iti //
   115. tatrāvaraṇe dve / tadyathā   kleśavaraṇam, jñeyāvaraṇaṃ ceti //	115. tatra AvaraNe dve / tat yaTA  kleSa varaNam, jQeya AvaraNam ca iti //
   116. nairātmyaṃ dvividham / tadyathā   dharmanairātmyam, pugdalanairātmyaṃ	116. nErAtmyam dviviDam / tat yaTA  Darma nErAtmyam, pugdala nErAtmyam
   ceti //	ca iti //
   117. saṃbhāro dvividhaḥ / tadyathā   puṇyasaṃbhāraḥ, jñānasaṃbhāraśceti //	117. saMBAraH dviviDaH / tat yaTA  puNya saMBAraH, jQAna saMBAraH ca iti //
   118. tatra ṣaṭ samādhyāvaraṇāni / tadyathā   kausīdyam, mānam, śāṭhyam,	118. tatra zaw samADi AvaraNAni / tat yaTA  kOsIdyam, mAnam, SAWyam,
   auddhatyam, anābhogaḥ, satyābhogaśceti //	OdDatyam, anABogaH, satya ABogaH ca iti //
   119. tatra pratipattyāṣṭau prahāṇasaṃskārāḥ / tadyathā   śraddhā,	119. tatra pratipattyA azwO prahANa saMskArAH / tat yaTA  SradDA,
   buddhaḥ(ddhiḥ), vyāyāmaḥ, prasrabdhiḥ, smṛtiḥ, saṃprajanyam, cetanā,	budDaH(dDiH), vyAyAmaH, prasrabDiH, smRtiH, saMprajanyam, cetanA,
   upekṣā ceti //	upekzA ca iti //
   120. tatra catvāro dvīpāḥ / tadyathā   pūrvavidehaḥ, jambudvīpaḥ,	120. tatra catvAraH dvIpAH / tat yaTA  pUrva videhaH, jambudvIpaH,
   aparagodāniḥ(nīyaḥ), uttarakurudvīpaśceti //	apara godAniH(nIyaH), uttarakuru dvIpaH ca iti //
   121. aṣṭāvuṣṇanarakāḥ / tadyathā   saṃjīvaḥ, kālasūtraḥ, saṃghātaḥ,	121. azwO= uzNa narakAH / tat yaTA  saMjIvaH, kAlasUtraH, saMGAtaH,
   rauravaḥ, mahārauravaḥ, tapanaḥ, pratāpanaḥ, avīciśceti //	rOravaH, mahArOravaH, tapanaH, pratApanaH, avIciH ca iti //
   122. aṣṭau śītanarakāḥ / tadyathā   arbudaḥ, nirarbudaḥ, aṭaṭaḥ, apapaḥ,	122. azwO SIta narakAH / tat yaTA  arbudaH, nirarbudaH, awawaH, apapaH,
   hāhādharaḥ, utpalaḥ, padmaḥ, mahāpadmaśceti //	hAhADaraH, utpalaH, padmaH, mahApadmaH ca iti //
   123. sapta pātālāni / tadyathā   dharaṇītalaḥ, acalaḥ, mahācalaḥ, āpaḥ,	123. sapta pAtAlAni / tat yaTA  DaraNI talaH, acalaH, mahA acalaH, ApaH,
   kāñcanaḥ, saṃjīvaḥ, narakaśceti /	kAQcanaH, saMjIvaH, narakaH ca iti /
   124. dvau cakravālau / tadyathā   cakravālamahācakravālau ceti //	124. dvO cakravAlO / tat yaTA  cakravAla mahA cakravAlO ca iti //
   125. aṣṭāṅgaparvatāḥ / tadyathā   yugaṃdharaḥ, īśādharaḥ, khadirakaḥ,	125. azwAFga parvatAH / tat yaTA  yugaMDaraH, ISa aDaraH, KadirakaH,
   sudarśanaḥ, vinatakaḥ, aśvakarṇaḥ, nemiṃdharagiriḥ, sumeruśceti //	sudarSanaH, vinatakaH, aSvakarNaH, nemiMDara giriH, sumeruH ca iti //
   126. sapta sāgarāḥ / tadyathā   kṣāraḥ, kṣīraḥ, dadhi, udadhiḥ, ghṛtam,	126. sapta sAgarAH / tat yaTA  kzAraH, kzIraH, daDi, udaDiH, GRtam,
   madhuḥ, surā ceti //	maDuH, surA ca iti //
   (Dhs, Vaidya 339)	(Dhs, VEdyaH 339)
   127. tatra ṣaṭ kāmāvacarā devāḥ / tadyathā   cāturmahārājakāyikāḥ,	127. tatra zaw kAmAvacarAH devAH / tat yaTA  cAturmahArAja kAyikAH,
   trāyastriṃśāḥ, tuṣitāḥ, yāmāḥ, nirmāṇaratayaḥ, paranirmitavaśavartinaśceti	trAyastriMSAH, tuzitAH, yAmAH, nirmANa ratayaH, paranirmitavaSavartinaH ca iti
   128. aṣṭādaśa rūpāvacarā devāḥ / tadyathā   brahmakāyikāḥ,	128. azwAdaSa rUpAvacarAH devAH / tat yaTA  brahmakAyikAH,
   brahmapurohitāḥ, brahmapārṣadyāḥ, mahābrahmāṇaḥ, parīttābhāḥ,	brahma purohitAH, brahmapArzadyAH, mahA brahmANaH, parItta ABAH,
   apramāṇābhāḥ, ābhāsvarāḥ, parīttaśubhāḥ, śubhakṛtsnāḥ, anabhrakāḥ,	apramANa ABAH, ABAsvarAH, parItta SuBAH, SuBa kRtsnAH, anaBrakAH,
   puṇyaprasavāḥ, bṛhatphalāḥ, asaṃjñisattvāḥ, avṛhāḥ, atapāḥ, sudṛśāḥ,	puNya prasavAH, bRhat PalAH, asaMjQi sattvAH, avRhAH, atapAH, sudRSAH,
   sudarśanāḥ, akaniṣṭhāśceti //	sudarSanAH, akanizWAH ca iti //
   129. catvāro 'rūpāvacarā devāḥ / ākāśānantyāyatanopagāḥ,	129. catvAraH arUpAvacarAH devAH / AkASa Anantya Ayatana upagAH,
   vijñānānantyāyatanopagāḥ, ākiṃcanyāyatanopagāḥ,	vijQAna AnantyAyatana upagAH, AkiMcanyAyatana upagAH,
   naivasaṃjñānāsaṃjñāyatanopagāśceti //	na eva saMjQAna asaMjQAyatana upagAH ca iti //
   130. trividhā ālaṅghanāḥ / tadyathā   satyālaṅghanā, dharmālaṅghanā,	130. triviDAH AlaFGanAH / tat yaTA  satya alaFGanA, Darma alaFGanA,
   anālaṅghanā ceti //	anAlaFGanA ca iti //
   131. trividhā mahāmaitrī / tadyathā   satyālaṅgha(mba)nā,	131. triviDA mahA mEtrI / tat yaTA  satya alaFGa (mba)nA,
   dharmalaṅgha(rmālamba)nā, anālaṅgha(mba)nā ceti //	Darma laFGa (rma Alamba)nA, anAlaFGa(mba)nA ca iti //
   132. trividhaṃ karma / tadyathā   dṛṣṭadharmavedanīyam, utpadyavedanīyam,	132. triviDam karma / tat yaTA  dRzwa Darma vedanIyam, utpadya vedanIyam,
   aparavedanīyaṃ ceti //	apara vedanIyam ca iti //
   133. trividhaṃ prātihāryam / tadyathā   ṛddhiprātihāryam,	133. triviDam prAtihAryam / tat yaTA  RdDi prAtihAryam,
   ādeśanāprātihāryam, anuśāsanīprātihāryaṃ ceti //	AdeSana aprAtihAryam, anuSAsanI prAtihAryam ca iti //
   134. aṣṭāvakṣaṇāḥ / tadyathā   narakopapattiḥ, tiryagupapattiḥ,	134. azwO= akzaNAH / tat yaTA  naraka upapattiH, tiryak upapattiH,
   yamalokopapattiḥ, pratyantajanapadopapattiḥ, dīrghāyuṣadevopapattiḥ,	yama loka upapattiH, pratyanta janapada upapattiH, dIrGa Ayuza deva upapattiH,
   indriyavikalatā, mithyādṛṣṭiḥ, cittotpādavirāgitatā ceti //	indriya vikalatA, miTyAdRzwiH, citta utpAda virAgita tA ca iti //
   135. trividhā vikalpāḥ / tadyathā   anusmaraṇavikalpaḥ,	135. triviDAH vikalpAH / tat yaTA  anusmaraNa vikalpaH,
   saṃtirana(tīraṇa)vikalpaḥ, sahajavikalpaśceti //	saMtirana(tIraNa) vikalpaH, sahaja vikalpaH ca iti //
   136. catvāraḥ samādhayaḥ / tadyathā   śūraṃgamaḥ, gaganagañjaḥ	136. catvAraH samADayaH / tat yaTA  SUraMgamaH, gagana gaQjaH
   vimalaprabhaḥ, siṃhavikrīḍitaśceti /	vimala praBaH, siMha vikrIxitaH ca iti /
   137. caturdaśāvyākṛtavastūni / tadyathā   śāśvato lokaḥ, aśāśvato lokaḥ,	137. caturdaSa avyAkRta vastUni / tat yaTA  SASvataH lokaH, aSASvataH lokaH,
   śāśvataścāśāśvataśca, naiva śāśvato nāśāśvataśca / antavāṃllokaḥ,	SASvataH ca aSASvataH ca, na eva SASvataH na aSASvataH ca / antavAn= lokaH,
   anantavāṃllokaḥ, antavāṃścānantavāṃllokaśca, naivāntavānnānantavāṃśca /	anantavAn= lokaH, antavAn= ca anantavAn= lokaH ca, na eva antavAn na anantavAn= ca /
   bhavati tathāgataḥ paraṃ maraṇāt, na bhavati tathāgataḥ paraṃ maraṇāt,	Bavati taTAgataH param maraNAt, na Bavati taTAgataH param maraNAt ,
   bhavati na ca bhavati ca tathāgataḥ paraṃ maraṇāt, naiva bhavati na	Bavati na ca Bavati ca taTAgataH param maraNAt, na eva Bavati na
   bhavati tathāgataḥ paraṃ maraṇāt / sa jīvastaccharīram, anyo jīvo	Bavati taTAgataH param maraNAt / sa jIvaH tat SarIram, anyaH jIvaH 
   'nyaccharīraṃ ceti //	anyat SarIram ca iti //
   138. trīṇi kuśalamūlāni / tadyathā   adveṣaḥ, alobhaḥ, amohaśceti //	138. trINi kuSala mUlAni / tat yaTA  advezaH, aloBaH, amohaH ca iti //
   139. etadviparyayāntrīṇyakuśalamūlāni / tadyathā   lobhaḥ, mohaḥ,	139. etad viparyayAntrINi akuSala mUlAni / tat yaTA  loBaH, mohaH,
   dveṣaśceti //	dvezaH ca iti //
   140. tisraḥ śikṣāḥ / tadyathā   adhicittaśikṣā, adhiśīlaśikṣā,	140. tisraH SikzAH / tat yaTA  aDicitta SikzA, aDiSIla SikzA,
   adhiprajñāśikṣā ceti //	aDiprajQA SikzA ca iti //
   iti nāgārjunapādaviracito 'yaṃ dharmasaṃgrahaḥ samāptaḥ //	iti nAgArjuna pAda viracitaH ayam Darma saMgrahaH samAptaH //
