   Kṣaṇabhaṅgasiddhiḥ /	KzaNa BaFga sidDiH /
   namaḥ samantabhadrāya /	namaH samantaBadrAya /
   ākṣiptavyatirekā ya vyāptiranvayarūpiṇī /	Akzipta vyatirekA yaH vyAptiH anvaya rUpiNI /
   sādharmmyavati dṛṣṭānte sattvahetorihocyate //	sADarmmyavati dRzwAnte sattva hetoH iha ucyate //
   yat sat tat kṣaṇikaṃ yathā ghaṭaḥ santaścāmī vivādāspadībhūtāḥ padārthā	yat sat tat kzaNikam yaTA GawaH santaH ca amI vivAda AspadIBUtAH padArTA
   iti /	iti /
   hetoḥ parokṣārthapratipādakatvaṃ hetvābhāsatvaśaṅkānirākaraṇamantareṇa na	hetoH parokza arTa pratipAdaka tvam hetvABAsa tva SaFkA nirAkaraNam antareNa na
   śakyate pratipādayituṃ / hetvābhāsāśca asidvavirudvānaikāntikabhedena	Sakyate pratipAdayitum / hetvABAsAH ca asi dvavirudvAn EkAntika Bedena
   trividhāḥ / tatra na tāvadayamasidvo hetuḥ / yadi nāma darśane darśane	triviDAH / tatra na tAvat ayam asidvaH hetuH / yadi nAma darSane darSane
   nānāprakāraṃ sattvalakṣaṇamuktamāste, arthakriyākāritvaṃ, sattāsamavāyaḥ,	nAnA prakAram sattva lakzaNam uktam Aste, arTa kriyA kAritvaM, sattA samavAyaH,
   svarūpasattvaṃ, utpādavyayaghrauvyayogitvaṃ pramāṇaviṣayatvaṃ,	svarUpa sattvan, utpAda vyaya GrOvya yogi tvam pramANa vizaya tvaM,
   sadupalambhapramāṇagocaratvaṃ vyapadeśaviṣayatvamityādi, tathāpi kimanena	sat upalamBa pramANa gocara tvam vyapadeSa vizaya tvam ityAdi, taTA api kim anena
   aprastutena idānīmeva niṣṭaṅkitena / yadeva hi pramāṇato nirūpyamāṇaṃ	aprastutena idAnIm eva nizwaFkitena / yat eva hi pramANataH nirUpyamANam
   padārthānāṃ sattvamupapannaṃ bhaviṣyati; tadeva vayamapi svīkariṣyāmaḥ /	padArTAnAm sattvam upapannam Bavizyati; tat eva vayam api svIkarizyAmaH /
   kevalaṃ yadetadarthakriyākāritvaṃ sarvvajanaprasidvamāste; tat khalvatra	kevalam yat etad arTa kriyA kAri tvam sarvu ajana prasidvam Aste; tat Kalu atra
   sattvaśabdenābhisandhāya sādhanatvenopāttaṃ / tacca yathāyogaṃ	sattva Sabdena aBisanDAya sADana tvena upAttam / tat ca yaTAyogam
   pratyakṣānumānapramāṇaprasidvasadbhāveṣu bhāveṣu pakṣīkṛteṣu pratyakṣādinā	pratyakza anumAna pramANa prasidvasadBAvezu BAvezu pakzIkRtezu pratyakza AdinA
   pramāṇena pratītamiti na svarūpeṇāśrayadvāreṇa vāsidvasambhāvanāpi //	pramANena pratItam iti na svarUpeNa ASraya dvAreNa vAsi dvasamBAvanA api //
   nāpi viruddhaḥ / sapakṣīkṛte ghaṭe sadbhāvāt / nanu kathamasya	na api virudDaH / sa pakzIkRte Gawe sadBAvAt / nanu kaTam asya
   sapakṣatvaṃ, pakṣavadatrāpi kṣaṇabhaṅgāsiddheḥ / nahyasya pratyakṣata	sa pakza tvan, pakzavat atra api kzaNa BaFga asidDeH / na hi asya pratyakzata
   kṣaṇabhaṅgasiddhiḥ / tathātvenāniścayāt / nāpi sattvānumānataḥ /	kzaNa BaFga sidDiH / taTA tvena aniScayAt / na api sattva anumAnataH /
   punarnidarśanāntarāpekṣāyāmanavasthāprasaṅgāt / na cānyadanumānamasti /	punar nidarSana antara apekzAyAm anavasTA prasaFgAt / na ca anyat anumAnam asti /
   sambhave vā tenaiva pakṣe 'pi kṣaṇabhaṅgasidveralaṃ sattānumāneneti cet /	samBave vA tena eva pakze api kzaNa BaFga sidveH alam satta anumAnena iti ced /
   ucyate / anumānāntarameva prasaṅgaprasaṅgaviparyyayātmakaṃ ghaṭe	ucyate / anumAna antaram eva prasaFga prasaFga viparyyaya Atmakam Gawe
   kṣaṇabhaṅgaprasādhakaṃ pramāṇāntaramasti, tathā ghaṭo varttamānakṣaṇe	kzaNa BaFga prasADakam pramANa antaram asti, taTA GawaH varttamAna kzaNe
   tāvat ekāmarthakriyāṃ karoti / atītānāgatakṣaṇayorapi kiṃ tāme	tAvat ekAm arTa kriyAm karoti / atIta anAga takzaNayoH api kim tAme
   vārthakriyāṃ kuryādanyāṃ vā, navā kāmapi kriyāmiti trayaḥ pakṣāḥ / nātra	vA arTa kriyAm kuryAt anyAm vA, navA kAm api kriyAm iti trayaH pakzAH / na atra
   prathamapakṣo yuktaḥ kṛtasya karaṇāyogāt / atha dvitīyo 'bhyupagamyate	praTama pakzaH yuktaH kRtasya karaNa ayogAt / aTa dvitIyaH aByupagamyate
   tadidamatra vicāryyatām / yadā ghaṭo varttamānakṣaṇabhāvi kāryyaṃ karoti	tat idam atra vicAryyatAm / yadA GawaH varttamAna kzaNa BAvi kAryyam karoti
   tadā kimatītānāgatakṣaṇabhāvinyapi kāryye śakto 'śakto vā / yadi	tadA kim atIta anAga takzaNa BAvini api kAryye SaktaH aSaktaH vA / yadi
   śaktastadā varttamānakṣaṇabhāvikāryyavat atītānāgatakṣaṇabhāvyapi kāryyaṃ	SaktaH tadA varttamAnakzaNa BAvi kAryya vat atItAnAga takzaNa BAvi api kAryyam
   kuryyāt tatrāpi śaktatvāt śaktasya kṣepāyogāt / anyathā	kuryyAt tatra api Sakta tvAt Saktasya kzepA yogAt / anyaTA
   varttamānakṣaṇabhāvino 'pi kāryyasyākaraṇaprasaṅgāt pūrvvāparakālayorapi	varttamAna kzaNa BAvinaH api kAryyasya akaraNa prasaFgAt pUrvva apara kAlayoH api
   śaktatvenāviśeṣāt, samarthasya ca sahakāryyapekṣāyā ayogāt /	Sakta tvena aviSezAt, samarTasya ca sahakAryi apekzAyAH ayogAt /
   athāśaktastadā ekatra kāryye śaktāśaktatvaviruddhadharmmādhyāsāt	aTa aSaktaH tadA ekatra kAryye Sakta aSakta tva virudDa Darmma aDyAsAt
   kṣaṇavidhvaṃso ghaṭasya durvvāraprasaraḥ syāt /	kzaNa viDvaMsaH Gawasya durvvAra prasaraH syAt /
   nāpi tṛtīyaḥ pakṣaḥ saṅgacchate śaktasvabhāvānuvṛttereva / yadā hi	na api tRtIyaH pakzaH saFgacCate Sakta svaBAva anuvRtteH eva / yadA hi
   śaktasya svabhāvasya vilambo 'pyasahyastadā dūrītsāritamakaraṇam / anyathā	Saktasya svaBAvasya vilambaH api asahyaH tadA dUrIt sAritam akaraNam / anyaTA
   vārttamānikasyāpi kāryyasyākaraṇaṃ syāt ityuktaṃ / tasmād yad yadā	vArtta mAnikasya api kAryyasya akaraNam syAt iti uktam / tasmAt yat yadA
   yajjananavyavahārapātraṃ, tattadā tat kuryyāt / akurvvacca na	yat janana vyavahAra pAtraM, tat tadA tat kuryyAt / akurvvat ca na
   jananavyavahārabhājanam / tadevamekatra kāryye samarthetarasvabhāvatayā	janana vyavahAra BAjanam / tat evam ekatra kAryye samarTa itara svaBAva tayA
   pratikṣaṇaṃ bhedāt ghaṭasya sapakṣatvamakṣatam /	pratikzaNam BedAt Gawasya sa pakza tvam akzatam /
   atra prayogaḥ / yad yadā yajjananavyavahārayogyaṃ tattadā tajjanayatyeva /	atra prayogaH / yat yadA yat janana vyavahAra yogyam tat tadA tat janayati eva /
   yathā antyā kāraṇasāmagrī svakāryyaṃ /	yaTA antyA kAraNa sAmagrI sva kAryyam /
   atītānāgatakṣaṇabhāvikāryyajananavyavahārayogyaścāyaṃ ghaṭo	atIta anAga takzaNa BAvi kAryya janana vyavahAra yogyaH ca ayam Gawo
   varttamānakṣaṇabhāvikāryyakaraṇakāle sakalakriyātikramakāle 'pīti	varttamAna kzaNa BAvi kAryya karaNa kAle sakala kriyA atikrama kAle api iti
   svabhāvahetuprasaṅgaḥ / asya ca	svaBAva hetu prasaFgaH / asya ca
   dvitīyādikṣaṇabhāvikāryyakaraṇavyavahāragocaratvasya prasaṅgasādhanasya	dvitIya Adi kzaNa BAvi kAryya karaNa vyavahAra gocara tvasya prasaFga sADanasya
   vārttamānikakāryyakaraṇakāle sakalakriyātikramakāle ca ghaṭe dharmmiṇi	vArtta mAnika kAryya karaNa kAle sakala kriyA atikrama kAle ca Gawe DarmmiNi
   parābhyupagamamātrataḥ sidvatvāt asidvistāvadasambhavinī / nāpi virudvatā,	para aByupagama mAtrataH sidva tvAt asi dviH tAvat asamBavinI / na api virudvatA,
   sapakṣe antyakāraṇasāmagryāṃ sadbhāvasambhavāt /	sa pakze antya kAraNa sAmagryAm sadBAva samBavAt /
   nanvayaṃ sādhāraṇānaikāntiko hetuḥ / sākṣādajanake 'pi	nanu ayam sADAraNA anEkAntikaH hetuH / sAkzAt ajanake api
   kuśūlādyavasthitavījādau vipakṣe samarthavyavahāragocaratvasya sādhanasya	kuSUla Adi avasTita vIja AdO vipakze samarTa vyavahAra gocara tvasya sADanasya
   darśanāditi cet / na / dvividho hi samarthavyavahāraḥ pāramārthikaḥ	darSanAt iti ced / na / dviviDaH hi samarTa vyavahAraH pAramArTikaH
   aupacārikaśca / tatra yatpāramārthikam jananaprayuktaṃ	OpacArikaH ca / tatra yat pAramArTikam janana prayuktam
   jananavyavahāragocaratvaṃ tadiha sādhanatvenopāttaṃ / tasya ca	janana vyavahAra gocara tvam tat iha sADana tvena upAttam / tasya ca
   kuśūlādyavasthita vījādau kāraṇakāraṇatvāt	kuSUla Adi avasTita vIja AdO kAraNa kAraNa tvAt
   aupacārikajananavyavahāraviṣayabhūte sambhavābhāvāt kutaḥ	OpacArika janana vyavahAra vizaya BUte samBava aBAvAt kutas 
   sādhāraṇānaikāntikatā / na cāsya sandigdhavyatirekitā viparyyaye	sADAraNa anEkAntika tA / na ca asya sandigDa vyatirekitAH viparyyaye
   bādhakapramāṇasadbhāvāt / tathāhīdaṃ jananavyavahāragocaratvaṃ	bADaka pramANa sadBAvAt / taTA ahi idam janana vyavahAra gocara tvam
   niyataviṣayatvena vyāptamiti sarvvajanānubhavasiddham / na cedaṃ	niyata vizaya tvena vyAptam iti sarvu ajana anuBava sidDam / na ca idam
   nirnimittaṃ / deśakālasvabhāvaniyamābhāvaprasaṅgāt / na ca	nirnimittam / deSa kAla svaBAva niyama aBAva prasaFgAt / na ca
   jananādanyannimittamupalabhyate / tadanvayavyatirekānuvidhānadarśanāt /	jananAt anyat nimittam upalaByate / tad anvaya vyatireka anuviDAna darSanAt /
   yadi ca jananamantareṇāpi jananavyavahāragocaratvaṃ syāt tadā sarvvasya	yadi ca jananam antareNa api janana vyavahAra gocara tvam syAt tadA sarvu asya
   sarvvatra jananavyavahāra ityaniyamaḥ syāt / niyataścāyaṃ pratītaḥ / tato	sarvu atra janana vyavahAraH iti aniyamaH syAt / niyataH ca ayam pratItaH / tatas 
   jananābhāve vipakṣe niyataviṣayatvasya vyāpakasya nivṛttau nivarttamānaṃ	janana aBAve vipakze niyata vizaya tvasya vyApakasya nivRttO nivarttamAnam
   jananavyavahāragocaratvaṃ janana eva viśrāmyatīti vyāptisidveranavadyo	janana vyavahAra gocara tvam jananaH eva viSrAmyati iti vyApti sidvera navat yaH 
   hetuḥ / na caiṣa ghaṭo varttamānakāryyakaraṇakṣaṇe sakalakriyātikramaṇe ca	hetuH / na ca eza GawaH varttamAna kAryya karaNa kzaNe sakala kriyA atikramaNe ca
   atītānāgatakṣaṇabhāvikāryyaṃ janayati / tato na jananavyavahārayogyaḥ /	atIta anAga takzaNa BAvi kAryyam janayati / tatas na janana vyavahAra yogyaH /
   sarvvaḥ prasaṅgaḥ prasaṅgaviparyyayaniṣṭha iti nyāyāt /	sarvvaH prasaFgaH prasaFga viparyyaya nizWaH iti nyAyAt /
   atrāpi prayogaḥ / yadyadā yanna karoti / tattadā tatra	atra api prayogaH / yat yadA yat na karoti / tat tadA tatra
   samarthavyavahārayogyaṃ yathā śālyaṅkuramakurvvan kodravaḥ śālyaṅkure / na	samarTa vyavahAra yogyam yaTA SAli aFkuram akurvvan kodravaH SAli aFkure / na
   karoti caiṣa ghaṭo varttamānakṣaṇabhāvikāryyakaraṇakāle	karoti ca eza GawaH varttamAna kzaNa BAvi kAryya karaNa kAle
   sakalakriyātikramakāle cātītānāgatakṣaṇabhāvikāryyamiti	sakala kriyA atikrama kAle ca atIta anAga takzaNa BAvi kAryyam iti
   vyāpakānupalabdhirbhinatti samarthakṣaṇādasamarthakṣaṇam /	vyApaka an upalabDiH Binatti samarTa kzaNAt asamarTa kzaNam /
   atrāpyasiddhirnāsti varttamānakṣaṇabhāvikāryyakaraṇakāle	atra api asidDiH na asti varttamAna kzaNa BAvi kAryya karaNa kAle
   sakalakriyātikramakāle ca atītānāgatakṣaṇabhāvikāryyakaraṇasyāyogāt / nāpi	sakala kriyA atikrama kAle ca atIta anAga takzaNa BAvi kAryya karaNasya ayogAt / na api
   virodhaḥ sapakṣe bhāvāt / na cānaikāntikatā pūrvvoktena nyāyena samartha	viroDaH sa pakze BAvAt / na ca anEkAntika tA pUrvva uktena nyAyena samarTa
   vyavahāragocaratvajanakatvayovidhibhūtayoḥ sarvvopasaṃhāravatyā vyāpteḥ	vyavahAra gocara tva janaka tva yaH viDi BUtayoH sarvvA upasaMhAravatyA vyApteH
   prasādhanāt /	prasADanAt /
   yatpunaratroktaṃ yadyadā yanna karoti na tattadā tatra samarthamityatra	yat punar atra uktam yat yadA yat na karoti na tat tadA tatra samarTam iti atra
   kaḥ karotyarthaḥ / kiṃ kāraṇatvaṃ? tatkāryyotpādānuguṇasahakārisākalyaṃ?	kaH karoti arTaH / kim kAraNa tvaM? tad kAryya utpAda anuguNa sahakAri sAkalyaM?
   āhosvit kāryyāvyabhicāraḥ? kāryyasambandho veti? tatra kāraṇatvameva	Ahosvit kAryya avyaBicAraH? kAryya sambanDaH vA iti? tatra kAraNa tvam eva
   karotyarthaḥ / tataḥ pakṣāntarabhāvino doṣā anabhyupagamapratihatāḥ /	karoti arTaH / tatas pakza antara BAvinaH dozAH anaByupagama pratihatAH /
   na cātrapakṣe kāraṇatvasāmarthyayoḥ paryyāyatvena vyāpakānupalambhasya	na ca atra pakze kAraNa tva sAmarTyayoH paryyAya tvena vyApaka anupalamBasya
   sādhyāviśiṣṭatvamabhidhātumucitaṃ / samarthavyavahāragocaratvābhāvasya	sADya aviSizwa tvam aBiDAtum ucitam / samarTa vyavahAra gocara tva aBAvasya
   sādhyatvāt / kāraṇatvasamarthavyavahāragocaratvayośca bṛkṣaśiṃśapayoriva	sADya tvAt / kAraNatva samarTa vyavahAra gocara tvayoH ca bRkza SiMSapayoH iva
   vyāvṛttibhedo 'stītyanavasara eva evaṃvidhasya kṣudrapralāpasya / tadevaṃ	vyAvRtti BedaH asti iti anavasaraH eva evaMviDasya kzudra pralApasya / tat evam
   prasaṅgaprasaṅgaviparyyayahetudvayabalato ghaṭe dṛṣṭānte kṣaṇabhaṅgaḥ	prasaFga prasaFga viparyyaya hetu dvaya balataH Gawe dRzwAnte kzaNa BaFgaH
   siddhaḥ / tatkathaṃ sattvādanyadanumānaṃ dṛṣṭānte kṣaṇabhaṅgasādhakam /	sidDaH / tat kaTam sattvAt anyat anumAnam dRzwAnte kzaNa BaFga sADakam /
   nāstītyucyate / na caivaṃ sattvahetorvaiyarthyaṃ / dṛṣṭāntamātra eva	na asti iti ucyate / na ca evam sattva hetoH vEyarTyam / dRzwAnta mAtre eva
   prasaṅgaprasaṅgaviparyyayābhyāṃ kṣaṇabhaṅgaprasādhanāt nanvābhyāmeva pakṣe	prasaFga prasaFga viparyyayAByAm kzaNa BaFga prasADanAt nanu AByAm eva pakze
   'pi kṣaṇabhaṅgasiddhirastviti cet / astu ko doṣaḥ / yo hi pratipattā	api kzaNa BaFga sidDiH astu iti ced / astu kaH dozaH / yaH hi pratipattA
   prativastu yadyadā yajjananavyavahārayogyaṃ tattadā tajjanayatītyā	prativastu yat yadA yat janana vyavahAra yogyam tat tadA tad janayati ityA
   dikamupanyasituṃ analasastasya tata eva kṣaṇabhaṅgasiddhiḥ / yastu	dikam upanyasitum analasaH tasya tatas eva kzaNa BaFga sidDiH / yaH tu
   prativastu tannyāyopanyāsaprayāsabhīruḥ sa ttvekatradharmmiṇi yadyadā	prativastu tat nyAya upanyAsa prayAsa BIruH sa ttu ekatra DarmmiNi yat yadA
   yajjananavyavahārayogyaṃ tattadā tajjanayatītyādinyāyena	yat janana vyavahAra yogyam tat tadA tat janayati ityAdi nyAyena
   sattvamātramasthairyyavyāptamavadhāryyasattvādevānyatra	sattva mAtram asTEryyavyAptam avaDAryya sattvAt eva anyatra
   kṣaṇikatvamavagacchatīti / kathamapramattovaiyarthyamasyācakṣīta	kzaNika tvam avagacCati iti / kaTam apramattaH vEyarTyam asya AcakzIta
   tadevamekārthakāriṇo ghaṭasya dvitīyādikṣaṇabhāvikāryyāpekṣayā	tat evam ekArTa kAriNaH Gawasya dvitIya Adi kzaNa BAvi kAryyA apekzayA
   samarthetarasvabhāvavirudvadharmmā dhyāsāt bheda eveti kṣaṇabhaṅgatayā	samarTa itara svaBAva virudva DarmmA DyAsAt BedaH eva iti kzaNa BaFga tayA
   sapakṣatāmāvahati ghaṭe sattveheturupalabhyamāno na virudvaḥ /	sa pakzatAm Avahati Gawe sattva IhetuH upalaByamAnaH na virudvaH /
   na cāya manaikāntikaḥ / atraiva sādharmmyavati dṛṣṭānte	na ca aya manEkAntikaH / atra eva sADarmmyavati dRzwAnte
   sarvvopasaṃhāravatyā vyāpteḥ prasādhanāt / nanu viparyyaye	sarvva upasaMhAravatyA vyApteH prasADanAt / nanu viparyyaye
   bādhakapramāṇabalābdyāptisiddhistasya copanyāsavārttāpi nāsti tatkathaṃ	bADaka pramANa bala abdya Apti sidDiH tasya ca upanyAsa vArttA api na asti tat kaTam
   vyāptiḥ prasādhiteti cet / tadetat taralatarabuddhivilasitaṃ / tathā hi	vyAptiH prasADitA iti ced / tat etat taralatara budDi vilasitam / taTA hi
   uktametat varttamānakṣaṇabhāvikāryyakaraṇakāle atītānāgatakṣaṇabhāvikāryye	uktam etat varttamAna kzaNa BAvi kAryya karaNa kAle atIta anAga takzaNa BAvi kAryye
   'pi ghaṭasya śaktisambhave tadānīmevaitat karaṇamakaraṇe ca	api Gawasya Sakti samBave tadAnIm eva etat karaNam akaraNe ca
   śaktāśaktasvabhāvatayā pratikṣaṇaṃ bheda iti kṣaṇikatvena vyāptaiva sā	Sakta aSakta svaBAva tayA pratikzaNam BedaH iti kzaNika tvena vyAptA eva sA
   arthakriyāśaktiḥ /	arTa kriyASaktiH /
   nanvevaṃ anvayamātramastu vipakṣāt punarekāntena vyāvṛttiriti kuto	nanu evam anvaya mAtram astu vipakzAt punar ekAntena vyAvRttiH iti kuto
   labhyamiti cet, vyāptisiddhereva / byatirekasandehe vyāptisiddhireva	laByam iti cet, vyApti sidDeH eva / byatiH eka sandehe vyApti sidDiH eva
   kathamiti cet, na dvividhā hi vyāptisiddhiranvayarūpā ca karttṛdharmmaḥ /	kaTam iti cet, na dviviDA hi vyApti sidDiH anvaya rUpA ca karttR DarmmaH /
   sādhanadharmmavati dharmmiṇi sādhyadharmmasyāvaśyambhāvo yaḥ /	sADana Darmmavati DarmmiNi sADya Darmmasya avaSyamBAvaH yaH /
   vyatirekarūpā ca karmmadharmmaḥ sādhyābhāve sādhanasyāvaśyamabhāvo yaḥ /	vyatireka rUpA ca karmma DarmmaH sADya aBAve sADanasya avaSyam aBAvaH yaH /
   enayoścaikatarapratītiniyamena dvitīyapratītimākṣipati / anyathā, ekasyāḥ	enayoH ca ekatara pratIti niyamena dvitIya pratItim Akzipati / anyaTA, ekasyAH
   eva siddhaḥ / tasmād / yathā viparyyaye bādhakapramāṇabalāt niyamavati	eva sidDaH / tasmAt / yaTA viparyyaye bADaka pramANa balAt niyamavati
   vyatireke siddhe anvayaviṣayaḥ saṃśayaḥ pūrvvaṃ sthito 'pi	vyatireke sidDe anvaya vizayaH saMSayaH pUrvvam sTitaH api
   paścātparigalati / tato 'nvayaprasādhanārthaṃ na pṛthaksādhanamucyate /	paScAt parigalati / tatas anvaya prasADana arTam na pRTak sADanam ucyate /
   tathā prasaṅgatadviparyyayahetudvayabalato niyamavatyanvaye siddhe	taTA prasaFga tad viparyyaya hetu dvaya balataH niyamavatI anvaye sidDe
   vyatirekaviṣaye pūrvvaṃ sthito 'pi sandehaḥ paścātparigalatyeva / na ca	vyatireka vizaye pUrvvam sTitaH api sandehaH paScAt parigalati eva / na ca
   vyatirekasādhakamanyat pramāṇaṃ vyaktavyam / tataśca sādhyābhāve	vyatireka sADakam anyat pramANam vyaktavyam / tatas ca sADya aBAve
   sādhanasyaikāntiko vyatirekaḥ / sādhane sati sādhyasyāvaśyamanvayo veti na	sADanasya ekAntikaH vyatirekaH / sADane sati sADyasya avaSyam anvayaH vA iti na
   kaścidarthabhedaḥ tadevaṃ viparyyayabādhakapramāṇamantareṇāpi	kaScid arTa BedaH tat evam viparyyaya bADaka pramANam antareNa api
   prasaṅgaprasaṅgaviparyyayahetudvayabalāt anvayarūpavyāptisidvau	prasaFga prasaFga viparyyaya hetu dvaya balAt anvaya rUpa vyApti sidvO
   sattvahetoranaikāntikasyābhāvādataḥ sādhanāt kṣaṇabhaṅgasidviranavadyeti /	sattva hetoH anEkAntikasya aBAvAt atas sADanAt kzaNa BaFga sidvis a navadyA iti /
   nanu ca sādhanamidamasidvaṃ, na hi kāraṇabudhyā kāryyaṃ gṛhyate / tasya	nanu ca sADanam idam asi dvaM, na hi kAraNa buDyA kAryyam gRhyate / tasya
   bhāvitvāt / na ca kāryyabudhyā kāraṇam / tasyātītatvāt / na ca	BAvi tvAt / na ca kAryya buDyA kAraNam / tasya atIta tvAt / na ca
   varttamānagrāhiṇā jñānena atītānāgatayorgrahaṇamatiprasaṅgāt / na ca	varttamAna grAhiNA jQAnena atIta anAgatayoH grahaNam ati prasaFgAt / na ca
   pūrvvāparayoḥ kālayorekaḥ pratisandhātāsti kṣaṇabhaṅgabhaṅgaprasaṅgāt /	pUrvva aparayoH kAlayoH ekaH pratisanDAtA asti kzaNa BaFga BaFga prasaFgAt /
   kāraṇābhāve tu kāryyābhāvapratītiḥ svasambedanavādino	kAraNa aBAve tu kAryya aBAva pratItiH sva sambedana vAdinaH 
   manorathasyāpyaviṣayaḥ / na ca pūrbbotarakālayoḥ sambittī tābhyāṃ vāsanā	manoraTasya api avizayaH / na ca pUrbbotara kAlayoH sambittI tAByAm vAsanA
   tayā ca hetuphalāvasāyī vikalpa iti yuktaṃ / sa hi vikalpo	tayA ca hetu Pala avasAyI vikalpaH iti yuktam / sa hi vikalpaH 
   gṛhītānusandhāyako 'tadrūpasamāropako vā na prathamaḥ pakṣaḥ / ekasya	gRhIta anusanDAyakaH atad rUpa samAropakaH vA na praTamaH pakzaH / ekasya
   pratisandhāturabhāve pūrvvāparagrahaṇayorayogāt / vikalpavāsanāyā	pratisanDa AtuH aBAve pUrvva apara grahaNayoH ayogAt / vikalpa vAsanAyA
   evābhāvāt / nāpi dvitīyaḥ; marīcikāyāmapi jalavijñānaprāmāṇyaprasaṅgāt /	eva aBAvAt / na api dvitIyaH; marIcikAyAm api jala vijQAna prAmANya prasaFgAt /
   tadevamanvayavyatirekayorapratipatterarthakriyālakṣaṇam sattvamasidvamiti	tat evam anvaya vyatirekayoH apratipatteH arTa kriyA lakzaNam sattvam asidvam iti
   kiñca prakārāntarādapīdaṃ sādhanamasidvaṃ / tathā hi vījādīnāṃ sāmarthyaṃ	kiQca prakAra antarAt api idam sADanam asi dvam / taTA hi vIja AdInAm sAmarTyam
   vījādijñānāt kāryyādaṅkurādervā niścetavyaṃ / kāryyatvañca vastutvasidvau	vIja Adi jQAnAt kAryyAt aFkura AdeH vA niScetavyam / kAryyatvaQca vastu tvasi dvO
   sidhyati, vastutvañca kāryyāntarāt / kāryyāntarasyāpi kāryyatvaṃ	siDyati, vastu tvaQca kAryya antarAt / kAryya antarasya api kAryya tvam
   vastutvasidvau / tadvastutvañca tadaparakāryyāntarādityanavasthā /	vastu tvasi dvO / tat vastu tvaQca tad apara kAryya antarAt iti anavasTA /
   athānavasthābhayāt paryyante kāryyāntaraṃ nāpekṣate, tadā tenaiva	aTa anavasTA BayAt paryyante kAryya antaram na apekzate, tadA tena eva
   pūrvveṣāmasattvaprasaṅgāt naikasyāpyarthakriyāsāmarthyaṃ sidhyati / nanu	pUrvvezAm asattva prasaFgAt na ekasya api arTa kriyA sAmarTyam siDyati / nanu
   kāryyatvasattvayorbhinnavyāvṛttikatvāt / sattāsidvāvapi kāryyatvasidvau kā	kAryya tva sattvayoH Binna vyAvRttika tvAt / sattAsi dvO= api kAryyatu a sidvO kA
   kṣatiriti cet / tadasaṅgatam, satyapi kāryyatvasattvayorvyāvṛttibhede	kzatiH iti ced / tad asaFgatam, sati api kAryya tva sattvayoH vyAvRtti Bede
   sattvasidvau kutaḥ kāryyatvasiddhiḥ / kāryyatvaṃ hyabhūtvābhāvitvaṃ,	sattva sidvO kutas kAryya tva sidDiH / kAryya tvam hi aBUtvA aBAvi tvaM,
   bhavanañca sattā / sattā ca saugatānāṃ sāmarthyameva / tataśca	BavanaQca sattA / sattA ca sOgatAnAm sAmarTyam eva / tatas ca
   sāmarthyasandehe bhavatītyeva vaktumaśakyaṃ kathamabhūtvābhāvitvaṃ	sAmarTya sandehe Bavati iti eva vaktum aSakyam kaTam aBUtvA aBAvi tvam
   kāryyatvaṃ setsyati / apekṣitaparavyāpāratvaṃ kāryyatvamityapi nāsato	kAryya tvam setsyati / apekzita para vyApAra tvam kAryya tvam iti api na asataH 
   dharmmaḥ sattvañca sāmarthyaṃ tacca sandigdhamiti kutaḥ kāryyasiddhiḥ /	DarmmaH sattvaQca sAmarTyam tat ca sandigDam iti kutas kAryya sidDiH /
   tadasidvau pūrvvasya sāmarthyaṃ na sidhyatīti sandigdhāsidvo hetuḥ /	tat asi dvO pUrvvasya sAmarTyam na siDyati iti sandigDA asidvaH hetuH /
   tathā virudvo 'pyayaṃ, tathā hi kṣaṇikatve sati na tāvat	taTA virudvaH api ayaM, taTA hi kzaNika tve sati na tAvat 
   ajātasyānanvayanirudvasya vā kāryyārambhakatvaṃ sambhavati / na ca	ajAtasya ananvaya nirudvasya vA kAryya AramBaka tvam samBavati / na ca
   nispannasya tāvān kṣaṇo 'sti yamupādāya kasmaicit kāryyāya vyāpāryyet /	nispannasya tAvAn kzaNaH asti yam upAdAya kasmEcid kAryyAya vyApAryyet /
   ataḥ kṣaṇikapakṣa eva arthakriyānupapattervirūdvatā / athavā vikalpena	atas kzaNika pakzaH eva arTa kriyA anupapatteH virUdvatA / aTavA vikalpena
   yadupanīyate, tatsarvvamavastu, tataśca vastvātmake kṣaṇikatve sādhye	yat upanIyate, tat saru vamavastu, tatas ca vastu Atmake kzaNika tve sADye
   'vastūpasthāpayannanumānavikalpo virudvaḥ / yadvā, sarvvasyaiva hetoḥ	avastu upasTApayan= anumAna vikalpaH virudvaH / yat vA, sarvu asya eva hetoH
   kṣaṇikatve sādhye virudvatvaṃ deśakālāntarānanugame	kzaNika tve sADye virudva tvam deSa kAla antara an anugame
   sādhyasādhanabhāvābhāvāt anugame ca nānākālamekamakṣaṇikaṃ kṣaṇikatvena	sADya sADana BAva aBAvAt anugame ca nAnA kAlam ekam akzaNikam kzaNika tvena
   virudhyata iti /	viruDyate iti /
   anaikāntiko 'pyayaṃ sattvasthairyyayorvirodhābhāvāditi / pratrocyate /	anEkAntikaH api ayam sattva sTEryyayoH viroDa aBAvAt iti / pratrA ucyate /
   yattāvaduktaṃ sāmarthyaṃ na pratīyata iti / tat kiṃ sarvvathaiva na	yat tAvat uktam sAmarTyam na pratIyate iti / tat kim sarvu aTa eva na
   pratīyate / kṣaṇabhaṅgapakṣe vā /	pratIyate / kzaNa BaFga pakze vA /
   prathamapakṣe sakalakārakajñāpakahetucakrocchedāt	praTama pakze sakala kAraka jQApaka hetu cakra ucCedAt 
   mukhaspandanamātrasyāpyakaraṇaprasaṅgaḥ / anyathā yenaiva vacanena	muKa spandana mAtrasya api akaraNa prasaFgaH / anyaTA yena eva vacanena
   sāmarthyaṃ nāstīti pratipādyate tasyaiva tat	sAmarTyam na asti iti pratipAdyate tasya eva tat 
   pratipādanasāmarthyamavyāhatamāyātam / tasmāt paramapuruṣārthasamīhayā	pratipAdana sAmarTyam avyAhatam AyAtam / tasmAt parama puruza arTa samIhayA
   vastutattvanirūpaṇapravṛttasya śaktisvīkārapūrvvakaiva pravṛttiḥ /	vastu tattva nirUpaNa pravRttasya Sakti svIkAra pUrvvakA eva pravRttiH /
   tadasvīkāre tu na kaścit kvacit pravartteteti nirīhaṃ jagajjāyate / atha	tat asvIkAre tu na kaScid kvacid pravartteta iti nirIham jagat jAyate / aTa
   dvitīyaḥ pakṣaḥ / tadāsti tāvat sāmarthyapratītiḥ / sā ca kṣaṇikatve yadi	dvitIyaH pakzaH / tadA asti tAvat sAmarTya pratItiH / sA ca kzaNika tve yadi
   nopapadyate tadā virudvaṃ vaktumucitaṃ, asidvamiti tu nyāyabhūṣaṇīyaḥ	na upapadyate tadA virudvam vaktum ucitan, asidvam iti tu nyAya BUzaNIyaH
   prāyovilāpaḥ / na ca satyapi kṣaṇikatve sāmarthyapratītivyāghātaḥ /	prAyas vilApaH / na ca sati api kzaNika tve sAmarTya pratIti vyAGAtaH /
   tathāhi kāraṇajñānopādeyabhūtena kāryyagrāhiṇā jñānena	taTA hi kAraNa jQAna upAdeya BUtena kAryya grAhiNA jQAnena
   tadarpitasaṃskāragarbheṇa asya bhāve asya bhāva iti anvayaniścayo janyate,	tad arpita saMskAra garBeNa asya BAve asya BAvaH iti anvaya niScayaH janyate,
   tathā kāraṇāpekṣayā bhūtalakaivalyagrāhijñānopādeyabhūtena kāryyāpekṣayā	taTA kAraNa apekzayA BU tala kEvalya grAhi jQAna upAdeya BUtena kAryya apekzayA
   bhūtalakaivalyagrāhiṇā jñānena tadarpitasaṃskāragarbhaṇa asyābhāve	BU tala kEvalya grAhiNA jQAnena tad arpita saMskAra garBaNa asya aBAve
   asyābhāva iti vyatirekaniścayo janyate / yadāhurguravaḥ /	asya aBAvaH iti vyatireka niScayaH janyate / yat AhuH guravaH /
   ekāvasāyasamanantarajātamanyavijñānamanvayavimarṣamupādadhāti /	eka avasAya samanantara jAtam anya vijQAnam anvaya vimarzam upAdaDAti /
   evaṃ tadekavirahānubhavodbhavānyavyāvṛttadhīḥ prathayati vyatirekabuddhiṃ	evam tad eka viraha anuBava udBavAni avyAvRtta DIH praTayati vyatirekabudDim
   evaṃ sati gṛhītānusandhāyake evāyaṃ vikalpaḥ /	evam sati gRhIta anusanDAyake eva ayam vikalpaH /
   upādānopādeyabhūtakramipratyakṣadvayagṛhītānusandhānāt / yadāhālaṅkāraḥ /	upAdAna upAdeya BUta krami pratyakza dvaya gRhIta anusanDAnAt / yat Aha alaFkAraH /
   yadi nāmaikamadhyakṣaṃ na pūrvvāparavittimat /	yadi nAma ekam aDyakzam na pUrvvApara vittimat /
   adhyakṣadvayasadbhāve prākparāvedanaṃ kathamiti /	aDyakza dvaya sadBAve prAc parAvedanam kaTam iti /
   nāpi dvitīyo 'sidvaprabhedaḥ / sāmarthyaṃ hi sattvamiti saugatānāṃ	na api dvitIyaH asidva praBedaH / sAmarTyam hi sattvam iti sOgatAnAm
   sthitireṣā / na caitat prasādhanārthamasmākamidānīmeva prārambhaḥ; kintu	sTitiH ezA / na ca etat prasADana arTam asmAkam idAnIm eva prAramBaH; kintu
   yatra pramāṇapratīte vījādau vastubhūte dharmmiṇi pramāṇapratītaṃ	yatra pramANa pratIte vIja AdO vastu BUte DarmmiNi pramANa pratItam
   sāmarthya tatra kṣaṇābhaṅga sādhanāya / tataścāṅkurādīnāṃ kāryyādaśanāt	sAmarTya tatra kzaNa aBaFga sADanAya / tatas ca aFkura AdInAm kAryyAt aSanAt 
   āhatyasāmarthyasandehe 'pi paṭupratyakṣaprasidvaṃ	Ahatya sAmarTya sandehe api pawu pratyakza prasidvam
   sanmātratvamavadhāryyameva / anyathā na kvacidapi vastumātrasyāpi	sat mAtra tvam avaDAryyam eva / anyaTA na kvacid api vastu mAtrasya api
   pratipattiḥ syāt / tasmācchāstrīyasattvalakṣaṇasandehe 'pi	pratipattiH syAt / tasmAt SAstrIya sattva lakzaNa sandehe api
   paṭupratyakṣavalāvalambitavastubhāve aṅkurādau kāryyatvamupalabhyamānaṃ	pawu pratyakza vala avalambita vastu BAve aFkura AdO kAryya tvam upalaByamAnam
   vījādeḥ sāmarthyamupasthāpayatīti nāsidvidoṣāvakāśaḥ /	vIja AdeH sAmarTyam upasTApayati iti na asidvidoza avakASaH /
   nāpi kśaṇikatve sāmarthyakṣatiḥ, yato virudvatā syāt,	na api kSaNika tve sAmarTya kzatiH, yatas virudvatA syAt ,
   kṣaṇikatvaniyataprāgbhāvitvalakṣaṇakāraṇatvayovirodhābhāvāt,	kzaNika tva niyata prAc BAvi tva lakzaNa kAraNa tvayaH viroDa aBAvAt,
   kṣaṇamātrasthāyinyapi sāmarthyasambhavāditi nādimo virodhaḥ / nāpi dvitīyo	kzaNa mAtra sTAyini api sAmarTya samBavAt iti na AdimaH viroDaH / na api dvitIyaH 
   virodhaprabhedaḥ / avastuno vastuno vā svākārasya grāhyatve 'pi,	viroDa praBedaH / avastunaH vastunaH vA su a AkArasya grAhya tve api,
   adhyavaseyavastvapekṣayaiva sarvvatra prāmāṇyapratipādanāt	aDyavaseya vastu apekzayA eva sarvu atra prAmANya pratipAdanAt 
   vastusvabhāvasyaiva kṣaṇikatvasidviriti kva virodhaḥ /	vastu svaBAvasya eva kzaNika tva sidviH iti kva viroDaH /
   yacca gṛhyate yaccādhyavasīyate te dve api anyanivṛttī na vastunī	yat ca gRhyate yat ca aDyavasIyate te dve api anya nivRttI na vastunI
   svalakṣaṇāvagāhitve abhilāpasaṃsargānupapatteriti cet / na /	sva lakzaNa avagAhi tve aBilApa saMsarga anupapatteH iti ced / na /
   adhyavasāyasvarūpāparijñānāt agṛhīte 'pi vastuni	aDyavasAya svarUpa aparijQAnAt agRhIte api vastuni
   mānasyādipravṛttikārakatvaṃ vikalpasyādhyavasāyitvaṃ, apratibhāse 'pi	mAnasya Adi pravRtti kAraka tvam vikalpasya aDyavasAyi tvan, apratiBAse api
   pravṛttiviṣayīkṛtatvamadhyavaseyatvam / etaccādhyavaseyatvaṃ	pravRtti vizayIkRta tvam aDyavaseya tvam / etat ca aDyavaseya tvam
   svalakṣaṇasyaiva yujyate, nānyasya / arthakriyārthitvāt arthipravṛtteḥ /	sva lakzaNasya eva yujyate, na anyasya / arTa kriyA arTi tvAt arTi pravRtteH /
   evañcādhyavasāye svalakṣaṇasyāsphuraṇameva / na ca tasyāsphuraṇe 'pi	evaQca aDyavasAye sva lakzaNasya asPuraNam eva / na ca tasya asPuraNe api
   sarvvatrāviśeṣeṇa pravṛttyākṣepaprasaṅgaḥ, pratiniyatasāmagrīprasūtāt,	sarvu atra aviSezeNa pravRtti Akzepa prasaFgaH, pratiniyata sAmagrI prasUtAt,
   pratiniyatasvākārāt, pratiniyataśaktiyogāt, pratiniyata	pratiniyata svAkArAt, pratiniyata Sakti yoga at, pratiniyata
   evātadrūpaparāvṛtte apratīte 'pi pravṛttisāmarthyadarśanāt / yathā	eva atad rUpa parAvRtte apratIte api pravRtti sAmarTya darSanAt / yaTA
   sarvvasyāsattve 'pi vījādaṅkurasyaivotpattiḥ dṛṣṭasya	saru u asyA sattve api vIjAt aFkurasya eva utpattiH dRzwasya
   niyatahetuphalabhāvasya pratikṣeptumaśakyatvāt / paraṃ vāhyenārthena sati	niyata hetu Pala BAvasya pratikzeptum aSakyatvAt / param vAhyena arTena sati
   pratibandhe prāmāṇyamanyathātvaprāmāṇyamiti viśeṣaḥ /	pratibanDe prAmANyam anyaTAtva prAmANyam iti viSezaH /
   tathā tṛtīyo 'pi pakṣaḥ prayāsaphalaḥ / nānākālasyaikasya vastuno vastuto	taTA tRtIyaH api pakzaH prayAsa PalaH / nAnA kAlasya ekasya vastunaH vastutas 
   'sambhavepyatadrūpaparāvṛttayoreva sādhyasādhanayoḥ pratyakṣeṇa	asamBavepya tad rUpa parAvRttayoH eva sADya sADanayoH pratyakzeNa
   vyāptigrahaṇāt / dvividho hi pratyakṣasya viṣayo grāhyo 'dhyavaseyaśca	vyApti grahaNAt / dviviDaH hi pratyakzasya vizayaH grAhyaH aDyavaseyaH ca
   sakalātadrūpaparāvṛttaṃ vastumātraṃ sākṣādasphuraṇāt pratyakṣasya grāhyo	sakalA tad rUpa parAvRttam vastu mAtram sAkzAt asPuraNAt pratyakzasya grAhyaH 
   viṣayo mā bhūt / tadekadeśagrahaṇe tu	vizayaH mA BUt / tad eka deSa grahaNe tu
   tanmātrayorvyāptiniścāyakavikalpajananādadhyavaseyo viṣayo bhavatyeva /	tanmAtrayoH vyApti niScAyaka vikalpa jananAt aDyavaseyaH vizayaH Bavati eva /
   kṣaṇagrahaṇe santānaniścayavat / rūpamātragrahaṇe ghaṭaniścayavacca /	kzaNa grahaNe santAna niScaya vat / rUpa mAtra grahaNe Gawa niScaya vat ca /
   anyathā sarvvānumānocchedaprasaṅgāt / tathā hi vyāptigrahaḥ sāmānyayoḥ,	anyaTA sarvvA anumAna ucCeda prasaFgAt / taTA hi vyApti grahaH sAmAnyayoH,
   viśeṣayoḥ, sāmānyaviśiṣṭaviśeṣayo rviśeṣaviśiṣṭasāmānyayorveti vikalpāḥ /	viSezayoH, sAmAnya viSizwa viSezayaH rviSeza viSizwa sAmAnyayoH vA iti vikalpAH /
   nādyo vikalpaḥ sāmānyasya vādhyatvāt / avādhyatve 'pyadṛśyatvāt / dṛśyatve	na AdyaH vikalpaH sAmAnyasya vA aDya tvAt / avADya tve api adRSya tvAt / dRSya tve
   'pi puruṣārthānupayogitayā tasyānumeyatvāyogāt / nāpyanumitāt sāmānyāt	api puruza arTa anupayogi tayA tasya anumeya tva ayogAt / na api anumitAt sAmAnyAt 
   viśeṣānumānam, sāmānyasarvvaviśeṣayorvakṣyamāṇanyāyena	viSeza anumAnam, sAmAnya sarvva viSezayoH vakzyamANa nyAyena
   pratibandhapratipatterayogāt / nāpi dvitīyo viśeṣasyānanugāmitvāt / antime	pratibanDa pratipatteH ayogAt / na api dvitIyaH viSezasya ananugAmi tvAt / antime
   tu vikalpadvaye sāmānyādhāratayā dṛṣṭa eva viśeṣaḥ sāmānyasya viśeṣyo	tu vikalpa dvaye sAmAnya ADAra tayA dRzwaH eva viSezaH sAmAnyasya viSezyaH 
   viśeṣaṇaṃ vā karttavyaḥ / adṛṣṭa eva vā deśakālāntaravarttī / yadvā	viSezaNam vA karttavyaH / adRzwaH eva vA deSa kAla antara varttI / yat vA
   dṛṣṭādṛṣṭātmako deśakālāntarabartī atadrūpaparāvṛttaḥ sarvvo viśeṣaḥ / na	dRzwa adRzwa AtmakaH deSa kAla antara bartI atad rUpa parAvRttaH sarvvaH viSezaH / na
   prathamaḥ pakṣo 'nanugāmittvāt; nāpi dvitīyaḥ, adṛṣṭatvāt / na ca tṛtīyaḥ,	praTamaH pakzaH ananugAmit tva at; na api dvitIyaH, adRzwa tvAt / na ca tRtIyaH,
   prastutaikaviśeṣadarśane 'pi deśakālāntaravarttināmadarśanāt /	prastuta eka viSeza darSane api deSa kAla antara vartti nAm a darSanAt /
   atha teṣāṃ sarvveṣāmeva viśeṣāṇāṃ sadṛśatvāt / sadṛśasāmagrīprasūtatvāt	aTa tezAm sarvu ezAm eva viSezANAm sadRSa tvAt / sadRSa sAmagrI prasUta tvAt
   sadṛśakāryyakāritvāditi prattyāsattyā, ekaviśeṣagrāhakaṃ	sadRSa kAryya kAri tvAt iti pratti AsattyA, eka viSeza grAhakam
   pratyakṣamatadrūpaparāvṛttamātreniścayaṃ	pratyakzam atad rUpa parAvRtta mAtreniScayam
   janayadatadrūpaparāvṛttaviśeṣamātrasya vyavasthāpakam /	janayat atat rUpa parAvRtta viSeza mAtrasya vyavasTApakam /
   yathaikasāmagrīpratibadvarūpamātragrāhakaṃ pratyakṣaṃ ghaṭe niścayaṃ	yaTA eka sAmagrI pratibadva rUpa mAtra grAhakam pratyakzam Gawe niScayam
   janayadghaṭagrāhakaṃ byavasthāpyate / anyathā ghaṭo 'pi ghaṭasantāno 'pi	janayat Gawa grAhakam byavasTApyate / anyaTA GawaH api Gawa santAnaH api
   pratyakṣato na sidhyet sarvvātmanā grahaṇābhāvāt /	pratyakzataH na siDyet sarvu AtmanA grahaNa aBAvAt /
   tadekadeśagrahaṇantvatadrūpaparāvṛtte 'pyaviśiṣṭam / yadyevamanenaiva	tad eka deSa grahaNantu atad rUpa parAvRtte api aviSizwam / yadi evam anena eva
   krameṇa sarvvasya viśeṣasya viśeṣaṇaviśeṣyabhāvavat	krameNa sarvu asya viSezasya viSezaNa viSezya BAva vat 
   vyāptipratipattirapyastu / tat kimarthaṃ	vyApti pratipattiH api aH tu / tat kim arTam
   nānākālamekakṣaṇikamabhyupagantavyaṃ yena kṣaṇikatve sādhanasya	nAnA kAlam eka kzaNikam aByupagantavyam yena kzaNika tve sADanasya
   virudvatvaṃ syāt iti na kaścidvirodhaprabhedaprasaṅgaḥ /	virudva tvam syAt iti na kaScid viroDa praBeda prasaFgaH /
   na cāyamanekāntiko 'pi hetuḥ / pūrvvoktakrameṇa sādharmmyadṛṣṭānte	na ca ayam anekAntikaH api hetuH / pUrvva ukta krameNa sADarmmya dRzwAnte
   prasaṅgaviparyyayahetubhyāmanvayarūpavyāpteḥ prasādhanāt / nanu yadi	prasaFga viparyyaya hetuByAm anvaya rUpa vyApteH prasADanAt / nanu yadi
   prasaṅgaviparyyayahetudvayavalato ghaṭe dṛṣṭānte kṣaṇabhaṅgaḥ sidhyettadā	prasaFga viparyyaya hetu dvayavalataH Gawe dRzwAnte kzaNa BaFgaH siDyet tadA
   sattvasya niyamena kṣaṇikatvena vyāptisidveranaikāntikatvaṃ na syāditi	sattvasya niyamena kzaNika tvena vyApti sidvera nEkAntika tvam na syAt iti
   yuktam / kevala midamevāsambhavi / tathāhi śakto 'pi ghaṭaḥ	yuktam / kevala midam eva asamBavi / taTA hi SaktaH api GawaH
   kramisahakāryyapekṣayā kramikāryyaṃ kariṣyati /	krami sahakAryi apekzayA krami kAryyam karizyati /
   na caitad vaktavyaṃ samartho 'rthaḥ svarūpeṇa karoti / svarūpañca	na ca etat vaktavyam samarTaH arTaH sva rUpeNa karoti / svarUpaQca
   sarvvadāstītyanupakāriṇi sahakāriṇyapekṣā na yujyata iti, satyapi	sarvvadA asti iti anupakAriNi saha kAriNI apekzA na yujyate iti, sati api
   svarūpeṇa kārakatve sāmarthyābhāvātkathaṃ karoti, sahakārisākalyaṃ hi	svarUpeNa kAraka tve sAmarTya aBAvAt kaTam karoti, sahakAri sAkalyam hi
   sāmarthyaṃ tadvaikalyañcāsāmarthyaṃ / na ca tayorāvirbhāvatirobhāvābhyāṃ	sAmarTyam tat vEkalyaQca asAmarTyam / na ca tayoH AvirBAva tiroBAvAByAm
   tadvataḥ kācit kṣatiḥ / tasya tābhyāmanyatvāt / tasmādarthaḥ samartho 'pi	tadvataH kAcid kzatiH / tasya tAByAm anya tvAt / tasmAt arTaH samarTaH api
   syāt na ca karotīti sandigdhavyatirekaḥ prasaṅgahetuḥ /	syAt na ca karoti iti sandigDa vyatirekaH prasaFga hetuH /
   atrocyate / bhavatu tāvat sahakārisākalyameva sāmarthyaṃ / tathāpi so 'pi	atra ucyate / Bavatu tAvat sahakAri sAkalyam eva sAmarTyam / taTA api saH api
   tāvadbhāvaḥ svarūpeṇa kārakaḥ / tasya ca yādṛśaścaramakṣaṇe	tAvat BAvaH sva rUpeNa kArakaH / tasya ca yAdRSaH cara makzaNe
   'kṣepakriyādharmmā svabhāvaḥ tādṛśa eva cet prathamakṣaṇe tadā tadāpi	akzepa kriyA DarmmA svaBAvaH tAdRSaH eva ced praTama kzaNe tadA tadA api
   prasahya kurbbāṇo brahmaṇāpyanivāryyaḥ / na ca so 'pyakṣepakriyādharmmā	prasahya kurbbANaH brahmaNA api anivAryyaH / na ca saH api akzepa kriyA DarmmA
   svabhāvaḥ sākalye sati jāto bhāvādbhinna evābhidhātuṃ śakyaḥ /	svaBAvaH sAkalye sati jAtaH BAvAt BinnaH eva aBiDAtum SakyaH /
   bhāvasyākarttṛtvaprasaṅgāt / evaṃ yāvadyāvat	BAvasya akarttR tva prasaFgAt / evam yAvat yAvat 
   dharmāntaraparikalpastāvattāvadudāsīno bhāvaḥ / tasmādyadrūpamādāya	Darma antara parikalpaH tAvat tAvat udAsInaH BAvaH / tasmAt yat rUpam AdAya
   svarūpeṇāpi janayatītyucyate; tasya prāgapi bhāve kathamajaniḥ kadācit /	sva rUpeNa api janayati iti ucyate; tasya prAk api BAve kaTam ajaniH kadAcid /
   akṣepakriyāpratyanīkasvabhāvasya prācyasya paścādanuvṛttau kathaṃ	akzepa kriyA pratyanIka svaBAvasya prAcyasya paScAt anuvRttO kaTam
   kadācidapi kāryyasambhavaḥ / nanu yadi sa evaikaḥ karttā syāt yuktametat /	kadAcid api kAryya samBavaH / nanu yadi saH eva ekaH karttA syAt yuktam etat /
   kintu sāmagrī janikā tataḥ sahakāryyantaravirahavelāyāṃ balīyaso 'pi na	kintu sAmagrI janikA tatas saha kAryi antara viraha velAyAm balIyasaH api na
   kāryyaprasava iti kimatra virudvaṃ / na hi bhāvaḥ svarūpeṇakarotīti	kAryya prasavaH iti kim atra virudvam / na hi BAvaH svarUpeNa karoti iti
   svarūpeṇaiva karoti / sahakārisahitādeva tataḥ kāryyotpattidarśanāt /	sva rUpeNa eva karoti / sahakAri sahitAt eva tatas kAryya utpatti darSanAt /
   tasmādyāptivat kāryyakāraṇabhāvo 'pi, ekatrānyayogabyavacchedena	tasmAt yApti vat kAryya kAraNa BAvaH api, ekatra anya yoga bi avacCedena
   anyatrāyogavyavacchedena nāvabodvavyaḥ, tathaiva laukikaparīkṣakāṇāṃ	anyatra ayoga vyavacCedena na avabodvavyaH, taTA eva lOkika parIkzakANAm
   sampratipatteriti /	sampratipatteH iti /
   atrocyate / yadā militāḥ santaḥ kāryyaṃ kurvvate tadaikārthakaraṇalakṣaṇaṃ	atra ucyate / yadA militAH santaH kAryyam kurvvate tadA eka arTa karaNa lakzaNam
   sahakāritvamepāmastu ko niṣedvā? militaireva tu tatkāryya karttavyamiti	sahakAri tvam epAmaH tu kaH nizedvA? militEH eva tu tat kAryya karttavyam iti
   kuto labhyate? pūrvvāparayorekasvabhāvatvādbhāvasya / sarvvadā	kutas laByate? pUrvva aparayoH eka svaBAva tvAt BAvasya / sarvvadA
   jananājananayoranyataraniyataprasaṅgasya durvvāratvāt / tasmāt sāmagrī	jananA jananayoH anyatara niyata prasaFgasya durvvAra tvAt / tasmAt sAmagrI
   janika naikaṃ janakamiti sthiravādināṃ manorathasyāpyaviṣayaḥ / dṛśyate	janika na ekam janakam iti sTira vAdinAm manoraTasya api avizayaH / dRSyate
   tāvadevamiti cet / dṛśyatāṃ kintu pūrvvasthitādeva	tAvat evam iti ced / dRSyatAm kintu pUrvvasTitAt eva
   sāmagrīmadhyapraviṣṭādbhāvāt kāryotpattiranyasmādeva vā	sAmagrI maDya pravizwAt BAvAt kArya utpattiH anyasmAt eva vA
   viśiṣṭādbhāvādutpannāditi vivādapadam / tatra prāgapi sambhave sarvvadaiva	viSizwAt BAvAt utpannAt iti vivAda padam / tatra prAk api samBave sarvvadA eva
   kāryyotpatti rna vā kadācidapīti virodhamasamādhāya cakṣuṣī nimīlya tata	kAryya utpatti rna vA kadAcid api iti viroDam asamADAya cakzuzI nimIlya tata
   eva kāryyotpattidarśanāditi sādhyānuvādamātrapravṛttaḥ kṛpāmarhatīti / na	eva kAryya utpatti darSanAt iti sADya anuvAda mAtra pravRttaH kRpAm arhati iti / na
   ca pratyabhijñādibalādekatvasidviḥ tat pauruṣasya	ca pratyaBijQA Adi balAt eka tva sidviH tat pOruzasya
   lūnapunarjātakeśanakhādāvapyupalambhato nirddalanāt, lakṣaṇabhedasya ca	lUna punar jAta keSa naKa AdO= api upalamBataH nirddalanAt, lakzaNa Bedasya ca
   darśayitumaśakyatvāt / sthirasidvidūṣaṇe cāsmābhiḥ prapañcato nirastatvāt	darSayitum aSakyatvAt / sTira sidvi dUzaNe ca asmABiH prapaQcataH nirasta tvAt 
   / tasmāt sākṣāt kāryyakāraṇabhāvāpekṣayā ubhayatrāpyanyayogavyavacchedaḥ /	/ tasmAt sAkzAt kAryya kAraNa BAva apekzayA uBayatra api anya yoga vyavacCedaH /
   vyāptau tu sākṣātparamparayā kāraṇamātrāpekṣayā kāraṇe vyāpake	vyAptO tu sAkzAt paramparayA kAraNa mAtra apekzayA kAraNe vyApake
   'yogavyavacchedaḥ / kāryye vyāpye 'nyayogavyavacchedaḥ / tathā	ayoga vyavacCedaH / kAryye vyApye anya yoga vyavacCedaH / taTA
   tadatatsvabhāve vyāpake 'yogavyavacchedaḥ / tatsvabhāve ca vyāpye	tad atad svaBAve vyApake ayoga vyavacCedaH / tad svaBAve ca vyApye
   'nyayogavyavacchedo vikalpāruḍharūpāpekṣayā vyāptau dvividhamavadhāraṃam /	anya yoga vyavacCedaH vikalpa AruXa rUpa apekzayA vyAptO dviviDam avaDAraMam /
   nanu yadi pūrvvāparakālayorekasvabhāvo bhāvaḥ	nanu yadi pUrvva apara kAlayoH eka svaBAvaH BAvaH
   sarvvadājanakatvenājanakatvena vā vyāpta upalabdhaḥ syāttadāyaṃ prasaṅgaḥ	sarvvat A janaka tvena ajanaka tvena vA vyAptaH upalabDaH syAt tadA ayam prasaFgaH
   saṅgacchate / na kṣaṇabhaṅgavādinā pūrvvāparakālayorekaḥ kaścidupalabdha	saFgacCate / na kzaNa BaFga vAdinA pUrvva apara kAlayoH ekaH kaScid upalabDa 
   iti cet / tadetadatigrāmyaṃ / tathāhi pūrvvāparakālayorekasvabhāvatve	iti ced / tat etat atigrAmyam / taTA hi pUrvva apara kAlayoH eka svaBAva tve
   satītyasyāyamarthaḥ / parakālabhāvī janako yaḥ svabhāvo bhāvasya sa eva	sati iti asya ayam arTaH / para kAla BAvI janakaH yaH svaBAvaH BAvasya saH eva
   yadi pūrvvakālabhāvī / pūrvvakālabhāvī vā yo 'janakaḥ svabhāvaḥ sa eva	yadi pUrvva kAla BAvI / pUrvva kAla BAvI vA yaH ajanakaH svaBAvaH saH eva
   yadi parakālabhāvī, tadopalabdhameva jananamajananambā syāt, tathā ca sati	yadi para kAla BAvI, tadA upalabDam eva jananam ajana nambA syAt, taTA ca sati
   sidvayoreva svabhāvayorekatvārope sidvameva jananamajananambāsajyata iti /	sidvayoH eva svaBAvayoH eka tva Arope sidvam eva jananam ajana nambAsa jyate iti /
   nanu kāryyameva sahakāriṇamapekṣate / na tu kāryyotpattihetuḥ / yasmāt	nanu kAryyam eva sahakAriNam apekzate / na tu kAryya utpatti hetuH / yasmAt 
   dvividhaṃ sāmarthya nijamāgantukañca sahakāryyantaraṃ tato 'kṣaṇikasyāpi	dviviDam sAmarTya nijam Agantu kaQca sahakAryi antaram tatas akzaNikasya api
   kramavat sahakārinānātvādapi kramavat kāryyanānātvopapatteraśakyaṃ	krama vat saha kAri nAnA tvAt api krama vat kAryya nAnAtva upapatteH aSakyam
   bhāvānāṃ pratikṣaṇamanyānyatvamupapādayitumiti cet / ucyate / bhavatu	BAvAnAm pratikzaNam anya anya tvam upapAdayitum iti ced / ucyate / Bavatu
   tāvannijāgantukabhedena dvividhaṃ sāmarthyaṃ / tathāpi yat prātisvikaṃ	tAvat nija Agantuka Bedena dviviDam sAmarTyam / taTA api yat prAtisvikam
   vastusvalakṣaṇaṃ arthakriyādharmmakamavaśyamabhyupagantavyaṃ tat kiṃ	vastu sva lakzaNam arTa kriyA Darmmakam avaSyam aByupagantavyam tat kim
   prāgapi paścādeva veti vikalpya yaddūṣaṇamugdīritaṃ / tatra	prAk api paScAt eva vA iti vikalpya yat dUzaNam ugdIritam / tatra
   kimuktamaneneti na pratīmaḥ / yattu kāryyeṇaiva sahakāriṇo 'pekṣanta	kim uktam anena iti na pratImaH / yat tu kAryyeNa eva sahakAriNaH apekzanta
   ityupatkṛtaṃ tadapi nirupayogaṃ / yadi hi kāryyameva svajanmani svatantraṃ	iti upatkRtam tat api nirupayogam / yadi hi kAryyam eva sva janmani svatantram
   syādyuktametat / kevalamevaṃ sati sahakārisākalyasāmarthyakalpanamaphalaṃ	syAt yuktam etat / kevalam evam sati sahakAri sAkalya sAmarTya kalpa nam a Palam
   / svātantryādeva hi kāryyaṃ kādācitkaṃ bhaviṣyati / tathā ca sati santo	/ svAtantryAt eva hi kAryyam kAdAcid kam Bavizyati / taTA ca sati santaH 
   hetavaḥ sarvvathāsamarthāḥ / asadetat kāryyaṃ svatantramiti viśuddhā	hetavaH sarvu aTa asamarTAH / asat etat kAryyam svatantram iti viSudDA
   budviḥ / atha kāryyasyaivāyamaparādho yadidaṃ samarthe kāraṇe satyapi	budviH / aTa kAryyasya eva ayam aparADaH yat idam samarTe kAraNe sati api
   kadācinnopapadyata iti cet / na tattarhi tat kāryyaṃ svātantryāt /	kadAcid na upapadyate iti ced / na tat tarhi tat kAryyam svAtantryAt /
   yadbhāṣyaṃ /	yat BAzyam /
   sarvvāvasthāsamāne 'pi kāraṇe yadyakāryyatā /	sarvvA avasTA samAne api kAraNe yadi akAryyatA /
   svatantraṃ kāryyamevaṃ syānnatatkāryyantathā sati //	svatantram kAryyam evam syAt natat kAryyan taTA sati //
   atha na tadbhāve bhavatīti tatkāryyamucyate, kintu tadabhāvena	aTa na tad BAve Bavati iti tad kAryyam ucyate, kintu tad aBAvena
   bhavatyeveti vyatirekaprādhānyāditi cet / na / yadi hi svayambhavan	Bavati eva iti vyatireka prADAnyAt iti ced / na / yadi hi svayam Bavan
   bhāvayedeva hetuḥ svakāryyaṃ tadā tadabhāvaprayukto 'syābhāva iti pratītiḥ	BAvayet eva hetuH sva kAryyam tadA tad aBAva prayuktaH asya aBAvaH iti pratItiH
   syāt / no ced yathā kāraṇe satyapi kāryyasvātantryānna bhavati / tathā	syAt / no ced yaTA kAraNe sati api kAryya svAtantryAt na Bavati / taTA
   tadabhāve 'pi svātantryādeva na bhūtamiti śaṅkā kena nivāryyeta /	tad aBAve api svAtantryAt eva na BUtam iti SaFkA kena nivAryyeta /
   yadbhāṣyaṃ /	yat BAzyam /
   tadbhāve 'pi na bhāvaścedabhāve 'bhāvitā kutaḥ /	tad BAve api na BAvaH ced aBAve aBAvitA kutas /
   tadabhāvaprayuktosya so 'bhāva iti tat kutaḥ //	tad aBAva prayuktosya saH aBAvaH iti tat kutas //
   tasmād yathaiva tadbhāve niyamena na bhavati / tathaiva tadbhāve niyamena	tasmAt yaTA eva tad BAve niyamena na Bavati / taTA eva tad BAve niyamena
   bhavedeva / abhavacca na tatkāraṇatāmātmanaḥ kṣamate / yaccoktaṃ,	Bavet eva / aBavat ca na tad kAraNa tAm AtmanaH kzamate / yat ca uktaM,
   prathamakāryyotpādanakāle hṛttarakāryyotpādanasvabhāvaḥ / ataḥ	praTama kAryya utpAdana kAle hRttara kAryya utpAdana svaBAvaH / atas 
   prathamakāla evāśeṣāṇi kāryyāṇi kuryyāditi / tadidaṃ mātā me	praTama kAle eva aSezANi kAryyANi kuryyAt iti / tat idam mAtA me
   vandhyetyādivat svavacananirodhādayuktaṃ, yo hṛttarakāryyajananasvabhāvaḥ	vanDyA ityAdi vat sva vacana niroDAt ayuktan, yaH hRttara kAryI ajanana svaBAvaH
   sa kathamādau kāryyaṃ kuryyāt / na tarhi tatkāryyakaraṇasvabhāvaḥ na hi	sa kaTam AdO kAryyam kuryyAt / na tarhi tad kAryya karaNa svaBAvaH na hi
   nīlotpādanasvabhāvaḥ pītādikamapi karotīti /	nIla utpAdana svaBAvaH pIta Adikam api karoti iti /
   atrocyate / sthirasvabhāvatve hi bhāvasya uttarakālamevedaṃ kāryyaṃ na	atra ucyate / sTira svaBAva tve hi BAvasya uttara kAlam eva idam kAryyam na
   pūrvvakālamiti kuta etat / tadabhāvācca kāraṇamapi	pUrvvakAlam iti kutas etat / tad aBAvAt ca kAraNam api
   uttarakāryyakaraṇasvabhāvamityapi kutaḥ / kiṃ kurmmaḥ uttarakālameva tasya	uttara kAryya karaNa svaBAvam iti api kutas / kim kurmmaH uttara kAlam eva tasya
   janmeti cet; astu sthiratve tadanupapadyamānamasthiratāmādiśatu;	janma iti cet; astu sTira tve tad anupapadyamAnam asTira tAm AdiSatu;
   sthiṣtvepyeṣa eva svabhāvastasya yaduttarakṣaṇa eva karotīti cet /	sTiztvA ipi ezaH eva svaBAvaH tasya yat uttarakzaNaH eva karoti iti ced /
   utedānīṃ pramāṇapratyāśā / dhūmādagnirityatrāpi svabhāva evāsya	uta idAnIm pramANa pratyASA / DUmAt agniH iti atra api svaBAvaH eva asya
   yadidānīmatra niragnirapi dhūma iti vaktuṃ śakyatvāt / tasmāt pramāṇasidve	yat idAnIm atra niragniH api DUmaH iti vaktum Sakya tvAt / tasmAt pramANa sidve
   svabhāvāvalambanaṃ, na tu svabhāvāvalambanena pramāṇavyālopaḥ / tasmād	svaBAva avalambanaM, na tu svaBAva avalambanena pramANa vyAlopaH / tasmAt 
   yadi kāraṇasyottarakāryyakārakatvamabhyupagamya kāryyasya	yadi kAraNasya uttara kAryya kAraka tvam aByupagamya kAryyasya
   prathamakṣaṇabhāvitvamāsajyate, syāt svavacanavirodhaḥ / yadā tu kāraṇasya	praTama kzaNa BAvi tvam Asa jyate, syAt sva vacana viroDaH / yadA tu kAraNasya
   sthiratve kāryyasyottarakālatvamevāsaṅgatam / ataḥ	sTira tve kAryyasya uttara kAla tvam eva asaFgatam / atas 
   kāraṇasyāpyuttarakāryyajanakatvaṃ vastuto 'sambhavi tadā	kAraNasya api uttara kAryya janaka tvam vastutas asamBavi tadA
   prasaṅgasādhanamidaṃ / jananavyavahāragocaratvaṃ hi jananena vyāptamiti	prasaFga sADanam idam / janana vyavahAra gocara tvam hi jananena vyAptam iti
   prasādhitaṃ / uttarakāryyajananavyavahāragocaratvañca tvadabhyupagamāt	prasADitam / uttara kAryI ajanana vyavahAra gocara tvaQca tvad aByupagamAt
   prathamakāryyakaraṇakāla eva ghaṭe dharmmiṇi sidvaṃ /	praTama kAryya karaNa kAle eva Gawe DarmmiNi sidvam /
   atastanmātrānubandhina uttarābhimatasya kāryyasya prathame kṣaṇe	atas tanmAtra anubanDinaH uttara aBimatasya kAryyasya praTame kzaNe
   'sambhavādeva prasaṅgaḥ kriyate / na hi nīlakārake 'pi pītakārakatvārope	asamBavAt eva prasaFgaH kriyate / na hi nIlakArake api pIta kAraka tva Arope
   pītasambhavaprasaṅgaḥ svavacanavirodhonāma / tadevaṃ śaktaḥ	pIta samBava prasaFgaH sva vacana viroDaH nAma / tat evam SaktaH
   sahakāryyanapekṣitatvāt jananena vyāptaḥ / ajanayaṃśca	saha kAryi anapekzita tvAt jananena vyAptaH / ajanayan= ca
   śaktāśaktatvavirudvadharmmādhyāsādbhinna eva / nanu bhavatu	Sakta aSakta tva virudva Darmma aDyAsAt BinnaH eva / nanu Bavatu
   prasaṅgaviparyyayabalādekakāryyaṃ	prasaFga viparyyaya balAt eka kAryyam
   pratiśaktāśaktatvalakṣaṇavirudvadharmmādhyāsaḥ / tathāpi na tato medaḥ	pratiSakta aSakta tva lakzaNa virudva Darmma aDyAsaH / taTA api na tatas medaH
   sidhyati; tathāhi bījamaṅkurādikaṃ kurvvad yadi yenaiva svabhāvenāṅkuraṃ	siDyati; taTA hi bIjam aFkura Adikam kurvvat yadi yena eva svaBAvena aFkuram
   karoti tenaiva kṣityādikantadākṣityādīnāmapyaṅkurasvābhāvyāpattiḥ /	karoti tena eva kziti Adi kantat Akziti AdInAm api aFkura svABAvya ApattiH /
   nānāsvabhāvatvena tu kārakatve svabhāvānāmanyonyābhāvāvyabhicāritvādekatra	nAnA svaBAva tvena tu kAraka tve svaBAvAnAm anyonya aBAva avyaBicAri tvAt ekatra
   bhāvābhāvau parasparavirudvau syātāmityekamapi bījaṃ bhidyeta / evaṃ	BAva aBAvO paraspara virudvO syAtAm iti ekam api bIjam Bidyeta / evam
   pradīpo 'pi tailakṣayavarttidāhādikaṃ; tathā	pradIpaH api tEla kzaya vartti dAha AdikaM; taTA
   pūrvvarūpamapyuttararūparasagandhādikamanekaiḥ svabhāvaiḥ parikaritaṃ	pUrvva rUpam api uttara rUpa rasa ganDa Adikam anekEH svaBAvEH parikaritam
   karoti / teṣāñca svabhāvānāmanyonyābhāvāvyabhicārādvirudvānāṃ yoge	karoti / tezAn ca svaBAvAnAm anyonya aBAva avyaBicArAt virudvAnAm yoge
   pradīpādikaṃ bhidyeta / na ca bhidyate / tanna ! virudvadharmmādhyāso	pradIpa Adikam Bidyeta / na ca Bidyate / tat naH ! virudva Darmma aDyAsaH 
   bhedakaḥ, tathā bījasyāṅkuraṃ prati kārakatvaṃ garddabhādikaṃ	BedakaH, taTA bIjasya aFkuram prati kAraka tvam garddaBa Adikam
   pratyakārakatvamiti kārakatvākārakatve api virudvau dharmau / na ca	pratyakAraka tvam iti kAraka tva AkAraka tve api virudvO DarmO / na ca
   tadyoge 'pi bījabhedaḥ / tadevamekatra bīje pradīpe rūpe ca vipakṣe	tad yoge api bIja BedaH / tat evam ekatra bIje pradIpe rUpe ca vipakze
   paridṛśyamānaḥ śaktāśaktatvādirvirudvadharmmādhyāso na ghaṭāderbhedaka iti	paridRSyamAnaH Sakta aSakta tva AdiH virudva Darmma aDyAsaH na Gawa AdeH BedakaH iti
   atra brūmaḥ / bhavatu	atra brUmaH / Bavatu
   tāvadvījādīnāmanekakāryyakāritvādvarmmabhūtānekasvabhāvabhedastathāpi kaḥ	tAvat vIja AdInAm aneka kAryya kAri tvAt varmma BUta aneka svaBAva BedaH taTA api kaH
   prastāvovirudvadharmmādhyāsasya / svabhāvānāṃ hyanyonyābhāvāvyabhicāre	prastAvaH virudva Darmma aDyAsasya / svaBAvAnAm hi anyonya aBAva avyaBicAre
   bhedaḥ prāptāvasaro na virodhaḥ / virodhastu yadvidhāne yanniṣedho	BedaH prApta avasaraH na viroDaH / viroDaH tu yat viDAne yat nizeDaH 
   yanniṣedhe yadvidhānaṃ tayorekatradharmmiṇi parasparaparihārasthitatayā	yat nizeDe yat viDAnam tayoH ekatra DarmmiNi paraspara parihAra sTita tayA
   syāt / tadatraikaḥ svbhāvaḥ svābhāvena virudvo yukto bhāvābhāvavat / na tu	syAt / tat atra ekaH svBAvaH svABAvena virudvaH yuktaH BAva aBAva vat / na tu
   svabhāvāntareṇa / ghaṭatvavastutvavat / evamaṅkurādikāritvaṃ tadakāritvena	svaBAva antareNa / Gawa tva vastu tva vat / evam aFkura Adi kAri tvam tat akAri tvena
   virudvaṃ na punarvastvantarakāritvena / pratyakṣavyāpāraścātra yathā	virudvam na punarvastu antara kAri tvena / pratyakza vyApAraH ca atra yaTA
   nānādharmmairadhyāsitaṃ bhāvamabhinnaṃ vyavasthāpayati / tathā	nAnA DarmmEH aDyAsitam BAvam aBinnam vyavasTApayati / taTA
   tatkāryyakāriṇaṃ kāryyāntarākāriṇañca / tadyadi	tad kAryya kAriNam kAryya antarA kAriNaQca / tat yadi
   pratiyogitvābhāvādanyonyābhāvāvyabhicāri ṇāvapi svabhāvāvavirudvo	pratiyogi tva aBAvAt anyonya aBAva avyaBicAri NO= api svaBAvO= avirudvaH 
   tatkārakatvānyākārakatve vā viṣayabhedādavirudve, tat	tad kAraka tvAni AkAraka tve vA vizaya BedAt avirudve, tat 
   kimāyātamekakāryyamprati śaktāśaktatvayoḥ	kim AyAtam eka kAryyam prati Sakta aSakta tvayoH
   parasparapratiyoginīrvirudvayordharmmayoḥ / etayorapi punaravirodhe	paraspara pratiyoginIrvirudvayoH DarmmayoH / etayoH api punar aviroDe
   virodho nāma dattajalāñjaliḥ / bhavatu tarhyekakāryyāpekṣayaiva	viroDaH nAma datta jala aQjaliH / Bavatu tarhi eka kAryya apekzayA eva
   sāmarthyāsāmarthyayorvirodhaḥ / kevalaṃ yathā tadeva kāryyaṃ prati	sAmarTya asAmarTyayoH viroDaH / kevalam yaTA tat eva kAryyam prati
   kvaciddeśe śaktirdeśāntare cāśaktiriti deśabhedādavirudve śaktayaśaktī	kvacid deSe SaktiH deSa antare ca aSaktiH iti deSa BedAt avirudve Saktaya SaktI
   tathaikatraiva kāryye kālabhedādapyavirudve / yathāpūrvvaṃ nniḥkriyaḥ	taTA ekatra eva kAryye kAla BedAt api avirudve / yaTApUrvvam nniHkriyaH
   sphaṭikaḥ sa eva paścāt sakriya iti cet /	sPawikaH saH eva paScAt sa kriyaH iti ced /
   ucyate / na hi vayaṃ paribhāṣāmātrādekatra kāryye deśabhedādavirudve	ucyate / na hi vayam pariBAzA mAtrAt ekatra kAryye deSa BedAt avirudve
   śaktyaśaktī brūmaḥ / kintu virodhābhāvāt / taddeśakāryya kāritvaṃ hi	Sakti aSaktI brUmaH / kintu viroDa aBAvAt / tad deSa kAryya kAri tvam hi
   taddeśakāryyākāritvena virudvaṃ / na punardeśāntare	tad deSa kAryya AkAri tvena virudvam / na punar deSa antare
   tatkāryyākāritvenānyakāryyakāritvena vā / yadyevantatkālakāryyakāritvaṃ	tad kAryya akAri tvena anya kAryya kAri tvena vA / yadi evantad kAla kAryya kAri tvam
   tatkālakāryyākāritvena virudvaṃ / na punaḥ kālāntare	tad kAla kAryya AkAri tvena virudvam / na punar kAla antare
   tatkāryyākāritvenānyakāryyakāritvena vā / tatkathaṃ kālabhede 'pi virodha	tad kAryya akAri tvena anya kAryya kAri tvena vA / tat kaTam kAla Bede api viroDa
   iti cet / ucyate / dvayorhi dharmmayorekatradharmmiṇyanavasthitiniyamaḥ	iti ced / ucyate / dvayoH hi DarmmayoH ekatra DarmmiNi anavasTiti niyamaH
   parasparaparihārasthitilakṣaṇo virodhaḥ / sa ca	paraspara parihAra sTiti lakzaNaH viroDaH / sa ca
   sākṣātparasparapratyanīkatayā bhāvābhāvavadvā bhavet / ekasya vā niyamena	sAkzAt paraspara pratyanIka tayA BAva aBAva vat vA Bavet / ekasya vA niyamena
   pramāṇāntareṇa bādhanānnityatvasattvavadvā bhavediti na kaścidarthabhedaḥ	pramANa antareNa bADanAt nitya tva sattva vat vA Bavet iti na kaScid arTa BedaH
   / tadatraikadharmmiṇi tat kālakāryyakāritvādhāre kālāntare	/ tad atra eka DarmmiNi tat kAla kAryya kAri tva ADAre kAla antare
   tatkāryyākāritvasyānyakāryyakāritvasya vā niyamena pramāṇāntareṇa	tad kAryya akAri tvasya anya kAryya kAri tvasya vA niyamena pramANa antareNa
   bādhanādvirodhaḥ / tathā hi yatraiva dharmmiṇi	bADanAt viroDaH / taTA hi yatra eva DarmmiNi
   tatkālakāryyakāritvamupalabdhanna tatraiva kālāntare tat	tad kAla kAryya kAri tvam upalabDan na tatra eva kAla antare tat 
   kāryyākāritvamanyakāryyakāritvaṃ vā brahmaṇāpyupasaṃharttuṃ śakyate,	kAryya akAri tvam anya kAryya kAri tvam vA brahmaNA api upasaMharttum Sakyate,
   yenānayoravirodhaḥ syāt / kṣaṇāntare kathita	yena anayoH aviroDaH syAt / kzaNa antare kaTita
   prasaṅgaviparyyayahetubhyāmavaśyambhāvena dharmmibhedaprasādhanāt / na ca	prasaFga viparyyaya hetuByAm avaSyam BAvena Darmmi Beda prasADanAt / na ca
   pratyabhijñānādekatvasidviḥ / tat pauruṣasya nirmmūlitatvāt / ata eva	pratyaBijQAnAt eka tva sidviH / tat pOruzasya nirmmUlita tvAt / atas eva
   vajro 'pi pakṣakūkṣau nikṣiptaḥ kathamasau sphaṭiko varākaḥ	vajraH api pakza kUkzO nikziptaH kaTam asO sPawikaH varAkaH
   kālabhedenābhedāsādhanāya dṛṣṭāntībhavitumarhati / na caivaṃ	kAla Bedena aBeda asADanAya dRzwAntI Bavitum arhati / na ca evam
   samānakālakāryyāṇāṃ deśabhede 'pi dharmmibhedo yukto	samAna kAla kAryyANAm deSa Bede api Darmmi BedaH yuktaH 
   bhedasādhakapramāṇābhāvādindriyapratyakṣeṇa	Beda sADaka pramANa aBAvAt indriya pratyakzeNa
   nirastavibhramāśaṅkenābhedaprasādhanācca / iti na kālabhede 'pi	nirasta viBrama ASaFkena aBeda prasADanAt ca / iti na kAla Bede api
   śaktyaśaktyorvirodhaḥ svasamayamātrādapahastayituṃ śakyaḥ /	Sakti aSaktyoH viroDaH sva samaya mAtrAt apahastayitum SakyaH /
   samayapramāṇayorapravṛtteriti /	samaya pramANayoH apravRtteH iti /
   tasmāt sarvvatra virudvadharmmādhyāsasidvireva bhedasidviḥ / vipratipannaṃ	tasmAt sarvu atra virudva Darmma aDyAsa sidvis eva Beda sidvis / vipratipannam
   prati tu virudvadharmmādhyāsādbhedavyavahāraḥ sādhyate / nanu tathāpi	prati tu virudva Darmma aDyAsAt Beda vyavahAraH sADyate / nanu taTA api
   sattvamidamanaikāntikamevāsādhāraṇatvāt sandigdhavyatirekatvādvā / yathā	sattvam idam anEkAntikam eva asADAraNa tvAt sandigDa vyatireka tvAt vA / yaTA
   hīdaṃ kramākramanivṛtto akṣaṇikānnivṛttaṃ, tathā	hi idam krama Akrama nivRttaH akzaNikAt nivRttaM, taTA
   sāpekṣatvānāpekṣatvayorekatvānekatvayorapi vyāpakayornivṛttau kṣaṇikādapi	sa apekza tvAnApekza tvayoH ekatva aneka tvayoH api vyApakayoH nivRttO kzaNikAt api
   / tathāhyupasapaṇapratyayena devadattakarapallavādinā sahacaro vījakṣaṇaḥ	/ taTA hi upasapaNa pratyayena deva datta kara pallava AdinA sahacaraH vIjakzaNaH
   pūrvvasmādeva puñjāt samarthojāto 'napekṣa ādyātiśayasya janaka iṣyate /	pUrvvasmAt eva puQjAt samarTaH jAtaH anapekzaH Adya atiSayasya janakaH izyate /
   tatra ca samānakuśūlajanmasu bahuṣu vijasantāneṣu kasmāt kiñcideva vījaṃ	tatra ca samAna kuSUla janmasu bahuzu vijasantAnezu kasmAt kiQcid eva vIjam
   paramparayāṅkurotpādānuguṇamupajanayati bījakṣaṇānnānye vījakṣaṇā	paramparayA aFkura utpAda anuguNam upajanayati bIja kzaNAt na anye vIjakzaNA
   bhinnasantānāntaḥpātinaḥ / nahyupasarpaṇapratyayāt prāgeva teṣāṃ	Binna santAna antaHpAtinaH / nahi upasarpaNa pratyayAt prAk eva tezAm
   samānāsamānasantānavarttināṃ vījakṣaṇānāṃ kaścit paramparātiśayaḥ /	samAna asamAna santAna varttinAm vIjakzaNAnAm kaScid paramparA atiSayaH /
   athopasarpaṇāt prāṅna tat santāna varttino 'pi janayanti	aTa upasarpaNAt prAk na tat santAna varttinaH api janayanti
   paramparayāpyaṅkurotpādānuguṇaṃ vījakṣaṇaṃ vījamātrajananātteṣāṃ /	paramparayA api aFkura utpAda anuguNam vIjakzaNam vIja mAtra jananAt tezAm /
   kasyacideva vījakṣaṇasyopasarpaṇapratyayasahabhuva ādyātiśayotpādaḥ /	kasyacid eva vIjakzaNasya upasarpaNa pratyaya sahaBuvaH Adya atiSaya utpAdaH /
   hanta tarhi yadabhāve satyutpannopi na janayedeva / tathā kevalānāṃ	hanta tarhi yad aBAve sati utpannopi na janayet eva / taTA kevalAnAm
   vyabhicārasambhavādādyātiśayotpādamaṅkuraṃ vā prati kṣityādīnāṃ	vyaBicAra samBavAt Adya atiSaya utpAdam aFkuram vA prati kziti AdInAm
   parasparāpekṣāṇāmevotpādakatvamakāmakenāpi svīkarttavyaṃ / ato na	paraspara apekzANAm eva utpAdaka tvam akAmakena api svIkarttavyam / atas na
   tāvadanapekṣā kṣaṇikasya sambhavinī / nāpya pekṣā yujyate /	tAvat anapekzA kzaNikasya samBavinI / na apya pekzA yujyate /
   samasamayakṣaṇayoḥ savyetaragoviṣāṇayorivopakāryyopakārakabhāvāyogāditi	sama sama ya kzaNayoH savya itara go vizANayoH iva upakAryya upakAraka BAvA yogAt iti
   nāsidvaḥ prathamo vyāpakābhāvaḥ / api cāntyo vījakṣaṇo 'napekṣo	na asidvaH praTamaH vyApaka aBAvaH / api ca antyaH vIjakzaNaH anapekzaH 
   'ṅkurādikaṃ kurvvan yadi yenaiva rūpeṇāṅkuraṃ karoti tenaiva kṣityādikaṃ /	aFkura Adikam kurvvan yadi yena eva rUpeNa aFkuram karoti tena eva kziti Adikam /
   tadā kṣityādīnāmapi aṅkurasvābhāvyāpattirabhinnakāraṇātvāditi na	tadA kziti AdInAm api aFkura svABAvya ApattiH aBinna kAraNA tvAt iti na
   tāvadekatvasambhavaḥ /	tAvat ekatva samBavaH /
   nanu rūpāntareṇa karoti / tathā hi vījasyāṅkuraṃ pratyupādānatvaṃ	nanu rUpa antareNa karoti / taTA hi vIjasya aFkuram pratyupAdAna tvam
   kṣityādikaṃ tu prati sahakāritvaṃ / yadyevaṃ sahakāritvopādānatve	kziti Adikam tu prati sahakAri tvam / yadi evam sahakAri tva upAdAna tve
   kimekantatvaṃ nānā vā / ekañceta kathaṃ rūpāntareṇa janakaṃ / nānātve	kim ekanta tvam nAnA vA / ekaQceta kaTam rUpa antareNa janakam / nAnAtve
   tvanayorvījādbhedo 'bhedo vā / bhede kathaṃ vījasya janakatvaṃ	tu anayA uH vIjAt BedaH aBedaH vA / Bede kaTam vIjasya janaka tvam
   tābhyāmevāṅkurādīnāmutpatteḥ / abhede vā kathaṃ vījasya na nānātvaṃ	tAByAm eva aFkura AdInAm utpatteH / aBede vA kaTam vIjasya na nAnA tvam
   bhinnatādātmyāt / etayorvā ekatvamekatādātmyāt / yadyucyeta / kśityādau	Binna tAdAtmyAt / etayoH vA eka tvam eka tAdAtmyAt / yadyucyeta / kSiti AdO
   janayitavye tadupādānam purvvameva kṣityādivījasya rūpāntaramiti / na	janayitavye tad upAdAnam purvvam eva kziti Adi vIjasya rUpa antaram iti / na
   tarhi vījantadanapekṣaṃ kṣityādīnāṃ janakaṃ / tadanapekṣatve	tarhi vIjantat anapekzam kziti AdInAm janakam / tad anapekza tve
   teṣāmaṅkurodbhedānupapatteḥ / na cānupakārakāṇyapekṣanta iti tvayaivoktaṃ	tezAm aFkura udBeda anupapatteH / na ca anupakArakANi apekzante iti tvayA eva uktam
   / na ca kṣaṇasyopakārasambhavo 'nyatra jananāt	/ na ca kzaNasya upakAra samBavaH anyatra jananAt 
   tasyābhedyatvādityanekatvamapi nāstīti dvitīyo 'pi vyāpakābhāvo na sidvaḥ	tasya aBedya tvAt iti aneka tvam api na asti iti dvitIyaH api vyApaka aBAvaH na sidvaH
   / tasmādasādhāraṇānaikāntikatvaṃ gandhavattvavaditi / yadi	/ tasmAt asADAraNa anEkAntika tvam ganDavat tva vat iti / yadi
   manyetānupakārakā api bhavanti sahakāriṇo 'pekṣaṇīyāśca	manyetAn upakArakAH api Bavanti sahakAriNaH apekzaNIyAH ca
   kāryyeṇānuvihitabhāvābhāvāt sahakaraṇācca / nanvanena krameṇākṣaṇikopi	kAryyeNa anuvihita BAva aBAvAt saha karaNAt ca / nanu anena krameNa akzaNikopi
   bhāvo 'nupakārakānapi sahakāriṇaḥ kramavataḥ	BAvaH anupakArakAn api sahakAriNaH kramavataH
   kramavatkāryyeṇānukṛtānvayavyatirekānapekṣiṣyate / kariṣyate ca kramavat	kramavat kAryyeNa anukRta anvaya vyatirekAn apekzizyate / karizyate ca krama vat 
   sahakārivaśaḥ krameṇa kāryyāṇīti vyāpakānupalabdherasidveḥ /	sahakAri vaSaH krameNa kAryyANi iti vyApaka anupalabDeH asi dveH /
   sandigdhavyatirekamanaikāntikaṃ sattvaṃ kṣaṇikatvasidvāviti //	sandigDa vyatirekam anEkAntikam sattvam kzaNika tvasi dvO= iti //
   atra brūmaḥ / kīdṛśaṃ punarapekṣārthamādāya	atra brUmaH / kIdRSam punar apekzA arTam AdAya
   kṣaṇikesāpekṣānapekṣatvanivṛttirūcyate / kiṃ sahakāriṇamapekṣata iti	kzaNikesa apekzA anapekza tva nivRttiH Ucyate / kim sahakAriNam apekzate iti
   sahakāriṇāsyopakāraḥ karttavyaḥ /	sahakAriNA asya upakAraH karttavyaH /
   atha pūrvvāvasthitasyaiva vījādeḥ sahakāriṇā saha sambhūyakaraṇaṃ / yadvā	aTa pUrvva avasTitasya eva vIja AdeH sahakAriNA saha samBUya karaNam / yat vA
   purvvāvasthitasyetyanapekṣamilitāvasthasya karaṇamātramapekṣārthaḥ / atra	purvvA avasTitasya iti anapekza milita avasTasya karaNa mAtram apekzA arTaH / atra
   prathamapakṣasyāsambhavādanapekṣaiva kṣaṇikasya kathamubhayavyāvṛttiḥ /	praTama pakzasya asamBavAt anapekzA eva kzaNikasya kaTam uBaya vyAvRttiH /
   yadyanapekṣaḥ kṣaṇikaḥ, kimityupasarpaṇapratyayābhāve 'pi na karoti /	yadi anapekzaH kzaNikaH, kim iti upasarpaNa pratyaya aBAve api na karoti /
   karotyeva yadi syāt / svayamasambhavī tu kathaṃ karotu / atha tadvā	karoti eva yadi syAt / svayam asamBavI tu kaTam karotu / aTa tat vA
   tādṛgvā āsīditi na kaścidviśeṣaḥ / tatastādṛksvabhāvasambhavepyakaraṇaṃ	tAdRS vA AsIt iti na kaScid viSezaH / tatas tAdRS svaBAva samBavepya karaNam
   sahakāriṇi nirapekṣatāṃ na kṣamata iti cet / asambadvametat /	sahakAriNi nirapekzatAm na kzamate iti ced / asamba dvam etat /
   varṇasaṃsthānasāmyepyakarttustatsvabhāvatāyā virahāt / sa	varNa saMsTAna sAmya Ipi akarttuH tad svaBAvatAyAH virahAt / sa
   cādyātiśayajanakatvalakṣaṇaḥ svabhāvaviśeṣo na samānāsamānasantānavarttiṣu	ca adya atiSaya janakatva lakzaNaH svaBAva viSezaH na samAna asamAna santAna varttizu
   vījakṣaṇeṣu sarvveṣveva sambhavī kintu keṣucideva karmmakarakara	vIjakzaNezu sarvu ezu eva samBavI kintu kezucid eva karmmakara kara
   pallavasahacareṣu / nanvekatra kṣetre niṣpattilabanādipūrvvakamānīyaikatra	pallava sahacarezu / nanu ekatra kzetre nizpatti labana Adi pUrvvakam AnIya ekatra
   kuśūle kṣiptāni sarvvāṇyeva vījāni sādhāraṇarūpāṇyeva pratīyante, tat	kuSUle kziptAni sarvvANi eva vIjAni sADAraNa rUpANi eva pratIyante, tat 
   kutastyo 'yamekavījasambhavī viśeṣonyeṣāmiti cet /	kutastyaH ayam ekavIja samBavI viSeza unyezAm iti ced /
   ucyate / kāraṇaṃ khalu sarvvatra kāryye dvividhaṃ dṛṣṭamadṛṣṭañca	ucyate / kAraNam Kalu sarvu atra kAryye dviviDam dRzwam adRzwaQca
   sarvvāstikaprasidvametat / tataḥ	sarvvAstika prasidvam etat / tatas 
   pratyakṣaparokṣasahakāripratyayasākalyamasarvvavidā pratyakṣato na śakyaṃ	pratyakza parokza sahakAri pratyaya sAkalyam asarvu avidA pratyakzataH na Sakyam
   pratipattuṃ / tato bhavedapi kāraṇasāmagrīśaktibhedāttādṛśaḥ	pratipattum / tatas Bavet api kAraNa sAmagrI Sakti BedAt tAdRSaH
   svabhāvabhedaḥ keṣāñcideva vījakṣaṇānāṃ yena taeva vījakṣaṇā	svaBAva BedaH kezAQcid eva vIjakzaNAnAm yena taA iva vIjakzaNA
   ādyātiśayamaṅkurambā paramparayā janayeyu rnānye vījakṣaṇāḥ / nanu	Adya atiSayam aFkurambA paramparayA janayeyu rna anye vIjakzaNAH / nanu
   yeṣūpasarpaṇapratyayasahacareṣu	yezu upasarpaNa pratyaya sahacarezu
   svakāraṇaśaktibhedādādyātiśayajanakatvalakṣaṇo viśeṣaḥ sambhāvyate, sa	sva kAraNa Sakti BedAt Adya atiSaya janakatva lakzaNaH viSezaH samBAvyate, sa
   tatrāvaśyamastīti kuto labhyamiti cet /	tatra avaSyam asti iti kutas laByam iti ced /
   aṅkurotpādādanumitādādyātiśayalakṣaṇāt kāryyāditi brūmaḥ /	aFkura utpAdAt anumitAt Adya atiSaya lakzaNAt kAryyAt iti brUmaH /
   kāraṇānupalabdhestarhi tadabhāva eva bhaviṣyatīti cet / na	kAraNa anupalabDeH tarhi tad aBAvaH eva Bavizyati iti ced / na
   dṛśyādṛśyasamudāyasya kāraṇasyādarśanepyabhāvasidveḥ kāraṇānupalabdheḥ	dRSya adRSya samudAyasya kAraNasya adarSana Ipya BAvasi dveH kAraNa anupalabDeH
   sandigdhāsidvatvāt / tadayamarthaḥ / pāṇisparśavataḥ kṣaṇasya na	sandigDa asi dva tvAt / tat ayam arTaH / pANi sparSavataH kzaNasya na
   bhedabhinnānyakālakṣaṇādbhedo veti matadvaye mitibalaṃ yasyāstyasau	Beda Binna anyakA lakzaNAt BedaH vA iti mata dvaye miti balam yasya asti asO
   jitvaraḥ / tatraikasya balaṃ nimittavirahaḥ kāryyāṅgamanyasya vā / sāmagrī	jitvaraH / tatra ekasya balam nimitta virahaH kAryya aFgam anyasya vA / sAmagrI
   tu na sarvvathekṣaṇasahā kāryyantu mānānugamamiti //	tu na sarvu aTa IkzaNa sahA kAryyantu mAna anugamam iti //
   tadevaṃ nopakāro 'pekṣārtha ityanapekṣyaiva kṣaṇikasya sahakāriṣu	tat evam na upakAraH apekzA arTaH iti anapekzya eva kzaNikasya sahakArizu
   nobhayavyāvṛttiḥ / atha sambhūyakaraṇamapekṣārthaḥ / tadā yadi	na uBaya vyAvRttiH / aTa samBUya karaNam apekzA arTaH / tadA yadi
   pūrvvasthitasyeti viśeṣaṇāpekṣā tadā kṣaṇikasya naivaṃ	pUrvvasTitasya iti viSezaNa apekzA tadA kzaNikasya na evam
   kadācidityanapekṣaivākṣīṇā / atha	kadAcid iti anapekzA eva akzINA / aTa
   pūrvvāsthitasyetyanapekṣyamilitāvasthitasyaiva karaṇamapekṣārthastadā	pUrvvAsTitasya iti anapekzya milita avasTitasya eva karaNam apekzA arTaH tadA
   sāpekṣataiva nānapekṣa / tathā ca nobhayavyāvṛttirityasidvaḥ prathamo	sa apekzatA eva na anapekza / taTA ca na uBaya vyAvRttiH iti asi dvaH praTamaH 
   vyāpakānupalambhaḥ / tathaikatvānekatvayorapi vyāpakayoḥ	vyApaka anupalamBaH / taTA ekatva aneka tvayoH api vyApakayoH
   kṣaṇikādvyāvṛttirasidvā /	kzaNikA dvi AvRttiH asidvA /
   tattadyāvṛttibhedamāśrityopādānatvādikālpanikasvabhāvabhede 'pi	tad tad ya AvRtti Bedam ASritya upAdAna tva Adi ka alpa nika svaBAva Bede api
   paramārthata ekenaiva svarūpeṇānekakāryyaniṣpādanādubhayavyāvṛtterabhāvāt	paramArTataH ekena eva sva rUpeNa aneka kAryya nizpAdanAt uBaya vyAvRtteH aBAvAt 
   / yacca vījasyaikenaiva svabhāvena kārakatve	/ yat ca vIjasya ekena eva svaBAvena kAraka tve
   kṣityādīnāmaṅkurasvābhāvyāpattiranyathā kāraṇābhede 'pi kāryyabhede 'pi	kziti AdInAm aFkura svABAvya ApattiH anyaTA kAraNa aBede api kAryya Bede api
   kāryyasyāhetukatvaprasaṅgādityuktaṃ tadasaṅgataṃ / kāraṇaikatvasya	kAryyasyA hetuka tva prasaFgAt iti uktam tad asaFgatam / kAraNa eka tvasya
   kāryyabhedasya ca paṭunendriyapratyakṣeṇa prasādhanāt /	kAryya Bedasya ca pawunA indriya pratyakzeNa prasADanAt /
   ekakāraṇajanyatvaikatvayorvyāpteḥ pratihatatvāt / prasaṅgasyānupadatvāt /	eka kAraNa janya tva eka tvayoH vyApteH pratihata tvAt / prasaFgasya anupada tvAt /
   yacca kāraṇābhede kāryyābheda ityuktaṃ tatra sāmagrīsvarūpaṃ	yat ca kAraNa aBede kAryya aBedaH iti uktam tatra sAmagrI svarUpam
   kāraṇamabhipretaṃ sāmagrīsajātīyatve na kāryyavijātīyatetyarthaḥ / na	kAraNam aBipretam sAmagrI sa jAtIya tve na kAryI avijAtIyatA iti arTaH / na
   punaḥ sāmagrīmadhyagatenaikenānekaṃ kāryyaṃ na karttavyaṃ nāma /	punar sAmagrI maDya gatena ekena anekam kAryyam na karttavyam nAma /
   ekasmādanekotpatteḥ pratyakṣasidvatvāt / na caivaṃ pratyabhijñānāt	ekasmAt aneka utpatteH pratyakza sidva tvAt / na ca evam pratyaBijQAnAt 
   kālabhedepyabhedasidvirityuktaprāyam / na cendriyapratyakṣaṃ bhinnadeśaṃ	kAla Beda Ipya Beda sidvis iti ukta prAyam / na ca indriya pratyakzam Binna deSam
   sapratighaṃ dṛśyamarthadvayamekamevopalambhayatīti kvacidupalabdhaṃ yena	sa pratiGam dRSyam arTa dvayam ekam eva upalamBayati iti kvacid upalabDam yena
   tatrāpi bhedaśaṅkā syāt / śaṅkāyāmbā paṭupratyakṣasyāpyapalāpe	tatra api Beda SaFkA syAt / SaFkAya ambA pawu pratyakzasya api apalApe
   sarvvapramāṇocchedaprasaṅgāt / nāpi sandigdhavyatirekaḥ /	sarvu apramANa ucCeda prasaFgAt / na api sandigDa vyatirekaH /
   kṣityāderdrabyāntarasya vījasvabhāvatvenāsmābhirasvīkṛtatvāt	kziti AdeH drabya antarasya vIja svaBAva tvena asmABiH asvIkRta tvAt 
   anupakāriṇyapekṣāyāḥ pratyākhyānāt / vyāpakānupalambhasyāsidvatvāyogāt /	anupakAriNI apekzAyAH pratyAKyAnAt / vyApaka anupalamBasya asi dvatva ayogAt /
   tadetau dvāvapi vyāpakānupalambhāvasidvau na kṣaṇikāt sattvannivarttata	tat etO dvO= api vyApaka anupalamBO= asi dvO na kzaNikAt sattvat nivarttata
   iti nāyamasādhāraṇo hetuḥ / api ca vidyamāno bhāvaḥ	iti na ayam asADAraNaH hetuH / api ca vidyamAnaH BAvaH
   sādhyetarayoraniścitānvayavyatireko gandhavattādivadasādhāraṇo yuktaḥ /	sADya itarayoH aniScita anvaya vyatirekaH ganDavat tA Adi vadasADAraNaH yuktaH /
   prakṛtavyāpakānupalambhācca sarvvathārthakriyaivāsatī	prakRta vyApaka anupalamBAt ca sarvu aTa arTa kriyA eva asatI
   ubhābhyāmbādibhyāmubhayasmādvinivarttitatvena nirāśrayatvāt / tat	uBa aByAmba AdiByAm uBayasmAt vinivarttita tvena nirASraya tvAt / tat 
   kathamasādhāraṇānaikāntikī bhaviṣyatyalaṃ pralāpini nirbbandhena / tadevaṃ	kaTam asADAraNa anEkAntikI Bavizyati alam pralApini nirbbanDena / tat evam
   śaktasya kṣepāyogāt samarthavyavahāragocaratvaṃ jananena vyāptamiti	Saktasya kzepA yogAt samarTa vyavahAra gocara tvam jananena vyAptam iti
   prasaṅgaviparyyayayoḥ sattve hetorapi nānaikāntikatvamataḥ	prasaFga viparyyayayoH sattve hetoH api na anEkAntika tvam atas 
   kṣaṇabhaṅgasidviriti sthitam //	kzaNa BaFga sidvis iti sTitam //
   iti sādharmyadṛṣṭānte 'nvayarūpavyāptyā	iti sADarmya dRzwAnte anvaya rUpa vyAptyA
   kṣaṇabhaṅgasidviḥ samāptā //	kzaNa BaFga sidvis samAptAH //
   kṛtiriyaṃ mahāpaṇḍitaratnakīrttipādānāmiti //	kRtiH iyam mahA paNxita ratna kIrtti pAdAnAm iti //
