   akaritva artha jagatī imu mārakarma Rgs_11.2d	akaritva arTa jagatI imu mAra-karma RgH-_11.2d
   akhilārjavo mṛdugirāya parākrameyyā Rgs_16.6d	aKila-ArjavaH mRdu-girAya parAkrameyyAH RgH-_16.6d
   agnīva yukta tṛṇakāṣṭhavanaṃ dahāti Rgs_9.1d	agni-iva yukta tRNa-kAzWa-vanam dahAti RgH-_9.1d
   agraṃ dadeya vara uttamadharmadānam Rgs_27.9c	agram dadeya varaH uttama-Darma-dAnam Rc-H-_27.9c
   agraṃ nidhāna ayu uttamadharmakośa Rgs_28.2a	agram niDAnaH ayu uttama-Darma-koSaH Rc-H-_28.2a
   agraṃ spṛśeya paramādbhuta buddhajñānam Rgs_27.9b	agram spRSeya parama-adButa budDa-jQAnam Rc-H-_27.9b
   aṇumātra kheda manaso na upādiyāti Rgs_19.8d	aNumA-atra Keda manasaH naH upAdiyAti RgH-_19.8d
   aṇumātra yo na khalu yujyati skandhadhātau Rgs_10.1c	aNumA-atra yaH na Kalu yujyati skanDa-DAtO Rc-H-_10.1c
   aṇumātru no labhati prajña vibhāvamānaḥ Rgs_7.3b	aNumAtru naH laBati prajQa viBAvamAnaH Rc-H-_7.3b
   atikramya bodhidvaya prāpsyati agrabodhim Rgs_14.6d	atikramya boDi-dvaya prApsyati agra-boDim RgH-_14.6d
   atikramya bhūmidvaya śrāvakapratyayānāṃ Rgs_14.1c	atikramya BUmi-dvaya SrAvaka-pratyayAnAm Rc-H-_14.1c
   atikrāntanāgata jinā sthita ye diśāsu Rgs_22.3a	atikrAntanAgata jinA sTitaH ye diSAsu RgH-_22.3a
   atikrāntanāgata daśaddiśi lokanāthā Rgs_28.2c	atikrAntanAgata daSat-diSi lokanATAH Rc-H-_28.2c
   atikrānta yā tathata yā tathatā aprāptā Rgs_16.2a	atikrAnta yA taTata yA taTatA aprAptAH RgH-_16.2a
   atrāntare na ca nimitta prabhāvitavyo Rgs_20.7c	atra-antare na ca nimitta praBAvitavyaH Rc-H-_20.7c
   atrāntare na parihāyati buddhadharmān Rgs_20.1d	atra-antare na parihAyati budDa-DarmAn RgH-_20.1d
   atha ānimitta pariṇāmita bhonti bodhau Rgs_6.7b	aTa Animitta pariNAmita Bonti boDO Rc-H-_6.7b
   atha tasyupadyati matī kimutālpamātraṃ Rgs_30.5a	aTa tasi-upadyati matI kim-uta-alpa-mAtram RgH-_30.5a
   atha tasyupadyati matīti aśobhanā ti Rgs_24.6a	aTa tasi-upadyati mati-iti aSoBanA ti RgH-_24.6a
   atha bodhi uttamaśivāṃ pariṇāmayanti Rgs_31.2c	aTa boDi uttama-SivAm pariNAmayanti Rc-H-_31.2c
   athavā na paśyati nimitta nikāṅkṣa bhoti Rgs_10.5c	aTavA na paSyati nimitta nikAFkza Boti Rc-H-_10.5c
   athavāpi saṃskṛta sa prajñapanāya śakyaḥ Rgs_20.19d	aTavA-api saMskRta sa prajQapanAya SakyaH RgH-_20.19d
   athavā manuṣya tada bhoti daridrarūpo Rgs_31.11d	aTavA manuzya tada Boti daridra-rUpaH RgH-_31.11d
   athavāsya manyanupapadyati vyākṛto 'smi Rgs_21.1a	aTavA-asya manyanupapadyati vyAkRtaH asmi RgH-_21.1a
   atha śreṇikasya abhutī parivrājakasya Rgs_1.7a	aTa SreNikasya aButI parivrAjakasya RgH-_1.7a
   adhyāśaye na parikhinna upasthiheti Rgs_29.14d	aDyASaye na pariKinnaH upasTihA-iti RgH-_29.14d
   adhyāśayena vara prasthita buddhabodhim Rgs_15.1b	aDyASayena vara prasTita budDa-boDim Rc-H-_15.1b
   anapekṣako bhavati sarvapriyāpriyeṣu Rgs_31.9b	anapekzakaH Bavati sarva-priya-apriyezu Rc-H-_31.9b
   anupādadhī spṛśati śānti samādhi śreṣṭhām Rgs_1.10d	anupAdaDI spRSati SAnti samADi SrezWAm RgH-_1.10d
   anupāda skandha imi jānati ādiśūnyān Rgs_20.1b	anupAda skanDaH imi jAnati AdiSUnyAn Rc-H-_20.1b
   anupādupādu ubhaye avikalpamāno Rgs_1.26c	anupAd-upAdu uBaye avikalpamAnaH Rc-H-_1.26c
   anupādu śūnya na ya jānati sarvadharmān Rgs_5.2c	anupAdu SUnya na yaH jAnati sarva-DarmAn Rc-H-_5.2c
   anupāya prajñavikalā pari śrāvakatve Rgs_16.5d	anupAya prajQa-vikalA pari SrAvaka-tve RgH-_16.5d
   anupūrva śuklaguṇapūrṇa bhavanti buddhāḥ Rgs_19.5d	anupUrva Sukla-guNa-pUrNa Bavanti budDAH RgH-_19.5d
   anubuddhayati tvarito śivamabhyupaiti Rgs_22.13d	anubudDayati tvaritaH Sivam-aByupEti RgH-_22.13d
   anu bodhiāgamu guṇāna ca pāripūrī Rgs_29.13c	anu boDia-Agamu guNAna ca pAripUrI Rc-H-_29.13c
   anubhūya kāmaguṇahetu akāmakārā Rgs_30.13c	anuBUya kAma-guNa-hetu akAma-kArAH Rc-H-_30.13c
   anumodamī tatha tathā pariṇāmayāmi Rgs_6.8d	anumodamI taTa taTA pariNAmayAmi RgH-_6.8d
   antargatāstathami pāramitā bhavanti Rgs_25.4d	antargatAH-taTami pAramitAH Bavanti RgH-_25.4d
   anyatra chāyagatasaṃkhya prabhāṣamāṇā Rgs_4.6d	anyatra CAya-gata-saMKya praBAzamANAH RgH-_4.6d
   anyatra sattvaparipācana kṣetraśodhī Rgs_29.6a	anyatra sattva-paripAcana kzetra-SoDI RgH-_29.6a
   anyatra sattvaparipācanabodhiyuktā Rgs_21.5c	anyatra sattva-paripAcana-boDi-yuktAH Rc-H-_21.5c
   anye ca neka vividhā bahu antarāyā Rgs_11.8b	anye ca neka viviDAH bahu antarAyAH Rc-H-_11.8b
   apayāti vā sa iha śikṣati buddhadharme Rgs_24.6d	apayAti vA saH iha Sikzati budDa-Darme RgH-_24.6d
   aparapraṇeya avivartiya veditavyāḥ Rgs_15.6d	apara-praNeya avivartiya veditavyAH RgH-_15.6d
   aparasmi kāli puna labdhva bhaveya tuṣṭo Rgs_22.12b	aparasmi kAli puna labDva Baveya tuzwaH Rc-H-_22.12b
   aparāntakoṭi sada yukta prajānamāno Rgs_19.8c	apara-anta-kowi sada yukta prajAnamAnaH Rc-H-_19.8c
   aparāntato 'pi pratiupanna triyadhvaśuddho Rgs_1.23b	apara-antataH api pratiupan-na triyaDva-SudDaH Rc-H-_1.23b
   aparī(ri)gṛhīta labhate sugatāna bodhim Rgs_1.6d	aparI(ri)-gRhIta laBate sugatAna boDim RgH-_1.6d
   api kṣetraśuddhi parigṛhṇati sattvaśuddhim Rgs_32.5b	api kzetra-SudDi parigRhNati sattva-SudDim Rc-H-_32.5b
   api kho punāśrayu ime catudhyāna sāṅgā Rgs_29.1c	api KaH punASrayu ime catuDyAna sa-aFgAH Rc-H-_29.1c
   api chidraśīlu na tu so pariśuddhaśīlo Rgs_31.7d	api Cidra-SIlu na tu saH pariSudDa-SIlaH RgH-_31.7d
   api tū khu prajñaparibhāvita pūjayanti Rgs_4.2b	api tU Ku prajQa-pariBAvita pUjayanti Rc-H-_4.2b
   api duḥkhito manasi bhoti sa jātisaṃgho Rgs_20.15d	api duHKitaH manasi Boti sa jAti-saMGaH RgH-_20.15d
   api buddhavaṃśa parigṛhṇati dharmavaṃśaṃ Rgs_32.5c	api budDavaMSa parigRhNati Darma-vaMSam Rc-H-_32.5c
   api sarvasattva dukhitā manasī bhavanti Rgs_20.16d	api sarva-sattva duKitAH manasI Bavanti RgH-_20.16d
   abhicāramantra na ca istriprayogamantrāḥ Rgs_17.5d	aBicAra-mantra na ca istri-prayoga-mantrAH RgH-_17.5d
   abhibhoti sarvajagatī kṣamamāṇu śūraḥ Rgs_30.12d	aBiBoti sarva-jagatI kzamamANu SUraH RgH-_30.12d
   abhibhoti sarvajagatī pariṇāmayukto Rgs_31.16d	aBiBoti sarva-jagatI pariNAma-yuktaH RgH-_31.16d
   abhibhoti sarvapariṇāmaku bodhisattvo Rgs_31.17d	aBiBoti sarva-pariNAma-ku boDisattvaH RgH-_31.17d
   abhibhonti sarvajagatī rahapratyayāṃśca Rgs_23.2c	aBiBonti sarva-jagatiH raha-pratyayAn=-ca Rc-H-_23.2c
   abhibhonti sarvi pariṇāmayamāna śūro Rgs_6.9d	aBiBonti sarvi pariNAmayamAna SUraH RgH-_6.9d
   abhimanyate na imi raṇyavivekacārī Rgs_21.7c	aBimanyate na imi raNya-viveka-cArI Rc-H-_21.7c
   abhiyukta rātridiva niṣpratikāṅkṣacitto Rgs_29.14b	aBiyukta rAtrit-iva nizpratikAFkza-cittaH Rc-H-_29.14b
   abhilāpamātra ima jānati sarvadharmāṃ Rgs_18.7a	aBilApa-mAtraH ima jAnati sarva-DarmAm RgH-_18.7a
   abhyantare ya nagare nigame ca grāme Rgs_20.17a	aByantare yaH nagare nigame ca grAme Rc-H-_20.17a
   abhyāśa grāmanagarāṇa ime nimittāḥ Rgs_10.3d	aByASa grAma-nagarANaH ime nimittAH RgH-_10.3d
   a(bhyāśa)to mahasamudra na so 'tidūre Rgs_10.5d	a(ByASa)taH mahasamudra na saH ati-dUre RgH-_10.5d
   abhyokireya gurupremata bodhisattvam Rgs_30.11b	aByokireya guru-premata boDisattvam Rc-H-_30.11b
   abhyovakāśasadṛśo upaśāntacārī Rgs_26.4d	aByovakASa-sadRSaH upaSAnta-cArI RgH-_26.4d
   amṛtasya dāyaku priyo marumānuṣāṇām Rgs_23.4b	amRtasya dAyaku priyaH maru-mAnuzANAm Rc-H-_23.4b
   amṛtaṃ ti jñānu paramaṃ na tu yo pareṇa Rgs_1.27c	amRtam ti jQAnu paramam na tu yaH pareNa Rc-H-_1.27c
   aya dharmadarśanu nidiṣṭu tathāgatena Rgs_12.8d	ayaH Darma-darSanu nidizwu taTAgatena RgH-_12.8d
   ayu eṣa eṣati hi sattvasukhābhiyukto Rgs_23.4c	ayu ezaH ezati hi sattva-suKa-aBiyuktaH Rc-H-_23.4c
   ayu gocaro daśabalāna vināyakānāṃ] Rgs_12.5a	ayu gocaraH daSa-balAna vinAyakAnAn] RgH-_12.5a
   ayu vīryapāramita ukta hitaṃkareṇa Rgs_30.7c	ayu vIrya-pAramitaH ukta hitaMkareNa Rc-H-_30.7c
   ayu śikṣitavyamati śikṣati etamartham Rgs_25.6d	ayu Sikzitavyam-ati Sikzati etam-arTam RgH-_25.6d
   ayu śīlasaṃvaru prakāśitu nāyakena Rgs_31.8d	ayu SIla-saMvaru prakASitu nAyakena RgH-_31.8d
   ayu sattvasaṃjñaparikalpaku bodhisattvo Rgs_7.4c	ayu sattva-saMjQa-parikalpa-ku boDisattvaH Rc-H-_7.4c
   araṇāya liṅga bhaṇahī guṇasāgarāṇām Rgs_17.1b	araNAya liFga BaNa-hI guNa-sAgarANAm Rc-H-_17.1b
   (a)rhantabhūmi(ta) gaveṣayiṣyanti bodhim Rgs_11.5d	(a)rhanta-BUmi(ta) gavezayizyanti boDim RgH-_11.5d
   arhantabhūmimapi pratyayabuddhabhūmau Rgs_20.22a	arhanta-BUmim-api pratyaya-budDa-BUmO Rc-H-_20.22a
   arhanvimokṣa sthapayitva tathāgatānāṃ Rgs_27.7c	arhan-vimokza sTapayitva taTAgatAnAm Rc-H-_27.7c
   arhaṃ vidhūtamalakleśa prahīṇakāṅkṣo Rgs_2.6c	arham viDUta-mala-kleSa prahINa-kAFkzaH Rc-H-_2.6c
   alpaṃ tyajitva labhate bahu aprameyam Rgs_31.14d	alpam tyajitva laBate bahu aprameyam RgH-_31.14d
   alpotsuko ka imu jñāsyati sattvakāyo Rgs_15.7d	alpa-utsukaH kaH imu jQAsyati sattva-kAyaH RgH-_15.7d
   avatāru so kutu labhiṣyati kṛṣṇabandhuḥ Rgs_24.2d	avatAru saH kutu laBizyati kRzNabanDuH RgH-_24.2d
   avasṛjya ātma sugatāṃ parasattvakārye Rgs_29.14a	avasRjya Atma sugatAm para-sattva-kArye Rc-H-_29.14a
   avasṛjya dhyānasukhaprītisamādhilābhaṃ Rgs_29.8c	avasRjya DyAna-suKa-prIti-samADi-lABam Rc-H-_29.8c
   avikalpakalpavigato 'dhiṣṭhānacārī Rgs_10.10c	avikalpa-kalpa-vigataH aDizWAna-cArI Rc-H-_10.10c
   avināyakā na prabhavanti spṛśetu bodhim Rgs_7.1d	avinAyakAH na praBavanti spRSetu boDim RgH-_7.1d
   avibhonti sarva krimijotikaprāṇabhūtāṃ Rgs_23.1c	aviBonti sarve krimi-jotika-prANa-BUtAm Rc-H-_23.1c
   avivartikā acalitāśca akopyadharmāḥ Rgs_15.5d	avivartikAH acalitAH-ca akopya-DarmAH RgH-_15.5d
   avivartiyasya varabodhayi prasthitasya Rgs_26.1a	avivartiyasya vara-boDayi prasTitasya RgH-_26.1a
   avivartiyāna imi liṅga prajānitavyā Rgs_17.7d	avivartiyAnaH imi liFga prajAnitavyAH RgH-_17.7d
   avivartiyā yatha bhavanti mahānubhāvā Rgs_17.1c	avivartiyAH yaTa Bavanti mahA-anuBAvAH Rc-H-_17.1c
   avivartiyeti ayu vyākṛtu veditavyaḥ Rgs_20.24d	avivartiya-iti ayu vyAkRtu veditavyaH RgH-_20.24d
   avivartiyeti ayu vyākṛtu veditavyo Rgs_20.22d	avivartiya-iti ayu vyAkRtu veditavyaH RgH-_20.22d
   avivartiyeti ayu vyākṛtu veditavyo Rgs_20.23d	avivartiya-iti ayu vyAkRtu veditavyaH RgH-_20.23d
   aṣṭau ca akṣaṇa kṣaṇāṃ labhate sa nityam Rgs_32.2b	azwO ca akzaNa kzaNAm laBate sa nityam Rc-H-_32.2b
   asatā na tasya puna prāpaṇanāya śakyam Rgs_19.2d	asatA na tasya puna prApaNanAya Sakyam RgH-_19.2d
   asatā na tasya spṛśatā puna śakya bhonti Rgs_19.2b	asatA na tasya spRSatA puna Sakya Bonti Rc-H-_19.2b
   asatā nadīya phalapuṣpa na saṃbhaveyuḥ Rgs_5.7c	asatA nadIya Pala-puzpa na saMBaveyuH Rc-H-_5.7c
   asatā pi paścima na dahyati dīpavarti Rgs_19.1d	asatA pi paScima na dahyati dIpa-varti RgH-_19.1d
   asato 'ṅkurasya drumasaṃbhavu nāsti loke Rgs_5.5a	asataH aFkurasya druma-saMBavu na-asti loke RgH-_5.5a
   asamāhito karuṇa prekṣati sattvadhātum Rgs_20.1c	asamAhitaH karuNa prekzati sattva-DAtum Rc-H-_20.1c
   asamāhito bhavati uddhatakṣiptacitto Rgs_29.9c	asamAhitaH Bavati udData-kzipta-cittaH Rc-H-_29.9c
   asthānameta yadi matsari so kareyā Rgs_31.10d	asTAnam-eta yadi matsari saH kareyAH RgH-_31.10d
   asthānameva yadi nirvṛti prāpuṇeyā Rgs_20.19c	asTAnam-eva yadi nirvRti prApuNeyAH Rc-H-_20.19c
   asthānu sthānu ayu sthānu jinena ukto Rgs_2.3d	asTa-anu sTAnu ayu sTAnu jinena uktaH RgH-_2.3d
   asmin samādhi sthitu no ca spṛśāti bodhim Rgs_20.4d	asmin samADi sTitu no ca spRSAti boDim RgH-_20.4d
   ahasaṃjñatastu mamatā bhavate ca rāgo Rgs_31.11a	ahasaMjQataH-tu mamatA Bavate ca rAgaH RgH-_31.11a
   ahasaṃjñi jāyi mriyate ca sadā abhūto Rgs_22.6d	aha-saMjQi jAyi mriyate ca sadA aBUtaH RgH-_22.6d
   ahu mahya dharma ubhi eti abhūta śūnyā Rgs_22.5c	ahu mahya DarmaH uBi eti aBUta SUnyAH Rc-H-_22.5c
   ahu vyākṛto daśabalehi spṛśeya bodhim Rgs_19.7b	ahu vyAkRtaH daSa-bale-hi spRSeya boDim Rc-H-_19.7b
   ahusaṃjñatā ca parivarjita sattvasaṃjñā Rgs_31.6c	ahu-saMjQa-tA ca parivarjita sattva-saMjQAH Rc-H-_31.6c
   ākāṅkṣamāṇa puruṣasya pateya kāṇḍam Rgs_20.9d	AkAFkzamANa puruzasya pateya kANxam RgH-_20.9d
   ākāṅkṣamāṇu śivamacyutamagrabodhim Rgs_30.7d	AkAFkzamANu Sivam-acyutam-agra-boDim RgH-_30.7d
   ākāli vāyuravasṛjya mahāprapāte Rgs_20.13c	AkAli vAyuH-avasRjya mahA-prapAte Rc-H-_20.13c
   ākāśagaṇṭhi ayu ātmana baddha bāle Rgs_22.5d	AkASa-gaNWi ayu AtmanaH badDa bAle RgH-_22.5d
   ākāśatulya ayu yāna mahāvimāno Rgs_1.21c	AkASa-tulya ayu yAna mahA-vimAnaH Rc-H-_1.21c
   ākāśa dṛṣṭu iti sattva pravyāharanti Rgs_12.9a	AkASa dRzwu iti sattva pravyAharanti RgH-_12.9a
   ākāśadhātu gaganasya siyā virodho Rgs_26.4a	AkASa-DAtu gaganasya siyAH viroDaH RgH-_26.4a
   ākāśadhātu purimādiśi dakṣiṇāyāṃ Rgs_16.1a	AkASa-DAtu purimAdiSi dakziNAyAm RgH-_16.1a
   ākāśadhātuprakṛtī sa anantapārā Rgs_2.10c	AkASa-DAtu-prakRtI sa ananta-pArAH Rc-H-_2.10c
   ākāśadhātusama tasya na cāsti bhedaḥ Rgs_2.9d	AkASa-DAtu-sama tasya na ca-asti BedaH RgH-_2.9d
   ākāśadhātusamatāya abhinnachinnāḥ Rgs_8.1d	AkASa-DAtu-samatAya aBinna-CinnAH RgH-_8.1d
   ākāśaniśrita yathaiva hi sūrya[raśmi] Rgs_12.7a	AkASa-niSrita yaTA-eva hi sUrya[raSmi] Rc-H-_12.7a
   ākāśaniśrita samīraṇa āpaskandho Rgs_20.5a	AkASa-niSrita samIraNe ApaskanDaH RgH-_20.5a
   ākāśa pakṣisadṛśā vicaranti prajñāḥ Rgs_8.3d	AkASa pakzi-sadRSAH vicaranti prajQAH RgH-_8.3d
   ākāśa yatra na pratiṣṭhitu kiṃci tatra Rgs_7.3d	AkASa yatra na pratizWitu kiMci tatra RgH-_7.3d
   ākāśasthānu kutu cintayi etamartham Rgs_20.5d	AkASa-sTa-anu kutu cintayi etam-arTam RgH-_20.5d
   ākāśi pakṣi viharāti na co patāti Rgs_27.8a	AkASi pakzi viharAti na caH patAti RgH-_27.8a
   ākruṣṭa cāpi athavā sada tāḍitā vā Rgs_29.12b	Akruzwa ca-api aTavA sada tAxitAH vE Rc-H-_29.12b
   ātmanyanātmi tathatā ta(tha) śūnyatāyām Rgs_2.2b	Atmani-anAtmi taTatA ta(Ta) SUnyatAyAm Rc-H-_2.2b
   ātmā kṣiṇoti tulayeya sa bodhisattvo Rgs_21.8d	AtmA kziNoti tulayeya sa boDisattvaH RgH-_21.8d
   ātmāna māṃsa tyajamānu adīnacitto Rgs_31.10b	AtmAna mAMsa tyajamAnu adIna-cittaH Rc-H-_31.10b
   ātmānamosariyi taṃ vilayaṃ vrajeyyā Rgs_16.4d	AtmAnam-osariyi tam vilayam vrajeyyAH RgH-_16.4d
   ātmānukarṣi para paṃsayi bodhisattvo Rgs_21.4c	Atma-anukarzi para paMsayi boDisattvaH Rc-H-_21.4c
   ātmopapatti vividhāṃ kriyasaṃprayogāṃ Rgs_26.6c	Atma-upapatti viviDAm kriya-saMprayogAm Rc-H-_26.6c
   ādityamaṇḍalu yadā prabhajāla muñcī Rgs_5.6a	AdityamaNxalu yadA praBajAla muQcI RgH-_5.6a
   ārambaṇāna prakṛtī sa a(na)ntapārā Rgs_2.10a	ArambaNAna prakRtI sa a(na)nta-pArAH RgH-_2.10a
   ārambhavīrya bhavate vidu bodhisattvo Rgs_30.5c	AramBa-vIrya Bavate vidu boDisattvaH Rc-H-_30.5c
   ārambhavīrya vidu paṇḍitu veditavyo Rgs_30.3d	AramBa-vIrya vidu paNxitu veditavyaH RgH-_30.3d
   ārādhiteṣu iha śikṣati buddhadharmaṃ Rgs_25.2c	ArADitezu iha Sikzati budDa-Darmam Rc-H-_25.2c
   ārūpyadhātuupapatti na prārthayantī Rgs_29.6c	ArUpya-DAtuupapatti na prArTayantI Rc-H-_29.6c
   ārūpyarūpi ca samādhi catasra śreṣṭhā Rgs_29.2b	ArUpya-rUpi ca samADi catasra SrezWA Rc-H-_29.2b
   āloka śāstri imi pāramitā pradiṣṭāḥ Rgs_22.3d	Aloka SAstri imi pAramitA pradizwAH RgH-_22.3d
   āścaryamadbhutamidaṃ guṇasaṃcayānāṃ Rgs_29.3a	AScaryam-adButam-idam guNa-saMcayAnAm RgH-_29.3a
   āśvāsaprāpta bhavatī na ca tasya trāso Rgs_10.3c	ASvAsa-prApta BavatI na ca tasya trAsaH Rc-H-_10.3c
   āśvāsaprāpta bhavatī na ca tasya trāso Rgs_10.4c	ASvAsa-prApta BavatI na ca tasya trAsaH Rc-H-_10.4c
   āsannu so bhavati bodhayi bodhisattvo Rgs_1.8d	Asannu saH Bavati boDayi boDisattvaH RgH-_1.8d
   āhārakāma parikalpayamāna sattvāḥ Rgs_22.5a	AhAra-kAma parikalpa-yamAna sattvAH Rc-H-_22.5a
   itu te prasūta na ca kṣīyati dharmadhātuḥ Rgs_28.2d	itu te prasUta na ca kzIyati DarmaDAtuH RgH-_28.2d
   itu te prasūta bhaviṣyantyanāgatāśca Rgs_12.2b	itu te prasUta Bavizyanti-anAgatAH-ca Rc-H-_12.2b
   ima prajñapāramita māta tathāgatānām Rgs_27.4b	ima prajQapAramita mAta taTAgatAnAm Rc-H-_27.4b
   ima prajñapāramita mātra samanvāharanti Rgs_12.1d	ima prajQapAramita mA-atra samanvAharanti RgH-_12.1d
   imameva prajñavarapāramitāhu gṛhṇe Rgs_4.1d	imam-eva prajQavara-pAramitA-Ahu gRhNe RgH-_4.1d
   ima vidya śikṣita anuttaravaidyarājāḥ Rgs_3.5d	ima vidya SikzitaH anuttara-vEdya-rAjAH RgH-_3.5d
   imi mārakarma bhaviṣyanti ya tasmi kāle Rgs_11.8a	imi mAra-karma Bavizyanti ye tasmi kAle RgH-_11.8a
   imi śīlavānimi duśīla karoti sattvān Rgs_31.7b	imi SIla-vAnimi duSIla karoti sattvAn Rc-H-_31.7b
   imi skandha śūnya parikalpayi bodhisattvo Rgs_1.9c	imi skanDa SUnya parikalpayi boDisattvaH Rc-H-_1.9c
   imu agru sevatu vihāru hitaṃkarāṇām Rgs_27.9d	imu agru sevatu vihAru hitaMkarANAm RgH-_27.9d
   imu kṣāntyanāgami na śakyati prāpuṇetuṃ Rgs_2.4c	imu kzAnti-anAgami na Sakyati prApuNetum Rc-H-_2.4c
   imu prajña akṣayata budhyati bodhisattvo Rgs_28.7b	imu prajQa akzayata buDyati boDisattvaH Rc-H-_28.7b
   imu prajñapāramita śikṣati buddhaśikṣām Rgs_28.1d	imu prajQapAramita Sikzati budDa-SikzAm RgH-_28.1d
   iṣvastrapāramigato pṛthuśilpayukto Rgs_20.2c	izu-astra-pAramigataH pRTu-Silpa-yuktaH Rc-H-_20.2c
   iṣvastraśikṣita yathā puruṣodha kāṇḍaṃ Rgs_20.9a	izu-astra-Sikzita yaTA puruzaH-Da kANxam RgH-_20.9a
   iha vidyaśikṣita vidu spṛśiṣyanti bodhim Rgs_3.6b	iha vidya-Sikzita vidu spRSizyanti boDim Rc-H-_3.6b
   utpattito bhavati bodhiriyaṃ jinānāṃ Rgs_19.4c	utpattitaH Bavati boDiH-iyam jinAnAm Rc-H-_19.4c
   udakabindu kumbha paripūryati stokastokaṃ Rgs_19.5a	udaka-bindu kumBa paripUryati stoka-stokam RgH-_19.5a
   udayāti sūryu vigatāśca marīcimālā Rgs_23.1a	udayAti sUryu vigatAH-ca marIci-mAlAH RgH-_23.1a
   upakāribhūta imi dhyāna varāgrabodhau Rgs_29.2c	upakAri-BUtaH imi DyAna vara-agra-boDO Rc-H-_29.2c
   uparādharāya daśaddiśi yāvadasti Rgs_16.1c	uparADarAya daSat-diSi yAvat-asti Rc-H-_16.1c
   ubhayatra tulyu manu tena upāditavyo Rgs_30.11d	uBayatra tulyu manu tena upAditavyaH RgH-_30.11d
   ubhayānti asthitu na tiṣṭhati arṇavesmin Rgs_19.6d	uBayAnti asTitu na tizWati arNavesmin RgH-_19.6d
   ubhi eti ātma kariṣyanti pratijñahānim Rgs_24.4b	uBi eti Atma karizyanti pratijQa-hAnim Rc-H-_24.4b
   ubhi eti dūra bhaviṣyanti jināna jñāne Rgs_24.3d	uBi eti dUra Bavizyanti jinAna jQAne RgH-_24.3d
   ubhi eti dūri bhaviṣyanti piśācatulyā Rgs_24.4a	uBi eti dUri Bavizyanti piSAca-tulyAH RgH-_24.4a
   ubhi pāṇi chatradvaya gṛhṇa upakṣayeyyā Rgs_20.13b	uBi pANi Catra-dvaya gRhNaH upakzayeyyAH Rc-H-_20.13b
   ekasmi tatra ciya teṣa jināna puṇyaṃ Rgs_6.3c	ekasmi tatra ciya teza jinAna puNyam Rc-H-_6.3c
   ekāki so puna gṛhītva parasmi kāle Rgs_29.7c	ekAki saH puna gRhItva parasmi kAle Rc-H-_29.7c
   ekā ca sā api nidarśayi sarvadharmān Rgs_4. 5 d	ekA ca sA api nidarSayi sarva-DarmAn RgH-_4. 5 d
   ekāntatrastamanasā sa bhayābhibhūtā Rgs_29.12c	ekAnta-trasta-manasA sa Baya-aBiBUtAH Rc-H-_29.12c
   ekāntadharmaniyatāḥ sada snigdhavākyāḥ Rgs_17.3b	ekAnta-Darma-niyatAH sada snigDa-vAkyAH Rc-H-_17.3b
   ekārtha prajña ayu pāramiteti nāmā Rgs_1.27d	eka-arTa prajQa ayu pAramitA-iti nAmAH RgH-_1.27d
   ekaika roma puna tāntaka nirmiṇeyyā Rgs_27.2c	ekEka roma puna tAntaka nirmiNeyyAH Rc-H-_27.2c
   ekaiva bhāvavigatā tathatā ananyā Rgs_12.3c	ekA-eva BAva-vigatA taTatA ananyAH Rc-H-_12.3c
   etārthu bodhimadhigamya hitānukampī Rgs_15.7c	etArTu boDim-aDigamya hita-anukampI Rc-H-_15.7c
   ete 'pi dharma parikīrtita nāmamātrāḥ Rgs_18.8b	ete api Darma parikIrtita nAma-mAtrAH Rc-H-_18.8b
   emeva citta prathamaṃ tu nidāna bodheḥ Rgs_19.3c	emeva citta praTamam tu nidAna boDeH Rc-H-_19.3c
   emeva citta prathamaṃ varabodhihetur Rgs_19.5c	emeva citta praTamam vara-boDi-hetuH Rc-H-_19.5c
   emeva te guṇadharā varabodhisattvā Rgs_29.5a	emeva te guNa-DarAH vara-boDisattvAH RgH-_29.5a
   emeva dhyāna catureva samādhi śāntāṃ Rgs_29.8a	emeva DyAna catur-eva samADi SAntAm RgH-_29.8a
   emeva dhyānabalapāragu bodhisattvo Rgs_27.8c	emeva DyAna-bala-pAragu boDisattvaH Rc-H-_27.8c
   emeva pañca imi pāramitā jinānāṃ Rgs_4.7a	emeva paQca imi pAramitA jinAnAm RgH-_4.7a
   emeva prajña iha durbalu bodhisattvo Rgs_14.10a	emeva prajQaH iha durbalu boDisattvaH RgH-_14.10a
   emeva prajñacarite na kadāci bhoti Rgs_26.6a	emeva prajQacarite na kadAci Boti RgH-_26.6a
   emeva prajñacarite vidu uttamānāṃ Rgs_25.5c	emeva prajQacarite vidu uttamAnAm Rc-H-_25.5c
   emeva prajñacarito vidu bodhisattvo Rgs_23.4a	emeva prajQacaritaH vidu boDisattvaH RgH-_23.4a
   emeva prajñacarito vidu bodhisattvo Rgs_26.4c	emeva prajQacaritaH vidu boDisattvaH Rc-H-_26.4c
   emeva prajñacarito vidu bodhisattvo Rgs_26.7c	emeva prajQacaritaH vidu boDisattvaH Rc-H-_26.7c
   emeva prajñacarito vidu bodhisattvo Rgs_26.8c	emeva prajQacaritaH vidu boDisattvaH Rc-H-_26.8c
   emeva prajñavarapāramitāguṇāni Rgs_4.4a	emeva prajQavara-pAramitA-guNAni RgH-_4.4a
   emeva prajñavarapāramitā jinānāṃ Rgs_10.4a	emeva prajQavara-pAramitA jinAnAm RgH-_10.4a
   emeva prajñavarapāramitā jinānāṃ Rgs_11.9c	emeva prajQavara-pAramitA jinAnAm Rc-H-_11.9c
   emeva prajñavarapāramitāṃ caranto Rgs_20.10a	emeva prajQavara-pAramitAm carantaH RgH-_20.10a
   emeva prajñavarapāramitāṃ caranto Rgs_23.2a	emeva prajQavara-pAramitAm carantaH RgH-_23.2a
   emeva bālupagato ahu mahya eṣo Rgs_22.6c	emeva bAlupagataH ahu mahyaH ezaH Rc-H-_22.6c
   emeva buddha(piṃ) daśaddiśi lokadhātau Rgs_12.1c	emeva budDa-(piM) daSat-diSi lokaDAtO Rc-H-_12.1c
   emeva bodhivaraprasthita ratnatulyo Rgs_22.13a	emeva boDi-vara-prasTita ratna-tulyaH RgH-_22.13a
   emeva bodhivaraprasthitu bodhisattvo Rgs_29.13a	emeva boDi-vara-prasTitu boDisattvaH RgH-_29.13a
   emeva bodhivaraprasthitu veditavyo Rgs_10.6a	emeva boDi-vara-prasTitu veditavyaH RgH-_10.6a
   emeva yasmi samaye vidu bodhisattvo Rgs_20.4a	emeva yasmi samaye vidu boDisattvaH RgH-_20.4a
   emeva śūnyatapratiṣṭhitu eṣa sattvo Rgs_20.6a	emeva SUnyata-pratizWitu eza sattvaH RgH-_20.6a
   emeva śūnyata vrajitvana ratnadvīpaṃ Rgs_20.16a	emeva SUnyata vrajitvana ratnadvIpam RgH-_20.16a
   emeva śūnyatasthito vidu bodhisattvo Rgs_20.12a	emeva SUnyata-sTitaH vidu boDisattvaH RgH-_20.12a
   emeva śraddhaparibhāvitu bodhisattvo Rgs_14.8a	emeva SradDa-pariBAvitu boDisattvaH RgH-_14.8a
   emeva śraddhasaṃgato ya prasādaprāpto Rgs_14.3a	emeva SradDa-saMgataH yaH prasAda-prAptaH RgH-_14.3a
   emeva sarvajagatī pṛthu dānaskandho Rgs_31.17c	emeva sarva-jagatI pRTu dAna-skanDaH Rc-H-_31.17c
   emeva sthitva karuṇāṃ vidu bodhisattvo Rgs_20.14a	emeva sTitva karuNAm vidu boDisattvaH RgH-_20.14a
   evaṃ kṣamitva vidu paṇḍitu bodhisattvo Rgs_30.12a	evam kzamitva vidu paNxitu boDisattvaH RgH-_30.12a
   evaṃ ca puṇya pariṇāmayamāna bodhau Rgs_6.9a	evam ca puNya pariNAma-yamAna boDO RgH-_6.9a
   evaṃ ca bodhi kramate na ca līnacitto Rgs_1.20c	evam ca boDi kramate na ca lIna-cittaH Rc-H-_1.20c
   evaṃ caranta guṇasāgara vādicandrāḥ Rgs_15.4a	evam caranta guNa-sAgara vAdi-candrAH RgH-_15.4a
   evaṃ carantu anupādu vicintayitvā Rgs_1.24b	evam carantu anupAdu vicintayitvA Rc-H-_1.24b
   evaṃ carantu caratī sugatāna prajñām Rgs_19.7d	evam carantu caratI sugatAna prajQAm RgH-_19.7d
   evaṃ carantu caratī sugatāna prajñām Rgs_22.4d	evam carantu caratI sugatAna prajQAm RgH-_22.4d
   evaṃ carantu caratī sugatāna prajñāṃ Rgs_1.12a	evam carantu caratI sugatAna prajQAm RgH-_1.12a
   evaṃ carantu caratī sugatāna prajñāṃ Rgs_18.6c	evam carantu caratI sugatAna prajQAm Rc-H-_18.6c
   evaṃ carantu na ca kāṅkṣati bodhisattvo Rgs_1.28a	evam carantu na ca kAFkzati boDisattvaH RgH-_1.28a
   evaṃ carantu na ca manyati bodhisattvo Rgs_19.7a	evam carantu na ca manyati boDisattvaH RgH-_19.7a
   evaṃ carantu parivarjayi sarvasaṅgāṃ Rgs_8.4c	evam carantu parivarjayi sarva-saFgAm Rc-H-_8.4c
   evaṃ carantu vidu nā pṛthudevasaṃghāḥ Rgs_27.1a	evam carantu vidu nA pRTu-deva-saMGAH RgH-_27.1a
   evaṃ carantu vidu paṇḍitu bodhisattvo Rgs_2.7a	evam carantu vidu paNxitu boDisattvaH RgH-_2.7a
   evaṃ carantu vidu paṇḍitu bodhisattvo Rgs_9.1a	evam carantu vidu paNxitu boDisattvaH RgH-_9.1a
   evaṃ carantu vidu paṇḍitu bodhisattvo Rgs_27.6a	evam carantu vidu paNxitu boDisattvaH RgH-_27.6a
   evaṃ ca sthānu athito sthita bodhisattvo Rgs_2.3c	evam ca sTAnu aTitaH sTita boDisattvaH Rc-H-_2.3c
   evaṃ jino bhaṇati apratikūlabhāṇī Rgs_2.13a	evam jinaH BaNati apratikUla-BANI RgH-_2.13a
   evaṃ jino bhaṇati sarvaguṇāgradhārī Rgs_15.2c	evam jinaH BaNati sarva-guNa-agra-DArI Rc-H-_15.2c
   evaṃ ta mūlamapahāya ajānamāno Rgs_11.4a	evam te mUlam-apahAya ajAnamAnaH RgH-_11.4a
   evaṃ tyajitva bhavate vidu sarvatyāgī Rgs_31.14c	evam tyajitva Bavate vidu sarva-tyAgI Rc-H-_31.14c
   evaṃ vadiṣyati idaṃ tava nāmadheyam Rgs_21.2b	evam vadizyati idam tava nAmaDeyam Rc-H-_21.2b
   evaṃ śruṇitva na ca muhyati nāsti trāso Rgs_1.5c	evam SruNi-tva na ca muhyati na-asti trAsaH Rc-H-_1.5c
   evātmaśānti viharanniha bodhisattvo Rgs_1.11a	eva-Atma-SAnti viharan=-iha boDisattvaH RgH-_1.11a
   eṣā sa prajñavarapāramitāya caryā Rgs_1.12d	ezA sa prajQavara-pAramitAya caryAH RgH-_1.12d
   eṣā sa prajñavarapāramitāya caryā Rgs_1.14d	ezA sa prajQavara-pAramitAya caryAH RgH-_1.14d
   eṣā sa prajñavarapāramitāya caryā Rgs_1.23d	ezA sa prajQavara-pAramitAya caryAH RgH-_1.23d
   eṣā sa prajñavarapāramitāya caryā Rgs_1.24d	ezA sa prajQavara-pAramitAya caryAH RgH-_1.24d
   eṣā sa prajñavarapāramitāya caryā Rgs_1.26d	ezA sa prajQavara-pAramitAya caryAH RgH-_1.26d
   eṣā sa prajñavarapāramitāya caryā Rgs_1.28d	ezA sa prajQavara-pAramitAya caryAH RgH-_1.28d
   eṣā sa prajñavarapāramitāya caryā Rgs_2.1d	ezA sa prajQavara-pAramitAya caryAH RgH-_2.1d
   eṣā sa prajñavarapāramitāya caryā Rgs_2.12d	ezA sa prajQavara-pAramitAya caryAH RgH-_2.12d
   eṣā sa prajñavarapāramitāya caryā Rgs_5.2d	ezA sa prajQavara-pAramitAya caryAH RgH-_5.2d
   eṣā sa prajñavarapāramitāya caryā Rgs_9.2d	ezA sa prajQavara-pAramitAya caryAH RgH-_9.2d
   eṣā sa prajñavarapāramitāya caryā Rgs_10.10d	ezA sa prajQavara-pAramitAya caryAH RgH-_10.10d
   eṣo viveku kathito sugatātmajānām Rgs_21.5d	ezaH viveku kaTitaH sugata-AtmajAnAm RgH-_21.5d
   eṣo viveku jagadarthabhiprasthitānāṃ Rgs_21.8c	ezaH viveku jagat-arTa-BiprasTitAnAm Rc-H-_21.8c
   otāru māru na ca vindati mārapakṣo Rgs_3.1d	otAru mAru na ca vindati mAra-pakzaH RgH-_3.1d
   obhāsa ulka varabodhayi prasthitānām Rgs_22.3c	oBAsaH ulka vara-boDayi prasTitAnAm Rc-H-_22.3c
   obhāsanārtha prabha osarayanti sarve Rgs_5.9b	oBAsana-arTa praBaH osarayanti sarve Rc-H-_5.9b
   kathameṣa dīnamanaso bhavi bodhisattvo Rgs_24.1d	kaTam-eza dIna-manasaH Bavi boDisattvaH RgH-_24.1d
   karmakriyāsu tada sattva parākramanti Rgs_5.6b	karma-kriyAsu tada sattva parAkramanti Rc-H-_5.6b
   kala puṇya bhonti na sa stūpi karitva pūjām Rgs_3.4d	kala puNya Bonti na sa stUpi karitva pUjAm RgH-_3.4d
   kalapuṇya so na bhavatī iha dānaskandho Rgs_22.9c	kalapuNya saH na BavatI iha dAna-skanDaH Rc-H-_22.9c
   kalapuṇya so na bhavate iha dānaskandhe Rgs_30.9d	kalapuNya saH na Bavate iha dAna-skanDe RgH-_30.9d
   kalahāvivādavigatā dṛḍhamaitracittā Rgs_17.6c	kalaha-avivAda-vigatAH dRXa-mEtra-cittAH Rc-H-_17.6c
   kalahāvivādupagatā yada bodhisattvā Rgs_24.3a	kalaha-avivAt-upagatA yada boDisattvAH RgH-_24.3a
   kalpāna koṭinayutāṃ bahu bhāṣamāṇo Rgs_18.7c	kalpAna kowina-yutAm bahu BAzamANaH Rc-H-_18.7c
   kalpāṃstriyadhvaparikalpa tato 'pi bhūyaḥ Rgs_3.3d	kalpAn=-triyaDva-parikalpa tatas api BUyas RgH-_3.3d
   kalyāṇamitra imi pāramitā nidiṣṭāḥ Rgs_22.2b	kalyANa-mitraH imi pAramitAH nidizwAH Rc-H-_22.2b
   kalyāṇamitraparipācita yaścaturthaḥ Rgs_2.6d	kalyANa-mitra-paripAcita yaH-caturTaH RgH-_2.6d
   kalyāṇamitra bhajitavya atandritena Rgs_22.1d	kalyANa-mitra BajitavyaH atandritena RgH-_22.1d
   kalyāṇamitramupaniśrita buddhadharmāḥ Rgs_15.2d	kalyANa-mitram-upaniSrita budDa-DarmAH RgH-_15.2d
   kalyāṇamitra sada sevayitavya vijñaiḥ Rgs_15.1d	kalyANa-mitra sada sevayitavya vijQEH RgH-_15.1d
   kalyāṇamitrasahitasya vipaśyakasya Rgs_1.15a	kalyANa-mitra-sahitasya vipaSyakasya RgH-_1.15a
   kaśadaṇḍaśastravadhabandhanatāḍanāśca Rgs_30.14a	kaSa-daNxa-Sastra-vaDa-banDana-tAxanAH-ca Rc-H-_30.14a
   kasmātkuto va imi śūnyaka sarva dharmāḥ Rgs_1.8b	kasmAt-kutas vaH imi SUnyaka sarva DarmAH Rc-H-_1.8b
   kasmārtha dharmaprakṛtiṃ parijānayitvā Rgs_1.11d	kasmArTa Darma-prakRtim parijAnayitvA RgH-_1.11d
   kasmā hu adya na kṣameya nidāna bodhau Rgs_30.13d	kasmE hu adya na kzameya nidAna boDO RgH-_30.13d
   kāṅkṣā ca keṣaci bhaviṣyati bhāṣamāṇe Rgs_11.3a	kAFkzA ca kezaci Bavizyati BAzamANe Rc-H-_11.3a
   kāṅkṣāvilekhavimatīvigatārthayuktāḥ Rgs_15.6b	kAFkzA-vileKa-vimatI-vigata-arTa-yuktAH Rc-H-_15.6b
   kācasya vā maṇina rāśi siyā mahanto Rgs_31.17a	kAcasya vA maNinaH rASi siyAH mahantaH RgH-_31.17a
   kāṇḍena gādha yatha sāgari eṣamāṇo Rgs_18.1c	kANxena gADa yaTa sAgari ezamANaH Rc-H-_18.1c
   kāntāramārgi durabhikṣi savyādhi lokāṃ Rgs_19.8a	kAntAra-mArgi duraBikzi sa-vyADi lokAm RgH-_19.8a
   kāntāramārgi puruṣo bahu(bhī)janehi Rgs_10.3a	kAntAra-mArgi puruzaH bahu(BI)-jana-ihi Rc-H-_10.3a
   kāntāramārgi pratipadya bahūamitro Rgs_20.3b	kAntAra-mArgi pratipadya bahUa-mitraH Rc-H-_20.3b
   kāmārtha vāṇiju yathā gami jānanāya Rgs_20.17b	kAma-arTa vANiju yaTA gami jAnanAya Rc-H-_20.17b
   kāruṇyāhitacetasā bhagavatā buddhena saṃdīpitam Rgs_HPr_1b	kAruNya-ahita-cetasA BagavatA budDena saMdIpitam Rc-H-_HPr_1b
   kāle 'smin bahudṛṣṭisaṃkulakalau pāṭhe 'pi dūraṃ gate Rgs_HPr_2a	kAle asmin bahu-dRzwi-saMkula-kalO pAWe api dUram gate Rc-H-_HPr_2a
   kiṃ kāraṇaṃ ayu pravucyati bodhiyāno Rgs_1.21a	kim kAraNam ayu pravucyati boDiyAnaH RgH-_1.21a
   kiṃ kāraṇaṃ ayu pravucyati bodhisattvo Rgs_1.16a	kim kAraNam ayu pravucyati boDisattvaH RgH-_1.16a
   kiṃ kāraṇaṃ ta iha śikṣita vādiśreṣṭhā Rgs_5.4a	kim kAraNam te iha SikzitaH vAdi-SrezWAH RgH-_5.4a
   kiṃ kāraṇaṃ tatu guṇāgamu paṇḍitānāṃ Rgs_15.2a	kim kAraNam tatu guNa-Agamu paNxitAnAm RgH-_15.2a
   kiṃ kāraṇaṃ na mi śarīri agauravatvaṃ Rgs_4.2a	kim kAraNam na mi SarIri agOrava-tvam RgH-_4.2a
   kiṃ kāraṇaṃ ya jina bhāṣati dharmanetrīṃ Rgs_1.4a	kim kAraNam yaH jina BAzati DarmanetrIm RgH-_1.4a
   kiṃcāpi utthitu svayaṃ na prabhoti gantum Rgs_14.9b	kiMca-api utTitu svayam na praBoti gantum Rc-H-_14.9b
   kiṃcāpi tatra sukha jīvati sārthavāho Rgs_20.15c	kiMca-api tatra suKa jIvati sArTavAhaH Rc-H-_20.15c
   kiṃcāpi nirvṛti spṛśedabhinandamāno Rgs_20.16c	kiMca-api nirvRti spRSet-aBinandamAnaH Rc-H-_20.16c
   kiṃcāpi prasthihati bhajyati antareṇa Rgs_14.10b	kiMca-api prasTihati Bajyati antareNa Rc-H-_14.10b
   kiṃcāpi rūpamapi śabda tathaiva gandho Rgs_29.10a	kiMca-api rUpam-api Sabda taTA-eva ganDaH Rc-H-_29.10a
   kiṃcāpi śraddhabahulo siya bodhisattvo Rgs_14.6a	kiMca-api SradDa-bahulaH siya boDisattvaH RgH-_14.6a
   kiṃ vā svapuṇyasamudāgamu kiṃci tasya Rgs_18.2d	kim vA sva-puNya-samudAgamu kiMci tasya RgH-_18.2d
   kuta jñānaprasravu bhavediha sarvaloke Rgs_5.8b	kuta jQAna-prasravu Bavet-iha sarva-loke Rc-H-_5.8b
   kuta nadyaprasravu bhavediha jambudvīpe Rgs_5.7b	kuta nadya-prasravu Bavet-iha jambudvIpe Rc-H-_5.7b
   kuta śakrabrahmaphala śrāvakaprādubhāvaḥ Rgs_5.5d	kuta Sakra-brahma-Pala SrAvaka-prAduBAvaH RgH-_5.5d
   kuta śākhapatraphalapuṣpaupādu tatra Rgs_5.5b	kuta SAKa-patra-Pala-puzpa-OpAdu tatra Rc-H-_5.5b
   kutu tyāgabuddhi bhaviṣyati sā muhānām Rgs_31.11b	kutu tyAga-budDi Bavizyati sA muhAnAm Rc-H-_31.11b
   kūpaṃ vādigajendrakumbhadaraṇe bhadreṇa yā śodhitā Rgs_HPr_2c	kUpam vAdi-gaja-indra-kumBa-daraNe BadreNa yA SoDitA Rc-H-_HPr_2c
   kṛtaañjalīpuṭa praṇamya namasyayanti Rgs_27.1b	kRta-aQjalI-puwa praNamya namasyayanti Rc-H-_27.1b
   ko bhāṣate ka śṛṇute kutu kasya kena Rgs_30.8c	kaH BAzate kaH SRNute kutu kasya kena Rc-H-_30.8c
   kausīdyaprāpta bhavatī sthitu ātmasaṃjñaiḥ Rgs_30.6c	kOsIdI-a-prApta BavatI sTitu Atma-saMjQEH Rc-H-_30.6c
   kausīdyaprāpta bhavate tada bodhisattvo Rgs_30.4d	kOsIdya-prApta Bavate tada boDisattvaH RgH-_30.4d
   kyantantarāyu bhaviṣyanti guṇe ratānām Rgs_11.1b	kyantantara-Ayu Bavizyanti guNe ratAnAm Rc-H-_11.1b
   kleśāpanīta upapatti nidarśayanti Rgs_8.2b	kleSa-apanItaH upapatti nidarSayanti Rc-H-_8.2b
   kṣaṇamātra bhasma nayatī vilayaṃ sumerum Rgs_30.5b	kzaNa-mA-atra Basma nayatI vilayam sumerum Rc-H-_30.5b
   'kṣato 'nupāhatu spṛśāti jināna bodhim Rgs_14.8d	akzataH anupAhatu spRSAti jinAna boDim RgH-_14.8d
   kṣamamāṇu eva puna citta upāditavyo Rgs_30.13a	kzamamANu eva puna cittaH upAditavyaH RgH-_30.13a
   kṣāntīya pāramita tiṣṭhati bodhisattvo Rgs_30.14d	kzAntIya pAramita tizWati boDisattvaH RgH-_30.14d
   kṣāntīya pāramita bodhi spṛśanti buddhāḥ Rgs_24.6b	kzAntIya pAramita boDi spRSanti budDAH Rc-H-_24.6b
   kṣāntīya rupa labhate paramaṃ udāraṃ Rgs_32.2c	kzAntIya rupa laBate paramam udAram Rc-H-_32.2c
   kṣāntīsthitasya pariśudhyati ātmabhāvo Rgs_30.10a	kzAntI-sTitasya pariSuDyati Atma-BAvaH RgH-_30.10a
   kṣepitva anya puna kāṇḍa paraspareṇa Rgs_20.9b	kzepitva anyaH puna kANxa paraspareNa Rc-H-_20.9b
   kṣemeṇa gatva puna gehamupāgameyyā Rgs_20.3d	kzemeNa gatva puna geham-upAgameyyAH RgH-_20.3d
   khagu kālahīna druma mantrabalādhiṣṭhāno Rgs_27.5d	Kagu kAla-hIna druma mantra-bala-aDizWAnaH RgH-_27.5d
   gagane sthito yamaka kurvati prātihāryāṃ Rgs_20.11b	gagane sTitaH yamaka kurvati prAtihAryAm Rc-H-_20.11b
   gaticaṃkramaṃ śayaniṣadya nidarśayāti Rgs_20.11c	gati-caMkramam Sayanizadya nidarSa-yAti Rc-H-_20.11c
   gati buddhi dvīpa pariṇāyaka arthakāmāḥ Rgs_15.4c	gati budDi dvIpa pariNAyaka arTa-kAmAH Rc-H-_15.4c
   gatvā sthānamaharniśaṃ nijamalaṃ dhmāyantu ye 'bhyāgatāḥ Rgs_HPr_1d	gatvA sTAnam-aharniSam nija-malam DmAyantu ye aByAgatAH Rc-H-_HPr_1d
   gamayanti dharma nikhilāniha śūnyatāyām Rgs_5.4b	gamayanti Darma niKilAn-iha SUnyatAyAm Rc-H-_5.4b
   gambhīra dharma ayu durdṛśu nāyakānāṃ Rgs_15.7a	gamBIra Darma ayu durdRSu nAyakAnAm RgH-_15.7a
   gambhīradharmaparidīpana no karoti Rgs_20.21b	gamBIra-Darma-paridIpana no karoti Rc-H-_20.21b
   gambhīrayānaparamārthanirupalepān Rgs_18.2b	gamBIra-yAna-parama-arTa-nirupalepAn Rc-H-_18.2b
   gambhīra rupa api vedana cetanā ca Rgs_18.1a	gamBIra rupa api vedana cetanA ca RgH-_18.1a
   gāthābhedamanekapustakagataṃ dṛṣṭvādhunā nyāyataḥ Rgs_HPr_2b	gATA-Bedam-aneka-pustaka-gatam dRzwvA-aDunA nyAyataH Rc-H-_HPr_2b
   guṇavarṇamālaparikīrtana kurvayanti Rgs_27.1d	guNa-varNa-mAla-parikIrtana kurvayanti RgH-_27.1d
   guruāśayena varabodhi gaveṣamāṇaḥ Rgs_22.1b	guruASayena vara-boDi gavezamANaH Rc-H-_22.1b
   gṛhibhūta nitya anadhyoṣita sarva vastuṃ Rgs_17.5b	gRhiBUta nitya anaDyozita sarva vastum Rc-H-_17.5b
   gṛhṇitva geha praviśitva na bhoti lubdho Rgs_29.7d	gRhNitva geha praviSitva na Boti lubDaH RgH-_29.7d
   gopāla sīma vanasaṃpada paśyate yo Rgs_10.3b	gopAla sIma vana-saMpada paSyate yaH Rc-H-_10.3b
   grāmānti yo viharate athavā araṇye Rgs_21.8a	grAmAnti yaH viharate aTavA araNye Rc-H-_21.8a
   grāme ca rāṣṭri nigame viharanti nityaṃ Rgs_21.5a	grAme ca rAzwri nigame viharanti nityam RgH-_21.5a
   ghaṭake apakvi yatha vāri vaheya kācit Rgs_14.5a	Gawake apakvi yaTa vAri vaheya kAcid RgH-_14.5a
   catukāraṇehi balavāṃ vidu bodhisattvo Rgs_27.3a	catu-kAraNa-ihi balavAm vidu boDisattvaH RgH-_27.3a
   catudhyānadhyāyi na ca niśrita tatra dhyāne Rgs_17.4d	catuDyAna-DyAyi na ca niSrita tatra DyAne RgH-_17.4d
   caturo sa māra atikramya dvaye ca bhūmim Rgs_20.4c	caturaH sa mAra atikramya dvaye ca BUmim Rc-H-_20.4c
   caturbhī ca dhyāna viharanti mahānubhāvā Rgs_29.1a	caturBI ca DyAna viharanti mahA-anuBAvAH RgH-_29.1a
   catvāri dvīpi samalaṃkṛtu kheṭatulyaṃ Rgs_31.12c	catvAri dvIpi samalaMkRtu Kewa-tulyam Rc-H-_31.12c
   catvāri pudgala ime na trasanti ye 'smin Rgs_2.6a	catvAri pudgalaH ime na trasanti ye asmin RgH-_2.6a
   candro va tatra prabhamaṇḍalu śuklapakṣe Rgs_31.18d	candraH va tatra praBamaNxalu Sukla-pakze RgH-_31.18d
   caraṇaṃ ca so 'caraṇaṃ ca prajānayitvā Rgs_1.12c	caraNam ca saH acaraNam ca prajAnayitvA Rc-H-_1.12c
   caratī imāṃ pravara śūnya samādhi śāntām Rgs_20.7b	caratI imAm pravara SUnya samADi SAntAm Rc-H-_20.7b
   caratīti so na upagacchati prajñadhārī Rgs_1.10c	carati-iti saH naH upagacCati prajQa-DArI Rc-H-_1.10c
   caratī nimittaanupādapade asakto Rgs_1.9d	caratI nimittaanupAdapade asaktaH RgH-_1.9d
   caramāṇa prajña katha yujyati bodhisattvo Rgs_10.1b	caramANa prajQa kaTa yujyati boDisattvaH Rc-H-_10.1b
   caramāṇu puṇyu parigṛhṇati aprameyam Rgs_18.6d	caramANu puNyu parigRhNati aprameyam RgH-_18.6d
   caramāṇu prajñavarapāramitāya yogī Rgs_10.9a	caramANu prajQavara-pAramitAya yogI Rc-H-_10.9a
   caramāṇu prajñavarapāramitāya yogī Rgs_22.10a	caramANu prajQavara-pAramitAya yogI Rc-H-_22.10a
   caramāṇu pratyayarahatvaspṛhāṃ janeti Rgs_31.5b	caramANu pratyaya-raha-tva-spRhAm jana-iti Rc-H-_31.5b
   caramāṇu yo na iha kalpayi buddhadharmāṃ Rgs_10.10a	caramANu yaH naH iha kalpayi budDa-DarmAm RgH-_10.10a
   cittaṃ anitya pariṇāmayi bodhisattvo Rgs_5.1b	cittam anitya pariNAmayi boDisattvaH Rc-H-_5.1b
   cittaṃ pradūṣayi vivādu samārabheyyā Rgs_24.5b	cittam pradUzayi vivAdu samAraBeyyAH Rc-H-_24.5b
   ciraduḥkha bheṣyati samācaramāṇu dharmaṃ Rgs_30.2c	cira-duHKa Bezyati samAcaramANu Darmam Rc-H-_30.2c
   cirabuddhadevamanujān triapāyi sattvān Rgs_22.11a	cira-budDa-deva-manujAn triapAyi sattvAn RgH-_22.11a
   cirayānaprasthitu sa vedayitavya sattvo Rgs_10.2a	cira-yAna-prasTitu sa vedayitavya sattvaH RgH-_10.2a
   cirasaṃjña bodhi samudāniya tena duḥkhe Rgs_30.2b	cira-saMjQa boDi samudAniya tena duHKe Rc-H-_30.2b
   choritva dharma kariṣyanti adharmakāryaṃ Rgs_11.6c	Coritva Darma karizyanti aDarma-kAryam Rc-H-_11.6c
   jagati kriyāṃ vividha darśayate vicitrām Rgs_20.6b	jagati kriyAm viviDa darSayate vicitrAm Rc-H-_20.6b
   jaravyādhimṛtyuvigatāścyuti darśayanti Rgs_8.2c	jara-vyADi-mRtyu-vigatAH-cyuti darSayanti Rc-H-_8.2c
   jātījarāmaraṇaśokataraṃgabhaṅge Rgs_14.3d	jAtI-jarA-maraNa-Soka-taraMga-BaFge RgH-_14.3d
   jātyandhakoṭiniyutānyaviunāyakānāṃ Rgs_7.1a	jAti-anDa-kowi-niyuta-ani-a-viu-nAyakAnAm RgH-_7.1a
   jānitva bhrāntu jagatī mṛgavāgureva Rgs_8.3c	jAnitva BrAntu jagatI mRgavAguH-eva Rc-H-_8.3c
   jinadhātu sarvi paripūrita cūḍibaddhā Rgs_4.1c	jinaDAtu sarvi paripUrita cUxibadDA Rc-H-_4.1c
   jinaputra satyakuśalo avivartiyaśca Rgs_2.6b	jinaputra satya-kuSalaH avivartiyaH-ca Rc-H-_2.6b
   jihvādoṣaiḥ pavanacaritaiḥ śleṣmadoṣapracārair Rgs_LPr_1c	jihvA-dozEH pavana-caritEH Slezma-doza-pracArEH Rc-H-_LPr_1c
   jñātavya manyanasthito ayu alpabuddhiḥ Rgs_21.1d	jQAtavya manyana-sTitaH ayu alpabudDiH RgH-_21.1d
   jñātavya yo vihara te sa upāyaprajño Rgs_1.28b	jQAtavyaH yaH vihara te saH upAya-prajQaH Rc-H-_1.28b
   jñātavyu kālu ayamasya prajāyanāya Rgs_10.8b	jQAta-vyu kAlu ayam-asya prajAyanAya Rc-H-_10.8b
   jñātavyu kṣipra ayu bhetsyati durbalatvāt Rgs_14.5b	jQAta-vyu kzipra ayu Betsyati durbala-tvAt Rc-H-_14.5b
   jñātavyu māru paryutthitu alpabuddhiḥ Rgs_21.3d	jQAta-vyu mAru paryutTitu alpabudDiH RgH-_21.3d
   jñātavyu māru paryutthitu alpabuddhiḥ Rgs_21.4d	jQAta-vyu mAru paryutTitu alpabudDiH RgH-_21.4d
   jñātvā ca dharmaprakṛtīṃ vaśikā nirātmyaṃ Rgs_31.10a	jQAtvA ca Darma-prakRtIm vaSikAH nirAtmyam RgH-_31.10a
   jñānarddhipāramigato aniketacārī Rgs_20.12b	jQAna-RdDi-pArami-gataH aniketa-cArI Rc-H-_20.12b
   jñānasya co asati nāsti guṇāna vṛddhiḥ Rgs_5.8c	jQAnasya caH asati na-asti guNAna vRdDiH Rc-H-_5.8c
   jñānaṃ ananta labhate jinakośagañjam Rgs_32.3b	jQAnam ananta laBate jinakoSa-gaQjam Rc-H-_32.3b
   jñānena sarva kriya kurvati nirvikalpo Rgs_26.8d	jQAnena sarva kriya kurvati nirvikalpaH RgH-_26.8d
   jñānena sarvaguṇadharma samāgamanti Rgs_5.6d	jQAnena sarva-guNa-Darma samAgamanti RgH-_5.6d
   jñānopalambhu na hi skandhavibhāvanā ca Rgs_1.7b	jQAna-upalamBu na hi skanDa-viBAvanA ca Rc-H-_1.7b
   taccaita kṣīṇa pariṇāmayiṣyanti yatra Rgs_6.6b	tat-ca-eta kzINa pariNAmayizyanti yatra Rc-H-_6.6b
   tata utthito kathayi dharma nirupalepam Rgs_18.5b	tatas utTitaH kaTayi Darma nirupalepam Rc-H-_18.5b
   tatu alpamātra parikīrtayiṣyāmi tāvat Rgs_11.1d	tatu alpa-mA-atra parikIrtayizyAmi tAvat RgH-_11.1d
   tatu labdhacakṣu bhavatī imu nāmadheyam Rgs_7.2b	tatu labDa-cakzu BavatI imu nAmaDeyam Rc-H-_7.2b
   tatu vardhate kuśalamūla mahānubhāvo Rgs_31.18c	tatu varDate kuSala-mUla mahA-anuBAvaH Rc-H-_31.18c
   tatu vīryapāramitahīna kusīdarūpo Rgs_30.2d	tatu vIrya-pAramita-hIna kusIda-rUpaH RgH-_30.2d
   tattatphalaṃ na ca tadasti na cāpi nāsti Rgs_19.4b	tad-tat-Palam na ca tat-asti na ca-api na-asti Rc-H-_19.4b
   tatra sthitāna yadi bhajyati ātmabhāvo Rgs_29.3c	tatra sTitAna yadi Bajyati Atma-BAvaH Rc-H-_29.3c
   tatrābhiśikṣita nararṣabhaśiṣyabhūtāḥ Rgs_1.4b	tatra-aBiSikzita nara-RzaBa-Sizya-BUtAH Rc-H-_1.4b
   tatha jñāna śrāvakavimuktisapratyayānāṃ Rgs_20.18a	taTa jQAna SrAvaka-vimukti-sapratyayAnAm RgH-_20.18a
   tatha dharmadarśanu nidiṣṭa tathāgatena Rgs_12.9c	taTa Darma-darSanu nidizwa taTAgatena Rc-H-_12.9c
   tatha paścimottaradiśāya anantapārā Rgs_16.1b	taTa paScima-uttara-diSAya ananta-pArAH Rc-H-_16.1b
   tathapi spṛśiṣyati nacireṇa hu buddhabodhim Rgs_10.6d	taTapi spRSizyati nacireNa hu budDa-boDim RgH-_10.6d
   tatha prajñapāramitaniśraya narāṇa siṃho Rgs_12.6c	taTa prajQapAramita-niSraya narANa siMhaH Rc-H-_12.6c
   tatha prajñapāramitaniśrita dharmarājo Rgs_12.7c	taTa prajQapAramita-niSrita DarmarAjaH Rc-H-_12.7c
   tatha prajñapāramitaniśrita buddhadhātuḥ Rgs_4.2d	taTa prajQapAramita-niSrita budDaDAtuH RgH-_4.2d
   tatha prajñapāramita śrutva sūtrānta eṣet Rgs_11.4d	taTa prajQapAramite Srutva sUtrAntaH ezet RgH-_11.4d
   tatha bodhicitta asatīha tathāgatasya Rgs_5.8a	taTa boDi-citta asati-iha taTAgatasya RgH-_5.8a
   tatha bodhicitta sada lokavidusya jñāto Rgs_5.6c	taTa boDi-citta sada loka-vidusya jQAtaH Rc-H-_5.6c
   tatha bodhisattva ima pāramitāṃ labhitvā Rgs_11.5c	taTa boDisattvaH ima pAramitAm laBitvA Rc-H-_11.5c
   tatha bodhisattva caramāṇu vimokṣadvāraṃ Rgs_20.20c	taTa boDisattva caramANu vimokza-dvAram Rc-H-_20.20c
   tatha bodhisattva caramāṇu vimokṣadvāre Rgs_20.8c	taTa boDisattva caramANu vimokza-dvAre Rc-H-_20.8c
   tatha bodhisattvapariṇāmana sattvasaṃjñā Rgs_6.5b	taTa boDisattva-pariNAmana sattva-saMjQA Rc-H-_6.5b
   tatha bodhisattva śruṇamāṇu jināna prajñāṃ Rgs_10.8c	taTa boDisattva SruNam-ANu jinAna prajQAm Rc-H-_10.8c
   tathalakṣaṇā ya imi jānati sarvadharmān Rgs_22.4b	taTA-lakzaNAH ye imi jAnati sarva-DarmAn Rc-H-_22.4b
   tatha śukladharmaupalambha jinena ukto Rgs_6.7d	taTa Sukla-Darma-OpalamBa jinena uktaH RgH-_6.7d
   tatha śūnya tuccha vaśikaṃ ca asārakaṃ ca Rgs_18.6b	taTa SUnya tucCa vaSikam ca asArakam ca Rc-H-_18.6b
   tatha sarvasattvavaśatāmupayānti dhīrāḥ Rgs_29.11d	taTa sarva-sattva-vaSa-tAm-upayAnti DIrAH RgH-_29.11d
   tatha saṃghavaṃśa parigṛhṇati sarvadharmān Rgs_32.5d	taTa saMGa-vaMSa parigRhNati sarva-DarmAn RgH-_32.5d
   tatha saṃskṛtāya athito aniketacārī Rgs_2.3b	taTa saMskRtAya aTitaH aniketa-cArI Rc-H-_2.3b
   tada kāyacitta khagapakṣisatulyabhūtā Rgs_24.2c	tada kAya-citta Kaga-pakzi-sa-tulya-BUtAH Rc-H-_24.2c
   tada khaṇḍaśīlu bhavate api chidraśīlo Rgs_31.5c	tada KaNxaSIlu Bavate api Cidra-SIlaH Rc-H-_31.5c
   tadatandritena sada osaritavya prajñā Rgs_22.9d	tat-atandritena sadaH osaritavyaH prajQA RgH-_22.9d
   tada bodhisattva imi jñātva daridrasattvān Rgs_31.12a	tada boDisattvaH imi jQAtva daridra-sattvAn RgH-_31.12a
   tada bhonti sarvajagatī vidu dakṣiṇīyā Rgs_22.10c	tada Bonti sarva-jagatI vidu dakziNIyAH Rc-H-_22.10c
   tada māra tuṣṭu bhavatī paramaṃ udagro Rgs_24.3c	tada mAra tuzwu BavatI paramam udagraH Rc-H-_24.3c
   tada māru tuṣṭu bhavatī namucīsapakṣo Rgs_24.4d	tada mAru tuzwu BavatI namucI-sa-pakzaH RgH-_24.4d
   tada vyākṛto 'hu parāpuruṣottamena Rgs_2.13c	tada vyAkRtaH ahu parApuruzottamena Rc-H-_2.13c
   tasmāddhi nāma labhate ayu bodhisattvo Rgs_1.16d	tasmAt-hi nAma laBate ayu boDisattvaH RgH-_1.16d
   tasmā hu tān jinaguṇā(n) parighettukāmo Rgs_4.4c	tasmE hu tAn jina-guNA(n) pariGet-tu-kAmaH Rc-H-_4.4c
   tasmā hu nāmapariṇāmana śikṣitavyā Rgs_6.8a	tasmE hu nAma-pariNAmana SikzitavyAH RgH-_6.8a
   tasmā hu buddha kṛta nāma tathāgatebhiḥ Rgs_12.4d	tasmE hu budDa kRta nAma taTAgateBiH RgH-_12.4d
   tasmā hu mānu nihanitvana paṇḍitena Rgs_22.1a	tasmE hu mA-anu nihani-tvana paNxitena RgH-_22.1a
   tasmā hu śraddadhata eva jināna mātāṃ Rgs_7.7a	tasmE hu SraddaDataH eva jinAna mAtAm RgH-_7.7a
   tasyānubhāvaśriya sābhu jagādhipasya Rgs_1.2d	tasya-anuBAva-Sriya sABu jagADipasya RgH-_1.2d
   tasyāpi uddhṛta spṛhanti karaṇḍakasmiṃ Rgs_4.3c	tasya-api udDRta spRhanti karaNxakasmim Rc-H-_4.3c
   tasyaiva te guṇa mahāratanasya bhonti Rgs_4.3d	tasya-eva te guNa mahAratanasya Bonti RgH-_4.3d
   ta hi niśritā iha mahāpṛthivī jagacca Rgs_20.5b	te hi niSritAH iha mahA-pRTivI jagat-ca Rc-H-_20.5b
   taṃ cāgrabodhi pariṇāmayate jagārtham Rgs_31.13d	tam ca-agraboDi pariNAmayate jagArTam RgH-_31.13d
   taṃ cāpi nāmayi jagārthanidāna bodhau Rgs_18.5c	tam ca-api nAmayi jagArTa-nidAna boDO Rc-H-_18.5c
   taṃ cittupādu pariṇāmayi agrabodhau Rgs_30.12b	tam cittupAdu pariNAmayi agra-boDO Rc-H-_30.12b
   taṃ caiva puṇya puna khyāyati riktameva Rgs_18.6a	tam ca-eva puNya puna KyAyati riktam-eva Rc-H-_18.6a
   taṃ caiva śraddha parigṛhṇayamāna prajñā Rgs_14.6c	tam ca-eva SradDa parigRhNayamAna prajQA Rc-H-_14.6c
   taṃ sarvasattva itu mārgatu prāpnuvanti Rgs_32.6d	tam sarva-sattvaH itu mArgatu prApnuvanti RgH-_32.6d
   tāpeti tṛṣṇanadi dharma nidarśayāti Rgs_12.7d	tApa-iti tRzNanadi Darma nidarSayAti RgH-_12.7d
   tāpetimāṃ dharaṇi darśayate ca rūpam Rgs_12.7b	tApa-itimAm DaraNi darSayate ca rUpam Rc-H-_12.7b
   tāvanta kalpa anubudhyati bodhisattvo Rgs_18.3d	tAvanta kalpaH anubuDyati boDisattvaH RgH-_18.3d
   tāvanta kalpa puna saṃnahitavya bhonti Rgs_24.5d	tAvanta kalpa puna saMnahitavya Bonti RgH-_24.5d
   tāvanti sattva arahanti vineya kaścit Rgs_5.3b	tAvanti sattva arahanti vineya kaScid Rc-H-_5.3b
   tāvanna tāṃ paramaśūnyata prāpuṇoti Rgs_20.10c	tAvat-na tAm param-aSUnyata prApuNoti Rc-H-_20.10c
   tāṃ bālu kalpayi avidya karoti vidyām Rgs_1.13b	tAm bAlu kalpayi avidya karoti vidyAm Rc-H-_1.13b
   tāṃ bodhisattva tathatāmanubuddhayanti Rgs_12.4c	tAm boDisattva taTatAm-anubudDayanti Rc-H-_12.4c
   tāṃ vyākuruṣva jinaguṇāna pradeśamātram Rgs_17.1d	tAm vyAkuruzva jina-guNAna pradeSa-mAtram RgH-_17.1d
   tāṃ sarvasattvahita bodhayi nāmayanti Rgs_31.1d	tAm sarva-sattva-hita boDayi nAmayanti RgH-_31.1d
   tiṣṭhanti ye 'pi parinirvṛta lokanāthā Rgs_6.2c	tizWanti ye api parinirvRta lokanATAH Rc-H-_6.2c
   tiṣṭhantu lokavidunāṃ parinirvṛtānāṃ Rgs_12.4a	tizWantu loka-vidunAm parinirvRtAnAm RgH-_12.4a
   tiṣṭheya sarvajagatī yatha preṣyabhūto Rgs_29.13b	tizWeya sarva-jagatI yaTa prezya-BUtaH Rc-H-_29.13b
   tṛṇa agni kāṣṭhaprabhavo dahate tameva Rgs_29.13d	tRNa agni kAzWa-praBavaH dahate tam-eva RgH-_29.13d
   te eva dharmasamudāgata niṣprapañcā Rgs_15.6a	te eva Darma-samudAgata nizprapaQcAH RgH-_15.6a
   te cānuśāsaka iyaṃ pratipattibhūmī Rgs_22.2c	te ca-anuSAsakaH iyam pratipatti-BUmI Rc-H-_22.2c
   te durlabhā bahupratyarthika nityakālam Rgs_11.9b	te durlaBAH bahu-pratyarTika nityakAlam Rc-H-_11.9b
   te dharmabhāṇaka viditvana kāryayuktaṃ Rgs_11.7c	te Darma-BANaka viditvana kArya-yuktam Rc-H-_11.7c
   tenaiva sapta ratanā balakāya sarve Rgs_3.8b	tena-eva sapta ratanA balakAya sarve Rc-H-_3.8b
   tenaiva sarvaguṇadharma samāgamanti Rgs_3.8d	tena-eva sarva-guNa-Darma samAgamanti RgH-_3.8d
   te pāraprāpta sthita pāramite hu bhonti Rgs_2.11d	te pAra-prApta sTita pAramite hu Bonti RgH-_2.11d
   te puṇyajñānadhanasaṃbhṛtayānapātrāḥ Rgs_14.4c	te puNya-jQAna-Dana-saMBRta-yAna-pAtrAH Rc-H-_14.4c
   te śiṣya māṃ janata so ca karoti kāryam Rgs_26.5b	te Sizya mAm janata saH ca karoti kAryam Rc-H-_26.5b
   teṣāṃ sa puṇyakriyavastvanumodayitvā Rgs_31.16b	tezAm sa puNya-kriyavaH-tu-anumodayitvA Rc-H-_31.16b
   te sarvi dāna dadayanti anantakalpān Rgs_31.15b	te sarvi dAna dadayanti ananta-kalpAn Rc-H-_31.15b
   te sarvi durmanasa tatra prayujyayeyuḥ Rgs_12.1b	te sarvi durmanasa tatra prayujyayeyuH Rc-H-_12.1b
   te sarvi pūjana kareyuranantakalpān Rgs_3.3b	te sarvi pUjana kareyuH-ananta-kalpAn Rc-H-_3.3b
   te sarvi bodhivaracitta upādayitvā Rgs_22.8b	te sarvi boDi-vara-cittaH upAdayitvA Rc-H-_22.8b
   tehi prapūrṇa siya kṣetrasahasrakoṭyo Rgs_3.2c	tehi prapUrNa siya kzetra-sahasra-kowyaH Rc-H-_3.2c
   tehī suśiṣyagurugauravasaṃprayukto Rgs_15.1c	tehI su-Sizya-guru-gOrava-saMprayuktaH Rc-H-_15.1c
   tailasya varti jvalitā prathame nipāte Rgs_19.1a	tElasya varti jvalitA praTame nipAte RgH-_19.1a
   trāṇā bhavanti jagatī śaraṇā ca lenā Rgs_15.4b	trANAH Bavanti jagatI SaraNA ca lenAH Rc-H-_15.4b
   trāso na bheṣyati śruṇitva jināna mātrām Rgs_1.15b	trAsaH na Bezyati SruNitva jinAna mAtrAm Rc-H-_1.15b
   triapāyaprāptu supinasmi viditva sattvān Rgs_20.23a	triapAya-prAptu supinasmi viditva sattvAn RgH-_20.23a
   tribhi yānasaṃjñavigatā aparigṛhītā Rgs_15.5c	triBi yAna-saMjQa-vigatAH aparigRhItAH Rc-H-_15.5c
   triyapāyavarjita vidū sadakāli bhonti Rgs_17.2c	triyapAya-varjita vidU sat-akAli Bonti Rc-H-_17.2c
   trisahasra meru tulayitva siyāpramāṇo Rgs_26.1c	tri-sahasra meru tulayitva siyA-pramANaH Rc-H-_26.1c
   traidhātukaṃ na spṛśate supināntare 'pi Rgs_20.22b	trEDAtukam na spRSate su-pina-antare api Rc-H-_20.22b
   traidhātukaṃ samatikrānta na bodhisattvā Rgs_8.2a	trEDAtukam samatikrAnta na boDisattvAH RgH-_8.2a
   traidhātukānta samatikramate apāyān Rgs_32.4b	trEDAtukAnta samatikramate apAyAn Rc-H-_32.4b
   dakamadhyi matsya viharāti na co marāti Rgs_27.8b	daka-maDyi matsya viharAti na caH marAti Rc-H-_27.8b
   dattvā udagra bhavate na hi dvīpalabdho Rgs_31.12d	dattvA udagra Bavate na hi dvIpa-labDaH RgH-_31.12d
   darśeti māyasadṛśo na vikalpacārī Rgs_26.6d	darSa-iti mAya-sadRSaH na vikalpa-cArI RgH-_26.6d
   darśeti sarva kriya nirmitamāyatulyam Rgs_26.7d	darSa-iti sarva kriya nirmita-mAya-tulyam RgH-_26.7d
   daśabhiśca te kuśalakarmapathebhi yuktā Rgs_17.2d	daSaBiH-ca te kuSala-karma-paTeBi yuktAH RgH-_17.2d
   dānaṃ ca śīlamapi kṣānti tathaiva vīryaṃ Rgs_15.3a	dAnam ca SIlam-api kzAnti taTA-eva vIryam RgH-_15.3a
   dānaṃ ca śīlamapi bhāvanasaṃprayuktam Rgs_6.1b	dAnam ca SIlam-api BAvana-saMprayuktam Rc-H-_6.1b
   dānaṃ daditva bahuvarṣasahasrakoṭīḥ Rgs_22.8c	dAnam daditva bahu-varza-sahasra-kowIH Rc-H-_22.8c
   dānaṃ daditva vidu paṇḍitu bodhisattvo Rgs_31.13a	dAnam daditva vidu paNxitu boDisattvaH RgH-_31.13a
   dānaṃ dadeyu vimalaṃ tatha śīla rakṣe Rgs_18.4b	dAnam dadeyu vimalam taTa SIla rakze Rc-H-_18.4b
   dānādhimukta bhavatī sada muktatyāgī Rgs_31.12b	dAna-aDimukta BavatI sada mukta-tyAgI Rc-H-_31.12b
   dānena pretagati chindati bodhisattvo Rgs_32.1a	dAnena preta-gati Cindati boDisattvaH RgH-_32.1a
   dānena sattva paripācayi kṛcchraprāptān Rgs_32.1d	dAnena sattva paripAcayi kRcCra-prAptAn RgH-_32.1d
   dāridrakaṃ ca chinatī tatha sarvakleśān Rgs_32.1b	dAridrakam ca CinatI taTa sarva-kleSAn Rc-H-_32.1b
   dāsyanti dharma jagatī dukhasaṃkṣayāye Rgs_26.2d	dAsyanti Darma jagatI duKa-saMkzayAye RgH-_26.2d
   divarātri prajñavarapāramitārthadarśī] Rgs_24.2b	diva-rAtri prajQavara-pAramitA-arTa-darSI] Rc-H-_24.2b
   divasaṃ pi antamaśa ekanuvartayeyā Rgs_22.9b	divasam pi antam-aSas ekanuvartayeyAH Rc-H-_22.9b
   divi devauttamapurā anuprāpuṇeyā Rgs_29.4b	divi deva-OttamapurA anuprApuNeyAH RgH-_29.4b
   divyehi puṣpavaragandhavilepanehi Rgs_3.3c	divyehi puzpa-vara-ganDa-vilepana-Ihi Rc-H-_3.3c
   diśadāha ulka kṣipate bhayadarśanārthaṃ Rgs_24.1c	diSat-Aha ulka kzipate Baya-darSana-arTam Rc-H-_24.1c
   dukhadharmaśokaśamanī pṛthusattvadhātoḥ Rgs_3.5b	duKa-Darma-Soka-SamanI pRTu-sattva-DAtoH Rc-H-_3.5b
   dukhitāṃśca sattva triapāya samuddharanti Rgs_12.5c	duKitAn=-ca sattva triapAya samudDaranti Rc-H-_12.5c
   durlābhu dharmaratanaṃ baddupadravaṃ ca Rgs_11.9d	durlABu Darma-ratanam badt-upadravam ca RgH-_11.9d
   duvi kāraṇena anubudhyati buddhabodhim Rgs_22.2d	duvi kAraNena anubuDyati budDa-boDim RgH-_22.2d
   duṣṭāna kṣāntivikalāna kuto 'sti bodhi Rgs_24.4c	duzwAna kzAnti-vikalAna kutas asti boDi Rc-H-_24.4c
   duḥśīlatā ayu prakāśitu nāyakena Rgs_31.3d	duHSIla-tA ayu prakASitu nAyakena RgH-_31.3d
   [duḥśīla bhoti]viduṣāṃ tatha chidracārī Rgs_31.2b	[duH-SIla Boti]-viduzAm taTa Cidra-cArI Rc-H-_31.2b
   dṛṣṭīgatāṃ mahati chindati sattvadhātoḥ Rgs_1.17c	dRzwI-gatAm mahati Cindati sattva-DAtoH Rc-H-_1.17c
   deśanti dharmaratanaṃ dukhasaṃkṣayāya Rgs_6.2d	deSanti Darma-ratanam duKa-saMkzayAya RgH-_6.2d
   deśeti dharma jagatī dukhasaṃkṣayāye Rgs_32.4d	deSa-iti Darma jagatI duKa-saMkzayAye RgH-_32.4d
   dvayayānacittavigato niyato 'grabodhim Rgs_21.8b	dvaya-yAna-citta-vigataH niyataH agra-boDim Rc-H-_21.8b
   dvātriṃśalakṣaṇaprabhāva anantapāro Rgs_30.10b	dvAtriMSa-lakzaNa-praBAva ananta-pAraH Rc-H-_30.10b
   dvitīyo 'pi] agni sakale śirasi kṣipeyā Rgs_30.11c	dvitIyaH api] agni sakale Sirasi kzipeyAH Rc-H-_30.11c
   dharmaṃ nirāmiṣu jagasyanuśāsayanti Rgs_17.3a	Darmam nirAmizu jagasi-anuSAsayanti RgH-_17.3a
   dharmaṃ bhaṇeya kala puṇya na dānaśīle Rgs_18.4d	Darmam BaNeya kala puNya na dAna-SIle RgH-_18.4d
   dharmā adharma imu paśyati dharmadhātuṃ Rgs_10.9c	DarmAH aDarmaH imu paSyati DarmaDAtum Rc-H-_10.9c
   dharmārtha jīvita tyajanti prayuktayogā Rgs_17.7c	Darma-arTa jIvita tyajanti prayukta-yogAH Rc-H-_17.7c
   dharmo anālayu anāgrahu prāpitavyo Rgs_15.8c	DarmaH anAlayu anAgrahu prApitavyaH Rc-H-_15.8c
   dhāreyi satkarayi puṣpavilepanehi Rgs_3.4c	DAreyi satkarayi puzpa-vilepana-Ihi Rc-H-_3.4c
   dhutavṛtta yādṛśu sa bheṣyati yuktayogī Rgs_21.3a	Duta-vRtta yAdRSu sa Bezyati yukta-yogI Rc-H-_21.3a
   dhyānāni prajña pariṇāmayitavya bodhau Rgs_15.3b	DyAnAni prajQa pariNAmayitavya boDO Rc-H-_15.3b
   dhyānena kāmaguṇa utsṛjate jugupsyān Rgs_32.3c	DyAnena kAma-guNaH utsRjate jugupsyAn Rc-H-_32.3c
   dhyāne samādhi viharanti nimitta nāsti Rgs_29.3b	DyAne samADi viharanti nimitta na-asti Rc-H-_29.3b
   dhyāne samādhi viharitva prayuktayogī Rgs_29.5b	DyAne samADi viharitva prayukta-yogI Rc-H-_29.5b
   dhyāne sthito 'tra bhavatī varaprajñalābhī Rgs_29.2a	DyAne sTitaH atra BavatI vara-prajQa-lABI RgH-_29.2a
   na kalā pi jyotikagaṇe siya sarvaābhāḥ Rgs_5.9d	na kalA pi jyotika-gaNe siya sarvaA-ABAH RgH-_5.9d
   na ca anya te śramaṇa brāhmaṇa āśrayanti Rgs_17.2b	na ca anye te SramaNa brAhmaNaH ASrayanti Rc-H-_17.2b
   na ca ādiśanti puruṣaiḥ striya icchakarmāṃ Rgs_17.6a	na ca AdiSanti puruzEH striyaH icCa-karmAm RgH-_17.6a
   na ca ānimittasthitu śānta praśāntacārī Rgs_20.7d	na ca Animitta-sTitu SAnta praSAnta-cArI RgH-_20.7d
   na ca ālayo na pi ca niśrayu kurvayāti Rgs_29.1b	na ca AlayaH na pi ca niSrayu kurvayAti Rc-H-_29.1b
   na ca eti prajña iti teṣa na asti prajñā Rgs_2.9c	na ca eti prajQaH iti teza na asti prajQA Rc-H-_2.9c
   na ca eṣa prajñavarapāramitāya caryā Rgs_1.25d	na ca eza prajQavara-pAramitAya caryAH RgH-_1.25d
   na ca eṣa prajñavarapāramitāya caryā Rgs_7.4d	na ca eza prajQavara-pAramitAya caryAH RgH-_7.4d
   na ca kāṅkṣate ayu prayujyati śikṣamāṇaḥ Rgs_10.2d	na ca kAFkzate ayu prayujyati SikzamANaH RgH-_10.2d
   na ca kīrtikāma na ca krodhaparītacittā Rgs_17.5a	na ca kIrti-kAma na ca kroDa-parIta-cittAH Rc-H-_17.5a
   na ca kenacīdadhigato na ca prāpuṇanti Rgs_15.7b	na ca kenacId-aDigataH na ca prApuNanti Rc-H-_15.7b
   na ca kṣīyate na ca vivardhati jātu prajñā Rgs_28.4d	na ca kzIyate na ca vivarDati jAtu prajQA RgH-_28.4d
   na ca kṣīyate na ca vivardhati dharmadhātuḥ Rgs_18.7d	na ca kzIyate na ca vivarDati DarmaDAtuH RgH-_18.7d
   na ca khidyatī na parihāyati nirvikalpā Rgs_28.3d	na ca KidyatI na parihAyati nirvikalpAH RgH-_28.3d
   na ca khedabuddhi aṇumātra upādiyāti Rgs_30.1c	na ca Keda-budDi aNu-mAtre upAdiyAti Rc-H-_30.1c
   na ca geha mārgi kuśalo puna bhoti vijño Rgs_20.17d	na ca geha mArgi kuSalaH puna Boti vijQaH RgH-_20.17d
   na ca citta paścima śivāmanuprāpuṇāti Rgs_19.2c	na ca citta paScima SivAm-anuprApuNAti Rc-H-_19.2c
   na ca jāti bhūmi parikīrtitu nāpi gotraṃ Rgs_11.3c	na ca jAti BUmi parikIrtitu na-api gotram Rc-H-_11.3c
   na ca jīvikāviṣayabhoga gaveṣayanti Rgs_17.5c	na ca jIvikA-vizaya-Boga gavezayanti Rc-H-_17.5c
   na ca tasya kāyu na pi citta na nāmadheyam Rgs_26.5d	na ca tasya kAyu na pi citta na nAmaDeyam RgH-_26.5d
   na ca tasyupadyati mado karamāṇu kiṃcit Rgs_26.7b	na ca tasyupadyati madaH karamANu kiMcid Rc-H-_26.7b
   na ca tāva puṇyu labhate akaritva cakṣuḥ Rgs_7.2d	na ca tAva puNyu laBate akaritva cakzuH RgH-_7.2d
   na ca tena manyati na ātmana karṣayethā Rgs_31.6b	na ca tena manyati naH Atmana karzayeTAH Rc-H-_31.6b
   na ca tena manyanupapadyati nāpi mānam Rgs_20.24c	na ca tena manyanupapadyati na-api mAnam Rc-H-_20.24c
   na ca trāsu bodhi bhavate na ihāsti kiṃcid Rgs_19.7c	na ca trAsu boDi Bavate naH iha-asti kiMcid Rc-H-_19.7c
   na ca dagdha varti asatā na vinā ya dagdhā Rgs_19.1b	na ca dagDa varti asatA na vinA yaH dagDAH Rc-H-_19.1b
   na ca deśikaṃ na pi ca paśyaka dharmatāyāṃ Rgs_27.6c	na ca deSikam na pi ca paSyaka Darma-tAyAm Rc-H-_27.6c
   na ca dharma dharmi pariṇāmayate kadācit Rgs_6.6c	na ca Darma Darmi pariNAmayate kadAcid Rc-H-_6.6c
   na ca dharmadhātutathatāya upaiti sthānaṃ Rgs_27.5a	na ca DarmaDAtu-taTa-tAya upEti sTAnam RgH-_27.5a
   na ca nirvṛtiṃ spṛśati no ca nimittacārī Rgs_19.6b	na ca nirvRtim spRSati no ca nimitta-cArI Rc-H-_19.6b
   na ca nirvṛtiṃ spṛśati no ca nimittacārī Rgs_20.8d	na ca nirvRtim spRSati no ca nimitta-cArI RgH-_20.8d
   na ca nirvṛtiṃ spṛśati paśyati dharmacārī Rgs_20.14d	na ca nirvRtim spRSati paSyati Darma-cArI RgH-_20.14d
   na ca nirvṛtiṃ spṛśati śūnyata nāsti sthānam Rgs_20.6d	na ca nirvRtim spRSati SUnyata na-asti sTAnam RgH-_20.6d
   na ca nirvṛtiṃ spṛśati so viharāti prajñām Rgs_1.7d	na ca nirvRtim spRSati saH viharAti prajQAm RgH-_1.7d
   na ca nirvṛtiṃ spṛśati so viharāti prajñām Rgs_10.9d	na ca nirvRtim spRSati saH viharAti prajQAm RgH-_10.9d
   na ca paśyakaṃ labhati nāpi ca sarvadharmān Rgs_9.2c	na ca paSyakam laBati na-api ca sarva-DarmAn Rc-H-_9.2c
   na ca prajñapāramita vardhati hīyate vā Rgs_28.6d	na ca prajQapAramita varDati hIyate vE RgH-_28.6d
   na ca prajñapāramita śraddadhitā jinānām Rgs_7.6b	na ca prajQapAram-ita SraddaDitA jinAnAm Rc-H-_7.6b
   na ca prajña bodhi parieṣati āśayena Rgs_26.3c	na ca prajQa boDi pariezati ASayena Rc-H-_26.3c
   na ca budhyakaṃ labhati nāpi ca buddhadharmān Rgs_27.6b	na ca buDyakam laBati na-api ca budDa-DarmAn Rc-H-_27.6b
   na ca bodhisattva calate kvaci dharmatāyāṃ Rgs_13.2c	na ca boDisattva calate kvaci Darma-tAyAm Rc-H-_13.2c
   na ca bodhisattvaupalabdhi na cittabodheḥ Rgs_1.5b	na ca boDisattva-OpalabDi na citta-boDeH Rc-H-_1.5b
   na ca bodhi sāgarasamā na ca buddhadharmāḥ Rgs_5.8d	na ca boDi sAgara-samAH na ca budDa-DarmAH RgH-_5.8d
   na ca bodhiskandha vimṛśitva parāmṛśeyā Rgs_15.3c	na ca boDiskanDa vimRSitva parAmRSeyAH Rc-H-_15.3c
   na ca bhajyatī na pi ca khidyati kalpakoṭī Rgs_20.12d	na ca BajyatI na pi ca Kidyati kalpa-kowI RgH-_20.12d
   na ca bhajyate spṛśati bodhi nararṣabhāṇām Rgs_14.10d	na ca Bajyate spRSati boDi nara-RzaBANAm RgH-_14.10d
   na ca bhidyate dhanasamagramupaiti tīram Rgs_14.7d	na ca Bidyate Dana-samagram-upEti tIram RgH-_14.7d
   na ca bhedanādbhayamupaiti ca svasti geham Rgs_14.5d	na ca BedanAt-Bayam-upEti ca svasti geham RgH-_14.5d
   na ca manyate ahu samādhitu vyutthito vā Rgs_1.11c	na ca manyate ahu samADitu vyutTitaH vE Rc-H-_1.11c
   na ca māya anya na ca skandha karoti anyān Rgs_1.14b	na ca mAya anya na ca skanDa karoti anyAn Rc-H-_1.14b
   na ca medinī kṣayamupaiti na cāpi vṛddhiṃ Rgs_28.3c	na ca medinI kzayam-upEti na ca-api vRdDim Rc-H-_28.3c
   na ca yantra kṣīyati avidya na cāpi vṛddhiḥ Rgs_28.5d	na ca yantra kzIyati avidya na ca-api vRdDiH RgH-_28.5d
   na ca rāja grāma vrajate na ca rājyarāṣṭrān Rgs_13.2a	na ca rAja grAma vrajate na ca rAjya-rAzwrAn RgH-_13.2a
   na ca rupavṛddhiparihāṇiparigrahāye Rgs_2.8a	na ca rupa-vRdDi-parihANi-parigrahAye RgH-_2.8a
   na ca rupa vedana na saṃjña na cetanā ca Rgs_1.6a	na ca rupa vedana na saMjQa na cetanA ca RgH-_1.6a
   na ca rupa vedana na saṃjña na cetanāyā Rgs_1.10a	na ca rupa vedana na saMjQa na cetanAyAH RgH-_1.10a
   na ca rūpavṛddhi na ca paśyati pārihāṇim Rgs_10.9b	na ca rUpa-vRdDi na ca paSyati pArihANim Rc-H-_10.9b
   na ca labhyate ya vrajate diśa āruhitvā Rgs_1.22a	na ca laByate yaH vrajate diSaH AruhitvA RgH-_1.22a
   na ca lābhakāma vṛṣabhā sada dharmakāmāḥ Rgs_17.4b	na ca lABa-kAma vRzaBA sada Darma-kAmAH Rc-H-_17.4b
   na ca vastuniśrayu karoti daditva dānaṃ Rgs_31.14a	na ca vastu-niSrayu karoti daditva dAnam RgH-_31.14a
   na ca śikṣakaṃ labhati nāpi ca śikṣadharmān Rgs_25.1b	na ca Sikzakam laBati na-api ca Sikza-DarmAn Rc-H-_25.1b
   na ca śikṣati vividhadharmaparigrahāye Rgs_2.8b	na ca Sikzati viviDa-Darma-parigrahAye Rc-H-_2.8b
   na ca śocatī na ca sa vyākṛtu veditavyo Rgs_20.21d	na ca SocatI na ca sa vyAkRtu veditavyaH RgH-_20.21d
   na ca sarvaśrāvakagaṇe siya puṇyaskandho Rgs_6.1d	na ca sarva-SrAvaka-gaNe siya puNya-skanDaH RgH-_6.1d
   na ca saṃskṛte bhavati mārgavidū vidhijño Rgs_20.18d	na ca saMskRte Bavati mArga-vidU viDi-jQaH RgH-_20.18d
   na ca sāgarāṇa ratanā bhavi naikarūpāḥ Rgs_5.7d	na ca sAgarANa ratanAH Bavi na-eka-rUpAH RgH-_5.7d
   na ca so śruṇiṣyati kṣipiṣyati mārakarma Rgs_11.3d	na ca saH SruNizyati kzipizyati mAra-karma RgH-_11.3d
   na ca so hi buddha kṣipate jina uktavādī Rgs_6.9b	na ca saH hi budDa kzipate jinaH ukta-vAdI Rc-H-_6.9b
   na ca skandhadhātu na ca āyatanaiḥ sanaddhāḥ Rgs_15.5b	na ca skanDa-DAtu na ca AyatanEH sa-nadDAH Rc-H-_15.5b
   na ca svāmikasya prativākyu dadāti dāsī Rgs_29.12a	na ca svAmikasya prativAkyu dadAti dAsI RgH-_29.12a
   na ca hīyate spṛśati uttamabuddhabodhim Rgs_18.8d	na ca hIyate spRSati uttama-budDa-boDim RgH-_18.8d
   nacireṇa patraphalapuṣpa samāgamanti Rgs_10.7b	nacireNa patra-Pala-puzpa samAgamanti Rc-H-_10.7b
   nacireṇa bodhivara prāpsyati nāyakānām Rgs_10.7d	nacireNa boDi-vara prApsyati nAyakAnAm RgH-_10.7d
   nacireṇa bodhivara lapsyati nāyakānām Rgs_30.5d	nacireNa boDivara lapsyati nAyakAnAm RgH-_30.5d
   na tveva tasya kuśalasyanumodanāye Rgs_26.1d	na tu-eva tasya kuSalasyanumodanAye RgH-_26.1d
   nadate achambhi pṛthutīrthika trāsayanto Rgs_12.6d	nadate aCamBi pRTutIrTika trAsayantaH RgH-_12.6d
   nadate achambhi mṛga kṣudraka trāsayanto Rgs_12.6b	nadate aCamBi mRga kzudraka trAsayantaH Rc-H-_12.6b
   na nivartate na pi ca khidyati yāva tatra Rgs_20.11d	na nivartate na pi ca Kidyati yAva tatra RgH-_20.11d
   na pi sattvasaṃjña api teṣu kadāci bhoti Rgs_12.5d	na pi sattva-saMjQa api tezu kadAci Boti RgH-_12.5d
   na punāsravakṣati sa śikṣati bodhisattvo Rgs_29.2d	na punA-asra-vakzati sa Sikzati boDisattvaH RgH-_29.2d
   nabhadarśanaṃ kutu vimṛṣyatha etamartham Rgs_12.9b	naBa-darSanam kutu vimRzyaTa etam-arTam Rc-H-_12.9b
   na mamātra nāma parikīrtitu nāyakena Rgs_11.3b	na mama-atra nAma parikIrtitu nAyakena Rc-H-_11.3b
   narakeṣu tiryayamaloki aneka duḥkhā Rgs_30.13b	narakezu tiryayam-aloki aneka duHKAH Rc-H-_30.13b
   navayānaprasthita sa sattva parīttabuddhiḥ Rgs_11.10a	nava-yAna-prasTita sa sattva parItta-budDiH RgH-_11.10a
   na vi chāyanānatu bhaveta viśeṣatāpi Rgs_4.6c	na vi CAyanAn-atu Baveta viSeza-tA-api Rc-H-_4.6c
   na vivekagocaru ayaṃ hi jinena ukto Rgs_21.7d	na viveka-gocaru ayam hi jinena uktaH RgH-_21.7d
   na sa jātu śikṣavikalo bhavate duśīlo Rgs_25.2b	na sa jAtu Sikza-vikalaH Bavate duSIlaH Rc-H-_25.2b
   na hi atra kaści yo kliśyati śudhyate vā Rgs_22.7c	na hi atra kaSci yaH kliSyati SuDyate vE Rc-H-_22.7c
   na hi arci paścimanipāta sa varti dagdhā Rgs_19.1c	na hi arci paScima-nipAta sa varti dagDAH Rc-H-_19.1c
   na hi tena tasya kutu kenacideṣa prāptā Rgs_26.4b	na hi tena tasya kutu kenacid-eza prAptAH Rc-H-_26.4b
   na hi darśanaṃ bhaṇitu śakya nidarśanena Rgs_12.9d	na hi darSanam BaNitu Sakya nidarSanena RgH-_12.9d
   na hi dharma paṇḍita vināśa karoti jātu Rgs_5.1d	na hi Darma paNxita vinASa karoti jAtu RgH-_5.1d
   nānātvatā na bhavate na viśeṣaprāptā Rgs_16.1d	nAnAtva-tA na Bavate na viSeza-prAptAH RgH-_16.1d
   nānātvadharmavigatāṃ sugatāna bodhim Rgs_16.3b	nAnAtva-Darma-vigatAm sugatAna boDim Rc-H-_16.3b
   nānātvasaṃjñaprasṛto paramaṃ duśīlo Rgs_31.7c	nAnAtva-saMjQa-prasRtaH paramam duSIlaH Rc-H-_31.7c
   nānātvasaṃjñavigatā gira yuktabhāṇī Rgs_17.2a	nAnAtva-saMjQa-vigatA gira yukta-BANI Rc-H-_17.2a
   nānātvasaṃjñavigato upaśāntacārī Rgs_1.14c	nAnAtva-saMjQa-vigataH upaSAnta-cArI Rc-H-_1.14c
   nānāprakāra vividhāśca anekarūpāḥ Rgs_4.6b	nAnA-prakAra viviDAH-ca aneka-rUpAH Rc-H-_4.6b
   nāmādhiṣṭhāna puna māra upāgamitvā Rgs_21.2a	nAma-aDizWAna puna mAraH upAgamitvA RgH-_21.2a
   nāmena ratnaguṇasaṃcaya bodhimārgaḥ Rgs_32.6c	nAmena ratna-guNa-saMcaya boDi-mArgaH Rc-H-_32.6c
   nāmena vā puna sa prajñapanāya śakyaḥ Rgs_20.20b	nAmena vA puna sa prajQapanAya SakyaH Rc-H-_20.20b
   nāmena vā puna sa prajñapanāya śakyaḥ Rgs_20.20d	nAmena vA puna sa prajQapanAya SakyaH RgH-_20.20d
   nāmeva rūpi jagatī ayu paṅkasaktā Rgs_8.3a	nAma-iva rUpi jagatI ayu paFka-saktAH RgH-_8.3a
   nārhantabhūmi na pi pratyayabuddhabhūmī Rgs_10.4d	na-arhanta-BUmi na pi pratyaya-budDa-BUmiH RgH-_10.4d
   nārhaṃmi śikṣati na pratyayabuddhabhūmau Rgs_2.7b	na-arhaMmi Sikzati na pratyaya-budDa-BUmO Rc-H-_2.7b
   nāvā yathā aparikarmakṛtā samudre Rgs_14.7a	nAvA yaTA aparikarma-kRtA samudre RgH-_14.7a
   nāśitva duḥkhi satataṃ ratanābhikāṅkṣī Rgs_22.12d	nASitva duHKi satatam ratana-aBikAFkzI RgH-_22.12d
   nāsti triloka śubha tena samaṃ bhaveyā Rgs_18.5d	na-asti triloka SuBa tena samam BaveyAH RgH-_18.5d
   nityamanityasukhaduḥkhaśubhāśubhaṃ ti Rgs_2.2a	nityam-anitya-suKa-duHKa-SuBa-aSuBam ti RgH-_2.2a
   nirmāṇu sarva jagato na ca tasya trāso Rgs_1.19d	nirmANu sarva jagataH na ca tasya trAsaH RgH-_1.19d
   niryāti yo iti prajānati bodhisattvo Rgs_1.13d	niryAti yaH iti prajAnati boDisattvaH RgH-_1.13d
   niryāyatī ya iya śikṣa guṇe ratānām Rgs_2.8d	niryAyatI yaH iya Sikza guNe ratAnAm RgH-_2.8d
   niryāyanāya ya icchati buddhajñāne Rgs_16.6a	niryAyanAya yaH icCati budDa-jQAne Rc-H-_16.6a
   nirvāṇaokagamanaṃ gati nopalabdhiḥ Rgs_1.22b	nirvANaoka-gamanam gati na-upalabDiH Rc-H-_1.22b
   nirvāṇato adhigato vidupaṇḍitehi Rgs_2.5c	nirvANataH aDigataH vidupaNxita-ihi Rc-H-_2.5c
   nairātmabhāvanavidūri nabhaṃ va bhūmeḥ Rgs_30.6d	nErAtma-BAvana-vidUri naBam va BUmeH RgH-_30.6d
   no ca prapāta patiyāti na yāva tatra Rgs_20.13d	no ca prapAta pati-yAti na yAva tatra RgH-_20.13d
   no cāpi tatra sthitu no ca patāti bhūmau Rgs_20.8b	no ca-api tatra sTitu no ca patAti BUmO Rc-H-_20.8b
   no cāpi tatra sthihatāna spṛheti teṣām Rgs_25.6c	no ca-api tatra sTihatAna spRhA-iti tezAm Rc-H-_25.6c
   no cāpi tatra sthihatī na ca ratnadvīpe Rgs_20.17c	no ca-api tatra sTihatI na ca ratnadvIpe Rc-H-_20.17c
   no cāpi tatra sthihate na ca buddhajñāne Rgs_20.18c	no ca-api tatra sTihate na ca budDa-jQAne Rc-H-_20.18c
   no cāpi so labhati yatra carāti dharmam Rgs_1.12b	no ca-api saH laBati yatra carAti Darmam Rc-H-_1.12b
   no cā viveku imu jānati bodhisattvo Rgs_21.6c	no cA viveku imu jAnati boDisattvaH Rc-H-_21.6c
   no cāsya koṣṭhagatu so viṣu pātyate ca Rgs_22.6b	no ca-asya kozWa-gatu saH vizu pAtyate ca Rc-H-_22.6b
   notpadyate akuśalamapi ekacittam Rgs_25.3b	na-utpadyate akuSalam-api ekacittam Rc-H-_25.3b
   pakṣisya nāsti padu gacchata antarīkṣe Rgs_20.8a	pakzisya na-asti padu gacCata antarIkze RgH-_20.8a
   pakṣisya yojanaśataṃ mahatātmabhāvo Rgs_16.4a	pakzisya yojana-Satam mahatA-Atma-BAvaH RgH-_16.4a
   pañcāśatā pi abalobhayakṣīṇapakṣo Rgs_16.4b	paQcASatA pi abala-uBaya-kzINa-pakzaH Rc-H-_16.4b
   patanādbhayaṃ na bhavate vrajate sukhena Rgs_14.9d	patanAt-Bayam na Bavate vrajate suKena RgH-_14.9d
   patanāya tasya purimasya na deya bhūmim Rgs_20.9c	patanAya tasya purimasya na deya BUmim Rc-H-_20.9c
   patha hitva utpathagatā ima mārakarma Rgs_11.6d	paTa hitvaH utpaTa-gatAH ima mAra-karma RgH-_11.6d
   padmeva vāriṇi aniśrita bāladharme Rgs_29.5d	padmeva vAriNi aniSrita bAla-Darme RgH-_29.5d
   para prema gaurava prasāda upasthapitvā Rgs_1.1a	para prema gOrava prasAdaH upasTapitvA RgH-_1.1a
   paramādbhutāṃ sugatabodhi spṛśanti śīghram Rgs_14.4d	parama-adButAm sugata-boDi spRSanti SIGram RgH-_14.4d
   paramārthasaukhyakriya tatphalaprāptitā ca Rgs_1.3c	parama-arTa-sOKya-kriya tad-Pala-prApti-tA ca Rc-H-_1.3c
   parasattvacittacaritāna nidarśitā(kā) ca Rgs_12.2d	para-sattva-citta-caritAna nidarSita-a(kA) ca RgH-_12.2d
   parasattvapudgalanidāna viśuddhasattvā Rgs_29.11a	para-sattva-pudgala-nidAna viSudDa-sattvAH RgH-_29.11a
   parasattvi pustaku dadeya viśiṣṭapuṇyaḥ Rgs_5.3d	para-sattvi pustaku dadeya viSizwa-puNyaH RgH-_5.3d
   parigrāhikā kuśaladharmaavipraṇāśe Rgs_4. 5 c	parigrAhikA kuSala-Darmaa-vipraNASe RgH-_4. 5 c
   paricārikā ya na ca kāṅkṣati paṇḍitehi Rgs_7.5b	paricArikA yaH na ca kAFkzati paNxita-ihi Rc-H-_7.5b
   pariṇāmayantu yadi vartati cittasaṃjñā Rgs_6.5a	pariNAmayantu yadi vartati citta-saMjQAH RgH-_6.5a
   pariṇāmayāti na ca manyati bodhisattvo Rgs_18.8c	pariNAma-yAti na ca manyati boDisattvaH Rc-H-_18.8c
   pariṇāmitaṃ na bhavatī upalabhyamānam Rgs_6.5d	pariNAmitam na BavatI upalaByamAnam RgH-_6.5d
   pariṇāmitaṃ bhavati eva prajānamāne Rgs_6.6d	pariNAmitam Bavati eva prajAnamAne RgH-_6.6d
   paritoṣayāti susukhaṃ vidu bodhisattvo Rgs_30.8b	paritoza-yAti su-suKam vidu boDisattvaH Rc-H-_30.8b
   parinirvṛtasya sugatasya kareyya stūpāṃ Rgs_3.2a	parinirvRtasya sugatasya kareyya stUpAm RgH-_3.2a
   paripakvi vāri ghaṭake vahamānu mārge Rgs_14.5c	paripakvi vAri Gawake vahamAnu mArge Rc-H-_14.5c
   paripācayitva jagatī kariṣyāmi artham Rgs_30.6b	paripAcayitva jagatI karizyAmi arTam Rc-H-_30.6b
   paripiṇḍayitva anumodayi bodhisattvo Rgs_6.4c	paripiNxayitvaH anumodayi boDisattvaH Rc-H-_6.4c
   paripūraṇārtha imi pāramitā mahātmā Rgs_29.6b	paripUraNa-arTaH imi pAramitA mahAtmA RgH-_29.6b
   paripūrayitva imi dharma sa bodhisattvo Rgs_32.5a	paripUrayitvaH imi Darma sa boDisattvaH RgH-_32.5a
   parimocituṃ ya iha icchati bodhisattvo Rgs_22.11b	parimocitum yaH iha icCati boDisattvaH Rc-H-_22.11b
   parihīnabuddhiguṇa nāvika bhinnanāvo Rgs_29.9d	parihIna-budDi-guNa nAvika Binna-nAvaH RgH-_29.9d
   paruṣaṃ śruṇitva vacanaṃ parato duruktaṃ Rgs_30.8a	paruzam SruNitva vacanam paratas duruktam RgH-_30.8a
   palagaṇḍa dakṣa vidunā kṛtu dāruyantro Rgs_26.8a	pala-gaNxa dakza vidunA kRtu dAruyantraH RgH-_26.8a
   paśyanti taṃ vividha kāryu nidarśayantaṃ Rgs_26.5c	paSyanti tam viviDa kAryu nidarSayantam Rc-H-_26.5c
   paśyitva te viṣaya tatra parigṛhītā Rgs_29.4c	paSyitva te vizaya tatra parigRhItAH Rc-H-_29.4c
   paśyitva nāsti bhaya uttari saṃnahante Rgs_19.8b	paSyitva na-asti BayaH uttari saMnahante Rc-H-_19.8b
   pārājiko gurutaro ayu cittupādo Rgs_31.5d	pArAjikaH gurutaraH ayu cittupAdaH RgH-_31.5d
   puna kāmadhātu upapadyati yathābhiprāyā Rgs_29.3d	puna kAmaDAtu upapadyati yaTA-aBiprAyAH RgH-_29.3d
   puna kāmadhātu praviśanti jagānukampī Rgs_29.8d	puna kAmaDAtu praviSanti jagAnukampI RgH-_29.8d
   puna kāmadhātusthita bhonti anopaliptā Rgs_29.5c	puna kAmaDAtu-sTita Bonti anopaliptAH Rc-H-_29.5c
   puna bodhisattva caramāṇu jināna prajñāṃ Rgs_20.1a	puna boDisattva caramANu jinAna prajQAm RgH-_20.1a
   punarāgameya na ca niśrayu tatra kuryāt Rgs_29.4d	punar-Agameya na ca niSrayu tatra kuryAt RgH-_29.4d
   puruṣā yathā mahaprapāti sthihitva kecid Rgs_20.13a	puruzAH yaTA mahaprapAti sTihitva kecid RgH-_20.13a
   puruṣe stritulya sa karoti ha sarvakāryam Rgs_26.8b	puruze stritulya sa karoti ha sarva-kAryam Rc-H-_26.8b
   puruṣo ya agru ratanasya alabdhapūrvo Rgs_22.12a	puruzaH yaH agru ratanasya alabDa-pUrvaH RgH-_22.12a
   puruṣo yathā kuśala sarvaguṇairupeto Rgs_20.2a	puruzaH yaTA kuSala sarva-guNEH-upetaH RgH-_20.2a
   puruṣo hi jīrṇa dukhito śataviṃśavarṣo Rgs_14.9a	puruzaH hi jIrNa duKitaH SataviMSa-varzaH RgH-_14.9a
   puruṣo hi sāgarajalaṃ vraji paśyanāya Rgs_10.5a	puruzaH hi sAgara-jalam vraji paSyanAya RgH-_10.5a
   pūjeya saptaratanāmayu kaścideva Rgs_3.2b	pUjeya saptarata-nAmayu kaScid-eva Rc-H-_3.2b
   pūrvaṃgamā bhavatu dānu dadantu prajñā Rgs_4. 5 a	pUrvaMgamAH Bavatu dAnu dadantu prajQA Rc-H-_4. 5 a
   pūrvaṃ pi tubhya imi āsi guṇovarūpā Rgs_21.3b	pUrvam pi tuByaH imi Asi guNovarUpAH Rc-H-_21.3b
   pūrvāntato na upalabhyati bodhisattvo Rgs_1.23a	pUrva-antataH naH upalaByati boDisattvaH RgH-_1.23a
   pṛthumārgu tīru upadarśayi sattvadhātau Rgs_22.11c	pRTu-mArgu tIru upadarSayi sattva-DAtO Rc-H-_22.11c
   prakṛtīasanta parijānayamāna dharmāṃ Rgs_1.28c	prakRtIa-santa parijAnayamAna DarmAm Rc-H-_1.28c
   prakṛtīya śuddha pariśuddhimi sarvadharmāṃ Rgs_9.2a	prakRtIya SudDa pariSudDimi sarva-DarmAm RgH-_9.2a
   prajahitva āvaraṇa kleśamalātikrāntāḥ Rgs_1.1b	prajahitvaH AvaraNa kleSa-mala-atikrAntAH Rc-H-_1.1b
   prajñāupāyadvayachatraparigṛhīto Rgs_20.14b	prajQAupAya-dvaya-Catra-parigRhItaH Rc-H-_20.14b
   prajñā upāya bala ṛddhi vicāramāṇo Rgs_20.10b	prajQA upAya balaH RdDi vicAramANaH Rc-H-_20.10b
   prajñā pi lokavidunāṃ sa anantapārā Rgs_2.10d	prajQA pi loka-vidunAm sa ananta-pArAH RgH-_2.10d
   prajñāya dharmaprakṛtī parijānayitvā Rgs_32.4a	prajQAya Darma-prakRtI parijAnayitvA RgH-_32.4a
   prajñāya pāramita etu na dhārayanti Rgs_11.8d	prajQAya pAramitaH etu na DArayanti RgH-_11.8d
   prajñāya pāramita te anuśāsayanti Rgs_15.2b	prajQAya pAramita te anuSAsayanti Rc-H-_15.2b
   prajñāya pāramita te viruhanti sarve Rgs_3.7d	prajQAya pAramita te viruhanti sarve RgH-_3.7d
   prajñāya pāramita nāmatayā bhavanti Rgs_4.7b	prajQAya pAramita nAmatayA Bavanti Rc-H-_4.7b
   prajñāya pāramita paśyati bodhisattvo Rgs_9.2b	prajQAya pAramita paSyati boDisattvaH Rc-H-_9.2b
   prajñāya pāramita buddha tathāgatena Rgs_12.3d	prajQAya pAramita budDa taTAgatena RgH-_12.3d
   prajñāya pāramita budhyati bodhisattve Rgs_22.7d	prajQAya pAramita buDyati boDisattve RgH-_22.7d
   prajñāya pāramita mātra vivarjayanti Rgs_14.3b	prajQAya pAramita mA-atra vivarjayanti Rc-H-_14.3b
   prajñāya pāramita yatra caranti dhīrāḥ Rgs_8.2d	prajQAya pAramita yatra caranti DIrAH RgH-_8.2d
   prajñāya pāramita yatra caranti nāthāḥ Rgs_3.1b	prajQAya pAramita yatra caranti nATAH Rc-H-_3.1b
   prajñāya pāramita yatra caranti śūrāḥ Rgs_1.1d	prajQAya pAramita yatra caranti SUrAH RgH-_1.1d
   prajñāya pāramita yasyimu hastaprāptā Rgs_10.7c	prajQAya pAramita yasyimu hasta-prAptAH Rc-H-_10.7c
   prajñāya pāramita yukta divā ca rātrau Rgs_22.11d	prajQAya pAramita yukta divA ca rAtrO RgH-_22.11d
   prajñāya pāramita yujyatu yāya yukto Rgs_16.3c	prajQAya pAramita yujyatu yAya yuktaH Rc-H-_16.3c
   prajñāya pāramita yogu na riñcitavyo Rgs_22.13b	prajQAya pAramita yogu na riQcitavyaH Rc-H-_22.13b
   prajñāya pāramita ramyavanāśritānām Rgs_12.5b	prajQAya pAramita ramya-vana-ASritAnAm Rc-H-_12.5b
   prajñāya pāramita śikṣita saṃskṛtānāṃ Rgs_25.4a	prajQAya pAramita Sikzita saMskRtAnAm RgH-_25.4a
   prajñāya pāramita śrutva na sīdayanti Rgs_15.6c	prajQAya pAramita Srutva na sIdayanti Rc-H-_15.6c
   prajñāya pāramita sarva karoti tāni Rgs_13.1d	prajQAya pAramita sarva karoti tAni RgH-_13.1d
   prajñāya skandha vimṛṣitva alabdhagādhā Rgs_18.1d	prajQAya skanDa vimRzitva alabDa-gADAH RgH-_18.1d
   prajñāvihīna vilayaṃ laghu prāpuṇāti Rgs_14.6b	prajQA-vihIna vilayam laGu prApuNAti Rc-H-_14.6b
   prajñāvihīnu laghu bodhimupaiti hānim Rgs_14.8b	prajQA-vihInu laGu boDim-upEti hAnim Rc-H-_14.8b
   prajñopadeśa kathito ayu bodhimārgo Rgs_32.6b	prajQA-upadeSa kaTitaH ayu boDi-mArgaH Rc-H-_32.6b
   praṇidhīnanantavipulāṃ sada sevya loke Rgs_16.5c	praNiDIn-ananta-vipulAm sada sevya loke Rc-H-_16.5c
   praṇidheti tatkṣaṇa apāya ucchoṣayeyam Rgs_20.23b	praNiDA-iti tad-kzaNa apAyaH ucCozayeyam Rc-H-_20.23b
   pratidarśayāti puna āyati saṃvarāṇi Rgs_24.6c	pratidarSa-yAti punas Ayati saMvarANi Rc-H-_24.6c
   pratipattiyā ca abhiyujyati āśayena Rgs_27.4c	pratipattiyA ca aBiyujyati ASayena Rc-H-_27.4c
   pratibhāna neka vividhāni upapadyiṣyanti Rgs_11.2a	pratiBAna neka viviDAni upapadyizyanti RgH-_11.2a
   pra(ti)varṇikāya carate aprajānamāno Rgs_5.1c	pra(ti)varNikAya carate aprajAnamAnaH Rc-H-_5.1c
   pratyantamlecchajanavarjitaantadeśāḥ Rgs_17.7a	pratyanta-mlecCa-jana-varjitaanta-deSAH Rc-H-_17.7a
   pratyutpanna yā tathata yā tathatārhatānām Rgs_16.2b	pratyutpat-na yA taTata yA taTatArhatAnAm Rc-H-_16.2b
   pratyekabuddhatathatā tathatā jinānām Rgs_12.3b	pratyekabudDa-taTatA taTatA jinAnAm Rc-H-_12.3b
   pratyekabuddha bhaviyāṃ tatha dharmarājo Rgs_2.4b	pratyekabudDa BaviyAm taTa DarmarAjaH Rc-H-_2.4b
   pratyekabodhi spṛśayanti ca buddhabodhim Rgs_5.4d	pratyeka-boDi spRSayanti ca budDa-boDim RgH-_5.4d
   pratyekabhūmiathito tatha buddhabhūmau Rgs_2.2d	pratyeka-BUmiaTitaH taTa budDa-BUmO RgH-_2.2d
   prathamaṃ upādu varabodhayi cittupādo Rgs_6.3a	praTamam upAdu vara-boDayi cittupAdaH RgH-_6.3a
   prathamaṃ upādu varabodhayi cittupādo Rgs_30.3a	praTamam upAdu vara-boDayi cittupAdaH RgH-_30.3a
   prathame nipāti anupūrva sa paścimena Rgs_19.5b	praTame nipAti anupUrva sa paScimena Rc-H-_19.5b
   prathameva citta spṛśatī na ca agrabodhim Rgs_19.2a	praTamA-iva citta spRSatI na ca agra-boDim Rc-H-_19.2a
   pradyota ulka varadharmakathī akṣobhyāḥ Rgs_15.4d	pradyotaH ulka vara-Darma-kaTI akzoByAH RgH-_15.4d
   pravivikta grāmanagare girikandarāṇi Rgs_21.4a	pravivikta grAma-nagare giri-kandarANi Rc-H-_21.4a
   pravivikta prajñavarapāramitābhiyuktāḥ Rgs_17.6b	pravivikta prajQa-vara-pAramitA-aBiyuktAH Rc-H-_17.6b
   prāgeva yāva sthitu bheṣyati dharmarājo Rgs_23.4d	prAk-eva yAva sTitu Bezyati DarmarAjaH RgH-_23.4d
   prāgeva rājyasthitu bheṣyati paṭṭadhārī Rgs_23.3d	prAk-eva rAjya-sTitu Bezyati pawwa-DArI RgH-_23.3d
   prāgeva vastu tada bāhira nātyajeyā Rgs_31.10c	prAk-eva vastu tada bAhira na-atyajeyAH Rc-H-_31.10c
   priyu bhoti sarvajagatī kṣamamāṇu vijño Rgs_30.10d	priyu Boti sarva-jagatI kzamamANu vijQaH RgH-_30.10d
   premāpanīta gamiṣyanti sudurmanāśca Rgs_11.7d	prema-apanIta gamizyanti su-durmanAH-ca RgH-_11.7d
   phala puṣpa auṣadhā(dhi) vanaspati rohayanti Rgs_1.2b	Pala puzpaH OzaDa-a(Di) vanaspati rohayanti Rc-H-_1.2b
   phalaprāpta pratyayajino tatha lokanātho Rgs_2.5b	Pala-prApta pratyaya-jinaH taTa lokanATaH Rc-H-_2.5b
   phalaprāptitāya athito arahantabhūmau Rgs_2.2c	Pala-prAptitAya aTitaH arahanta-BUmO Rc-H-_2.2c
   phalarūpaśuddhita sarvajñataśuddhimāhuḥ Rgs_8.1b	Pala-rUpa-SudDita sarvajQata-SudDim-AhuH Rc-H-_8.1b
   bala ṛddhipāda na ca kalpayi bodhi śāntām Rgs_10.10b	balaH RdDipAda na ca kalpayi boDi SAntAm Rc-H-_10.10b
   baladhyānaindriyavimokṣasamādhiprāptān Rgs_21.7b	bala-DyAnEndriya-vimokza-samADi-prAptAn Rc-H-_21.7b
   balavān dudharṣu kṛtayogya kalāvidhijño Rgs_20.2b	balavAn duDarzu kRta-yogya kalA-viDi-jQaH Rc-H-_20.2b
   bahu antarāyu bhaviṣyanti bhaṇāti śāsta Rgs_11.1c	bahu antarAyu Bavizyanti BaNAti SAstaH Rc-H-_11.1c
   bahukalpakoṭiniyutāṃ samudānayeyyā Rgs_16.5b	bahu-kalpa-kowi-niyutAm samudAnayeyyAH Rc-H-_16.5b
   bahubuddhakoṭinayutehi kṛtādhikāro Rgs_10.2b	bahu-budDa-kowina-yutA-ihi kRta-aDikAraH Rc-H-_10.2b
   bījaṃ pratītya ca bhavedyavaśālikādes Rgs_19.4a	bIjam pratItya ca Bavet-yava-SAlika-AdeH RgH-_19.4a
   bījātu stamba phala puṣpa samāgamanti Rgs_19.3a	bIjAtu stamba Pala puzpa samAgamanti RgH-_19.3a
   bījāḥ prakīrṇa pṛthivīsthita saṃbhavanti Rgs_3.7a	bIjAH prakIrNa pRTivI-sTita saMBavanti RgH-_3.7a
   buddhaṃ ca dharma śaraṇāgatu āryasaṃgham Rgs_31.4b	budDam ca Darma SaraNa-agatu Arya-saMGam Rc-H-_31.4b
   buddhaṃ subhūti paripṛcchati vādicandraṃ Rgs_11.1a	budDam suBUti paripRcCati vAdi-candram RgH-_11.1a
   buddhā daśaddiśi parigrahasaṃprayuktāḥ Rgs_11.10d	budDAH daSat-diSi parigraha-saMprayuktAH RgH-_11.10d
   buddhāna gotrajananaṃ sukhasaukhyagañjo Rgs_28.2b	budDAna gotra-jananam suKa-sOKya-gaQjaH Rc-H-_28.2b
   buddhāna lokavidunārhatapratyayānāṃ Rgs_30.9c	budDAna loka-viduna-arhata-pratyayAnAm Rc-H-_30.9c
   buddhānubhāva puna ātmabalānubhāvā Rgs_1.4d	budDa-anuBAva pune Atma-bala-anuBAvAH RgH-_1.4d
   buddhānuloki vidu nārhatipratyayānāṃ Rgs_31.15c	budDa-anuloki vidu na-arhati-pratyayAnAm Rc-H-_31.15c
   buddhā pi yāvata daśaddiśi lokadhātau Rgs_27.1c	budDA pi yAvata daSat-diSi lokaDAtO Rc-H-_27.1c
   buddhā ya bodhivaraprasthita bodhisattvā Rgs_22.2a	budDAH yaH boDi-vara-prasTita boDisattvAH RgH-_22.2a
   buddhāṃśca paśyati katheti janasya dharmaṃ Rgs_20.22c	budDAn=-ca paSyati kaTA-iti janasya Darmam Rc-H-_20.22c
   buddhitva bodhi jagatī parimocayitvā Rgs_26.6b	budDitva boDi jagatI parimocayitvA Rc-H-_26.6b
   buddhena deśita prayukta prakāśitāṃśca Rgs_18.7b	budDena deSita prayukta prakASitAn=-ca Rc-H-_18.7b
   buddho bhaviṣyasi anāgataadhvanasmin Rgs_2.13d	budDaH Bavizyasi anAgataa-Dvanasmin RgH-_2.13d
   buddho yadā bhavi idaṃ tava nāmadheyam Rgs_21.2d	budDaH yadA Bavi idam tava nAmaDeyam RgH-_21.2d
   bodhiṃ spṛśiṣyati jināna asaṅgabhūtāṃ Rgs_1.16c	boDim spRSizyati jinAna asaFga-BUtAm Rc-H-_1.16c
   bhavatī athānasthita so laghu antarīkṣe Rgs_27.5b	BavatI aTa-anasTita saH laGu antarIkze Rc-H-_27.5b
   bhavate dugharṣu catumāraasaṃprakampyo Rgs_27.3b	Bavate duGarzu catumAraa-saMprakampyaH Rc-H-_27.3b
   bhāvasvabhāvakuśalā paramārthadarśī Rgs_14.4b	BAva-svaBAva-kuSalA parama-arTa-darSI Rc-H-_14.4b
   bhāvasvabhāvavigatā bhavatīha māyā Rgs_19.4d	BAva-svaBAva-vigatA Bavati-iha mAyA RgH-_19.4d
   bhāṣanti yuktisahitāṃśca udīrayanti Rgs_1.3b	BAzanti yukti-sahitAn=-ca udIrayanti Rc-H-_1.3b
   bhikṣū yathā paramaṛddhibalenupeto Rgs_20.11a	BikzU yaTA paramaRdDi-balenu-petaH RgH-_20.11a
   bhinditva paśca adhigamyasi agrabodhim Rgs_30.4b	Binditva paH-ca aDigamyasi agra-boDim Rc-H-_30.4b
   bhūja(ta) gajendranāgapatiniśrayanovata(na)sya(?) Rgs_1.2c	BUja(ta) gaja-indra-nAga-pati-niSrayanovata(na)sya-(?) Rc-H-_1.2c
   bhūtagrahā vividha vyādhaya martyaloke Rgs_20.24a	BUta-grahAH viviDa vyADaya martya-loke RgH-_20.24a
   bhṛtakaṃ manuṣya tṛṇakāṣṭhamagṛhṇamāno Rgs_14.2b	BRtakam manuzya tRNa-kAzWam-agRhNamAnaH Rc-H-_14.2b
   bheṣyanti bodhivarauttamaprāpaṇāya Rgs_29.1d	Bezyanti boDivara-Ottama-prApaNAya RgH-_29.1d
   bhogāṃścanantavipulāṃ labhate caranto Rgs_32.1c	BogAn=-cananta-vipulAm laBate carantaH Rc-H-_32.1c
   bhonti parasparaviruddhaka ruṣṭacittāḥ Rgs_24.3b	Bonti paraspara-virudDaka ruzwa-cittAH Rc-H-_24.3b
   bhontī niruddha pṛthu indriya yāvadasti Rgs_25.5b	BontI nirudDa pRTu indriya yAvat-asti Rc-H-_25.5b
   maṇiratna sarvi guṇayukta anarghaprāpto Rgs_4.3a	maNi-ratna sarvi guNa-yuktaH anarGa-prAptaH RgH-_4.3a
   mamatāṃ na tatra karayenna ca vastuprema Rgs_31.18b	mamatAm na tatra karayet-na ca vastu-premaH Rc-H-_31.18b
   marutaśca sarvajagatī sukhasaukhyadharmāḥ Rgs_28.4b	marutaH-ca sarva-jagatI suKa-sOKya-DarmAH Rc-H-_28.4b
   mahatāya atra ayu bheṣyati sattvarāśeḥ Rgs_1.17b	mahatAya atra ayu Bezyati sattva-rASeH Rc-H-_1.17b
   mahatā sanaddhu namuciṃ śaṭha dharṣayiṣye Rgs_1.18c	mahatA sanadDu namucim SaWa Darzayizye Rc-H-_1.18c
   mahatīṃ janeti karuṇāṃ na ca sattvasaṃjñā Rgs_1.24c	mahatIm jana-iti karuNAm na ca sattva-saMjQAH Rc-H-_1.24c
   mahatīṃ janeti karuṇāṃ na ca sattvasaṃjñā Rgs_22.10b	mahatIm jana-iti karuNAm na ca sattva-saMjQA Rc-H-_22.10b
   mahato janasya bahu chindati śīrṣakoṭī Rgs_1.19b	mahataH janasya bahu Cindati SIrza-kowI Rc-H-_1.19b
   mahanāyako mahatabuddhi mahānubhāvo Rgs_1.18a	mahanAyakaH mahata-budDi mahA-anuBAvaH RgH-_1.18a
   mahamaitri sarvi upabandhati sattvadhātau Rgs_20.4b	maham-Etri sarvi upabanDati sattva-DAtO Rc-H-_20.4b
   mahayāna uttamajināna samādhirūḍho Rgs_1.18b	mahayAnaH uttama-jinAna samADi-rUXaH Rc-H-_1.18b
   mahavidya prajña ayu pāramitā janānāṃ Rgs_3.5a	mahavidya prajQa ayu pAramitA janAnAm RgH-_3.5a
   mahasattva tena hi pravucyati kāraṇena Rgs_1.17d	mahasattva tena hi pravucyati kAraNena RgH-_1.17d
   mahasattva tena hi pravucyati kāraṇena Rgs_1.18d	mahasattva tena hi pravucyati kAraNena RgH-_1.18d
   mahasattva so 'tha kenocyati kāraṇena Rgs_1.17a	mahasattva saH aTa kena-ucyati kAraNena RgH-_1.17a
   mātā pitā ca parigṛhya saputradāraṃ Rgs_20.3a	mAtA pitA ca parigRhya sa-putra-dAram RgH-_20.3a
   mātāpitāya anusaptamupaiti vaṃśo Rgs_21.2c	mAtA-pitAya anusaptam-upEti vaMSaH Rc-H-_21.2c
   māteva ekasutake paricāryamāṇo Rgs_29.14c	mAtA-iva eka-sutake paricAryamANaH Rc-H-_29.14c
   mātrāya putra bahu santi gilāni kāye Rgs_12.1a	mAtrAya putra bahu santi gilAni kAye RgH-_12.1a
   mātrāhīnaṃ kathamapi padaṃ pādagāthākṣaraṃ vā Rgs_LPr_1b	mAtrA-hInam kaTam-api padam pAda-gATa-akzaram vA RgH-_LPr_1b
   mātsarya preta bhavate upapadyayātī Rgs_31.11c	mAtsarya preta Bavate upapadyayAtI Rc-H-_31.11c
   māmeva so anu vadhiṣyati kāraṇena Rgs_29.12d	mAm-eva saH anu vaDizyati kAraNena RgH-_29.12d
   māyākaro yatha catuṣpathi nirmiṇitvā Rgs_1.19a	mAyA-karaH yaTa catuzpaTi nirmiNitvA RgH-_1.19a
   māyāvidhijñaparamo jagadarthakāmo Rgs_20.2d	mAyA-viDi-jQa-paramaH jagat-arTa-kAmaH RgH-_20.2d
   māyopamāṃ ya iha jānati pañca skandhāṃ Rgs_1.14a	mAyA-upamAm ye iha jAnati paQca skanDAm RgH-_1.14a
   mārasyatītaviṣayā aparapraṇeyā Rgs_17.4c	mArasi-atIta-vizayAH apara-praNeyAH Rc-H-_17.4c
   māro 'tra utsuku bhaviṣyati antarāye Rgs_11.10c	mAraH atra utsuku Bavizyati antarAye Rc-H-_11.10c
   māro 'pi tasmi samaye bhavate saśalyo Rgs_24.1a	mAraH api tasmi samaye Bavate sa-SalyaH RgH-_24.1a
   mārge akovidu kuto nagarapraveśe Rgs_7.1b	mArge akovidu kutas nagara-praveSe Rc-H-_7.1b
   mārgeṣu ṣaṣṭiku labhitva sa bhojanāgryam Rgs_11.5b	mArgezu zazwiku laBitva sa Bojana-agryam Rc-H-_11.5b
   mūlātu chedana karitva puna āgameyā Rgs_7.7d	mUlAtu Cedana karitva punas AgameyAH RgH-_7.7d
   mociṣya sattvaniyutāṃ bahurogaspṛṣṭān Rgs_7.4b	mocizya sattva-niyutAm bahu-roga-spRzwAn Rc-H-_7.4b
   ya imaṃ durlābhu dharmaratanaṃ parāpuṇanti Rgs_11.10b	yaH imam durlABu Darma-ratanam parApuNanti Rc-H-_11.10b
   ya imāṃ grahīṣyati paryāpuṇatī sa nityaṃ Rgs_3.1a	yaH imAm grahIzyati paryApuNatI sa nityam RgH-_3.1a
   yajjātiyo 'yaṃ prabhavo yadalakṣaṇaṃ ca Rgs_6.8c	yat-jAtiyaH ayam praBavaH yat-alakzaNam ca Rc-H-_6.8c
   yata utpatī daśabalāna vināyakānām Rgs_3.4b	yatas utpatI daSa-balAna vinAyakAnAm Rc-H-_3.4b
   yatrāntarasmi bhavate pragṛhīta prajñā Rgs_7.2a	yatra-antarasmi Bavate pragRhIta prajQA RgH-_7.2a
   yatrāruhitva sa nirvāpayi sarvasattvān Rgs_1.21b	yatra-aruhitva sa nirvApayi sarva-sattvAn Rc-H-_1.21b
   yatreha bodhiguṇapāramitāna hāni Rgs_29.6d	yatra-iha boDi-guNa-pAramitAna hAni RgH-_29.6d
   yatha agni nirvṛtu na tasya gatipracāro Rgs_1.22c	yaTaH agni nirvRtu na tasya gati-pracAraH Rc-H-_1.22c
   yatha ātmanaṃ tatha prajānati sarvasattvāṃ Rgs_1.26a	yaTaH Atmanam taTa prajAnati sarva-sattvAm RgH-_1.26a
   yatha ārapāragamanāya atītadarśī Rgs_2.4d	yaTaH Ara-pAra-gamanAya atIta-darSI RgH-_2.4d
   yatha istri gurviṇi ya ceṣṭati vedanābhi Rgs_10.8a	yaTaH istri gurviNi yaH cezwati vedanA-aBi RgH-_10.8a
   yatha udgraho tatha prakāśitu saṃkileśo Rgs_22.7a	yaTaH udgrahaH taTa prakASitu saMkileSaH RgH-_22.7a
   yatha kaścideva puruṣo ratanaṃ nidhānaṃ Rgs_29.7a	yaTa kaScid-eva puruzaH ratanam niDAnam RgH-_29.7a
   yatha kumbhadāsi avaśāvaśa bhartikasya Rgs_29.11c	yaTa kumBa-dAsi avaSAvaSa Bartikasya Rc-H-_29.11c
   yatha gaṅgavālikasamaiḥ sugatasya stūpaiḥ Rgs_3.2d	yaTa gaFgavAlika-samEH sugatasya stUpEH RgH-_3.2d
   yatha citrakarmapariniṣṭhita cakṣuhīno Rgs_7.2c	yaTa citrakarma-parinizWita cakzu-hInaH Rc-H-_7.2c
   yatha jambudvīpaka manuṣya alabdhapūrvā Rgs_29.4a	yaTa jambudvIpaka manuzya alabDa-pUrvAH RgH-_29.4a
   yatha jambudvīpi bahuvṛkṣasahasrakoṭī Rgs_4.6a	yaTa jambudvIpi bahu-vRkza-sahasra-kowI RgH-_4.6a
   yatha jīvitendriya niruddhi ya kecidanye Rgs_25.5a	yaTa jIvita-indriya nirudDi yaH kecid-anye RgH-_25.5a
   yatha te ca māya tatha jānati sarvasattvāṃ Rgs_1.19c	yaTa te ca mAya taTa jAnati sarva-sattvAm Rc-H-_1.19c
   yatha te jinā kuśala eva prajānayanti Rgs_6.8b	yaTa te jinAH kuSalaH eva prajAnayanti Rc-H-_6.8b
   [yatha te bhavanti vidu āśayasaṃprayuktā Rgs_24.2a	[yaTa te Bavanti vidu ASaya-saMprayuktAH RgH-_24.2a
   yatha nāyako 'sthitaku dhātuasaṃskṛtāyā Rgs_2.3a	yaTa nAyakaH asTitaku DAtua-saMskRtAyAH RgH-_2.3a
   yatha nāviko kuśala gacchati ārapāram Rgs_19.6c	yaTa nAvikaH kuSala gacCati Ara-pAram Rc-H-_19.6c
   yatha nirmito puruṣa no va adṛśyakāyo Rgs_20.20a	yaTa nirmitaH puruza naH vaH adRSya-kAyaH RgH-_20.20a
   yatha nopatapta asato bhujagādhipasya Rgs_5.7a	yaTa na-upatapta asataH Bujaga-aDipasya RgH-_5.7a
   yatha prajñapāramita śūnyata lakṣaṇena Rgs_22.4a	yaTa prajQapAramita SUnyata lakzaNena RgH-_22.4a
   yatha buddha nirmita karoti ca buddhakāryaṃ Rgs_26.7a	yaTa budDa nirmita karoti ca budDa-kAryam RgH-_26.7a
   yatha bhojanaṃ śatarasaṃ labhiyāna kaścit Rgs_11.5a	yaTa Bojanam Sata-rasam laBiyAna kaScid Rc-H-_11.5a
   yatha māyakārapuruṣasya na eva bhoti Rgs_26.5a	yaTa mAya-kAra-puruzasya naH eva Boti RgH-_26.5a
   yatha rāgadharmacaritaḥ puruṣaḥ striyāye Rgs_18.3a	yaTa rAga-Darma-caritaH puruzaH striyAye Rc-H-_18.3a
   yatha rājaniśrita naro labhi sarvi pūjāṃ Rgs_4.2c	yaTa rAja-niSrita naraH laBi sarvi pUjAm Rc-H-_4.2c
   yatha rājaputra dhanadāyaku arthakāmo Rgs_23.3a	yaTa rAja-putra Dana-dAyaku arTa-kAmaH RgH-_23.3a
   yathavādi sattvakaruṇānugatāvasthānaḥ Rgs_27.3d	yaTava-Adi sattva-karuNa-anugata-avasTAnaH RgH-_27.3d
   yatha śaṅkitena viṣasaṃjñata abhyupaiti Rgs_22.6a	yaTa SaFkitena viza-saMjQate aByupEti RgH-_22.6a
   yatha sarvasattva tatha prajānati sarvadharmān Rgs_1.26b	yaTa sarva-sattva taTa prajAnati sarva-DarmAn Rc-H-_1.26b
   yada dharma saṃskṛta asaṃskṛta kṛṣṇaśuklo Rgs_7.3a	yada Darma saMskRta asaMskRta kRzNa-SuklaH RgH-_7.3a
   yada prajñapāramita gacchati saṃkhya loke Rgs_7.3c	yada prajQapAramita gacCati saMKya loke Rc-H-_7.3c
   yadahaṃ imāya varapāramitāya āsī Rgs_2.13b	yat-aham imAya vara-pAramitAya AsI Rc-H-_2.13b
   yadi anya vyākṛtaku manyati bodhisattvo Rgs_21.1c	yadi anyaH vyAkRtaku manyati boDisattvaH Rc-H-_21.1c
   yadi icchathā spṛśitu uttamabuddhajñānam Rgs_7.7b	yadi icCaTA spRSitu uttama-budDa-jQAnam Rc-H-_7.7b
   yadi kalpakoṭi daśabhī kuśalaiḥ pathebhiś Rgs_31.5a	yadi kalpa-kowi daSaBI kuSalEH paTeBiH RgH-_31.5a
   yadi pañca kāmaguṇa bhuñjati bodhisattvo Rgs_31.4a	yadi paQca kAma-guNa BuQjati boDisattvaH RgH-_31.4a
   yadi pṛcchamāna cari indriya bodhisattvo Rgs_20.21a	yadi pRcCamAna cari indriya boDisattvaH RgH-_20.21a
   yadi bodhisattva caramāṇu jināna mārge Rgs_31.7a	yadi boDisattva caramANu jinAna mArge RgH-_31.7a
   yadi bodhisattva dadamāna jagasya dānaṃ Rgs_31.18a	yadi boDisattva dadamAna jagasya dAnam RgH-_31.18a
   yadi bodhisattva viharāti samādhidhyāne Rgs_29.9a	yadi boDisattva viharAti samADi-DyAne RgH-_29.9a
   yadyāpi pañca ima pāramitā jinānāṃ Rgs_16.5a	yadya-api paQca ima pAramitA jinAnAm RgH-_16.5a
   yadyāpi saṃmukha na vyākṛtu nāyakeno Rgs_10.6c	yadya-api saMmuKa na vyAkRtu nAyakena-U Rc-H-_10.6c
   yannirvṛte 'pi jinadhātu labhanti pūjām Rgs_4.4b	yat-nirvRte api jinaDAtu laBanti pUjAm Rc-H-_4.4b
   yaścaiava prajñavarapāramitābhiyukto Rgs_22.9a	yaH-ca-eava prajQavara-pAramitA-aBiyuktaH RgH-_22.9a
   yaścaiva prajña ima pāramitā likhitvā Rgs_5.3c	yaH-ca-eva prajQaH ima pAramitA liKitvA Rc-H-_5.3c
   yaścaiva prajñavarapāramitāprayukto Rgs_18.4c	yaH-ca-eva prajQavara-pAramitA-prayuktaH Rc-H-_18.4c
   yaścaiva buddhatanayāna(ca) śrāvakāṇāṃ Rgs_6.4a	yaH-ca-eva budDa-tana-yAna(ca) SrAvakANAm RgH-_6.4a
   yaścaiva ratnabharitaṃ trisahasra dadyāt Rgs_30.9b	yaH-ca-eva ratna-Baritam tri-sahasra dadyAt Rc-H-_30.9b
   yaśco imāṃ sugatamāta likhitva puste Rgs_3.4a	yaH-caH imAm sugata-mAta liKitva puste Rc-H-_3.4a
   yaśco upāyakuśalo vidu bodhisattvo Rgs_31.16a	yaH-caH upAya-kuSalaH vidu boDisattvaH RgH-_31.16a
   yasminna kāyu na pi citta na sattvasaṃjñā Rgs_30.7a	yasmin-na kAyu na pi citta na sattva-saMjQAH RgH-_30.7a
   yasminna prajñavarapāramitopalabdhiḥ Rgs_1.5a	yasmin-na prajQavara-pAramitA-upalabDiH RgH-_1.5a
   yasmin na rūpa api vedana cāpi saṃjñā Rgs_5.2a	yasmin na rUpa api vedana ca-api saMjQA RgH-_5.2a
   yasmin na skandha na pi āyatanaṃ na dhātu Rgs_18.2c	yasmin na skanDa na pi Ayatanam na DAtu Rc-H-_18.2c
   yasmiṃ karaṇḍaki bhave sa namasyanīyaḥ Rgs_4.3b	yasmim karaNxaki Bave sa namasyanIyaH Rc-H-_4.3b
   yasmiṃśca kāli vidu paṇḍitu bodhisattvo Rgs_20.7a	yasmin=-ca kAli vidu paNxitu boDisattvaH RgH-_20.7a
   yasmiṃś ca kāli samaye vidu bodhisattvo Rgs_1.24a	yasmin ca kAli samaye vidu boDisattvaH RgH-_1.24a
   yasyāmi śraddha sugate dṛḍha bodhisattvo Rgs_14.1a	yasyAmi SradDa sugate dRXa boDisattvaH RgH-_14.1a
   yasyo na asti ahasaṃjña na sattvasaṃjñā Rgs_31.8a	yasyaH na asti ahasaMjQa na sattva-saMjQAH RgH-_31.8a
   yasyo na saṃvari asaṃvari manyanāsti Rgs_31.8c	yasyaH na saMvari asaMvari manyanAsti Rc-H-_31.8c
   yaṃ kāli maitri jagatī anubandhayitvā Rgs_20.19a	yam kAli mEtri jagatI anubanDayitvA RgH-_20.19a
   yaḥ sarvaśikṣavidu icchati pāra gantum Rgs_28.1c	yaH sarva-Sikza-vidu icCati pAra gantum Rc-H-_28.1c
   yāvat su dharmakṣayakālu vināyakānām Rgs_6.3b	yAvat su Darma-kzaya-kAlu vinAyakAnAm Rc-H-_6.3b
   yāvanta buddhasama śrāvakapratyayāśca Rgs_28.4a	yAvanta budDa-sama SrAvaka-pratyayAH-ca Rc-H-_28.4a
   yāvanta śrāvakavihāra sapratyayānāṃ Rgs_27.7a	yAvanta SrAvaka-vihAra sa-pratyayAnAm RgH-_27.7a
   yāvanta sattva kuśalārthika mokṣakāmā Rgs_26.2a	yAvanta sattva kuSala-arTika mokza-kAmAH RgH-_26.2a
   yāvanta sattva tribhave nikhilena asti Rgs_31.15a	yAvanta sattva tri-Bave niKilena asti RgH-_31.15a
   yāvanta sattva nikhile iha jambudvipe Rgs_22.8a	yAvanta sattva niKile iha jambu-dvipe RgH-_22.8a
   yāvanta sattva puna tāntaka kṣetrakoṭyo Rgs_3.3a	yAvanta sattva puna tAntaka kzetra-kowyaH RgH-_3.3a
   yāvanta sattva mṛdumadhyamutkṛṣṭa loke Rgs_28.5a	yAvanta sattva mRdu-maDyam-utkRzwa loke RgH-_28.5a
   yāvanti kṣānti rahapratyayasattvadhātoḥ Rgs_30.12c	yAvanti kzAnti raha-pratyaya-sattva-DAtoH Rc-H-_30.12c
   yāvanti gaṅganadivālikatulyakṣetre Rgs_5.3a	yAvanti gaFgana-divAlika-tulya-kzetre RgH-_5.3a
   yāvanti gaṅganadivālisame hi kṣetre Rgs_27.2a	yAvanti gaFgana-divAli-same hi kzetre RgH-_27.2a
   yāvanti cittakṣaṇikā khiladoṣayuktās Rgs_24.5c	yAvanti citta-kzaNikA Kila-doza-yuktAH Rc-H-_24.5c
   yāvanti cittacaritā divasena tasya Rgs_18.3c	yAvanti citta-caritAH divasena tasya Rc-H-_18.3c
   yāvanti jñāna nayadvāra uyāyamūlāḥ Rgs_28.6a	yAvanti jQAna naya-dvAraH uyAya-mUlAH Rc-H-_28.6a
   yāvanti duḥkha jagatī ahu tatsahāmi Rgs_30.14c	yAvanti duHKa jagatI ahu tat-sahAmi Rc-H-_30.14c
   yāvanti dharma jinaśrāvaka deśayanti Rgs_1.3a	yAvanti Darma jinaSrAvaka deSayanti RgH-_1.3a
   yāvanti nadya pravahantiha jambudvīpe Rgs_1.2a	yAvanti nadya pravahantiha jambudvIpe RgH-_1.2a
   yāvanti buddhakriya dharmata śrāvakāṇāṃ Rgs_13.1c	yAvanti budDakriya Darmata SrAvakANAm Rc-H-_13.1c
   yāvanti bodhiguṇa pāramitāśca pañca Rgs_3.7c	yAvanti boDi-guNa pAramitAH-ca paQca Rc-H-_3.7c
   yāvanti loki upalambhikabodhisattvā Rgs_6.9c	yAvanti loki upalamBika-boDisattvAH Rc-H-_6.9c
   yāvanti loki kvaci jotikaprāṇabhūtā Rgs_5.9a	yAvanti loki kvaci jotika-prANa-BUtAH RgH-_5.9a
   yāvanti loki parikīrtita dharmanāma Rgs_1.27a	yAvanti loki parikIrtita Darma-nAmaH Rc-H-_1.27a
   yāvanti vṛkṣa phalapuṣpavanaspatī yā Rgs_28.3a	yAvanti vRkza Pala-puzpa-vanaspatI yAH RgH-_28.3a
   yāvanti śikṣa paridīpita nāyakena Rgs_28.1a	yAvanti Sikza paridIpita nAyakena RgH-_28.1a
   yāvanti śrāvakagaṇāḥ prasavanti puṇyaṃ Rgs_6.1a	yAvanti SrAvaka-gaNAH prasavanti puNyam RgH-_6.1a
   yāvanti śrāvakaguṇān parikalpa sthāne Rgs_31.15d	yAvanti SrAvaka-guNAn parikalpa sTAne RgH-_31.15d
   yāvanti sattva tribhave samanvāharitvā Rgs_31.13b	yAvanti sattva tri-Bave samanvAharitvA Rc-H-_31.13b
   yāvanti saṃvarakriya anuvartayanti Rgs_31.1c	yAvanti saMvara-kriya anuvartayanti Rc-H-_31.1c
   yāvanna te kuśalamūla bhavanti pūrṇāḥ Rgs_20.10d	yAvat-na te kuSala-mUla Bavanti pUrNAH RgH-_20.10d
   yā sarvadharmatathatā tathatārhatānāṃ Rgs_16.2c	yA sarva-Darma-taTatA taTatArhatAnAm Rc-H-_16.2c
   yāṃ śrutva śrāvaka spṛśanti vimukti śīghraṃ Rgs_5.4c	yAm Srutva SrAvaka spRSanti vimukti SIGram Rc-H-_5.4c
   yugamātraprekṣiṇa vrajantyabhrāntacintā Rgs_17.3d	yuga-mAtra-prekziNa vrajanti-aBra-anta-cintAH RgH-_17.3d
   yuta śīghra vidyuta yathā parihāyiṣyanti Rgs_11.2c	yuta SIGra vidyuta yaTA parihAyizyanti Rc-H-_11.2c
   yūyaṃ buddhāḥ subhavanagatā bodhisattvāḥ kṣamadhvam Rgs_LPr_1d	yUyam budDAH su-Bavana-gatAH boDisattvAH kzamaDvam Rc-H-_LPr_1d
   ye atra saṃjñavigamaṃ anuprāpnuvanti Rgs_2.11c	ye atra saMjQa-vigamam anuprApnuvanti Rc-H-_2.11c
   ye ādikarmika na deśayitavya evam Rgs_15.3d	ye Adikarmika na deSayitavyaH evam RgH-_15.3d
   ye cāpi tasmi samaye imu dharma śreṣṭhaṃ Rgs_11.7a	ye ca-api tasmi samaye imu Darma SrezWam RgH-_11.7a
   ye cāpi pañca imi pāramitā jinānām Rgs_18.8a	ye ca-api paQca imi pAramitA jinAnAm Rc-H-_18.8a
   ye cāpi śrāvakaguṇā tatha pratyayānāṃ Rgs_25.6a	ye ca-api SrAvaka-guNA taTa pratyayAnAm RgH-_25.6a
   ye 'tīta ye 'pi ca daśaddiśa lokanāthā Rgs_3.5c	ye atIta ye api ca daSat-diSa lokanATAH Rc-H-_3.5c
   ye 'tīta ye 'pi ca daśaddiśi lokanāthā Rgs_12.2a	ye atIta ye api ca daSat-diSi lokanATAH RgH-_12.2a
   ye te bhavanti ratanā ya anarghaprāptā Rgs_11.9a	ye te Bavanti ratanA yaH anarGa-prAptAH RgH-_11.9a
   ye te bhavanti varaprajñaparigṛhītā Rgs_14.4a	ye te Bavanti vara-prajQa-parigRhItAH RgH-_14.4a
   yenaiva prajña iya pāramitā jinānāṃ Rgs_3.8c	yena-eva prajQaH iya pAramitA jinAnAm Rc-H-_3.8c
   yenaiva rāja vrajate sa ha cakravartī Rgs_3.8a	yena-eva rAja vrajate sa ha cakravartI RgH-_3.8a
   ye buddhakoṭiniyutā purimā vyatītā Rgs_6.2a	ye budDa-kowi-niyutA purimA vyatItAH RgH-_6.2a
   ye vā anantabahukṣetrasahasrakoṭayaḥ Rgs_6.2b	ye vE ananta-bahu-kzetra-sahasra-kowayaH Rc-H-_6.2b
   ye vā caranti cariyāṃ hitasānukampām Rgs_3.6a	ye vA caranti cariyAm hita-sa-anukampAm Rc-H-_3.6a
   ye saukhya saṃskṛta asaṃskṛta ye ca saukhyā Rgs_3.6c	ye sOKya saMskRta asaMskRta ye ca sOKyAH Rc-H-_3.6c
   yehī samākulikṛtā bahu bhikṣu tatra Rgs_11.8c	yehI samAkuli-kRtAH bahu Bikzu tatra Rc-H-_11.8c
   yo ādikarma sthitu bhūmiya bodhisattvo Rgs_15.1a	yaH Adikarma sTitu BUmiya boDisattvaH RgH-_15.1a
   yo icchatī sugataśrāvaka haṃ bhaveyaṃ Rgs_2.4a	yaH icCatI sugata-SrAvaka ham Baveyam RgH-_2.4a
   yo eva paśyati sa paśyati sarvadharmān Rgs_13.1a	yaH eva paSyati sa paSyati sarva-DarmAn Rc-H-_13.1a
   yo eva yujyati(sa yujyati)bodhisattvaḥ Rgs_10.1d	yaH eva yujyati(sa yujyati)boDisattvaH RgH-_10.1d
   yo evaśīlasamanvāgatu niṣprapañco Rgs_31.9a	yaH eva-SIla-samanvAgatu nizprapaQcaH RgH-_31.9a
   yo eva śrutva abhimanyati bodhisattvo Rgs_21.3c	yaH eva Srutva aBimanyati boDisattvaH Rc-H-_21.3c
   yo gṛhṇate vrajati pārasthalaṃ prayāti Rgs_14.2d	yaH gRhNate vrajati pAra-sTalam prayAti RgH-_14.2d
   yo cittupādu anumoditu āśayena Rgs_26.1b	yaH cittupAdu anumoditu ASayena Rc-H-_26.1b
   yo tu pratītyasamutpādu anudbhavāye Rgs_28.7a	yaH tu pratItyasamutpAdu anudBavAye RgH-_28.7a
   yo dharma bodhiguṇaāgamu sūratānāṃ Rgs_31.3a	yaH Darma boDi-guNaAgamu sUratAnAm RgH-_31.3a
   yo dharma bodhiguṇahāni hitaṃkarāṇāṃ Rgs_31.3c	yaH Darma boDi-guNa-hAni hitaMkarANAm Rc-H-_31.3c
   yo dharma bhāṣyati ya bhāṣyati bhāṣyamāṇāṃ Rgs_2.5a	yaH Darma BAzyati yaH BAzyati BAzyamANAm RgH-_2.5a
   yo pañcayojanaśate girikandareṣu Rgs_21.6a	yaH paQca-yojana-Sate giri-kandarezu RgH-_21.6a
   yo pāpamitrasahito ca parapraṇeyo Rgs_1.15c	yaH pApa-mitra-sahitaH ca para-praNeyaH Rc-H-_1.15c
   yo bodhisattva adhimucyati bhāṣyamāṇām Rgs_27.4a	yaH boDisattvaH aDimucyati BAzyamANAm Rc-H-_27.4a
   yo bodhisattva ayu vyākṛtu vyākṛtasmiṃ Rgs_24.5a	yaH boDisattva ayu vyAkRtu vyAkRtasmim RgH-_24.5a
   yo bodhisattva avikalpaku sarvadharmān Rgs_26.3a	yaH boDisattva avikalpaku sarva-DarmAn Rc-H-_26.3a
   yo bodhisattva imi icchati prāpuṇetuṃ Rgs_16.3a	yaH boDisattvaH imi icCati prApuNetum RgH-_16.3a
   yo bodhisattva imu jānati eva śikṣāṃ Rgs_25.2a	yaH boDisattvaH imu jAnati eva SikzAm RgH-_25.2a
   yo bodhisattva imu budhyati eva dharmāṃ Rgs_18.2a	yaH boDisattvaH imu buDyati eva DarmAm RgH-_18.2a
   yo bodhisattva cirasaṃsaraṇābhiprāyo Rgs_30.1a	yaH boDisattva cira-saMsaraNa-aBiprAyaH RgH-_30.1a
   yo bodhisattva parijānati eva dharmāṃ Rgs_1.7c	yaH boDisattva parijAnati eva DarmAm Rc-H-_1.7c
   yo bodhisattva bahukalpasahasrakoṭayo Rgs_18.4a	yaH boDisattva bahu-kalpa-sahasra-kowayaH RgH-_18.4a
   yo bodhisattva varapāramiteti cīrṇo Rgs_7.5a	yaH boDisattva vara-pAramitA-iti cIrNaH RgH-_7.5a
   yo bodhisattva varaprajña vibhāvayanto Rgs_18.5a	yaH boDisattva vara-prajQa viBAvayantaH RgH-_18.5a
   yo śikṣate sa iha śikṣati buddhadharme Rgs_25.1d	yaH Sikzate saH iha Sikzati budDa-Darme RgH-_25.1d
   yo śikṣamāṇu na upaiti kahiṃci śikṣāṃ Rgs_25.1a	yaH Sikzam-ANu naH upEti kahiMci SikzAm RgH-_25.1a
   yo śuddha so anabhisaṃskṛtu niṣprapañco Rgs_1.23c	yaH SudDa saH anaBisaMskRtu nizprapaQcaH Rc-H-_1.23c
   yo śrutva dharmi imi nirmitamāyakalpāṃ Rgs_10.2c	yaH Srutva Darmi imi nirmita-mAya-kalpAm Rc-H-_10.2c
   yo sarvasattvaguṇaagratu gantukāmo Rgs_27.9a	yaH sarva-sattva-guNa-agratu gantu-kAmaH RgH-_27.9a
   yo 'sau dharmaṃ sugatagaditaṃ paṭhate bhaktibhāvān Rgs_LPr_1a	yaH asO Darmam sugata-gaditam paWate Bakti-BAvAn RgH-_LPr_1a
   yo 'sau na vidyati sa eṣa avidyamāno Rgs_1.13a	yaH asO na vidyati saH eza avidyamAnaH RgH-_1.13a
   rakṣantu śīla pariṇāmayi agrabodhiṃ Rgs_31.6a	rakzantu SIla pariNAmayi agra-boDim RgH-_31.6a
   raṇyā vivikta vanaprastha niṣevamāṇo Rgs_21.4b	raNyA vivikta vana-prasTa nizevamANaH Rc-H-_21.4b
   ratanaṃ va labdhva gṛhamāṇu abhinnasattvo Rgs_22.13c	ratanam va labDva gRhamANu aBinna-sattvaH Rc-H-_22.13c
   ratanārthiko yatha vrajitvana ratnadvīpaṃ Rgs_20.15a	ratana-arTikaH yaTa vrajitvana ratnadvIpam RgH-_20.15a
   rati chanda vīkṣati spṛśiṣyati bodhi śīghram Rgs_10.8d	rati Canda vIkzati spRSizyati boDi SIGram RgH-_10.8d
   raśmīgate na sthihate purato 'ndhakāram Rgs_25.3d	raSmI-gate na sTihate puratas anDakAram RgH-_25.3d
   rasa sparśa kāmaguṇa pañcabhi yukta bhogī Rgs_29.10b	rasa sparSa kAma-guNa paQcaBi yukta BogI Rc-H-_29.10b
   rahapratyayāna vigato 'nantabodhisattvo Rgs_29.10c	raha-pratyayAna vigataH ananta-boDisattvaH Rc-H-_29.10c
   rahapratyayāni spṛhatāṃ janayanti tatra Rgs_21.5b	raha-pratyayAni spRhatAm janayanti tatra Rc-H-_21.5b
   rahapratyayāni spṛhabuddhi na saṃjaneyyā Rgs_29.9b	raha-pratyayAni spRha-budDi na saMjaneyyAH Rc-H-_29.9b
   rātriṃdivaikamanasā tamadhiṣṭhiheyā Rgs_30.3c	rAtriMdiva-eka-manasA tam-aDizWi-heyAH Rc-H-_30.3c
   rupasmi yo na sthihate na ca vedanāyāṃ Rgs_2.1a	rupasmi yaH na sTihate na ca vedanAyAm RgH-_2.1a
   rupaṃ ca saṃjña api vedana cetanā ca Rgs_1.20a	rupam ca saMjQa api vedana cetanA ca RgH-_1.20a
   rupe na prajña iti rupi na asti prajñā Rgs_2.9a	rupe na prajQaH iti rupi na asti prajQA RgH-_2.9a
   rūpasmi yo na carate pariśuddhacārī Rgs_8.4a	rUpasmi yaH na carate pariSudDa-cArI RgH-_8.4a
   rūpasya darśanu adarśanu vedanāye Rgs_12.8a	rUpasya darSanu adarSanu vedanAye RgH-_12.8a
   rūpasya śuddhi phalaśuddhita veditavyā Rgs_8.1a	rUpasya SudDi Pala-SudDita veditavyAH RgH-_8.1a
   laghu prāpsyate anabhibhū(tu) jināna bodhim Rgs_14.1d	laGu prApsyate anaBiBU(tu) jinAna boDim RgH-_14.1d
   labdhvā tu tatra spṛhabuddhi na saṃjaneyyā Rgs_29.7b	labDvA tu tatra spRha-budDi na saMjaneyyAH Rc-H-_29.7b
   labdhvāna dhyāna bala indriya bodhisattvo Rgs_20.16b	labDvA-anaH DyAna balaH indriya boDisattvaH Rc-H-_20.16b
   labdhvāna prīti sukhadāṃ vidu bodhisattvāḥ Rgs_29.8b	labDvA-ana prIti suKa-dAm vidu boDisattvAH Rc-H-_29.8b
   labdhvāna ratna puna gehamupāgameyyā Rgs_20.15b	labDvA-ana ratna puna geham-upAgameyyAH Rc-H-_20.15b
   likhamāna prajña imu pāramitā jinānām Rgs_11.2b	liKamAna prajQaH imu pAramitA jinAnAm Rc-H-_11.2b
   loka(sya) darśika janetri jināna mātā Rgs_12.2c	loka(sya) darSika janetri jinAna mAtA Rc-H-_12.2c
   lokasya yā tathata yā tathatārhatānāṃ / Rgs_12.3a	lokasya yA taTata yA taTatArhatAnAm / RgH-_12.3a
   lokaṃ prāpayituṃ sukhena padavīṃ saṃpaddūyāvāhinīṃ Rgs_HPr_1a	lokam prApayitum suKena padavIm saMpad-dUyA-vAhinIm Rc-H-_HPr_1a
   lokārthaṃ hariṇā mayā suvihitā seyaṃ budhairgṛhyatām Rgs_HPr_2d	loka-arTam hariNA mayA su-vihitA sA-iyam buDEH-gRhyatAm Rc-H-_HPr_2d
   lokena sārdha ayu vigrahu prādubhūto Rgs_15.8d	lokena sa-arDa ayu vigrahu prAdu-BUtaH RgH-_15.8d
   varaprajñapāramitaāśayasaṃprayogo Rgs_14.1b	vara-prajQapAramitaA-ASaya-saMprayogaH Rc-H-_14.1b
   varasūryamaṇḍalaviniḥsṛta ekaraśmī Rgs_5.9c	vara-sUrya-maNxala-viniHsRtaH eka-raSmI Rc-H-_5.9c
   vartitva cakraratanaṃ puruṣarṣabhāṇāṃ Rgs_32.4c	varti-tva cakraratanam puruza-RzaBANAm Rc-H-_32.4c
   vicaranti vīryabalapāramitābhiyuktāḥ Rgs_29.11b	vicaranti vIrya-bala-pAramitA-aBiyuktAH Rc-H-_29.11b
   vijñānacittamanudarśanu yatra nāsti Rgs_12.8c	vijQAna-cittam-anudarSanu yatra na-asti Rc-H-_12.8c
   vijñāna naiva na pi cetanayopalabdhiḥ Rgs_5.2b	vijQAna na-eva na pi cetanaya-upalabDiH Rc-H-_5.2b
   vijñāna bandhu na ca mukta asaṅgabhūto Rgs_1.20b	vijQAna banDu na ca muktaH asaFga-BUtaH Rc-H-_1.20b
   vijñāna saṃjña api vedana cetanā ca Rgs_2.9b	vijQAna saMjQa api vedana cetanA ca Rc-H-_2.9b
   vijñāna saṃjña api vedana cetanāyām Rgs_8.4b	vijQAna saMjQa api vedana cetanAyAm Rc-H-_8.4b
   vijñāna saṃjña prakṛtī animittaśāntā Rgs_18.1b	vijQAna saMjQa prakRtI animitta-SAntAH Rc-H-_18.1b
   vijñāna skandha caratī aprajānamāno Rgs_1.9b	vijQAna skanDa caratI aprajAnamAnaH Rc-H-_1.9b
   vijñāna sthānu aṇumātra na bhonti tasya Rgs_1.6b	vijQAna sTAnu aNumA-atra na Bonti tasya Rc-H-_1.6b
   vijñāni yo na caratī aniketacārī Rgs_1.10b	vijQAni yaH na caratI aniketa-cArI Rc-H-_1.10b
   vijñāni yo na sthihate sthitu dharmatāyāṃ Rgs_2.1c	vijQAni yaH na sTihate sTitu Darma-tAyAm Rc-H-_2.1c
   vidu pāku naiva pratikāṅkṣati so kadācit Rgs_31.14b	vidu pAku na-eva pratikAFkzati saH kadAcid Rc-H-_31.14b
   vidyā abhijña abhinirharate samādhim Rgs_32.3d	vidyA aBijQa aBinirharate samADim RgH-_32.3d
   vidyā avidya ubhi eti asanta dharmā Rgs_1.13c	vidyAH avidyaH uBi eti asanta DarmAH Rc-H-_1.13c
   vidyādharo va abhilambhu vanābhiprāyā Rgs_27.5c	vidyADaraH vaH aBilamBu vana-aBiprAyAH Rc-H-_27.5c
   vidhamitva dṛṣṭigahanaṃ vidu bodhisattvo Rgs_23.2b	viDamitva dRzwi-gahanam vidu boDisattvaH Rc-H-_23.2b
   vidhamitvavidyapaṭalaṃ bhavate svayaṃbhūḥ Rgs_28.7d	viDami-tva-vidya-pawalam Bavate svayaMBUH RgH-_28.7d
   vidhamitva sarva tamasākulamandhakāram Rgs_23.1b	viDamitva sarva tamasA-Akulam-anDakAram Rc-H-_23.1b
   vina prajña nāstyadhigamo naranāyakānām Rgs_16.3d	vina prajQa na-asti-aDigamaH nara-nAyakAnAm RgH-_16.3d
   vina prajña pañca imi pāramitā acakṣuḥ Rgs_7.1c	vina prajQa paQca imi pAramitAH acakzuH Rc-H-_7.1c
   vina bodhicitta jinasaṃbhavu nāsti loke Rgs_5.5c	vina boDi-citta jina-saMBavu na-asti loke Rc-H-_5.5c
   vilayamupaiti sadhanā saha vāṇijebhiḥ Rgs_14.7b	vilayam-upEti sa-DanA saha vANijeBiH Rc-H-_14.7b
   vilayaṃ prayāti jalamadhya aprāptatīro Rgs_14.2c	vilayam prayAti jala-maDye aprApta-tIraH Rc-H-_14.2c
   vividhāṃ kriyāṃ jagati darśayate anantāṃ Rgs_20.12c	viviDAm kriyAm jagati darSayate anantAm Rc-H-_20.12c
   viṣa vahni śastra udakaṃ na kramāti tasyo Rgs_3.1c	viza vahni Sastre udakam na kramAti tasyaH Rc-H-_3.1c
   viṣasṛṣṭa bhojanu yathaiva kriyāpraṇīto Rgs_6.7c	viza-sRzwa Bojanu yaTA-eva kriyA-praNItaH Rc-H-_6.7c
   vīryeṇa śuklaguṇa hāni na abhyupaiti Rgs_32.3a	vIryeNa Sukla-guNa hAni na aByupEti RgH-_32.3a
   vaiḍūryaratna abhibhoti sa sarva eko Rgs_31.17b	vExUrya-ratna aBiBoti sa sarve ekaH Rc-H-_31.17b
   vaidyottamo jagati rogacikitsakārī Rgs_32.6a	vEdya-uttamaH jagati roga-cikitsa-kArI RgH-_32.6a
   vaidyo va ātura svarogacikitsanārthaṃ Rgs_22.1c	vEdyaH vaH Atura sva-roga-cikitsana-arTam Rc-H-_22.1c
   vyālāvakīrṇi nivasedbahuvarṣakoṭī Rgs_21.6b	vyAla-avakIrNi nivaset-bahu-varza-kowI Rc-H-_21.6b
   vyuparīkṣate punarayaṃ katareṣu prajñā Rgs_1.8a	vyuparIkzate punar-ayam katarezu prajQA RgH-_1.8a
   vyuparīkṣamāṇu na ca līyati nāsti trāso Rgs_1.8c	vyuparIkzam-ANu na ca lIyati na-asti trAsaH Rc-H-_1.8c
   vyodāna ukta ahu mahya anopalabdhi Rgs_22.7b	vyodAnaH uktaH ahu mahya anopalabDi Rc-H-_22.7b
   śakro jinasya paripṛcchati devarājo Rgs_10.1a	SakraH jinasya paripRcCati devarAjaH RgH-_10.1a
   śakro jinena paripṛcchitu praśnamāhu Rgs_4.1a	SakraH jinena paripRcCitu praSnam-Ahu Rc-H-_4.1a
   śākhāpalāśa parieṣayiṣyanti mūḍhāḥ Rgs_11.4b	SAKA-palASa pariezayizyanti mUXAH Rc-H-_11.4b
   śāntā samādhipraśame sukhasaṃprayuktā Rgs_27.7b	SAntA samADi-praSame suKa-saMprayuktAH Rc-H-_27.7b
   śāntaiṣiṇāmayu vihāra guṇe ratānām Rgs_27.6d	SAnta-eziNA-mayu vihAra guNe ratAnAm RgH-_27.6d
   śikṣantu eva vidu prajña prabhaṃkarāṇāṃ Rgs_25.3a	Sikzantu eva vidu prajQa praBaMkarANAm RgH-_25.3a
   śikṣā aśikṣa ubhayo avikalpamāno Rgs_25.1c	SikzAH aSikzaH uBayaH avikalpamAnaH Rc-H-_25.1c
   śikṣāaśikṣa na ya śikṣati eṣa śikṣā Rgs_2.7d	SikzAa-Sikza na yaH Sikzati eza SikzAH RgH-_2.7d
   śikṣātiśikṣakuśalo ti nirūpalambho Rgs_25.2d	SikzA-ati-Sikza-kuSalaH ti nirUpa-lamBaH RgH-_25.2d
   śirachedakarṇacaraṇākaranāsachedāḥ Rgs_30.14b	SiraCeda-karNa-caraNa-Akara-nAsa-CedAH Rc-H-_30.14b
   śirahastapāda tyajamāna adīnacitto Rgs_31.9c	Sira-hasta-pAda tyajamAnaH adIna-cittaH Rc-H-_31.9c
   śīle ca kṣānti tatha vīrya tathaiva dhyāne Rgs_4. 5 b	SIle ca kzAnti taTa vIrya taTA-eva DyAne Rc-H-_4. 5 b
   śīlena udgata bhavanti samādhikāṅkṣī Rgs_31.1a	SIlena udgata Bavanti samADi-kAFkzI RgH-_31.1a
   śīlena tīryagati varjayi nekarupām Rgs_32.2a	SIlena tIrya-gati varjayi nekarupAm RgH-_32.2a
   śuciśaucaambaradharā trivivekaśuddhā Rgs_17.4a	Suci-SOca-ambara-DarA triviveka-SudDAH RgH-_17.4a
   śūnyānalakṣaṇa prajānayamāna dharmān Rgs_22.4c	SUnyAnalakzaNa prajAnayamAna DarmAn Rc-H-_22.4c
   śūnyānimitta avivartiyabodhidharmāṃ Rgs_20.21c	SUnya-animitta avivartiya-boDi-DarmAm Rc-H-_20.21c
   śūnyānimittacarito pṛthu bodhisattvo Rgs_23.2d	SUnya-animitta-caritaH pRTu boDisattvaH RgH-_23.2d
   śūnyānimitta parijānati niṣprapañcān Rgs_26.3b	SUnya-animitta parijAnati nizprapaQcAn Rc-H-_26.3b
   śūnyānimittapraṇidhiṃ caramāṇu dharmā Rgs_19.6a	SUnya-animitta-praNiDim caramANu DarmAH RgH-_19.6a
   śūnyānimittapraṇidhiṃ vimṛṣāti dharmān Rgs_20.14c	SUnya-animitta-praNiDim vimRzAti DarmAn Rc-H-_20.14c
   śūnyānimittapraṇidhī carate samādhim Rgs_20.19b	SUnya-animitta-praNiDI carate samADim Rc-H-_20.19b
   śūnyāvihāri na ca nirvṛti prāpuṇāti Rgs_27.8d	SUnya-avihAri na ca nirvRti prApuNAti RgH-_27.8d
   śūnyāvihāri bhavate na ca sattvatyāgī Rgs_27.3c	SUnya-avihAri Bavate na ca sattva-tyAgI Rc-H-_27.3c
   śṛṇutā jagārthamabhiprasthita sura(vra?)tānāṃ Rgs_1.1c	SRNutAH jagArTam-aBiprasTita sura-(vra?)tAnAm Rc-H-_1.1c
   śṛṇu tāta yo labhati bodhi gaveṣamāṇaḥ Rgs_10.4b	SRNu tAta yaH laBati boDi gavezamANaH Rc-H-_10.4b
   śaikṣa aśaikṣa kuśalāsrava nāsravāśca Rgs_6.4b	SEkza aSEkza kuSala-Asrava na-AsravAH-ca Rc-H-_6.4b
   śokātu duḥkhitu anantamano 'lpasthāmo Rgs_24.1b	SokAtu duHKitu ananta-manaH alpa-sTAmaH Rc-H-_24.1b
   śruṇanāya chandika utpādayiṣyanti śraddhām Rgs_11.7b	SruNanAya CandikaH utpAdayizyanti SradDAm Rc-H-_11.7b
   śruṇamāṇa prajña imi pāramitā jinānām Rgs_10.6b	SruNamANa prajQaH imi pAramitA jinAnAm Rc-H-_10.6b
   śrutvā ca so imu kṣipiṣyati so 'lpabuddhiḥ Rgs_7.6c	SrutvA ca saH imu kzipizyati saH alpabudDiH Rc-H-_7.6c
   śrutvā te 'khiladharmatattvanilayaṃ sūtraṃ samādānato Rgs_HPr_1c	SrutvA te aKila-Darma-tattva-nilayam sUtram samAdAnataH Rc-H-_HPr_1c
   ṣaḍapīha ekanayamarchati bodhināmā Rgs_4.7d	zaz-api-ihaH ekanayam-arCati boDi-nAmA RgH-_4.7d
   sa kṣipitva yāsyati avīcimatrāṇabhūto Rgs_7.6d	sa kzipitva yAsyati avIcima-trANa-BUtaH RgH-_7.6d
   saṅgā uchinnu vrajate jagatī asakto Rgs_9.1b	saFgAH uCinnu vrajate jagatI asaktaH Rc-H-_9.1b
   saṅgādvimucya carate sugatāna prajñām Rgs_8.4d	saFgAt-vimucya carate sugatAna prajQAm RgH-_8.4d
   saci eva jānati nirudhyati kṣīṇadharmā Rgs_6.6a	saci eva jAnati niruDyati kzINa-DarmAH RgH-_6.6a
   saci kalpakoṭi gaṇaye vidu bodhisattvo Rgs_30.2a	saci kalpa-kowi gaNaye vidu boDisattvaH RgH-_30.2a
   saci kaści candanapuṭaṃ grahiyāna sattvo Rgs_30.11a	saci kaSci candana-puwam grahiyAna sattvaH RgH-_30.11a
   saci kaścideva vadayeya sumeruśailaṃ Rgs_30.4a	saci kaScid-eva vadayeya sumeru-SElam RgH-_30.4a
   saci kāyacittavacasā ca parākrameyyā Rgs_30.6a	saci kAya-citta-vacasA ca parAkrameyyAH RgH-_30.6a
   saci khedabuddhi kurute ca pramāṇabuddhiṃ Rgs_30.4c	saci Keda-budDi kurute ca pramANa-budDim Rc-H-_30.4c
   saci gaṅgavālikasamā siya buddhakṣetrāḥ Rgs_4.1b	saci gaFgavAlika-samA siya budDa-kzetrAH Rc-H-_4.1b
   saci gaṅgavālukasamāni sthihitva kalpāṃ Rgs_2.12a	saci gaFga-vAluka-samAni sTihitva kalpAm RgH-_2.12a
   saci paśyate drumavanaspatiśailarājam Rgs_10.5b	saci paSyate druma-vanaspati-SEla-rAjam Rc-H-_10.5b
   saci pratyayānarahabodhi spṛhāṃ janeti Rgs_31.2a	saci pratyayAnaraha-boDi spRhAm jana-iti Rc-H-_31.2a
   saci manyate ahu carāmi jināna prajñāṃ Rgs_7.4a	saci manyate ahu carAmi jinAna prajQAm RgH-_7.4a
   saci rupa saṃjña api vedana cetanā ca Rgs_1.9a	saci rupa saMjQa api vedana cetanA ca RgH-_1.9a
   saci rūpa saṃjña api vedana cetanāyāṃ Rgs_5.1a	saci rUpa saMjQa api vedana cetanAyAm RgH-_5.1a
   saci sattvasaṃjña dukhasaṃjña upādayātī Rgs_1.25a	saci sattva-saMjQa duKa-saMjQaH upAdayAtI RgH-_1.25a
   saci so nimitta kurute na ca mānayāti Rgs_6.7a	saci saH nimitta kurute na ca mAnayAti RgH-_6.7a
   satataṃ amoghu paribhuñjati rāṣṭrapiṇḍam Rgs_22.10d	satatam amoGu pariBuQjati rAzwra-piNxam RgH-_22.10d
   satataṃ samāhitu prajānayitavya śūro Rgs_29.10d	satatam samAhitu prajAnayitavyaH SUraH RgH-_29.10d
   satkāyadṛṣṭi yatha ṣaṣṭi duve ca dṛṣṭī Rgs_25.4c	sat-kAya-dRzwi yaTa zazwi duve ca dRzwiH Rc-H-_25.4c
   satkārakāma bhaviṣyanti ca lābhakāmāḥ Rgs_11.6a	satkAra-kAma Bavizyanti ca lABa-kAmAH RgH-_11.6a
   satkṛtya buddhaniyutāṃ paricārikāyāṃ Rgs_7.6a	satkRtya budDa-niyutAm paricArikAyAm RgH-_7.6a
   sattvarthi te jinaguṇa ananta prāpuṇitvā Rgs_26.2c	sattva-rTi te jina-guNa ananta prApuNitvA Rc-H-_26.2c
   sattvaśca ālayarato viṣayābhilāṣī Rgs_15.8a	sattvaH-ca Alaya-rataH vizaya-aBilAzI RgH-_15.8a
   sattvasyupādu kutu bheṣyati ādiśuddho Rgs_2.12c	sattvasi-upAdu kutu Bezyati AdiSudDaH Rc-H-_2.12c
   sattvā ta sarvi parikalpa bhaveyu mārāḥ Rgs_27.2b	sattvAH te sarvi parikalpa Baveyu mArAH Rc-H-_27.2b
   sattvāna karmaupabhoganidānameva Rgs_20.5c	sattvAna karma-OpaBoga-nidAnam-eva Rc-H-_20.5c
   sattvāna jñānapraṇidhānaadhiṣṭhānameva Rgs_20.6c	sattvAna jQAna-praNiDAna-aDizWAnam-eva Rc-H-_20.6c
   sattvāna yā ca prakṛtī sa anantapārā Rgs_2.10b	sattvAna yA ca prakRtI sa ananta-pArAH Rc-H-_2.10b
   [sattvāna śūnyavaradharma niśāmayātī Rgs_30.10c	[sattvAna SUnya-vara-Darma niSAmayAtI Rc-H-_30.10c
   sattvārtha agravarabodhayi nāmayeyā Rgs_31.16c	sattva-arTa agra-vara-boDayi nAmayeyAH Rc-H-_31.16c
   sattvārtha kṣetrapariśodhanayuktayogī Rgs_30.1b	sattva-arTa kzetra-pariSoDana-yukta-yogI Rc-H-_30.1b
   sattveti śabda parikīrtayi nāyako 'yam Rgs_2.12b	sattva-iti Sabda parikIrtayi nAyakaH ayam Rc-H-_2.12b
   satyādhiṣṭhāna vividhāni samṛddhyayanti Rgs_21.1b	satya-aDizWAna viviDAni samRdDyayanti Rc-H-_21.1b
   satyādhiṣṭhāni praśameti sa cāgniskandham Rgs_20.23c	satya-aDizWAni praSama-iti sa ca-agni-skanDam Rc-H-_20.23c
   satyādhiṣṭhāni praśameti hitānukampī Rgs_20.24b	satya-aDizWAni praSama-iti hita-anukampI Rc-H-_20.24b
   samacitta sarvajagatī pitṛmātṛsaṃjñā Rgs_16.6b	samacitta sarva-jagatI pitR-mAtR-saMjQA Rc-H-_16.6b
   sarvajñakāma sada śāsani nimnacittāḥ Rgs_17.6d	sarvajQa-kAma sada SAsani nimna-cittAH RgH-_17.6d
   sarvajñatā ca manasī bhaviṣyāmi buddho Rgs_31.4c	sarvajQa-tA ca manasI BavizyAmi budDaH Rc-H-_31.4c
   sarvajñatāya anuśikṣati buddhadharme Rgs_2.7c	sarvajQa-tAya anuSikzati budDa-Darme Rc-H-_2.7c
   sarvajñatāya abhiprasthitu veditavyo Rgs_27.4d	sarvajQa-tAya aBiprasTitu veditavyaH RgH-_27.4d
   sarvajñatāya pariṇāmayamāṇa sarve Rgs_4.7c	sarvajQa-tAya pariNAmayamANa sarve Rc-H-_4.7c
   sarvajñatāya phalaśuddhita rūpaśuddhī Rgs_8.1c	sarvajQa-tAya Pala-SudDita rUpa-SudDI Rc-H-_8.1c
   sarvajñatāṃ ca parigṛhṇati śikṣamāṇo Rgs_2.8c	sarvajQa-tAm ca parigRhNati SikzamANaH Rc-H-_2.8c
   sarvatra bhoti kuśalo vidu bodhisattvo Rgs_20.18b	sarvatra Boti kuSalaH vidu boDisattvaH Rc-H-_20.18b
   sarvatra saṅgakriya icchati saṅgachedī Rgs_1.16b	sarvatra saFga-kriyaH icCati saFga-CedI Rc-H-_1.16b
   sarvaṃ ca ādadati so viṣayātu āyam Rgs_13.2b	sarvam ca Adadati saH viza-yAtu Ayam Rc-H-_13.2b
   sarvaṃ ca nāmayi jagārthanidāna bodhi Rgs_6.4d	sarvam ca nAmayi jagArTa-nidAna boDi RgH-_6.4d
   sarvaṃ ca nāmayi jagārthanidāna bodhau Rgs_22.8d	sarvam ca nAmayi jagArTa-nidAna boDO RgH-_22.8d
   sarvānamātyakiriyā ti upekṣya rājā Rgs_13.1b	sarvAn-amAtya-kiriyA ti upekzya rAjA Rc-H-_13.1b
   sarvāstityāgi bhavate satataṃ alīno Rgs_31.9d	sarvAH-ti-tyAgi Bavate satatam alInaH RgH-_31.9d
   sarvāṃśca ādadati ye guṇa buddhadharme Rgs_13.2d	sarvAn=-ca Adadati ye guNa budDa-Darme RgH-_13.2d
   sarvāṃśca tārakagaṇānapi candraābhām Rgs_23.1d	sarvAn=-ca tAraka-gaNAn-api candraABAm RgH-_23.1d
   sarve avidyaprabhavā sugatena uktāḥ Rgs_28.5b	sarve avidya-praBavA sugatena uktAH Rc-H-_28.5b
   sarve ca medinisamudgata prādubhūtāḥ Rgs_28.3b	sarve ca medini-samudgata prAdu-BUtAH Rc-H-_28.3b
   sarve ca saukhya prasutā itu veditavyāḥ Rgs_3.6d	sarve ca sOKya prasutAH itu veditavyAH RgH-_3.6d
   sarve ta ātmaja nidṛṣṭa tathāgatena Rgs_2.5d	sarve te Atmaja nidRzwa taTAgatena RgH-_2.5d
   sarveta pāramita ukta ya saṃgṛhītā Rgs_25.5d	sarveta pAramitaH uktaH yaH saMgRhItAH RgH-_25.5d
   sarve ti prajñavarapāramitāprasūtā Rgs_28.4c	sarve ti prajQavara-pAramitA-prasUtAH Rc-H-_28.4c
   sarve ti prajñavarapāramitāprasūtāḥ Rgs_28.6b	sarve ti prajQavara-pAramitA-prasUtAH Rc-H-_28.6b
   sarve na śakya karaṇe vidu antarāyam Rgs_27.2d	sarve na Sakya karaNe vidu antarAyam RgH-_27.2d
   sarveṣa dharmatathatā na viśeṣaprāptā Rgs_16.2d	sarveza Darma-taTatA na viSeza-prAptAH RgH-_16.2d
   sarveṣa pāramita bhontiha saṃgṛhītāḥ Rgs_25.4b	sarveza pAramita Bonti-ha saMgRhItAH Rc-H-_25.4b
   sarveṣa bhonti anumoditu puṇyarāśi Rgs_26.2b	sarveza Bonti anumoditu puNya-rASi Rc-H-_26.2b
   sarveṣa śikṣa ayu agru niruttarā ca Rgs_28.1b	sarveza Sikza ayu agru niruttarA ca Rc-H-_28.1b
   sarveṣu agra ayu vihāru niruttaraśca Rgs_27.7d	sarvezu agre ayu vihAru niruttaraH-ca RgH-_27.7d
   sarveṣu teṣu bhavate ayu dattadānaṃ Rgs_31.13c	sarvezu tezu Bavate ayu datta-dAnam Rc-H-_31.13c
   sarveṣupādasamatikramu nirgamitvā Rgs_1.27b	sarva-izu-pAda-samatikramu nirgamitvA Rc-H-_1.27b
   sarveṣu bhonti vidu śikṣitu bodhisattvā Rgs_25.6b	sarvezu Bonti vidu Sikzitu boDisattvAH Rc-H-_25.6b
   sarveṣu mārgu ayu pāramitā ananyo Rgs_22.3b	sarvezu mArgu ayu pAramitA ananyaH Rc-H-_22.3b
   sarveṣu śreṣṭha bhavate abhigāminīye Rgs_23.3b	sarvezu SrezWa Bavate aBigAminIye Rc-H-_23.3b
   sarvo ayaṃ puruṣakāru tathāgatasya Rgs_1.3d	sarvaH ayam puruzakAru taTAgatasya RgH-_1.3d
   saha yukta pāramita ye 'pi ca buddhadharmāḥ Rgs_6.3d	saha yukta pAramita ye api ca budDa-DarmAH RgH-_6.3d
   sa ha labdhva nāśayi puno 'pi pramādabhūto Rgs_22.12c	sa ha labDva nASayi punaH api pramAda-BUtaH Rc-H-_22.12c
   saha śrutva tasya puna bheṣyati śāstṛsaṃjñā Rgs_7.5c	saha Srutva tasya puna Bezyati SAstR-saMjQAH Rc-H-_7.5c
   sa hi bodhisattva anumodana ekacitte Rgs_6.1c	sa hi boDisattva anumodanaH ekacitte Rc-H-_6.1c
   sa hyeṣa etarahi sattva pramocayāti Rgs_23.3c	sa hi-ezaH etarahi sattva pramocayAti Rc-H-_23.3c
   saṃkīrṇa so viharate adhimānaprāptaḥ Rgs_21.6d	saMkIrNa saH viharate aDimAna-prAptaH RgH-_21.6d
   saṃketa kṛtva alabhantu vivartayeyā Rgs_18.3b	saMketa kRtva alaBantu vivartayeyAH Rc-H-_18.3b
   saṃjñāya darśanu adarśanu cetanāye Rgs_12.8b	saMjQAya darSanu adarSanu cetanAye Rc-H-_12.8b
   saṃjñāya dṛṣṭisthitu citta trisaṅgayukto Rgs_6.5c	saMjQAya dRzwi-sTitu citta tri-saFga-yuktaH Rc-H-_6.5c
   saṃjñāya yo na sthihate na ca cetanāyām Rgs_2.1b	saMjQAya yaH na sTihate na ca cetanAyAm Rc-H-_2.1b
   saṃjñāvirāgu kutu tasya asaṃvaro 'sti Rgs_31.8b	saMjQA-virAgu kutu tasya asaMvaraH asti Rc-H-_31.8b
   saṃjñāvivarti sthitu advayadharmacārī Rgs_30.7b	saMjQA-vivarti sTitu advaya-Darma-cArI Rc-H-_30.7b
   saṃjñāṃ vibhāviya prahāṇa vrajanti pāram Rgs_2.11b	saMjQAm viBAviya prahANa vrajanti pAram Rc-H-_2.11b
   saṃjñeti nāma parikīrtitu nāyakena Rgs_2.11a	saMjQA-iti nAma parikIrtitu nAyakena RgH-_2.11a
   saṃnā ha eṣa varapudgalauttamānām Rgs_1.20d	saMnA ha eza vara-pudgala-OttamAnAm RgH-_1.20d
   saṃnāhu duṣkarū mahāyaśu saṃnahantī Rgs_15.5a	saMnAhu duzkarU mahA-yaSu saMnahantI RgH-_15.5a
   saṃsāracakri bhramate 'nilacakratulye Rgs_8.3b	saMsAra-cakri Bramate anila-cakra-tulye Rc-H-_8.3b
   saṃsārasāgara tadā sada saṃsaranti Rgs_14.3c	saMsAra-sAgara tadA sada saMsaranti Rc-H-_14.3c
   saṃsāri yuktamanasaḥ sada saṃsmaranti Rgs_22.5b	saMsAri yukta-manasaH sada saMsmaranti Rc-H-_22.5b
   sākṣātkaritva yatha śikṣita deśayanti Rgs_1.4c	sAkzAtkaritva yaTa Sikzita deSayanti Rc-H-_1.4c
   sā caiva nāva parikarmakṛtā suyuktā Rgs_14.7c	sA ca-eva nAva parikarma-kRtA su-yuktAH Rc-H-_14.7c
   sāpekṣacitta kulasaṃstavasaṃprayuktāḥ Rgs_11.6b	sa-apekza-citta kula-saMstava-saMprayuktAH Rc-H-_11.6b
   sāmagripratyaya pravartati jñānayantro Rgs_28.6c	sAmagri-pratyaya pravartati jQAnayantraH Rc-H-_28.6c
   sāmagripratyayu pravartati duḥkhayantro Rgs_28.5c	sAmagri-pratyayu pravartati duHKa-yantraH Rc-H-_28.5c
   sāmagri labdhva viruhanti anekarupāḥ Rgs_3.7b	sAmagri labDva viruhanti anekarupAH Rc-H-_3.7b
   sāmudriyāya yatha nāvi praluptikāye Rgs_14.2a	sAmudriyAya yaTa nAvi pralupti-kAye RgH-_14.2a
   siṃho yathaiva girikandari niśrayitvā Rgs_12.6a	siMhaH yaTA-eva giri-kandari niSrayitvA RgH-_12.6a
   sukhasaukhyakṣemabhiprāpaṇu yānaśreṣṭho Rgs_1.21d	suKa-sOKyakzema-BiprApaNu yAna-SrezWaH RgH-_1.21d
   suvarṇacchavi priyu jagasya udīkṣaṇīyo Rgs_32.2d	suvarNa=-Cavi priyu jagasyaH udIkzaNIyaH RgH-_32.2d
   suvasanti kāli patite tṛṇapatraśākhā Rgs_10.7a	suvasanti kAli patite tRNa-patra-SAKAH RgH-_10.7a
   sūrye yathā gagani gacchati antarīkṣe Rgs_25.3c	sUrye yaTA gagani gacCati antarIkze Rc-H-_25.3c
   sūryo va rāhugrahamukta virocamāno Rgs_9.1c	sUryaH va rAhu-graha-mukta virocamAnaH Rc-H-_9.1c
   so ātmasa(ttva) parikalpaku bodhisattvo Rgs_1.25c	saH Atma-sa(ttva) parikalpaku boDisattvaH Rc-H-_1.25c
   so āmabhājana yathodakaspṛṣṭa bhinno Rgs_1.15d	saH Ama-BAjana yaTA-udaka-spRzwa BinnaH RgH-_1.15d
   so caṃkramārthamabhiyuktakabodhisattvān Rgs_21.7a	saH caMkrama-arTam-aBiyuktaka-boDisattvAn RgH-_21.7a
   so caiva prajñavarapāramitāsuyukto Rgs_14.8c	saH ca-eva prajQavara-pAramitA-su-yuktaH Rc-H-_14.8c
   so tena nirvṛti pravucyati kāraṇena Rgs_1.22d	saH tena nirvRti pravucyati kAraNena RgH-_1.22d
   so trāyatriṃśabhavanādiṣu jambudvīpe Rgs_16.4c	saH trAyatriMSa-Bavana-Adizu jambudvIpe Rc-H-_16.4c
   so nirmiṇitva puruṣān bahu śūravīrān Rgs_20.3c	saH nirmiNitva puruzAn bahu SUra-vIrAn Rc-H-_20.3c
   so prajñapāramita gṛhṇatu eṣa mokṣo Rgs_4.4d	saH prajQapAramita gRhNatu eza mokzaH RgH-_4.4d
   so bodhisattva kṣamate guṇadharmayukto Rgs_30.9a	saH boDisattva kzamate guNa-Darma-yuktaH RgH-_30.9a
   so bodhi(sa)ttva carate sugatāna prajñām Rgs_1.5d	saH boDi(-sa)ttva carate sugatAna prajQAm RgH-_1.5d
   so yukta kṣāntivarapāramitāya vijño Rgs_30.8d	saH yukta kzAnti-vara-pAramitAya vijQaH RgH-_30.8d
   so yukta prajñavarapāramitāya yogī Rgs_26.3d	saH yukta prajQavara-pAramitAya yogI RgH-_26.3d
   so vā anuttaraśivāmanuprāpuṇeyā Rgs_30.3b	saH vA anuttara-SivAm-anuprApuNeyAH Rc-H-_30.3b
   so vā upāyabalaprajñaparigṛhīto Rgs_14.10c	saH vA upAya-bala-prajQa-parigRhItaH Rc-H-_14.10c
   so vāṇijo yatha vrajitvana ratnadvīpaṃ Rgs_7.7c	saH vANijaH yaTa vrajitvana ratnadvIpam Rc-H-_7.7c
   so vā niruddha asato na hi tasya bodhiḥ Rgs_19.3d	saH vA nirudDa asataH na hi tasya boDiH RgH-_19.3d
   so vāniruddha asato na hi tasya vṛkṣo Rgs_19.3b	saH vA-anirudDaH asataH na hi tasya vRkzaH Rc-H-_19.3b
   so vāmadakṣiṇadvaye puruṣe gṛhīte Rgs_14.9c	saH vAma-dakziNa-dvaye puruze gRhIte Rc-H-_14.9c
   so vā laghū anubudhiṣyati bodhi śāntām Rgs_7.5d	saH vA laGU anubuDizyati boDi SAntAm RgH-_7.5d
   so vīryapāramitayukta atandritaśca Rgs_30.1d	saH vIrya-pAramita-yukta atandritaH-ca RgH-_30.1d
   so vyākṛto puramakehi tathāgatehi Rgs_1.11b	saH vyAkRtaH puramakehi taTAgatehi Rc-H-_1.11b
   so śīlaarthu guṇadharmasamanvitānām Rgs_31.3b	saH SIla-arTu guNa-Darma-samanvitAnAm Rc-H-_31.3b
   so sarvadharmaasthito aniketacārī Rgs_1.6c	saH sarva-Darmaa-sTitaH aniketa-cArI Rc-H-_1.6c
   so sūrya abhrapaṭale yatha muktaraśmī Rgs_28.7c	saH sUrya aBra-pawale yaTa mukta-raSmI Rc-H-_28.7c
   sthaviro subhūti paripṛcchati lokanāthaṃ Rgs_17.1a	sTaviraH suBUti paripRcCati lokanATam RgH-_17.1a
   sthita agrahe abudha yo mahaandhabhūto Rgs_15.8b	sTita agrahe abuDa yaH mahaanDa-BUtaH Rc-H-_15.8b
   [sthita eṣa dharmataniyāma śūnyadharmā Rgs_12.4b	[sTitaH eza Darma-taniyAma SUnya-DarmAH Rc-H-_12.4b
   sthita gocare daśabalāna akhaṇḍaśīlāḥ Rgs_31.1b	sTita gocare daSa-balAnaH aKaNxa-SIlAH Rc-H-_31.1b
   sthiticaṃkramaṃ śayaniṣadya susaṃprajānā Rgs_17.3c	sTiti-caMkramam Sayanizadya su-saMprajAnAH Rc-H-_17.3c
   sthitu śīlapāramita kāmaguṇebhi yukto Rgs_31.2d	sTitu SIla-pAramita kAma-guNeBi yuktaH RgH-_31.2d
   sthitu śīlapāramita vedayitavya vijño Rgs_31.4d	sTitu SIla-pAramita vedayitavya vijQaH RgH-_31.4d
   sthitu śīlapāramiti vucyati bodhisattvo Rgs_31.6d	sTitu SIla-pAram-iti vucyati boDisattvaH RgH-_31.6d
   svakabhūmi kāṅkṣavigatāḥ sada merukalpāḥ Rgs_17.7b	svaka-BUmi kAFkza-vigatAH sada meru-kalpAH Rc-H-_17.7b
   hariṣyāmi duḥkha jagatīṃ kariṣyāmi artham Rgs_1.25b	harizyAmi duHKa jagatIm karizyAmi arTam Rc-H-_1.25b
   hastiṃ labhitva yatha hastipadaṃ gaveṣe Rgs_11.4c	hastim laBitva yaTa hasti-padam gaveze Rc-H-_11.4c
   hitacitta maitramana eva parākrameyyā Rgs_16.6c	hita-citta mEtra-manaH eva parAkrameyyAH Rc-H-_16.6c
