   govardhanācārya-viracitā	govarDana-AcArya--viracitA
   āryā-saptaśatī	AryA-saptaSatI
   || śrīḥ ||	|| SrIH ||
   granthārambha-vrajyā	granTa-AramBa-vrajyA
   pāṇi-grahe pulakitaṃ vapur aiśaṃ bhūti-bhūṣitaṃ jayati |	pANi-grahe pulakitam vapuH ESam BUti-BUzitam jayati |
   aṅkurita iva mano-bhūr yasmin bhasmāvaśeṣo 'pi ||GAss_*1||	aFkuritaH iva mano-BUH yasmin Basma-avaSezaH api ||GAsH-_*1||
   mā vama saṃvṛṇu viṣam idam iti sātaṅkaṃ pitāmahenoktaḥ |	mA vama saMvRNu vizam idam iti sAtaFkam pitAmahena-uktaH |
   prātar jayati salajjaḥ kajjala-malinādharaḥ śambhuḥ ||GAss_*2||	prAtar jayati sa-lajjaH kajjala--malina-aDaraH SamBuH ||GAsH-_*2||
   jayati priyā-padānte garala-graiveyakaḥ smarārātiḥ |	jayati priyA--pada-ante garala-grEveyakaH smarArAtiH |
   viṣama-viśikhe viśann iva śaraṇaṃ gala-baddha-karavālaḥ ||GAss_*3||	vizama--viSiKe viSan iva SaraNam gala-badDa-karavAlaH ||GAsH-_*3||
   jayati lalāṭa-kaṭākṣaḥ śaśi-mauleḥ pakṣmalaḥ priyāgraṇatau |	jayati lalAwa--kawAkzaH SaSi-mOleH pakzmalaH priya-agraNatO |
   dhanuṣi smareṇa nihitaḥ sa-kaṇṭakaḥ ketakeṣur iva ||GAss_*4||	Danuzi smareNa nihitaH sa-kaNwakaH ketaka-izuH iva ||GAsH-_*4||
   jayati jaṭā-kiñjalkaṃ gaṅgā-madhu muṇḍa-valaya-bījam ayam |	jayati jawA-kiQjalkam gaFgA-a-maDu muNxa-valaya--bIjam ayam |
   gala-garala-paṅka-sambhavam abhoruham ānanaṃ śambhoḥ ||GAss_*5||	gala-garala--paFka-samBavam aBoruham Ananam SamBoH ||GAsH-_*5||
   sandhyā-salilāñjalim api kaṅkaṇa-phaṇi-pīyamānam avijānan |	sanDyA--salila-aQjalim api kaFkaNa-PaNi-pIyamAnam avijAnan |
   gaurī-mukhārpita-manā vijayā-hasitaḥ śivo jayati ||GAss_*6||	gOrI--muKa-arpita-manAH vijayA-hasitaH SivaH jayati ||GAsH-_*6||
   pratibimbita-gaurī-mukha-vilokanotkampa-śithila-kara-galitaḥ |	pratibimbita-gOrI--muKa--vilokana-utkampa-SiTila--kara--galitaH |
   sveda-bhara-pūryamāṇaḥ śambhoḥ salilāj jalir jayati ||GAss_*7||	sveda--Bara--pUryamANaH SamBoH salilAt jaliH jayati ||GAsH-_*7||
   praṇaya-kupita-priyā-pada-lākṣā-sandhyānubandha-madhurenduḥ |	praNaya--kupita-priya-a-pada-lAkzA--sanDyA-anubanDa---maDura-induH |
   tad-valaya-kanaka-nikaṣa-grāva-grīvaḥ śivo jayati ||GAss_*8||	tad--valaya-kanaka-nikaza--grAva-grIvaH SivaH jayati ||GAsH-_*8||
   pūrṇa-nakhendur dviguṇita-mañjīrā prema-śṛṅkhalā jayati |	pUrNa-naKa-induH dvi-guNita-maQjIrA prema--SRFKalA jayati |
   hara-śaśi-lekhā gaurī-caraṇāṅguli-madhya-gulpheṣu ||GAss_*9||	hara--SaSi--leKAH gOrI--caraNa-aFguli--maDya--gulPezu ||GAsH-_*9||
   śrī-kara-pihitaṃ cakṣuḥ sukhayatu vaḥ puṇḍarīka-nayanasya |	SrI--kara--pihitam cakzuH suKayatu vaH puNxarIka--nayanasya |
   jaghanam ivekṣitum āgatam abja-nibhaṃ nābhi-suṣireṇa ||GAss_*10||	jaGanam iva-Ikzitum Agatam ap-ja--niBam nABi-suzireNa ||GAsH-_*10||
   śyāmaṃ śrī-kuca-kuṅkuma-piñjaritam uro muradviṣo jayati |	SyAmam SrI--kuca-kuFkuma-piQjaritam uraH muradvizaH jayati |
   dina-mukha-nabha iva kaustubha-vibhākaro yad vibhūṣayati ||GAss_*11||	dina--muKa-naBaH iva kOstuBa-viBAkaraH yat viBUzayati ||GAsH-_*11||
   pratibimbita-priyā-tanu sa-kaustubhaṃ jayati madhubhido vakṣaḥ |	pratibimbita--priyA--tanu sa-kOstuBam jayati maDuBidaH vakzaH |
   puruṣāyitam abhyasyati lakṣmīr yad vīkṣya mukuram iva ||GAss_*12||	puruzAyitam aByasyati lakzmIH yat vIkzya mukuram iva ||GAsH-_*12||
   keli-calāṅguli-lambhita-lakṣmī-nābhir muradviṣaś caraṇaḥ |	keli-cala-aFguli--lamBita--lakzmI--nABiH muradvizaH caraNaH |
   sa jayati yena kṛtā śrīr anurūpā padmanābhasya ||GAss_*13||	sa jayati yena kRtA SrIH anurUpA padmanABasya ||GAsH-_*13||
   romāvalī murāreḥ śrīvatsa-niṣevitāgra-bhāgā vaḥ |	roma-AvalI murAreH SrIvatsa--nizevita-agra-BAgAH vaH |
   unnāla-nābhi-nalina-cchāyevottāpam apaharatu ||GAss_*14||	unnAla--nABi--nalina--=-CAyA-iva-uttApam apaharatu ||GAsH-_*14||
   ādāya sapta-tantrocitāṃ vipañcīm iva trayīṃ gāyan |	AdAya sapta-tantra-ucitAm vipaQcIm iva trayIm gAyan |
   madhuraṃ turaṅga-vadanocitaṃ harir jayati haya-mūrdhā ||GAss_*15||	maDuram turaFga-vadana-ucitam hariH jayati haya-mUrDAH ||GAsH-_*15||
   sa jayati mahābāho jala-nidhi-jaṭhare ciraṃ nimagnāpi |	sa jayati mahA-bAho jala-niDi-jaWare ciram nimagnA-api |
   yenāntrair iva saha phaṇi-gaṇair balād uddhṛtā dharaṇī ||GAss_*16||	yena-antrEH iva saha PaNi--gaNEH balAt udDRtA DaraNI ||GAsH-_*16||
   brahmāṇḍa-kumbhakāraṃ bhujagākāraṃ janārdanaṃ naumi |	brahmANxa--kumBa-kAram Bujaga-AkAram janArdanam nOmi |
   sphāre yat-phaṇa-cakre dharā śarāva-śriyaṃ vahati ||GAss_*17||	sPAre yat--PaNa--cakre DarA SarAva--Sriyam vahati ||GAsH-_*17||
   caṇḍī-jaṅghā-kāṇḍaḥ śirasā caraṇa-spṛśi priye jayati |	caNxI-jaFGA--kANxaH SirasA caraNa--spRSi priye jayati |
   śaṅkara-paryanta-jito vijaya-stambhaḥ smarasyeva ||GAss_*18||	SaFkara--paryanta--jitaH vijaya-stamBaH smarasi-a-iva ||GAsH-_*18||
   unnāla-nābhi-paṅkeruha iva yenāvabhāti śambhur api |	unnAla--nABi--paFkeruhaH iva yena-avaBAti SamBuH api |
   jayati puruṣāyitāyās tad-ānanaṃ śaila-kanyāyāḥ ||GAss_*19||	jayati puruzAyitAyAH tat--Ananam SEla-kanyAyAH ||GAsH-_*19||
   aṅka-nilīna-gajānana-śaṅkākula-bāhuleya-hṛta-vasanau |	aFka-nilIna--gaja-Anana--SaFkA-Akula--bAhuleya--hRta--vasanO |
   sa-smita-hara-kara-kalitau hima-giri-tanayā-stanau jayataḥ ||GAss_*20||	sa-smita-hara-kara--kalitO hima-giri-tanayA--stanO jayataH ||GAsH-_*20||
   kaṇṭhocito 'pi huṅkṛti-mātra-nirastaḥ padāntike patitaḥ |	kaNWa-ucitaH api huFkRti--mAtra--nirastaH pada-antike patitaH |
   yasyāś candra-śikhaḥ smara-bhalla-nibho jayati sā caṇḍī ||GAss_*21||	yasyAH candra-SiKaH smara--Balla--niBaH jayati sA caNxI ||GAsH-_*21||
   deve'rpita-varaṇa-sraji bahumāye vahati kaiṭabhī-rūpam |	deve-arpita--varaNa--sraji bahu-mAye vahati kEwaBI--rUpam |
   jayati surāsura-hasitā lajjā-jihmekṣaṇā lakṣmīḥ ||GAss_*22||	jayati sura-asura--hasitA lajjA--jihma-IkzaNA lakzmIH ||GAsH-_*22||
   tān asurān api harim api taṃ vande kapaṭa-kaiṭabhī-rūpam |	tAn asurAn api harim api tam vande kapawa--kEwaBI--rUpam |
   yair yad bimbādhara-madhu-lubdhaiḥ pīyuṣam api mumuce ||GAss_*23||	yEH yat bimba-aDara--maDu--lubDEH pIyuzam api mumuce ||GAsH-_*23||
   talpī-kṛtāhir agaṇita-garuḍo hārābhihata-vidhir jayati |	talpI-kRta-ahiH agaNita--garuxaH hAra-aBihata--viDiH jayati |
   phaṇa-śata-pīta-śvāso rāgāndhāyāḥ śriyaḥ keliḥ ||GAss_*24||	PaNa--Sata--pIta-SvAsaH rAga-anDAyAH SriyaH keliH ||GAsH-_*24||
   smerān anena hariṇā yat spṛham ākāra-vedinākalitam |	smerAn anena hariNA yat spRham AkAra-vedinA-kalitam |
   jayati puruṣāyitāyāḥ kamalāyāḥ kaiṭabhī-dhyānam ||GAss_*25||	jayati puruzAyitAyAH kamalAyAH kEwaBI-DyAnam ||GAsH-_*25||
   kṛta-kānta-keli-kutuka-śrī-śīta-śvāsa-seka-nidrāṇaḥ |	kRta-kAnta--keli--kutuka--SrI--SIta--SvAsa--seka--nidrANaH |
   ghorita-vitatāli-ruto nābhi-saroje vidhir jayati ||GAss_*26||	Gorita--vitatAli--rutaH nABi-saroje viDiH jayati ||GAsH-_*26||
   eka-rada dvaimātura nistriguṇa caturbhujāpi pañca-kara |	eka-rada dvEmAtura nistriguNa caturBujA-api paQca-karaH |
   jaya ṣaṇ-mukha-nuta sapta-cchada-gandhi-madāṣṭa-tanu-tanaya ||GAss_*27||	jaya zaN-muKa--nuta sapta--cCada--ganDi--mada-azwa--tanu--tanayaH ||GAsH-_*27||
   maṅgala-kalaśa-dvaya-maya-kumbham adambhena bhajata gaja-vadanam |	maFgala--kalaSa--dvaya--maya--kumBam adamBena Bajata gaja--vadanam |
   yad-dāna-toya-taralais tila-tulanālambi rolambaiḥ ||GAss_*28||	yat--dAna--toya--taralEH tila--tulana-Alambi rolambEH ||GAsH-_*28||
   yābhir anaṅgaḥ sāṅgī-kṛtaḥ striyo 'strī-kṛtāś ca tā yena |	yABiH anaFgaH sa-aFgI-kRtaH striyaH astrI-kRtAH ca tAH yena |
   vāmācaraṇa-pravaṇau praṇamtatau kāminī-kāmau ||GAss_*29||	vAma-AcaraNa--pravaNO praNamtatO kAminI--kAmO ||GAsH-_*29||
   vihita-ghanālaṅkāraṃ vicitra-varṇāvalī-maya-sphuraṇam |	vihita-Gana-alaFkAram vicitra--varNa-AvalI--maya--sPuraNam |
   śakrāyudham iva vakraṃ valmīka-bhuvaṃ kaviṃ naumi ||GAss_*30||	SakrAyuDam iva vakram valmIka-Buvam kavim nOmi ||GAsH-_*30||
   vyāsa-girāṃ niryāsaṃ sāraṃ viśvasya bhārataṃ vande |	vyAsa--girAm niryAsam sAram viSvasya BAratam vande |
   bhūṣaṇayaiva sañjñāṃ yad aṅkitāṃ bhāratī vahati ||GAss_*31||	BUzaNayA-eva saQjQAm yat aFkitAm BAratI vahati ||GAsH-_*31||
   sati kākutstha-kulonnati-kāriṇi rāmāyaṇe kim anyena |	sati kAkutsTa--kula-unnati--kAriNi rAmAyaNe kim anyena |
   rohati kulyā gaṅgā-pūre kiṃ bahurase vahati ||GAss_*32||	rohati kulyA gaFgA-pUre kim bahu-rase vahati ||GAsH-_*32||
   atidīrgha-jīvi-doṣād vyāsena yaśo 'pahāritaṃ hanta |	ati-dIrGa--jIvi--dozAt vyAsena yaSaH apahAritam hanta |
   kair nocyeta guṇāḍhyaḥ sa eva janmāntarāpannaḥ ||GAss_*33||	kEH na-ucyeta guNa-AXyaH saH eva janma-antarApannaH ||GAsH-_*33||
   śrī-rāmāyaṇa-bhārata-bṛhat-kathānāṃ kavīn namaskurmaḥ |	SrI--rAmAyaNa--BArata--bRhat--kaTAnAm kavIn namaskurmaH |
   trisrotā iva sarasā sarasvatī sphurati yair bhinnā ||GAss_*34||	tri-srotAH iva sarasA sarasvatI sPurati yEH BinnAH ||GAsH-_*34||
   sākūta-madhura-komala-vilāsinī-kaṇṭha-kūjita-prāye |	sa-AkUta--maDura--komala-vilAsi-nI--kaNWa--kUjita--prAye |
   śikṣa-samaye'pi mude rata-līlā-kālidāsoktī ||GAss_*35||	Sikza--samaye-api mude rata--lIlA--kAli-dAsa-uktI ||GAsH-_*35||
   bhavabhūteḥ sambandhād bhūdhara-bhūr eva bhāratī bhāti |	Bava-BUteH sambanDAt BUDara-BUH eva BAratI BAti |
   etat-kṛta-kāruṇye kim anyathā roditi grāvā ||GAss_*36||	etat--kRta-kAruNye kim anyaTA roditi grAvAH ||GAsH-_*36||
   jātā śikhaṇḍinī prāg yathā śikhaṇḍī tathāvagacchāmi |	jAtA SiKaNxinI prAk yaTA SiKaNxI taTA-avagacCAmi |
   prāgalbhyam adhikam āptuṃ vāṇī bāṇo babhūveti ||GAss_*37||	prAgalByam aDikam Aptum vANI bANaH baBUva-iti ||GAsH-_*37||
   yaṃ gaṇayati guror anu yasyās te dharma-karma saṅkucitam |	yam gaNayati guroH anu yasyAH te Darma-karma saFkucitam |
   kavim aham uśanasam iva taṃ tātaṃ nīlāmbaraṃ vande ||GAss_*38||	kavim aham uSanasam iva tam tAtam nIla-ambaram vande ||GAsH-_*38||
   sakala-kalāḥ kalpayituṃ prabhuḥ prabandhasya kumuda-bandhoś ca |	sakala--kalAH kalpayitum praBuH prabanDasya kumuda-banDoH ca |
   sena-kula-tila-bhūpatir eko rākā-pradoṣaś ca ||GAss_*39||	sena-kula-tila--BUpatiH ekaH rAkA--pradozaH ca ||GAsH-_*39||
   kāvyasyākṣara-maitrī-bhājo na ca karkaśā na ca grāmyāḥ |	kAvyasya-akzara--mEtrI-BAjaH na ca karkaSAH na ca grAmyAH |
   śabdā api puruṣā api sādhava evārtha-bodhāya ||GAss_*40||	SabdAH api puruzAH api sADavaH eva-arTa-boDAya ||GAsH-_*40||
   vaṃśe ghuṇa iva na viśati doṣo rasa-bhāvite satāṃ manasi |	vaMSe GuNaH iva na viSati dozaH rasa-BAvite satAm manasi |
   rasam api tu na pratīcchati bahu-doṣaḥ sannipātīva ||GAss_*41||	rasam api tu na pratIcCati bahu-dozaH sannipAtI-iva ||GAsH-_*41||
   viguṇo 'pi kāvya-bandhaḥ sādhūnām ānanaṃ gataḥ svadate |	viguNaH api kAvya-banDaH sADUnAm Ananam gataH svadate |
   phūtkāro 'pi suvaṃśair anūdyamānaḥ śrutiṃ harati ||GAss_*42||	PUtkAraH api su-vaMSEH anUdyamAnaH Srutim harati ||GAsH-_*42||
   svayam api bhūri-cchidraś cāpalam api sarvatomukhaṃ tanvan |	svayam api BUri-=-CidraH cApalam api sarvatomuKam tanvan |
   titaus tuṣasya piśuno doṣasya vivecane'dhikṛtaḥ ||GAss_*43||	titOH tuzasya piSunaH dozasya vivecane-aDikRtaH ||GAsH-_*43||
   antar-gūḍhānarthānavyañjayataḥ prasāda-rahitasya |	antar-gUXa-anarTAn-avyaQjayataH prasAda--rahitasya |
   sandarbhasya nadasya ca na rasaḥ prītyai rasa-jñānām ||GAss_*44||	sandarBasya nadasya ca na rasaH prItyE rasa-jQAnAm ||GAsH-_*44||
   yadasevanīyam asatām amṛta-prāyaṃ suvarṇa-vinyāsam |	yat-asevanIyam asatAm amRta--prAyam suvarNa--vinyAsam |
   surasārthamayaṃ kāvyaṃ triviṣṭapaṃ vā samaṃ vidmaḥ ||GAss_*45||	surasA-arTa-mayam kAvyam trivizwapam vA samam vidmaH ||GAsH-_*45||
   sat-kavi-rasanā-śūrpī-nistuṣatara-śabda-śāli-pākena |	sat-ka-vi-rasanA--SUrpI--nistuzatara--Sabda--SAli-pAkena |
   tṛpto dayitādharam api nādriyate kā sudhā dāsī ||GAss_*46||	tRptaH dayitA-aDaram api na-Adriyate kA suDA dAsI ||GAsH-_*46||
   akalita-śabdālaṅkṛtir anukūlā skhali-pada-niveśāpi |	akalita--Sabda-alaFkRtiH anukUlA sKali-pada--niveSa-api |
   abhisārikeva ramayati sūktiḥ sotkarṣa-śṛṅgārā ||GAss_*47||	aBisArikA-iva ramayati sUktiH sa-utkarza--SRFgArAH ||GAsH-_*47||
   adhvani pada-graha-paraṃ madayati hṛdayaṃ na vā na vā śravaṇam |	aDvani pada-graha-param madayati hRdayam na vA na vA SravaNam |
   kāvyam abhijña-sabhāyāṃ mañjīraṃ keli-velāyām ||GAss_*48||	kAvyam aBijQa--saBAyAm maQjIram keli-velAyAm ||GAsH-_*48||
   āsvādita-dayitādhara-sudhā-rasasyaiva sūktayo madhurāḥ |	AsvAdita--dayita-aDara--suDA-rasasya-eva sUktayaH maDurAH |
   akalita-rasāla-mukulo na kokilaḥ kalam udañcayati ||GAss_*49||	akalita--rasAla--mukulaH na kokilaH kalam udaQcayati ||GAsH-_*49||
   bālā-kaṭākṣa-sūtritam asatī-netra-tribhāga-kṛta-bhāṣyam |	bAlA--kawAkza--sUtritam asatI--netra--tri-BAga-kRta---BAzyam |
   kavi-māṇavakā dūtī-vyākhyātam adhīyate bhāvam ||GAss_*50||	kavi-mANavakAH dUtI--vyAKyAtam aDIyate BAvam ||GAsH-_*50||
   masṛṇa-pada-gīti-gatayaḥ sajjana-hṛdayābhisārikāḥ surasāḥ |	masRNa-pada-gIti-gatayaH sat-jana--hRdaya-aBisArikAH surasAH |
   madanādvayopaniṣado viśadā govardhanasyāryāḥ ||GAss_*51||	madanA-dvaya-upanizadaH viSadAH govarDanasya-AryAH ||GAsH-_*51||
   vāṇī prākṛta-samucita-rasā balenaiva saṃskṛtaṃ nītā |	vANI prAkRta--samucita-rasAH balena-eva saMskRtam nItA |
   nimnānurūpa-nīrā kalinda-kanyeva gagana-talam ||GAss_*52||	nimna-anurUpa--nIrA kalinda-kanyA-iva gagana-talam ||GAsH-_*52||
   āryā-saptaśatīyaṃ pragalbha-manasām anādṛtā yeṣām |	AryA--saptaSatIyam pragalBa--manasAm anAdRtAH yezAm |
   dūtī-rahitā iva te na kāminī-manasi niviśante ||GAss_*53||	dUtI--rahitAH iva te na kAminI--manasi niviSante ||GAsH-_*53||
   rata-rīti-vīta-vasanā priyeva śuddhāpi vāṅ-mude sarasā |	rata-rIti--vIta--vasanA priyA-iva SudDA-api vA-ac--mude sarasA |
   arasā sālaṅkṛtir api na rocate śālabhañjīva ||GAss_*54||	arasA sa-alaFkRtiH api na rocate SAlaBaQjI-iva ||GAsH-_*54||
   iti granthārambha-vrajyā samāptā |	iti granTa-AramBa-vrajyA samAptAH |
   a-kāra-vrajyā	a-kAra-vrajyA
   avadhi-dināvadhi-jīvāḥ prasīda jīvantu pathika-janajāyāḥ |	avaDi-dina-avaDi-jIvAH prasIda jIvantu paTika--jana-jAyAH |
   durlaṅghya-vartma-śailau stanau pidhehi prapāpāli ||GAss_1||	durlaFGya-vartma--SElO stanO piDehi prapApAli ||GAsH-_1||
   ativatsalā suśīlā sevā-caturā mano 'nukūlā ca |	ati-vatsalA suSIlA sevA--caturA manaH anukUlA ca |
   ajani vinītā gṛhiṇī sapadi saptnī-stanodbhede ||GAss_2||	ajani vinItA gRhiNI sapadi saptnI--stana-udBede ||GAsH-_2||
   ayi kūla-nicula-mūlocchedana-duḥśīla-vīci-vācāle |	ayi kUla--nicula--mUla-ucCedana--duHSIla--vIci--vAcAle |
   baka-vighasa-paṅka-sārā na cirāt kāveri bhavitāsi ||GAss_3||	baka--viGasa--paFka---sArAH na cirAt kAveri BavitAsi ||GAsH-_3||
   ayi vividha-vacana-racane dadāsi candraṃ kare samānīya |	ayi viviDa-vacana--racane dadAsi candram kare samAnIya |
   vyasana-divaseṣu dūti kva punas tvaṃ darśanīyāsi ||GAss_4||	vyasana--divasezu dUti kva punar tvam darSanIyA-asi ||GAsH-_4||
   astu mlānir loko lāñchanam apadiśatu hīyatām ojaḥ |	astu mlAniH lokaH lAQCanam apadiSatu hIyatAm ojaH |
   tad api na muñcati sa tvāṃ vasudhā-chāyām iva sudhāṃśuḥ ||GAss_5||	tat api na muQcati sa tvAm vasuDA-CAyAm iva suDAMSuH ||GAsH-_5||
   aticāpalaṃ vitanvann antarniviśan nikāma-kāṭhinyaḥ |	ati-cApalam vitanvan antar-niviSan nikAma-kAWinyaH |
   mukharayasi svayam etāṃ sad-vṛttāṃ śaṅkur iva ghaṇṭām ||GAss_6||	muKarayasi svayam etAm sat--vRttAm SaFkuH iva GaNwAm ||GAsH-_6||
   aṅgeṣu jīryati paraṃ khañjana-yūnor manobhava-prasaraḥ |	aFgezu jIryati param KaQjana--yUnoH manoBava--prasaraH |
   na punar anantar-garbhita-nidhini dharā-maṇḍale keliḥ ||GAss_7||	na punar anantar--garBita--niDini DarA--maNxale keliH ||GAsH-_7||
   andhatvam andha-samaye badhiratvaṃ badhira-kāla ālambya |	anDa-tvam anDa--samaye baDira-tvam baDira-kAle Alambya |
   śrī-keśavayoḥ praṇayī prajāpatir nābhi-vāstavyaḥ ||GAss_8||	SrI-keSavayoH praNayI prajApatiH nABi-vAstavyaH ||GAsH-_8||
   ayi koṣa-kāra kuruṣe vanecarāṇāṃ puro guṇodgāram |	ayi koza-kAra kuruze vanecarANAm puras guNa-udgAram |
   yan na vidārya vicārita-jaṭharas tvaṃ sa khalu te lābhaḥ ||GAss_9||	yat na vidArya vicArita--jaWaraH tvam sa Kalu te lABaH ||GAsH-_9||
   agaṇita-mahimā laṅghita-gurur adhanehaḥ stanandhaya-virodhī |	agaNita--mahimA laFGita--guruH aDana-IhaH stananDaya--viroDI |
   iṣṭākīrtis tasyās tvayi rāgaḥ prāṇa-nirapekṣaḥ ||GAss_10||	izwa-akIrtiH tasyAH tvayi rAgaH prANa--nirapekzaH ||GAsH-_10||
   aparādhād adhikaṃ māṃ vyathayati tava kapaṭa-vacana-racaneyam |	aparADAt aDikam mAm vyaTayati tava kapawa--vacana--racanA-iyam |
   śastrāghāto na tathā sūcī-vyadha-vedanā yādṛk ||GAss_11||	Sastra-AGAtaH na taTA sUcI--vyaDa--vedanAH yAdRS ||GAsH-_11||
   asatī-locana-mukure kim api pratiphalati yan manovarti |	asatI--locana--mukure kim api pratiPalati yat manaH-varti |
   sārasvatam api cakṣuḥ satimiram iva tan na lakṣayati ||GAss_12||	sArasvatam api cakzuH sa-timiram iva tat na lakzayati ||GAsH-_12||
   anya-mukhe durvādo yaḥ priya-vadane sa eva parihāsaḥ |	anya--muKe durvAdaH yaH priya-vadane saH eva parihAsaH |
   itarendhana-janmā yo dhūmaḥ so 'gurubhavo dhūpaḥ ||GAss_13||	itara-inDana--janmA yaH DUmaH saH aguru-BavaH DUpaH ||GAsH-_13||
   ayi subhaga kutuka-taralā vicarantī saurabhānusāreṇa |	ayi suBaga kutuka-taralA vicarantI sOraBa-anusAreNa |
   tvayi mohāya varākī patitā madhupīva viṣa-kusume ||GAss_14||	tvayi mohAya varAkI patitAH maDupI-iva viza-kusume ||GAsH-_14||
   ayi mugdha-gandha-sindhura-śaṅkā-mātreṇa dantino dalitāḥ |	ayi mugDa--ganDa--sinDura--SaFkA--mAtreNa dantinaH dalitAH |
   upabhuñjate kareṇūḥ kevalam iha mat-kuṇāḥ kariṇaḥ ||GAss_15||	upaBuQjate kareNUH kevalam iha mat--kuNAH kariNaH ||GAsH-_15||
   ativinaya-vāmana-tanur vilaṅghate geha-dehalīṃ na vadhūḥ |	ati-vinaya-vAmana-tanuH vilaFGate geha--dehalIm na vaDUH |
   asyāḥ punar ārabhaṭīṃ kusumbhavāṭī vijānāti ||GAss_16||	asyAH punar AraBawIm kusumBa-vAwI vijAnAti ||GAsH-_16||
   antar-gatair guṇaiḥ kiṃ dvitrā api yatra sākṣiṇo viralāḥ |	antar--gatEH guNEH kim dvitrAH api yatra sAkziNaH viralAH |
   sa guṇo gīter yad asau vanecaraṃ hariṇam api harati ||GAss_17||	sa guNaH gIteH yat asO vanecaram hariNam api harati ||GAsH-_17||
   alulita-sakala-vibhūṣāṃ prātar bālāṃ vilokya muditaṃ prāk |	alulita-sakala--viBUzAm prAtar bAlAm vilokya muditam prAk |
   priya-śirasi vīkṣya yāvakam atha niḥśvasitaṃ sapatnībhiḥ ||GAss_18||	priya--Sirasi vIkzya yAvakam aTa niHSvasitam sapatnIBiH ||GAsH-_18||
   ayi lajjāvati nibhara-niśītha-rata-niḥsahāṅgi sukha-supte |	ayi lajjAvati niBara--niSITa--rata--niHsaha-aFgi suKa--supte |
   locana-kokanada-cchadam unmīlaya suprabhātaṃ te ||GAss_19||	locana--kokanada--cCadam unmIlaya su-praBAtam te ||GAsH-_19||
   amilita-vadanam apīḍita-vakṣoruham atividūra-jaghanoru |	amilita-vadanam apIxita-vakzoruham ati-vidUra--jaGana-uru |
   śapatha-śatena bhujābhyāṃ kevalam āliṅgito 'smi tayā ||GAss_20||	SapaTa--Satena BujAByAm kevalam AliFgitaH asmi tayA ||GAsH-_20||
   atipūjita-tāreyaṃ dṛṣṭiḥ śruti-laṅghana-kṣamā sutanu |	ati-pUjita-tArA-iyam dRzwiH Sruti-laFGana--kzamA su-tanu |
   jina-siddhānta-sthitir iva sa-vāsanā kaṃ na mohayati ||GAss_21||	jina-sidDAnta--sTitiH iva sa--vAsanA kam na mohayati ||GAsH-_21||
   alam aviṣaya-bhaya-lajjā-vañcitam ātmānam iyam iyat samayam |	alam avizaya--Baya--lajjA--vaQcitam AtmAnam iyam iyat samayam |
   nava-paricita-dayita-guṇā śocati nālapati śayana-sakhīḥ ||GAss_22||	nava--paricita---dayita-guNA Socati na-alapati Sayana-saKIH ||GAsH-_22||
   anurāga-vartinā tava viraheṇogreṇa sā gṛhītāṅgī |	anurAga-vartinA tava viraheNa-ugreNa sA gRhIta-aFgI |
   tripura-ripuṇeva gaurī vara-tanur ardhāvaśiṣṭaiva ||GAss_23||	tripura-ripuNA-iva gOrI vara-tanuH arDa-avaSizwA-eva ||GAsH-_23||
   anya-pravaṇe preyasi viparīte srotasīva vihitāsthāḥ |	anya--pravaNe preyasi viparIte srotasi-iva vihita-AsTAH |
   tad-gatim icchantyaḥ sakhi bhavanti viphala-śramāḥ hāsyāḥ ||GAss_24||	tad--gatim icCantyaH saKi Bavanti viPala-SramAH hAsyAH ||GAsH-_24||
   adhikaḥ sarvebhyo yaḥ priyaḥ priyebhyo hṛdi sthitaḥ satatam |	aDikaH sarveByaH yaH priyaH priyeByaH hRdi sTitaH satatam |
   sa luṭhati virahe jīvaḥ kaṇṭhe'syās tvam iva sambhoge ||GAss_25||	sa luWati virahe jIvaH kaNWe-asyAH tvam iva samBoge ||GAsH-_25||
   anayana-pathe priye na vyathā yathā dṛśya eva duṣprāpe |	anayana--paTe priye na vyaTA yaTA dRSyaH eva duzprApe |
   mlānaiva kevalaṃ niśi tapana-śilā vāsare jvalati ||GAss_26||	mlAnA-eva kevalam niSi tapana-SilA vAsare jvalati ||GAsH-_26||
   avibhāvyo mitre'pi sthiti-mātreṇaiva nandayan dayitaḥ |	aviBAvyaH mitre-api sTiti--mAtreNa-eva nandayan dayitaH |
   rahasi vyapadeśād ayam arthaḥ ivārājake bhogyaḥ ||GAss_27||	rahasi vyapadeSAt ayam arTaH iva-arAjake BogyaH ||GAsH-_27||
   aśrauṣīr aparādhān mama tathyaṃ kathaya man-mukhaṃ vīkṣya |	aSrOzIH aparADAn mama taTyam kaTaya man-muKam vIkzya |
   abhidhīyate na kiṃ yadi na māna-caurānanaḥ kitavaḥ ||GAss_28||	aBiDIyate na kim yadi na mAna--cOra-AnanaH kitavaH ||GAsH-_28||
   anyonyam anu srotasam anyad athānyat taṭāt taṭaṃ bhajatoḥ |	anyonyam anu srotasam anyat aTa-anyat tawAt tawam BajatoH |
   udite'rke'pi na māgha-snānaṃ prasamāpyate yūnoḥ ||GAss_29||	udite-arke-api na mAGa--snAnam prasamApyate yUnoH ||GAsH-_29||
   ayi cūta-valli phala-bhara-natāṅgi viṣvag-vikāsi-saurabhye |	ayi cUta-valli Pala--Bara-nata-aFgi vizvag-vikAsi--sOraBye |
   śvapaca-ghaṭa-karparāṅkā tvaṃ kila phalitāpi viphalaiva ||GAss_30||	Svapaca--Gawa--karpara-aFkA tvam kila PalitA-api viPalA-eva ||GAsH-_30||
   añjalir akāri lokair mlānim anāptaiva rañjitā jagatī |	aQjaliH akAri lokEH mlAnim anAptA-eva raQjitA jagatI |
   sandhyāyā iva vasatiḥ svalpāpi sakhe sukhāyaiva ||GAss_31||	sanDyAyAH iva vasatiH su-alpA-api saKe suKAya-eva ||GAsH-_31||
   agṛhītānunayāṃ mām upekṣya sakhyo gatā bataikāham |	agRhIta-anunayAm mAm upekzya saKyaH gatA bata-ekA-aham |
   prasabhaṃ karoṣi mayi cet tvad upari vapur adya mokṣyāmi ||GAss_32||	prasaBam karozi mayi ced tvat upari vapuH adya mokzyAmi ||GAsH-_32||
   asthira-rāgaḥ kitavo mānī capalo vidūṣakas tvam asi |	asTira-rAgaH kitavaH mAnI capalaH vidUzakaH tvam asi |
   mama sakhyāḥ patasi kare paśyāmi yathā ṛjur bhavasi ||GAss_33||	mama saKyAH patasi kare paSyAmi yaTA RjuH Bavasi ||GAsH-_33||
   akaruṇa kātara-manaso darśita-nīrā nirantarāleyam |	akaruNa kAtara-manasaH darSita--nIrAH nirantarAleyam |
   tvām anu dhāvati vimukhaṃ gaṅgeva bhagīrathaṃ dṛṣṭiḥ ||GAss_34||	tvAm anu DAvati vimuKam gaFgA-iva BagIraTam dRzwiH ||GAsH-_34||
   antaḥ-kaluṣa-stambhita-rasayā bhṛṅgāranālayeva mama |	antaH--kaluza--stamBita-rasayA BRFga-AranAlayA-iva mama |
   apy unmukhasya vihitā varavarṇini na tvayā tṛptiḥ ||GAss_35||	api unmuKasya vihitA varavarNini na tvayA tRptiH ||GAsH-_35||
   ayi sarale sarala-taror mada-mudita-dvipa-kapola-pāleś ca |	ayi sarale sarala-taroH mada-mudita--dvipa--kapola--pAleH ca |
   anyonya-mugdha-gandha-vyatihāraḥ kaṣaṇam ācaṣṭe ||GAss_36||	anyonya--mugDa--ganDa--vyatihAraH kazaNam Acazwe ||GAsH-_36||
   asyāḥ kara-ruha-khaṇḍita-kāṇḍa-paṭa-prakaṭa-nirgatā dṛṣṭiḥ |	asyAH kara-ruha--KaNxita--kANxa--pawa--prakawa--nirgatA dRzwiH |
   paṭa-vigalita-niṣkaluṣā svadate pīyūṣa-dhāreva ||GAss_37||	pawa--vigalita--nizkaluzA svadate pIyUza-DArA-iva ||GAsH-_37||
   asyāḥ pati-gṛha-gamane karoti mātāśru-picchilāṃ padavīm |	asyAH pati-gRha--gamane karoti mAtA-aSru--picCilAm padavIm |
   guṇa-garvitā punar asau hasati śanaiḥ śuṣka-rudita-mukhī ||GAss_38||	guNa--garvitA punar asO hasati SanEs Suzka-rudita-muKI ||GAsH-_38||
   aṅke niveśya kūṇita-dṛśaḥ śanair akaruṇeti śaṃsantyāḥ |	aFke niveSya kUNita-dRSaH SanEs akaruNA-iti SaMsantyAH |
   mokṣyāmi veṇi-bandhaṃ kadā nakhair gandha-tailāktaiḥ ||GAss_39||	mokzyAmi veNi-banDam kadA naKEH ganDa-tEla-aktEH ||GAsH-_39||
   alam analaṅkṛti-subhage bhūṣaṇam upahāsa-viṣayam itarāsām |	alam analaFkRti--suBage BUzaNam upahAsa--vizayam itarAsAm |
   kuruṣe vanaspati-latā prasūnam iva bandhya-vallīnām ||GAss_40||	kuruze vanaspati-latA prasUnam iva banDya--vallInAm ||GAsH-_40||
   abudhā ajaṅgamā api kayāpi gatyā paraṃ padam avāptāḥ |	abuDAH ajaFgamAH api kayA-api gatyA param padam avAptAH |
   mantriṇa iti kīrtyante naya-bala-guṭikā iva janena ||GAss_41||	mantriNaH iti kIrtyante naya-bala-guwikAH iva janena ||GAsH-_41||
   atiśīla-śīta-latayā lokeṣu sakhī mṛdu-pratāpā naḥ |	ati-SIla--SIta--latayA lokezu saKI mRdu--pratApAH naH |
   kṣaṇa-vāmya-dahyamānaḥ pratāpam asyāḥ priyo veda ||GAss_42||	kzaNa-vAmya--dahyamAnaH pratApam asyAH priyaH veda ||GAsH-_42||
   anyāsv api gṛhiṇīti dhyāyann abhilaṣitam āpnoti |	anyAsu api gRhiNI-iti DyAyan aBilazitam Apnoti |
   paśyan pāṣāṇamayīḥ pratimā iva devatātvena ||GAss_43||	paSyan pAzANa-mayIH pratimAH iva devatA-tvena ||GAsH-_43||
   anupetya nīca-bhāvaṃ bālaka parito gabhīra-madhurasya |	anupetya nIca--BAvam bAlaka paritas gaBIra--maDurasya |
   asyāḥ premṇaḥ pātraṃ na bhavasi sarito rasasyeva ||GAss_44||	asyAH premNaH pAtram na Bavasi saritaH rasasya-iva ||GAsH-_44||
   adhivāsanam ādheyaṃ guṇa-mārgam apekṣate na ca grathanām |	aDivAsanam ADeyam guNa--mArgam apekzate na ca graTanAm |
   kalayati yuvajana-mauliṃ ketaka-kalikā svarūpeṇa ||GAss_45||	kalayati yuva-jana--mOlim ketaka-kalikA sva-rUpeNa ||GAsH-_45||
   apanīta-nikhila-tāpāṃ subhaga sva-kareṇa vinihitāṃ bhavatā |	apanIta--niKila--tApAm suBaga sva-kareNa vinihitAm BavatA |
   patiśayana-vāra-pāli-jvarauṣadhaṃ vahati sā mālām ||GAss_46||	pati-Sayana--vAra--pAli--jvara-OzaDam vahati sA mAlAm ||GAsH-_46||
   agaṇita-guṇena sundara kṛtvā cāritram apy udāsīnam |	agaNita-guNena sundara kRtvA cAritram api udAsInam |
   bhavatānanya-gatiḥ sā vihitāvartena taraṇir iva ||GAss_47||	BavatA-ananya--gatiH sA vihita-Avartena taraNiH iva ||GAsH-_47||
   anurakta-rāmayā punar āgataye sthāpitottarīyasya |	anurakta--rAmayA punar Agataye sTApita-uttarIyasya |
   apy eka-vāsasas tava sarva-yuvabhyo 'dhikā śobhā ||GAss_48||	api eka-vAsasaH tava sarva-yuvaByaH aDikA SoBA ||GAsH-_48||
   ardhaḥ prāṇity eko mṛta itaro me vidhuntudasyeva |	arDaH prANiti ekaH mRtaH itaraH me viDuntudasya-iva |
   sudhayeva priyayā pathi saṅgatyāliṅgitārdhasya ||GAss_49||	suDayA-iva priyayA paTi saFgatya-AliFgita-arDasya ||GAsH-_49||
   avadhīrito 'pi nidrā-miṣeṇa māhātmyam asṛṇayā priyayā |	avaDIritaH api nidrA-mizeNa mAhAtmyam asRNayA priyayA |
   avabodhito 'smi capalo bāṣpa-sthita-mitena talpena ||GAss_50||	avaboDitaH asmi capalaH bAzpa--sTita--mitena talpena ||GAsH-_50||
   ayi śabda-mātra-sāmyād āsvādita-śarkarasya tava pathika |	ayi Sabda--mAtra--sAmyAt AsvAdita--Sarkarasya tava paTika |
   svalpo rasanā-cchedaḥ purato jana-hāsyatā mahatī ||GAss_51||	su-alpaH rasanA-=-CedaH puratas jana--hAsya-tA mahatI ||GAsH-_51||
   abhinava-yauvana-durjaya-vipakṣa-jana-hanyamānamānāpi |	aBinava--yOvana--durjaya--vipakza--jana-hanyamAna-mAnA-api |
   sūnoḥ pitṛ-priyatvād bibharti subhagā-madaṃ gṛhiṇī ||GAss_52||	sUnoH pitR-priya-tvAt biBarti suBagA-madam gRhiNI ||GAsH-_52||
   apamānitam iva samprati guruṇā grīṣmeṇa durbalaṃ śaityam |	apamAnitam iva samprati guruNA grIzmeNa durbalam SEtyam |
   snānotsuka-taruṇī-stana-kalaśa-nibaddhaṃ payo viśati ||GAss_53||	snAna-utsuka-taruNI-H-tana--kala-Sa--nibadDam payaH viSati ||GAsH-_53||
   alasayati gātram akhilaṃ kleśaṃ mocayati locanaṃ harati |	alasayati gAtram aKilam kleSam mocayati locanam harati |
   svāpa iva preyān mama moktuṃ na dadāti śayanīyam ||GAss_54||	svApaH iva preyAt mama moktum na dadAti SayanIyam ||GAsH-_54||
   aṃsāvalambi-kara-dhṛta-kacam abhiṣekārdra-dhavala-nakha-rekham |	aMsa-avalambi--kara--DRta---kacam aBizeka-Ardra-Davala-naKa--reKam |
   dhautādhara-nayanaṃ vapur astram anaṅgasya tava niśitam ||GAss_55||	DOta-aDara-nayanam vapuH astram anaFgasya tava niSitam ||GAsH-_55||
   avinihitaṃ vinihitam iva yuvasu svaccheṣu vāra-vāma-dṛśaḥ |	avinihitam vinihitam iva yuvasu su-acCezu vAra-vAma--dRSaH |
   upadarśayanti hṛdayaṃ darpaṇa-bimbeṣu vadanam iva ||GAss_56||	upadarSayanti hRdayam darpaNa--bimbezu vadanam iva ||GAsH-_56||
   atilajjayā tvayaiva prakaṭaḥ preyān akāri nibhṛto 'pi |	ati-lajjayA tvayA-eva prakawaH preyAn akAri niBRtaH api |
   prāsāda-maulir upari prasarantyā vaijayanty eva ||GAss_57||	prAsAda--mOliH upari prasarantyAH vEjayantI eva ||GAsH-_57||
   anyonya-grathanāguṇa-yogād gāvaḥ padārpaṇair bahubhiḥ |	anyonya--graTanA-guNa-yogAt gAvaH pada-arpaNEH bahuBiH |
   khalam api tudanti meḍhī-bhūtaṃ madhya-stham ālambya ||GAss_58||	Kalam api tudanti meXI--BUtam maDya--sTam Alambya ||GAsH-_58||
   ananugraheṇa na tathā vyathayati kaṭu-kūjitair yathā piśunaḥ |	ananugraheNa na taTA vyaTayati kawu-kUjitEH yaTA piSunaH |
   rudhirādānād adhikaṃ dunoti karṇe kvaṇan maśakaḥ ||GAss_59||	ruDira-AdAnAt aDikam dunoti karNe kvaNat maSakaH ||GAsH-_59||
   agre laghimā paścān mahatāpi pidhīyate na hi mahimnā |	agre laGimA paScAt mahatA-api piDIyate na hi mahimnA |
   vāmana iti trivikramam abhidadhati daśāvatāra-vidaḥ ||GAss_60||	vAmanaH iti trivikramam aBidaDati daSa-avatAra-vidaH ||GAsH-_60||
   aṅke stanandhayas tava caraṇe paricārikā priyaḥ pṛṣṭhe |	aFke stananDayaH tava caraNe paricArikA priyaH pRzWe |
   asti kim u labhyam adhikaṃ gṛhiṇi yadā śaṅkase bālām ||GAss_61||	asti kim u laByam aDikam gRhiNi yadA SaFkase bAlAm ||GAsH-_61||
   adhara udastaḥ kūjitam āmīlitam akṣi lolito mauliḥ |	aDaraH udastaH kUjitam AmIlitam akzi lolitaH mOliH |
   āsāditam iva cumbana-sukham asparśe'pi taruṇābhyām ||GAss_62||	AsAditam iva cumbana--suKam asparSe-api taruNAByAm ||GAsH-_62||
   atirabhasena bhujo 'yaṃ vṛti-vivareṇa praveśitaḥ sadanam |	ati-raBasena BujaH ayam vRti-vivareNa praveSitaH sadanam |
   dayitāsparśollasito nāgacchati vartmanā tena ||GAss_63||	dayitA-sparSa-ullasitaH na-AgacCati vartmanA tena ||GAsH-_63||
   ambara-madhya-niviṣṭaṃ tavedam aticapalam alaghu jaghana-taṭam |	ambara--maDya--nivizwam tava-idam ati-capalam alaGu jaGana--tawam |
   cātaka iva navam abhraṃ nirīkṣamāṇo na tṛpyāmi ||GAss_64||	cAtakaH iva navam aBram nirIkzamANaH na tRpyAmi ||GAsH-_64||
   ayam andhakāra-sindhura-bhārākrāntāvanī-bharākrāntaḥ |	ayam anDakAra--sinDura--BAra-AkrAnta-avanI--Bara-AkrAntaH |
   unnata-pūrvādri-mukhaḥ kūrmaḥ sandhyāsram udvamati ||GAss_65||	unnata-pUrva-adri-muKaH kUrmaH sanDyA-asram udvamati ||GAsH-_65||
   antarbhūto nivasati jaḍe jaḍaḥ śiśira-mahasi hariṇa iva |	antarBUtaH nivasati jaxe jaxaH SiSira--mahasi hariNaH iva |
   ajaḍe śaśīva tapane sa tu praviṣṭo 'pi niḥsarati ||GAss_66||	ajaxe SaSI-iva tapane sa tu pravizwaH api niHsarati ||GAsH-_66||
   agaṇita-janāpavādā tvat-pāṇi-sparśa-harṣa-taraleyam |	agaNita-jana-apavAdA tu-at--pANi--sparSa--harza---taraleyam |
   āyāsyato varākī jvarasya talpaṃ prakalpayati ||GAss_67||	AyAsyataH varAkI jvarasya talpam prakalpayati ||GAsH-_67||
   apy eka-vaṃśa-januṣoḥ paśyata pūrṇatva-tucchatā-bhājoḥ |	api eka-vaMSa--januzoH paSyata pUrNa-tva--tucCatA-BAjoH |
   jyā-kārmukayoḥ kaścid guṇa-bhūtaḥ kaścid api bhartā ||GAss_68||	jyA--kArmukayoH kaScid guNa-BUtaH kaScid api BartA ||GAsH-_68||
   abhinava-keli-klāntā kalayati bālā krameṇa gharmāmbhaḥ |	aBinava--keli-klAntA kalayati bAlA krameNa GarmAmBaH |
   jyām arpayituṃ namitā kusumāstra-dhanur lateva madhu ||GAss_69||	jyAm arpayitum namitA kusuma-astra-DanuH latA-iva maDu ||GAsH-_69||
   asatī kulajā dhīrā prauḍhā prativeśinī yad āsaktim |	asatI kula-jA DIrA prOXA prativeSinI yat Asaktim |
   kurute sarasā ca tadā brahmānandaṃ tṛṇaṃ manye ||GAss_70||	kurute sarasA ca tadA brahma-Anandam tRNam manye ||GAsH-_70||
   avirala-patitāśru vapuḥ pāṇḍu snigdhaṃ tavopanītam idam |	avirala--patita-aSru vapuH pANxu snigDam tava-upanItam idam |
   śata-dhautam ājyam iva me smara-śara-dāha-vyathāṃ harati ||GAss_71||	Sata-DOtam Ajyam iva me smara-Sara--dAha--vyaTAm harati ||GAsH-_71||
   antar nipatita-guñjā-guṇa-ramaṇīyaś cakāsti kedāraḥ |	antar nipatita---guQjA--guNa-ramaNIyaH cakAsti kedAraH |
   nija-gopī-vinaya-vyaya-khedena vidīrṇa-hṛdaya iva ||GAss_72||	nija--gopI--vinaya--vyaya-Kedena vidIrNa--hRdayaH iva ||GAsH-_72||
   amunā hatam idam idam iti rudatī prativeśine'ṅgam aṅgam iyam |	amunA hatam idam idam iti rudatI prativeSine-aFgam aFgam iyam |
   roṣa-miṣa-dalita-lajjā gṛhiṇī darśayati pati-purataḥ ||GAss_73||	roza-miza-dalita--lajjA gRhiNI darSayati pati--puratas ||GAsH-_73||
   iti vibhāvyākhyā-sametā a-kāra-vrajyā ||	iti viBAvi-a-AKyA--sametAH a-kAra--vrajyA ||
   ā-kāra-vrajyā	A-kAra-vrajyA
   āntaram api bahiri va hi vyañjayituṃ rasam aśeṣataḥ satatam |	Antaram api bahiri va hi vyaQjayitum rasam aSezatas satatam |
   asatī sat-kavi-sūktiḥ kāca-ghaṭīti trayaṃ veda ||GAss_74||	asatI sat-ka-vi-su-uktiH kAca-GawI-iti trayam veda ||GAsH-_74||
   āloka eva vimukhī kvacid api divase na dakṣiṇā bhavasi |	AlokaH eva vimuKI kvacid api divase na dakziNA Bavasi |
   chāyeva tad api tāpaṃ tvam eva me harasi mānavati ||GAss_75||	CAyA-iva tat api tApam tvam eva me harasi mAnavati ||GAsH-_75||
   ājñā kākur yācñā-kṣepo hasitaṃ ca śuṣka-ruditaṃ ca |	AjQA kAkuH yAcQA-kzepaH hasitam ca Suzka-ruditam ca |
   iti nidhuvana-pāṇḍityaṃ dhyāyaṃs tasyā na tṛpyāmi ||GAss_76||	iti niDuvana--pANxityam DyAyan tasyAH na tRpyAmi ||GAsH-_76||
   ājñāpayiṣyasi padaṃ dāsyasi dayitasya śirasi kiṃ tvarase |	AjQApayizyasi padam dAsyasi dayitasya Sirasi kim tvarase |
   asamaya-mānini mugdhe mā kuru bhagnāṅkuraṃ prema ||GAss_77||	asamaya--mAnini mugDe mA kuru Bagna-aFkuram prema ||GAsH-_77||
   āsādya bhaṅgam anayā dyūte vihitābhirucita-keli-paṇe |	AsAdya BaFgam anayA dyUte vihita-aBirucita--keli-paNe |
   niḥsārayatākṣāniti kapaṭa-ruṣotsāritāḥ sakhyaḥ ||GAss_78||	niHsArayata-akzAn-iti kapawa--ruzA-utsAritAH saKyaH ||GAsH-_78||
   ādaraṇīya-guṇā sakhi mahatā nihitāsi tena śirasi tvam |	AdaraNIya-guNA saKi mahatA nihitA-asi tena Sirasi tvam |
   tava lāghava-doṣo 'yaṃ saudha-patākeva yac calasi ||GAss_79||	tava lAGava--dozaH ayam sODa-patAkA-iva yat calasi ||GAsH-_79||
   ārdram api stana-jaghanān nirasya sutanu tvayaitad unmuktam |	Ardram api stana--jaGanAt nirasya su-tanu tvayA-etat unmuktam |
   kha-stham avāptum iva tvāṃ tapanāṃśūn aṃśukaṃ pibati ||GAss_80||	Ka-sTam avAptum iva tvAm tapana-aMSUn aMSukam pibati ||GAsH-_80||
   āropitā śilāyām aśmeva tvaṃ bhaveti mantreṇa |	AropitA SilAyAm aSmA-iva tvam Bava-iti mantreNa |
   magnāpi pariṇayāpadi jāra-mukhaṃ vīkṣya hasitaiva ||GAss_81||	magnA-api pariNaya-Apadi jAra-muKam vIkzya hasitA-eva ||GAsH-_81||
   āyāti yāti khedaṃ karoti madhu harati madhukarīvānyā |	AyAti yAti Kedam karoti maDu harati maDukarI-iva-anyA |
   adhidevatā tvam eva śrīr iva kamalasya mama manasaḥ ||GAss_82||	aDidevatA tvam eva SrIH iva kamalasya mama manasaH ||GAsH-_82||
   āsādya dakṣiṇāṃ diśam avilambaṃ tyajati cottarāṃ taraṇiḥ |	AsAdya dakziNAm diSam avilambam tyajati ca-uttarAm taraNiH |
   puruṣaṃ haranti kāntāḥ prāyeṇa hi dakṣiṇā eva ||GAss_83||	puruzam haranti kAntAH prAyeNa hi dakziNAH eva ||GAsH-_83||
   ādāna-pāna-lepaiḥ kāścid garalopatāpa-hāriṇyaḥ |	AdAna--pAna--lepEH kAScid garala-upatApa--hAriNyaH |
   sadasi sthitaiva siddhauṣadhi-vallī kāpi jīvayati ||GAss_84||	sadasi sTitA-eva sidDOzaDi-vallI kA-api jIvayati ||GAsH-_84||
   āndola-lola-keśīṃ cala-kāñcī-kiṅkiṇī-gaṇa-kvaṇitām |	Anda-ula--lola-keSIm cala--kAQcI--kiFkiNI--gaNa--kvaNitAm |
   smarasi puruṣāyitāṃ tāṃ smara-cāmara-cihna-yaṣṭim iva ||GAss_85||	smarasi puruzAyitAm tAm smara--ca-amara--cihna--yazwim iva ||GAsH-_85||
   ākṣipasi karṇam akṣṇā balir api baddhas tvayā tridhā madhye |	Akzipasi karNam akzNA baliH api badDaH tvayA triDA maDye |
   iti jita-sakala-vadānye tanu-dāne lajjase sutanu ||GAss_86||	iti jita-sakala--vadAn-ye tanu--dAne lajjase su-tanu ||GAsH-_86||
   ākṣepa-caraṇa-laṅghana-keśa-graha-keli-kutuka-taralena |	Akzepa--caraNa--laFGana-keSa--graha--keli--kutuka--taralena |
   strīṇāṃ patir api gurur iti dharmaṃ na śrāvitā sutanuḥ ||GAss_87||	strINAm patiH api guruH iti Darmam na SrAvitA su-tanuH ||GAsH-_87||
   āgacchatānavekṣita-pṛṣṭhenārthī varāṭakeneva |	AgacCatA-anavekzita--pRzWena-arTI varAwakena-iva |
   muṣitāsmi tena jaghanāṃ-śukam api voḍhuṃ naśaktena ||GAss_88||	muzitA-asmi tena jaGana-aM-Sukam api voXum na-Saktena ||GAsH-_88||
   ākuñcitaika-jaṅghaṃ darāvṛtordhvoru gopitārdhoru |	AkuQcita-eka--jaFGam dara-AvRta-UrDva-Uru gopitA-arDa-Uru |
   sutanoḥ śvasita-kramana-mad-udara-sphuṭa-nābhi śayanam idam ||GAss_89||	su-tanoH Svasita-kramana-mad--udara--sPuwa-nABi Sayanam idam ||GAsH-_89||
   ādāya dhanam analpaṃ dadānayā subhaga tāvakaṃ vāsaḥ |	AdAya Danam analpam dadAnayA suBaga tAvakam vAsaH |
   mugdhā rajaka-gṛhiṇyā kṛtā dinaiḥ katipayair niḥsvā ||GAss_90||	mugDA rajaka-gRhiNyA kRtA dinEH katipayEH niHsvAH ||GAsH-_90||
   āstāṃ varam avakeśī mā doha-damasya racaya pūga-taroḥ |	AstAm varam avakeSI mA doha-damasya racaya pUga-taroH |
   etasmāt phalitād api kevalam udvegam adhigaccha ||GAss_91||	etasmAt PalitAt api kevalam udvegam aDigacCa ||GAsH-_91||
   ārabdham abdhi-mathanaṃ svahastayitvā dvi-jihvam amarair yat |	ArabDam abDi-maTanam sva-hastayitvA dvi-jihvam amarEH yat |
   ucitas tat-pariṇāmo viṣamaṃ viṣam eva yaj jātam ||GAss_92||	ucitaH tat--pariNAmaH vizamam vizam eva yat jAtam ||GAsH-_92||
   āvarjitālakāli śvāsotkampa-stanārpitaika-bhujam |	Avarjita-alakAli SvAsa-utkampa--stana-arpita-eka--Bujam |
   śayanaṃ rati-vivaśa-tanoḥ smarāmi śithilāṃśukaṃ tasyāḥ ||GAss_93||	Sayanam rati-vivaSa--tanoH smarAmi SiTila-aMSukam tasyAH ||GAsH-_93||
   āmrāṅkuro 'yam aruṇa-śyāmala-rucir asthi-nirgataḥ sutanu |	Amra-aFkuraH ayam aruNa-SyAmala--ruciH asTi--nirgataH su-tanu |
   nava-kamaṭha-karpara-puṭān mūrdhevordhvaṃ gataḥ sphurati ||GAss_94||	nava-ka-maWa-karpara--puwAn mUrDA-iva-UrDvam gataH sPurati ||GAsH-_94||
   ābhaṅgurāgra-bahu-guṇa-dīrghāsvāda-pradā priyā-dṛṣṭiḥ |	ABaFgura-agra--bahu--guNa--dIrGa-AsvAda--pradA priyA--dRzwiH |
   karṣati mano madīyaṃ hrada-mīnaṃ baḍiśa-rajjur iva ||GAss_95||	karzati manaH madIyam hrada--mInam baxiSa--rajjuH iva ||GAsH-_95||
   ālapa yathā yathecchasi yuktaṃ tava kitava kim apavārayasi |	Alapa yaTA yaTA-icCasi yuktam tava kitava kim apavArayasi |
   strī-jāti-lāñchanam asau jīvita-raṅkā sakhī subhaga ||GAss_96||	strI--jAti--lAQCanam asO jIvita--raFkA saKI suBagaH ||GAsH-_96||
   āsvādito 'si mohād bata viditā vadana-mādhurī bhavataḥ |	AsvAditaH asi mohAt bata viditA vadana--mADurI BavataH |
   madhu-lipta-kṣura rasanāc chedāya paraṃ vijānāsi ||GAss_97||	maDu-lipta-kzura rasanAt CedAya param vijAnAsi ||GAsH-_97||
   ākṛṣṭi-bhagna-kaṭakaṃ kena tava prakṛti-komalaṃ subhage |	AkRzwi-Bagna--kawakam kena tava prakRti-komalam suBage |
   dhanyena bhuja-mṛṇālaṃ grāhyaṃ madanasya rājyam iva ||GAss_98||	Danyena Buja--mRNAlam grAhyam madanasya rAjyam iva ||GAsH-_98||
   āruhya dūram agaṇita-raudra-kleśā prakāśayantī svam |	Aruhya dUram agaNita-rOdra--kleSA prakASayantI svam |
   vāta-pratīcchana-paṭī vahitram iva harasi māṃ sutanu ||GAss_99||	vAta--pratIcCana--pawI vahitram iva harasi mAm su-tanu ||GAsH-_99||
   āyāsaḥ para-hiṃsā vaitaṃsika-sārameya tava sāraḥ |	AyAsaH para-hiMsA vEtaMsika--sArameya tava sAraH |
   tvām apasārya vibhājyaḥ kuraṅga eṣo 'dhunaivānyaiḥ ||GAss_100||	tvAm apasArya viBAjyaH kuraFgaH ezaH aDunA-eva-anyEH ||GAsH-_100||
   ānayati pathika-taruṇaṃ hariṇa iha prāpayann ivātmānam |	Anayati paTika-taruNam hariNaH iha prApayan iva-AtmAnam |
   upakalam ago 'pi komala-kalam āvalika-valanottaralaḥ ||GAss_101||	upakalam agaH api komala--kalam Avalika-valana-uttaralaH ||GAsH-_101||
   āsīd eva yad ārdraḥ kim api tadā kim ayam āhato 'py āha |	AsIt eva yat ArdraH kim api tadA kim ayam AhataH api Aha |
   niṣṭhura-bhāvād adhunā kaṭūni sakhi raṭati paṭaha iva ||GAss_102||	nizWura--BAvAt aDunA kawUni saKi rawati pawahaH iva ||GAsH-_102||
   ājñā-karaś ca tāḍana-paribhava-sahanaś ca satyam aham asyāḥ |	AjQA-karaH ca tAxana--pariBava--sahanaH ca satyam aham asyAH |
   na tu śīla-śītaleyaṃ priyetarad vaktum api veda ||GAss_103||	na tu SIla-SItaleyam priyA-itarat vaktum api veda ||GAsH-_103||
   ādhāya dugdha-kalaśe manthānaṃ śrānta-dor-latā gopī |	ADAya dugDa--kalaSe manTAnam SrAnta-dos--latA gopI |
   aprāpta-pārijātā daive doṣaṃ niveśayati ||GAss_104||	aprApta--pArijAtAH dEve dozam niveSayati ||GAsH-_104||
   āstāṃ mānaḥ kathanaṃ sakhīṣu vā mayi nivedya-durvinaye |	AstAm mAnaH kaTanam saKIzu vA mayi nivedya--durvinaye |
   śithilita-rati-guṇa-garvā mamāpi sā lajjitā sutanuḥ ||GAss_105||	SiTilita--rati-guNa--garvAH mama-api sA lajjitA su-tanuH ||GAsH-_105||
   āvartair ātarpaṇa-śobhāṃ ḍiṇḍīra-pāṇḍurair dadhatī |	AvartEH AtarpaNa--SoBAm xiNxIra--pANxurEH daDatI |
   gāyati mukharita-salilā priya-saṅgama-maṅgalaṃ surasā ||GAss_106||	gAyati muKarita--salilA priya-saFgama-maFgalam surasA ||GAsH-_106||
   iti vibhāvyākhyā-sametā ā-kāra-vrajyā ||	iti viBAvi-a-AKyA--sametAH A-kAra-vrajyA ||
   i-kāra-vrajyā	i-kAra-vrajyA
   iyam udgatiṃ harantī-netra-nikocaṃ ca vidadhatī purataḥ |	iyam udgatim harantI--netra-nikocam ca vidaDatI puratas |
   na vijānīmaḥ kiṃ tava vadati sapatnīva dina-nidrā ||GAss_107||	na vijAnImaH kim tava vadati sapatnI-iva dina--nidrA ||GAsH-_107||
   idam ubhaya-bhitti-santata-hāra-guṇāntar-gataika-kuca-mukulam |	idam uBaya-Bitti-santata-hAra--guNa-antar--gata-eka-kuca--mukulam |
   guṭikā-dhanur iva bālā-vapuḥ smaraḥ śrayati kutukena ||GAss_108||	guwikA--DanuH iva bAlA--vapuH smaraH Srayati kutukena ||GAsH-_108||
   iha śikhari-śikharāvalambini vinoda-dara-tarala-vapuṣi taru-hariṇe |	iha SiKari--SiKara-avalambini vinoda-dara--tarala-vapuzi taru-hariNe |
   paśyābhilaṣati patituṃ vihagī nija-nīḍa-mohena ||GAss_109||	paSya-aBilazati patitum vihagI nija--nIxa--mohena ||GAsH-_109||
   ikṣur nadī-pravāho dyūtaṃ māna-grahaś ca he sutanu |	ikzuH nadI--pravAhaH dyUtam mAna-grahaH ca he su-tanu |
   bhrū-latikā ca taveyaṃ bhaṅge rasam adhikam āvahati ||GAss_110||	BrU-latikA ca tava-iyam BaFge rasam aDikam Avahati ||GAsH-_110||
   indor ivāsya purato yad vimukhī sāpa-vāraṇā bhramasi |	indoH iva-asya puratas yat vimuKI sa-apa-vAraNAH Bramasi |
   tat kathaya kiṃ nu duritaṃ sakhi tvayā chāyayeva kṛtam ||GAss_111||	tat kaTaya kim nu duritam saKi tvayA CAyayA-iva kRtam ||GAsH-_111||
   iha kapaṭa-kutuka-taralita-dṛśi viśvāsaṃ kuraṅga kiṃ kuruṣe |	iha kapawa-kutuka-taralita-dRSi viSvAsam kuraFga kim kuruze |
   tava rabhasa-taraliteyaṃ vyādha-vadhūr vāladhau valate ||GAss_112||	tava raBasa--taralitA-iyam vyADa-vaDUH vAlaDO valate ||GAsH-_112||
   iha vahati bahu mahodadhivibhūṣaṇā mānagarvam iyam urvī |	iha vahati bahu mahA-udaDi-viBUzaNA mAna-garvam iyam urvI |
   devasya kamaṭhamūrteḥ na pṛṣṭhaṃ api nikhilam āpnoti ||GAss_113||	devasya kamaWa-mUrteH na pRzWam api niKilam Apnoti ||GAsH-_113||
   iti vibhāvyākhyā-sametā i-kāra-vrajyā ||	iti viBAvi-a-AKyA--sametAH i-kAra--vrajyA ||
   ī-kāra-vrajyā	I-kAra-vrajyA
   īrṣyā-roṣa-jvalito-nija-pati-saṅgaṃ vicintayaṃs tasyāḥ |	IrzyA-roza--jvalitaH--nija-pati-saFgam vicintayan tasyAH |
   cyuta-vasana-jaghana-bhāvana-sāndrānandena nirvāmi ||GAss_114||	cyuta--vasana--jaGana--BAvana--sAndra-Anandena nirvAmi ||GAsH-_114||
   īśvara-parigrahocita-moho 'syāṃ madhupa kiṃ mudhā patasi |	ISvara--parigraha-ucita-mohaH asyAm maDupa kim muDA patasi |
   kanakābhidhāna-sārā vīta-rasā kitava-kalikeyam ||GAss_115||	kanaka-aBiDAna--sArAH vIta-rasA kitava--kalikA-iyam ||GAsH-_115||
   īṣad avaśiṣṭa-jaḍimā śiśire gata-mātra eva ciram aṅgaiḥ |	Izat avaSizwa--jaximA SiSire gata--mAtraH eva ciram aFgEH |
   nava-yauvaneva tanvī niṣevyate nirbharaṃ vāpī ||GAss_116||	nava-yOvanA-iva tanvI nizevyate nirBaram vApI ||GAsH-_116||
   iti vibhāvyākhyā-sametā ī-kāra-vrajyā ||	iti viBAvi-a-AKyA--sametAH I-kAra-vrajyA ||
   u-kāra-vrajyā	u-kAra-vrajyA
   ullasita-bhrū-dhanuṣā tava pṛthunā locanena rucirāṅgi |	ullasita--BrU--DanuzA tava pRTunA locanena rucira-aFgi |
   acalā api na mahāntaḥ ke cañcala-bhāvam ānītāḥ ||GAss_117||	acalAH api na mahAntaH ke caQcala-BAvam AnItAH ||GAsH-_117||
   upanīya yan nitambe bhujaṅgam uccair alambi vibudhaiḥ śrīḥ |	upanIya yat nitambe BujaFgam uccEs alambi vibuDEH SrIH |
   ekaḥ sa mandara-giriḥ sakhi garimāṇaṃ samudvahatu ||GAss_118||	ekaH sa mandara-giriH saKi garimANam samudvahatu ||GAsH-_118||
   ullasita-lāñchano 'yaṃ jyotsnā-varṣī sudhākaraḥ sphurati |	ullasita-lAQCanaH ayam jyotsnA--varzI suDAkaraH sPurati |
   āsakta-kṛṣṇa-caraṇaḥ śakaṭa iva prakaṭita-kṣīraḥ ||GAss_119||	Asakta--kRzNa--caraNaH SakawaH iva prakawita-kzIraH ||GAsH-_119||
   upacārānunayās te kitavasyopekṣitāḥ sakhī-vacasā |	upacAra-anunayAH te kitavasya-upekzitAH saKI--vacasA |
   adhunā niṣṭhuram api yadi sa vadati kalikaitavād yāmi ||GAss_120||	aDunA nizWuram api yadi sa vadati kali-kEtavAt yAmi ||GAsH-_120||
   uṣasi parivartayantyā muktā-dāmopavītatāṃ nītam |	uzasi parivartayantyA muktA-dAma-upavIta-tAm nItam |
   puruṣāyita-vaidagdhyaṃ vrīḍāvati kairna kalitaṃ te ||GAss_121||	puruzAyita--vEdagDyam vrIxAvati kEH-na kalitam te ||GAsH-_121||
   uḍḍīnānām eṣāṃ prāsādāt taruṇi pakṣiṇāṃ paṅktiḥ |	uxxInAnAm ezAm prAsAdAt taruNi pakziNAm paFktiH |
   visphurati vaijayantī-pavana-cchinnāpaviddheva ||GAss_122||	visPurati vEjayantI--pavana--cCinna-apavidDA-iva ||GAsH-_122||
   ujjāgarita-bhrāmita-dantura-dala-ruddha-madhukara-prakare |	ujjAgarita--BrAmita--dantura-dala--rudDa--maDukara--prakare |
   kāñcana-ketaki mā tava vikasatu saurabhya-sambhāraḥ ||GAss_123||	kAQcana-ketaki mA tava vikasatu sOraBya--samBAraH ||GAsH-_123||
   ullasita-bhrūḥ kim atikrāntaṃ cintayasi nistaraṅgākṣi |	ullasita--BrUH kim atikrAntam cintayasi nistaraFga-akzi |
   kṣudrāpacāra-virasaḥ pākaḥ premṇo guḍasyeva ||GAss_124||	kzudra-apacAra-virasaH pAkaH premNaH guxasya-iva ||GAsH-_124||
   uddiśya niḥsarantīṃ sakhīm iyaṃ kapaṭa-kopa-kuṭila-bhrūḥ |	uddiSya niHsarantIm saKIm iyam kapawa-ka-upa-kuwila-BrUH |
   evam avataṃsam ākṣipad āhata-dīpo yathā patati ||GAss_125||	evam avataMsam Akzipat Ahata-dIpaH yaTA patati ||GAsH-_125||
   udito 'pi tuhina-gahane gagana-prānte na dīpyate tapanaḥ |	uditaH api tuhina--gahane gagana--prAnte na dIpyate tapanaH |
   kaṭhina-ghṛta-pūra-pūrṇe śarāva-śirasi pradīpa iva ||GAss_126||	kaWina--GRta-pUra-pUrNe SarAva--Sirasi pradIpaH iva ||GAsH-_126||
   udgamanopaniveśana-śayana-parāvṛtti-valana-calaneṣu |	udgamana-upaniveSana-Sayana--parAvRtti--valana-calanezu |
   aniśaṃ sa mohayati māṃ hṛl-lagnaḥ śvāsa iva dayitaḥ ||GAss_127||	aniSam sa mohayati mAm hRl--lagnaH SvAsaH iva dayitaH ||GAsH-_127||
   ujjhita-saubhāgya-mada-sphuṭa-yācñānaṅga-bhītayor yūnoḥ |	ujJita--sOBAgya--mada--sPuwa--yAcQA-anaFga-BItayoH yUnoH |
   akalita-manasor ekā dṛṣṭir dūtī nisṛṣṭārthī ||GAss_128||	akalita-manasoH ekA dRzwiH dUtI nisRzwa-arTI ||GAsH-_128||
   uttama-bhujaṅga-saṅgama-nispanda-nitamba-cāpalas tasyāḥ |	uttama--BujaFga--saFgama--nispanda--nitamba-cApalaH tasyAH |
   mandara-girir iva vibudhair itas tataḥ kṛṣyate kāyaḥ ||GAss_129||	mandara-giriH iva vibuDEH itas tatas kRzyate kAyaH ||GAsH-_129||
   upanīya kalama-kuḍavaṃ kathayati sabhayaś cikitsake halikaḥ |	upanIya kalama--kuxavam kaTayati sa-BayaH cikitsake halikaH |
   śoṇaṃ somārdha-nibhaṃ vadhū-stane vyādhim upajātam ||GAss_130||	SoNam soma-arDa--niBam vaDU--stane vyADim upajAtam ||GAsH-_130||
   unmukulitādhara-puṭe-bhūti-kaṇa-trāsa-mīlitārdhākṣi |	unmukulita-aDara--puwe--BUti-kaNa-trAsa--mIlita-arDa-akzi |
   dhūmo 'pi neha virama-bhramaro 'yaṃ śvasitam anusarati ||GAss_131||	DUmaH api na-iha virama--BramaraH ayam Svasitam anusarati ||GAsH-_131||
   upari pariplavate mama bāleyaṃ gṛhiṇi haṃsa-māleva |	upari pariplavate mama bAlA-iyam gRhiNi haMsa--mAlA-iva |
   sarasa iva nalina-nālā tvam āśayaṃ prāpya vasasi punaḥ ||GAss_132||	sarasaH iva nalina-nAlA tvam ASayam prApya vasasi punar ||GAsH-_132||
   utkampa-gharma-picchila-doḥ-sādhika-hasta-vicyutaś cauraḥ |	utkampa--Garma--picCila-doH--sADika-hasta-vicyutaH cOraH |
   śivam āśāste sutanu-stanayos tava pañcalāñcalayoḥ ||GAss_133||	Sivam ASAste su-tanu--stanayoH tava paQcala-aQcalayoH ||GAsH-_133||
   utkṣipta-bāhu-darśita-bhuja-mūlaṃ cūta-mukula mama sakhyā |	utkzipta--bAhu--darSita-Buja--mUlam cUta-mukula mama saKyA |
   ākṛṣyamāṇa rājati bhavataḥ param ucca-pada-lābhaḥ ||GAss_134||	AkRzyamANa rAjati BavataH param ucca-pada--lABaH ||GAsH-_134||
   ucca-kuca-kumbha-nihito hṛdayaṃ cālayati jaghana-lagnāgraḥ |	ucca-kuca-kumBa--nihitaH hRdayam cAlayati jaGana---lagna-agraH |
   atinimna-madhya-saṅkrama-dāru-nibhas taruṇi tava hāraḥ ||GAss_135||	ati-nimna--maDya--saFkrama-dAru--niBaH taruNi tava hAraH ||GAsH-_135||
   ullasita-śīta-dīdhiti-kalopakaṇṭhe sphuranti tāraughāḥ |	ullasita-SIta-dIDiti--kalA-upa-kaNWe sPuranti tAra-oGAH |
   kusumāyudha-vidhṛta-dhanur-nirgata-makaranda-bindu-nibhāḥ ||GAss_136||	kusumAyuDa--viDRta--DanuH--nirgata--makaranda--bindu--niBAH ||GAsH-_136||
   upanīya priyam asamaya-vidaṃ ca me dagdha-mānam apanīya |	upanIya priyam asamaya-vidam ca me dagDa-mAnam apanIya |
   narmopakrama eva kṣaṇade dūtīva calitāsi ||GAss_137||	narma-upakramaH eva kzaNade dUtI-iva calitA-asi ||GAsH-_137||
   uttama-vanitaika-gatiḥ karīva sarasī-payaḥ sakhī-dhairyam |	uttama--vanitA-eka-gatiH karI-iva sarasI--payaH saKI--DEryam |
   āskanditoruṇā tvaṃ hastenaiva spṛśan harasi ||GAss_138||	Askandita-UruNA tvam hastena-eva spRSan harasi ||GAsH-_138||
   iti vibhāvyākhyā-sametā u-kāra-vrajyā ||	iti viBAvi-a-AKyA--sametAH u-kAra-vrajyA ||
   ū-kāra-vrajyā	U-kAra-vrajyA
   ūḍhāmunātivāhaya pṛṣṭhe lagnāpi kālam acalāpi |	UXa-amunA-ativAhaya pRzWe lagnA-api kAlam acalA-api |
   sarvaṃsahe kaṭhora-tvacaḥ kim aṅkena kamaṭhasya ||GAss_139||	sarvaMsahe kaWora--tvacaH kim aFkena kamaWasya ||GAsH-_139||
   iti vibhāvyākhyā-sametā ū-kāra-vrajyā ||	iti viBAvi-a-AKyA--sametAH U-kAra-vrajyA ||
   ṛ-kāra-vrajyā	R-kAra-vrajyA
   ṛjunā nidhehi caraṇau parihara sakhi nikhila-nāgarācāram |	RjunA niDehi caraNO parihara saKi niKila--nAgara-AcAram |
   iha ḍākinīti pallī-patiḥ kaṭākṣe'pi daṇḍayati ||GAss_140||	iha xAkinI-iti pallI--patiH kawAkze-api daNxayati ||GAsH-_140||
   ṛṣabho 'tra gīyata iti śrutvā svara-pāragā vayaṃ prāptāḥ |	RzaBaH atra gIyate iti SrutvA svara--pAragAH vayam prAptAH |
   ko veda goṣṭham etad go-śāntau vihita-bahu-mānam ||GAss_141||	kaH veda gozWam etat go-SAntO vihita-bahu--mAnam ||GAsH-_141||
   iti vibhāvyākhyā-sametā ṛ-kāra-vrajyā ||	iti viBAvi-a-AKyA--sametAH R-kAra-vrajyA ||
   e-kāra-vrajyā	e-kAra-vrajyA
   eko haraḥ priyādhara-guṇa-vedī diviṣado 'pare mūḍhāḥ |	ekaH haraH priya-aDara--guNa--vedI divizadaH apare mUXAH |
   viṣam amṛtaṃ vā samam iti yaḥ paśyan garalam eva papau ||GAss_142||	vizam amRtam vA samam iti yaH paSyan garalam eva papO ||GAsH-_142||
   eṣyati mā punar ayam iti gamane yad amaṅgalaṃ mayākāri |	ezyati mA punar ayam iti gamane yat amaFgalam mayA-kAri |
   adhunā tad eva kāraṇam avasthitau dagdha-geha-pateḥ ||GAss_143||	aDunA tat eva kAraNam avasTitO dagDa--geha--pateH ||GAsH-_143||
   ekaikaśo yuva-janaṃ vilaṅghamānākṣa-nikaram iva taralā |	ekEkaSas yuva--janam vilaFGamAna-akza--nikaram iva taralA |
   viśrāmyati subhaga tvām aṅgulir āsādya merum iva ||GAss_144||	viSrAmyati suBaga tvAm aFguliH AsAdya merum iva ||GAsH-_144||
   ekaḥ sa eva jīvati svahṛdaya-śūnyo 'pi sahṛdayo rāhuḥ |	ekaH saH eva jIvati sva-hRdaya--SUnyaH api sahRdayaH rAhuH |
   yaḥ sakala-laghima-kāraṇam udaraṃ na bibharti duṣpūram ||GAss_145||	yaH sa-kala-laGim-a-kAraNam udaram na biBarti duzpUram ||GAsH-_145||
   ekena cūrṇa-kuntalam apareṇa kareṇa cibukam unnamayan |	ekena cUrNa-kuntalam apareNa kareNa cibukam unnamayan |
   paśyāmi bāṣpa-dhauta-śruti nagara-dvāri tad-vadanam ||GAss_146||	paSyAmi bAzpa--DOta--Sruti nagara-dvAri tad--vadanam ||GAsH-_146||
   ekaṃ jīvana-mūlaṃ cañcalam api tāpayantam api satatam |	ekam jIvana--mUlam caQcalam api tApayantam api satatam |
   antar vahati varākī sā tvāṃ nāseva niḥśvāsam ||GAss_147||	antar vahati varAkI sA tvAm nAsA-iva niHSvAsam ||GAsH-_147||
   ekaṃ vadati mano mama yāmi na yāmīti hṛdayam aparaṃ me |	ekam vadati manaH mama yAmi na yAmi-iti hRdayam aparam me |
   hṛdaya-dvayam ucitaṃ tava sundari hṛta-kānta-cittāyāḥ ||GAss_148||	hRdaya--dvayam ucitam tava sundari hRta-kAnta--cittAyAH ||GAsH-_148||
   eraṇḍa-pattra-śayanā janayantī svedam alaghu-jaghana-taṭā |	eraNxa-pattra--SayanA janayantI svedam alaGu--jaGana--tawA |
   dhūli-puṭīva milantī smara-jvaraṃ harati halika-vadhūḥ ||GAss_149||	DUli--puwI-iva milantI smara--jvaram harati halika-vaDUH ||GAsH-_149||
   iti vibhāvyākhyā-sametā e-kāra-vrajyā ||	iti viBAvi-a-AKyA--sametAH e-kAra-vrajyA ||
   ka-kāra-vrajyā	ka-kAra-vrajyA
   keli-nilayaṃ sakhīm iva nayati navoḍhāṃ svayaṃ na māṃ bhajate |	keli--nilayam saKIm iva nayati na-va-UXAm svayam na mAm Bajate |
   itthaṃ gṛhiṇīm arye stuvati prativeśinā hasitam ||GAss_150||	itTam gRhiNIm arye stuvati prativeSinA hasitam ||GAsH-_150||
   kāla-krama-kamanīya-kroḍeyaṃ ketakīti kāśaṃsā |	kAla--krama-kamanIya--kroxA-iyam ketakI-iti kASaMsA |
   vṛddhir yathā yathā syās tathā tathā kaṇṭakotkarṣaḥ ||GAss_151||	vRdDiH yaTA yaTA syAH taTA taTA kaNwaka-utkarzaH ||GAsH-_151||
   kṛtakasvāpa madīya-śvāsa-dhvani-datta-karṇa kiṃ tīvraiḥ |	kRtaka-svApa madIya--SvAsa--Dvani-datta-karNa kim tIvrEH |
   vidhyasi māṃ niḥśvāsaiḥ smaraḥ śaraiḥ śabda-vedhīva ||GAss_152||	viDyasi mAm niHSvAsEH smaraH SarEH Sabda-veDI-iva ||GAsH-_152||
   kva sa nirmoka-dukūlaḥ kvālaṅkaraṇāya phaṇi-maṇi-śreṇī |	kva sa nirmoka-dukUlaH kva-alaFkaraNAya PaNi-maNi--SreNI |
   kāliya-bhujaṅga-gamanād yamune viśvasya gamyāsi ||GAss_153||	kAliya--BujaFga--gamanAt yamune viSvasya gamyA-asi ||GAsH-_153||
   kiñcin na bālayoktaṃ na saprasādā niveśitā dṛṣṭiḥ |	kiQcid na bAlayA-uktam na sa-prasAdA niveSitA dRzwiH |
   mayi pada-patite kevalam akāri śuka-pañjaro vimukhaḥ ||GAss_154||	mayi pada-patite kevalam akAri Suka--paQjaraH vimuKaH ||GAsH-_154||
   kṛta-hasita-hasta-tālaṃ manmatha-taralair vilokitāṃ yuvabhiḥ |	kRta--hasita-hasta-tAlam manmaTa-taralEH vilokitAm yuvaBiH |
   kṣiptaḥ kṣipto nipatann aṅge nartayati bhṛṅgas tām ||GAss_155||	kziptaH kziptaH nipatan aFge nartayati BRFgaH tAm ||GAsH-_155||
   kamala-mukhi sarvatomukha-nivāraṇaṃ vidadhad eva bhūṣayati |	kamala--muKi sarvatomuKa--nivAraNam vidaDat eva BUzayati |
   rodho 'ruddha-svarasās taraṅgiṇīs tarala-nayanāś ca ||GAss_156||	roDaH arudDa--svarasAH taraFgiNIH tarala--nayanAH ca ||GAsH-_156||
   kitava prapañcitā sā bhavatā mandākṣa-manda-sañcārā |	kitava prapaQcitA sA BavatA manda-akza-manda--saQcArAH |
   bahu-dāyair api samprati pāśakasārīva nāyāti ||GAss_157||	bahu-dAyEH api samprati pASaka-sArI-iva na-AyAti ||GAsH-_157||
   kaḥ ślāghanīya-janmā māgha-niśīthe'pi yasya saubhāgyam |	kaH SlAGanIya--janmA mAGa--niSITe-api yasya sOBAgyam |
   prāleyānila-dīrghaḥ kathayati kāñcī-ninādo 'yam ||GAss_158||	prAleya-anila--dIrGaH kaTayati kAQcI-ninAdaH ayam ||GAsH-_158||
   kim aśakanīyaṃ premṇaḥ phaṇinaḥ kathayāpi yā bibheti sma |	kim aSakanIyam premNaH PaNinaH kaTaya-api yA biBeti sma |
   sā giriśa-bhuja-bhujaṅgama-pheṇopadhānādya nidrāti ||GAss_159||	sA giri-Sa--Buja--BujaFgama-PeNa-upaDAna-adya nidrAti ||GAsH-_159||
   kṛtrima-kanakeneva premṇā muṣitasya vāra-vanitābhiḥ |	kRtrima--kanakena-iva premNA muzitasya vAra-vanitABiH |
   laghur iva vitta-vināśa-kleśo jana-hāsyatā mahatī ||GAss_160||	laGuH iva vitta--vinASa--kleSaH jana--hAsya-tA mahatI ||GAsH-_160||
   kiṃ parva-divasam ārjita-dantoṣṭhi nijaṃ vapur na maṇḍayasi |	kim parva--divasam Arjita--danta-uzWi nijam vapuH na maNxayasi |
   sa tvāṃ tyajati na parvasv api madhurām ikṣu-yaṣṭim iva ||GAss_161||	sa tvAm tyajati na parvasu api maDurAm ikzu--yazwim iva ||GAsH-_161||
   kaṣṭaṃ sāhasa-kāriṇi tava nayanārdhena so 'dhvani spṛṣṭaḥ |	kazwam sAhasa--kAriNi tava nayana-arDena saH aDvani spRzwaH |
   upavītād api vidito na dvija-dehas tapasvī te ||GAss_162||	upavItAt api viditaH na dvija-dehaH tapasvI te ||GAsH-_162||
   kleśe'pi tanyamāne militeyaṃ māṃ pramodayaty eva |	kleSe-api tanyamAne militA-iyam mAm pramodayati eva |
   raudre'nabhre'pi nabhaḥ-surāpagā-vāri-vṛṣṭir eva ||GAss_163||	rOdre-anaBre-api naBaH--sura-ApagA-vAri-vRzwiH eva ||GAsH-_163||
   kūpa-prabhavāṇāṃ param ucitam apāṃ paṭṭa-bandhanaṃ manye |	kUpa--praBavANAm param ucitam apAm pawwa-banDanam manye |
   yāḥ śakyante labdhuṃ na pārthivenāpi viguṇena ||GAss_164||	yAH Sakyante labDum na pArTivena-api viguNena ||GAsH-_164||
   kararuha-śikhā-nikhāta bhrāntvā viśrānta rajani-duravāpa |	kararuha--SiKA--niKAta BrAntvA viSrAnta rajani-duH-avApa |
   ravir iva yantrollikhitaḥ kṛśo 'pi lokasya harasi dṛśam ||GAss_165||	raviH iva yantra-ulliKitaH kRSaH api lokasya harasi dRSam ||GAsH-_165||
   kiṃ karavāṇi divā-niśam api lagnā sahaja-śītala-prakṛtiḥ |	kim karavANi divA-niSam api lagnA sahaja-SItala--prakRtiH |
   hanta sukhayāmi na priyam ātmānam ivātmanaś chāyā ||GAss_166||	hanta suKayAmi na priyam AtmAnam iva-AtmanaH CAyAH ||GAsH-_166||
   keśaiḥ śiraso garimā maraṇaṃ pīyūṣa-kuṇḍa-pātena |	keSEH SirasaH garimAH maraNam pIyUza--kuNxa--pAtena |
   dayita-vahanena vakṣasi yadi bhāras tad idam acikitsyam ||GAss_167||	dayita--vahanena vakzasi yadi BAraH tat idam acikitsyam ||GAsH-_167||
   kiñcit karkaśatām anu rasaṃ pradāsyan nisarga-madhuraṃ me |	kiQcid karkaSatAm anu rasam pradAsyan nisarga--maDuram me |
   ikṣor iva te sundari mānasya granthir api kāmyaḥ ||GAss_168||	ikzoH iva te sundari mAnasya granTiH api kAmyaH ||GAsH-_168||
   kena giriśasya dattā buddhir bhujagaṃ jaṭāvane'rpayitum |	kena giriSasya dattA budDiH Bujagam jawA-vane-arpayitum |
   yena rati-rabhasa-kāntā-kara-cikurākarṣaṇaṃ muṣitam ||GAss_169||	yena rati--raBasa-kAntA-kara--cikura-AkarzaNam muzitam ||GAsH-_169||
   kara-caraṇa-kāñci-hāra-prahāram avacintya bala-gṛhīta-kacaḥ |	kara--caraNa--kAQci-hAra--prahAram avacintya bala-gRhIta-kacaH |
   praṇayī cumbati dayitā-vadanaṃ sphurad-adharam aruṇākṣam ||GAss_170||	praNayI cumbati dayitA--vadanam sPurat--aDaram aruNa-akzam ||GAsH-_170||
   kurutāṃ cāpalam adhunā kalayatu surasāsi yādṛśī tad api |	kurutAm cApalam aDunA kalayatu surasA-asi yAdRSI tat api |
   sundari harītakīm anu paripītā vāridhāreva ||GAss_171||	sundari harItakIm anu paripItAH vAri-DArA-iva ||GAsH-_171||
   kajjala-tilaka-kalaṅkita-mukha-candre galita-salila-kaṇa-keśi |	kajjala-tilaka--kalaFkita-muKa-candre galita-salila--kaNa-keSi |
   nava-viraha-dahana-tūlo jīvayitavyas tvayā katamaḥ ||GAss_172||	nava--viraha--dahana-tUlaH jIvayitavyaH tvayA katamaH ||GAsH-_172||
   kṛcchrānuvṛttayo 'pi hi paropakāraṃ tyajanti na mahāntaḥ |	kRcCra-anuvRttayaH api hi para-upakAram tyajanti na mahAntaH |
   tṛṇa-mātra-jīvanā api kariṇo dāna-dravārdra-karāḥ ||GAss_173||	tRNa--mAtra--jIvanAH api kariNaH dAna-drava-Ardra-karAH ||GAsH-_173||
   kiṃ hasatha kiṃ pradhāvatha kiṃ janam āhvayatha bālakā viphalam |	kim hasaTa kim praDAvaTa kim janam AhvayaTa bAlakAH viPalam |
   tad atha darśayati yathāriṣṭaḥ kaṇṭhe'munā jagṛhe ||GAss_174||	tat aTa darSayati yaTA-arizwaH kaNWe-amunA jagRhe ||GAsH-_174||
   kātaratā-kekarita-smara-lajjā-roṣa-masṛṇa-madhurākṣī |	kAtara-tA-kekarita-smara---lajjA-ra-Uza--masRNa--maDura-akzI |
   yoktuṃ na moktum athavā valate'sāv artha-labdha-ratiḥ ||GAss_175||	yoktum na moktum aTavA valate-asO arTa-labDa--ratiH ||GAsH-_175||
   ketaka-garbhe gandhādareṇa dūrād amī drutam upetāḥ |	ketaka-garBe ganDa-AdareNa dUrAt amI drutam upetAH |
   madana-syandana-vājita iva madhupā dhūlim ādadate ||GAss_176||	madana--syandana--vAjitaH iva maDupAH DUlim Adadate ||GAsH-_176||
   ko vakrimā guṇāḥ ke kā kāntiḥ śiśira-kiraṇa-lekhānām |	kaH vakrimA guNAH ke kA kAntiH SiSira--kiraNa--leKAnAm |
   antaḥ praviśya yāsām ākrāntaṃ paśu-viśeṣeṇa ||GAss_177||	antar praviSya yAsAm AkrAntam paSu--viSezeNa ||GAsH-_177||
   kṛta-vividha-mathana-yatnaḥ parābhāvāya prabhuḥ surāsurayoḥ |	kRta-viviDa-maTana-yatnaH parABAvAya praBuH sura-asurayoH |
   icchati saubhāgyam adāt svayaṃvareṇa śriyaṃ viṣṇuḥ ||GAss_178||	icCati sOBAgyam adAt svayaMvareNa Sriyam vizNuH ||GAsH-_178||
   kiṃ putri gaṇḍa-śaila-bhrameṇa nava-nīradeṣu nidrāsi |	kim putri gaNxa--SEla--BrameNa nava--nIradezu nidrA-asi |
   anubhava capalāvilasita-garjita-deśāntara-bhrāntīḥ ||GAss_179||	anuBava capala-Avilasita--garjita-deSa-antara--BrAntIH ||GAsH-_179||
   kāntaḥ padena hata iti saralām aparādhya kiṃ prasādayatha |	kAntaH padena hataH iti saralAm aparADya kim prasAda-yaTa |
   so 'py evam eva sulabhaḥ pada-prahāraḥ prasādaḥ kim ||GAss_180||	saH api evam eva sulaBaH pada--prahAraH prasAdaH kim ||GAsH-_180||
   karṇa-gateyam amoghā dṛṣṭis tava śaktir indra-dattā ca |	karNa--gatA-iyam amoGA dRzwiH tava SaktiH indra-dattA ca |
   sā nāsādita-vijayā kvacid api nāpārtha-patiteyam ||GAss_181||	sA na-AsAdita-vijayA kvacid api na-apArTa--patitA-iyam ||GAsH-_181||
   kleśayasi kim iti dūtīr yad aśakyaṃ sumukhi tava kaṭākṣeṇa |	kleSayasi kim iti dUtIH yat aSakyam su-muKi tava kawAkzeNa |
   kāmo 'pi tatra sāyakam akīrti-śaṅkī na sandhatte ||GAss_182||	kAmaH api tatra sAyakam akIrti-SaFkI na sanDatte ||GAsH-_182||
   ko veda mūlyam akṣa-dyūte prabhuṇā paṇīkṛtasya vidhoḥ |	kaH veda mUlyam akza-dyUte praBuNA paNIkRtasya viDoH |
   prativijaye yat pratipaṇam adharaṃ ghara-nandinī vidadhe ||GAss_183||	prativijaye yat pratipaNam aDaram Gara-nandinI vidaDe ||GAsH-_183||
   kupitāṃ caraṇa-praharaṇa-bhayena muñcāmi na khalu caṇḍi tvām |	kupitAm caraNa--praharaNa--Bayena muQcAmi na Kalu caNxi tvAm |
   alir anila-capala-kisalaya-tāḍana-sahano latāṃ bhajate ||GAss_184||	aliH anila-ca-pala-ki-salaya--tAxana--sahanaH latAm Bajate ||GAsH-_184||
   kopākṛṣṭa-bhrū-smara-śarāsane saṃvṛṇu priye patataḥ |	kopa-AkRzwa--BrU--smara--SarAsane saMvRNu priye patataH |
   chinna-jyā-madhupān iva kajjala-malināśru-jala-bindūn ||GAss_185||	Cinna-jyA--maDupAn iva kajjala--malina-aSru---jala--bindUn ||GAsH-_185||
   kāmenāpi na bhettuṃ kim u hṛdayam apāri bāla-vanitānām |	kAmena-api na Bettum kim u hRdayam apAri bAla--vanitAnAm |
   mūḍha-viśikha-prahārocchūnam ivābhāti yad-vakṣaḥ ||GAss_186||	mUXa--viSiKa--prahAra-ucCUnam iva-ABAti yat--vakzaH ||GAsH-_186||
   kiṃ para-jīvair dīvyasi vismaya-madhurākṣi gaccha sakhi dūram |	kim para-jIvEH dIvyasi vismaya--maDura-akzi gacCa saKi dUram |
   ahim adhicatvaram uraga-grāhī khelayatu nirvighnaḥ ||GAss_187||	ahim aDicatvaram uraga--grAhI Kelayatu nirviGnaH ||GAsH-_187||
   kara-caraṇena praharati yathā yathāṅgeṣu kopa-taralākṣī |	kara-caraNena praharati yaTA yaTA-aFgezu kopa-tarala-akzI |
   roṣayati paruṣa-vacanais tathā tathā preyasīṃ rasikaḥ ||GAss_188||	rozayati paruza--vacanEH taTA taTA preyasIm rasikaH ||GAsH-_188||
   kas tāṃ nindati lumpati kaḥ smara-phalakasya varṇakaṃ mugdhaḥ |	kaH tAm nindati lumpati kaH smara-Palakasya varNakam mugDaH |
   ko bhavati ratna-kaṇṭakam amṛte kasyārucir udeti ||GAss_189||	kaH Bavati ratna-kaNwakam amRte kasya-aruciH udeti ||GAsH-_189||
   kopavati pāṇi-līlā-cañcala-cūtāṅkure tvayi bhramati |	kopavati pANi--lIlA--caQcala--cUta-aFkure tvayi Bramati |
   kara-kampita-karavāle smara iva sā mūrcchitā sutanuḥ ||GAss_190||	kara--kampita-karavAle smaraH iva sA mUrcCitA su-tanuH ||GAsH-_190||
   kaulīnyādalamenāṃ bhajāmi nakulaṃ smaraḥ pramāṇayati |	kOlInyAt-alam-enAm BajAmi nakulam smaraH pramANayati |
   tad-bhāvanena bhajato mama gotra-skhalanam anivāryam ||GAss_191||	tad--BAvanena BajataH mama gotra--sKalanam anivAryam ||GAsH-_191||
   kuta iha kuraṅga-śāvaka kedāre kalam amañjarīṃ tyajasi |	kutas iha kuraFga--SAvaka kedAre kalam amaQjarIm tyajasi |
   tṛṇa-bāṇas tṛṇa-dhanvā tṛṇa-ghaṭitaḥ kapaṭa-puruṣo 'yam ||GAss_192||	tRNa-bANaH tRNa-DanvA tRNa--GawitaH kapawa-puruzaH ayam ||GAsH-_192||
   iti vibhāvyākhyā-sametā ka-kāra-vrajyā ||	iti viBAvi-a-AKyA--sametA ka-kAra-vrajyA ||
   kha-kāra-vrajyā	Ka-kAra-vrajyA
   khala-sakhyaṃ prāṅ madhuraṃ vayo 'natarāle nidāgha-dinam ante |	Kala--saKyam prAk maDuram vayaH anatarAle nidAGa-dinam ante |
   ekaādi-madhya-pariṇati-ramaṇīyā sādhu-jana-maitrī ||GAss_193||	ekaAdi-maDya--pariNati--ramaNIyA sADu--jana--mEtrI ||GAsH-_193||
   iti vibhāvyākhyā-sametā kha-kāra-vrajyā ||	iti viBAvi-a-AKyA--sametA Ka-kAra-vrajyA ||
   ga-kāra-vrajyā	ga-kAra-vrajyA
   guṇam adhigatam api dhanavān na cirān nāśayati rakṣati daridraḥ |	guNam aDigatam api DanavAn na cirAt nASayati rakzati daridraH |
   majjayati rajjum ambhasi pūrṇaḥ kumbhaḥ sakhi na tucchaḥ ||GAss_194||	majjayati rajjum amBasi pUrNaH kumBaH saKi na tucCaH ||GAsH-_194||
   gurur api laghūpanīto na nimajjati niyatam āśaye mahataḥ |	guruH api laGu-upanItaH na nimajjati niyatam ASaye mahataH |
   vānakaropanītaḥ śailo makarālayasyeva ||GAss_195||	vAnakara-upanItaH SElaH makara-Alayasya-iva ||GAsH-_195||
   gaurī-pater garīyo garalaṃ gatvā gale jīrṇam |	gOrI--pateH garIyaH garalam gatvA gale jIrNam |
   jīryati karṇe mahatāṃ durvādo nālpam api viśati ||GAss_196||	jIryati karNe mahatAm durvAdaH na-alpam api viSati ||GAsH-_196||
   gṛhapati-purato jāraṃ kapaṭa-kathā-kathita-manmathāvastham |	gRhapati--puratas jAram kapawa--kaTA--kaTita--manmaTa-avasTam |
   prīṇayati pīḍayati ca bālā niḥśvasya niḥśvasya ||GAss_197||	prINayati pIxayati ca bAlA niHSvasya niHSvasya ||GAsH-_197||
   gati-gañjita-vara-yuvatiḥ karī kapolau karotu mada-malinau |	gati-gaQjita--vara--yuvatiH karI kapolO karotu mada--malinO |
   mukha-bandha-mātra-sindhura labodara kiṃ madaṃ vahasi ||GAss_198||	muKa-banDa--mAtra--sinDura labodara kim madam vahasi ||GAsH-_198||
   gehinyāḥ śṛṇvantī gotra-skhalitāparādhato mānam |	gehinyAH SRNvantI gotra--sKalita-aparADataH mAnam |
   snigdhāṃ priye sa-garvāṃ sakhīṣu bālā dṛśaṃ diśati ||GAss_199||	snigDAm priye sa-garvAm saKIzu bAlA dRSam diSati ||GAsH-_199||
   grīṣṃa-maye samaye'smin vinirmitaṃ kalaya keli-vana-mūle |	grIzMa-maye samaye-asmin vinirmitam kalaya keli--vana--mUle |
   alam ālavāla-valaya-cchalena kuṇḍalitam iva śaityam ||GAss_200||	alam AlavAla--valaya--cCalena kuNxalitam iva SEtyam ||GAsH-_200||
   guṇa-baddha-caraṇa iti mā līlā-vihagaṃ vimuñca sakhi mugdhe |	guNa--badDa--caraNaH iti mA lIlA--vihagam vimuQca saKi mugDe |
   asmin valayita-śākhe kṣaṇena guṇa-yantraṇaṃ truṭati ||GAss_201||	asmin valayita--SAKe kzaNena guNa-yantraNam truwati ||GAsH-_201||
   guru-garji-sāndra-vidyud-bhaya-mudrita-karṇa-cakṣuṣāṃ purataḥ |	guru-garji--sAndra--vidyut--Baya--mudrita-karNa--cakzuzAm puratas |
   bālā cumbati jāraṃ vajrād adhiko hi madaneṣuḥ ||GAss_202||	bAlA cumbati jAram vajrAt aDikaH hi madana-izuH ||GAsH-_202||
   gṛhiṇī-guṇeṣu gaṇitā vinayaḥ sevā vidheyateti guṇāḥ |	gRhiNI--guNezu gaNitAH vinayaH sevA viDeya-tA-iti guNAH |
   mānaḥ prabhutā vāmyaṃ vibhūṣaṇaṃ vāma-nayanānām ||GAss_203||	mAnaH praBu-tA vAmyam viBUzaNam vAma--nayanAnAm ||GAsH-_203||
   guṇam āntaram aguṇaṃ vā lakṣmīr gaṅgā ca veda hari-harayoḥ |	guNam Antaram aguNam vA lakzmIH gaFgA ca veda hari-harayoH |
   ekā pade'pi ramate na vasati nihitā śirasy aparā ||GAss_204||	ekA pade-api ramate na vasati nihitA Sirasi aparAH ||GAsH-_204||
   gatvā jīvita-saṃśayam abhyastaḥ soḍhum aticirād virahaḥ |	gatvA jIvita--saMSayam aByastaH soXum ati-cirAt virahaH |
   akaruṇaḥ punar api ditsasi surata-durabhyāsam asmākam ||GAss_205||	akaruNaH punar api ditsasi surata-duraByAsam asmAkam ||GAsH-_205||
   gotra-skhalita-praśne'py uttaram atiśīla-śītalaṃ dattvā |	gotra--sKalita-praSne-api uttaram ati-SIla-SItalam dattvA |
   niḥśvasya mogha-rūpe sva-vapuṣi nihitaṃ tayā cakṣuḥ ||GAss_206||	niHSvasya moGa--rUpe sva--vapuzi nihitam tayA cakzuH ||GAsH-_206||
   gandha-grāhiṇi śālonmīlita-niryāsa-nihita-nikhilāṅgi |	ganDa--grAhiNi SAlA-unmIlita-niryAsa--nihita--niKila-aFgi |
   upabhukta-mukta-bhūruha-śate'dhunā bhramari na bhramasi ||GAss_207||	upaBukta-mukta-BUruha--Sate-aDunA Bramari na Bramasi ||GAsH-_207||
   guruṣu militeṣu śirasā praṇamasi laghuṣūnnatā sameṣu samā |	guruzu militezu SirasA praNamasi laGuzu-unnatA samezu samAH |
   ucitajñāsi tule kiṃ tulayasi guñjā-phalaiḥ kanakam ||GAss_208||	ucita-jQA-asi tule kim tulayasi guQjA-a-PalEH kanakam ||GAsH-_208||
   gehinyā hriyamāṇaṃ nirudhyamānaṃ navoḍhayā purataḥ |	gehinyA hriyamANam niruDyamAnam na-voXayA puratas |
   mama naukā-dvitayārpita-guṇa iva hṛdayaṃ dvidhā bhavati ||GAss_209||	mama nOkA--dvitaya-arpita--guNaH iva hRdayam dviDA Bavati ||GAsH-_209||
   guṇa ākarṣaṇa-yogyo dhanuṣa ivaiko 'pi lakṣa-lābhāya |	guNaH AkarzaNa--yogyaH DanuzaH iva-ekaH api lakza-lABAya |
   lūtātantubhir iva kiṃ guṇair vimardāsahair bahubhiḥ ||GAss_210||	lUtA-tantuBiH iva kim guNEH vimarda-asahEH bahuBiH ||GAsH-_210||
   gāyati gīte vaṃśe vādayati sa vipañcīṣu |	gAyati gIte vaMSe vAdayati sa vipaQcIzu |
   pāṭhayati pañjara-śukaṃ tava sandeśākṣaraṃ rāmā ||GAss_211||	pAWayati paQjara--Sukam tava sandeSa-akzaram rAmAH ||GAsH-_211||
   gaṇayati na madhu-vyayam ayam aviratam āpibatu madhukaraḥ kumudam |	gaNayati na maDu--vyayam ayam aviratam Apibatu maDukaraH kumudam |
   saubhāgya-mānavān param asūyati dyu-maṇaye candraḥ ||GAss_212||	sOBAgya--mAnavAn param asUyati dyu-maNaye candraH ||GAsH-_212||
   guṇa-vidhṛtā sakhi tiṣṭhasi tathaiva dehena kiṃ tu hṛdayaṃ te |	guNa--viDRtA saKi tizWasi taTA-eva dehena kim tu hRdayam te |
   hṛtam amunā mālāyāḥ samīraṇeneva saurabhyam ||GAss_213||	hRtam amunA mAlAyAH samIraNena-iva sOraByam ||GAsH-_213||
   guru-sadane nedīyasi caraṇa-gate mayi ca mūkayāpi tayā |	guru--sadane nedIyasi caraNa--gate mayi ca mUkayA-api tayA |
   nūpuram apāsya padayoḥ kiṃ na priyam īritaṃ priyayā ||GAss_214||	nUpuram apAsya padayoH kim na priyam Iritam priyayA ||GAsH-_214||
   granthilatayā kim ikṣoḥ kim apabhraṃśena bhavati gītasya |	granTila-tayA kim ikzoH kim apaBraMSena Bavati gItasya |
   kim anārjavena śaśinaḥ kiṃ dāridryeṇa dayitasya ||GAss_215||	kim anArjavena SaSinaH kim dAridryeNa dayitasya ||GAsH-_215||
   gehinyā cikura-graha-samaya-sasītkāra-mīlita-dṛśāpi |	gehinyA cikura--graha--samaya--sa-sItkAra--mIlita-dRSA-api |
   bālā-kapola-pulakaṃ vilokya nihito 'smi śirasi padā ||GAss_216||	bAlA--kapola--pulakam vilokya nihitaH asmi Sirasi padA ||GAsH-_216||
   guru-pakṣma jāgarāruṇa-ghūrṇat-tāraṃ kathañcid api valate |	guru-pakzma jAgara-aruNa-GUrNat--tAram kaTaQcid api valate |
   nayanam idaṃ sphuṭa-nakha-pada-niveś a-kṛta-kopa-kuṭila-bhru ||GAss_217||	nayanam idam sPuwa-naKa--pada--niveH a-kRta-kopa-kuwila-Bru ||GAsH-_217||
   iti vibhāvyākhyā-sametā ga-kāra-vrajyā ||	iti viBAvi-a-AKyA--sametAH ga-kAra-vrajyA ||
   gha-kāra-vrajyā	Ga-kAra-vrajyA
   ghaṭita-jaghanaṃ nipīḍita-pīnoru nyasta-nikhila-kuca-bhāram |	Gawita--jaGanam nipIxita--pIna-Uru nyasta--niKila--kuca-BAram |
   āliṅganty api bālā vadaty asau muñca muñceti ||GAss_218||	AliFganti api bAlA vadati asO muQca muQca-iti ||GAsH-_218||
   ghaṭita-palāśa-kapāṭaṃ niśi niśi sukhino hi śerate padmāḥ |	Gawita-palASa--kapAwam niSi niSi suKinaH hi Serate padmAH |
   ujjāgareṇa kairava kati śakyā rakṣituṃ lakṣmīḥ ||GAss_219||	ujjAgareNa kErava kati SakyA rakzitum lakzmIH ||GAsH-_219||
   ghūrṇanti vipralabdhāḥ snehāpāyāt pradīpa-kalikāś ca |	GUrNanti vipralabDAH sneha-apAyAt pradIpa-kalikAH ca |
   prātaḥ prasthita-pāntha-strī-hṛdayaṃ sphuṭati kamalaṃ ca ||GAss_220||	prAtar prasTita-pAnTa--strI--hRdayam sPuwati kamalam ca ||GAsH-_220||
   iti vibhāvyākhyā-sametā gha-kāra-vrajyā ||	iti viBAvi-a-AKyA--sametAH Ga-kAra-vrajyA ||
   ca-kāra-vrajyā	ca-kAra-vrajyA
   capalasya palita-lāñchita-cikuraṃ dayitasya maulim avalokya |	capalasya palita--lAQCita-cikuram dayitasya mOlim avalokya |
   khedocite'pi samaye saṃmadam evādade gṛhiṇī ||GAss_221||	Keda-ucite-api samaye saMmadam eva-Adade gRhiNI ||GAsH-_221||
   caṇḍi prasāritena spṛśan bhujenāpi kopanāṃ bhavatīm |	caNxi prasAritena spRSan Bujena-api kopanAm BavatIm |
   tṛpyāmi paṅkilām iva piban nadīṃ nalina-nālena ||GAss_222||	tRpyAmi paFkilAm iva piban nadIm nalina-nAlena ||GAsH-_222||
   capala-bhujaṅgī-bhuktojjhita śītala-gandhavaha niśi bhrānta |	capala--BujaFgI-Bukta-ujJita SItala-ganDavaha niSi BrAntaH |
   aparāśāṃ pūrayituṃ pratyūṣa-sadāgate gaccha ||GAss_223||	apara-ASAm pUrayitum pratyUza--sadAgate gacCa ||GAsH-_223||
   cira-pathika drāghima-milad-alaka-latā-śaivalāvali-grathilā |	cira-paTika drAGima-milat--ala-ka-latA--SEvala-Avali-graTilA |
   kara-toyeva mṛgākṣyā dṛṣṭir idānīṃ sadānīrā ||GAss_224||	kara-toyA-iva mRga-akzyAH dRzwiH idAnIm sadAnIrAH ||GAsH-_224||
   caṇḍi dara-capala-cela-vyaktoru-vilokanaika-rasikena |	caNxi dara--capala--cela--vyakta-Uru--vilokana-eka-rasikena |
   dhūli-bhayād api na mayā caraṇa-hṛtau kuñcitaṃ cakṣuḥ ||GAss_225||	DUli-BayAt api na mayA caraNa--hRtO kuQcitam cakzuH ||GAsH-_225||
   cala-kuṇḍala-calad-alaka-skhalad-urasija-vasana-sajjad-ūru-yugam |	cala--kuNxala--calat--alaka-sKala-d-u-rasi-ja--vasana-sajja-d-Uru--yugam |
   jaghana-bhara-klama-kūṇita-nayanam idaṃ harati gatam asyāḥ ||GAss_226||	jaGana--Bara--klama--kUNita--nayanam idam harati gatam asyAH ||GAsH-_226||
   caraṇaiḥ parāga-saikatam aphalam idaṃ likhasi madhupa ketakyāḥ |	caraNEH parAga--sEkatam aPalam idam liKasi maDupa ketakyAH |
   iha vasati kānti-sāre nāntaḥ-salilāpi madhu-sindhuḥ ||GAss_227||	iha vasati kAnti--sAre na-antaH--salilA-api maDu--sinDuH ||GAsH-_227||
   cira-kāla-pathika śaṅkā-taraṅgitākṣaḥ kim īkṣase mugdha |	cira--kAla-paTika SaFkA-taraFgita-akzaH kim Ikzase mugDaH |
   tvan-nistriṃśāśleṣa-vraṇa-kiṇarājīyam etasyāḥ ||GAss_228||	tu-an--nistriMSa-ASleza--vraNa-kiNa-rAjIyam etasyAH ||GAsH-_228||
   capalāṃ yathā madāndhaś chāyāmayam ātmanaḥ karo hanti |	capalAm yaTA mada-anDaH CAyA-m-ayam AtmanaH karaH hanti |
   āsphālayati karaṃ pratigajas tathāyaṃ puro ruddhaḥ ||GAss_229||	AsPAlayati karam pratigajaH taTA-ayam puras rudDaH ||GAsH-_229||
   cumbana-lolupa-mad-adhara-hṛta-kāśmīraṃ smaran na tṛpyāmi |	cumbana--lolupa-mad-a-Dara--hRta-kASmIram smaran na tRpyAmi |
   hṛdaya-dviradālāna-stambhaṃ tasyās tad-ūru-yugam ||GAss_230||	hRdaya-dvirada-AlAna--stamBam tasyAH tad--Uru--yugam ||GAsH-_230||
   cikura-visāraṇa-tiryaṅ-nata-kaṇṭhī vimukha-vṛttir api bālā |	cikura--visAraNa--tiryaF-nata--kaNWI vimuKa--vRttiH api bAlA |
   tvām iyam aṅguli-kalpita-kacāvakāśā vilokayati ||GAss_231||	tvAm iyam aFguli-kalpita-kaca-avakASA vilokayati ||GAsH-_231||
   cumbana-hṛtāñjanārghaṃ sphuṭa-jāgara-rāgam īkṣaṇaṃ kṣipasi |	cumbana--hRta-aQjana-arGam sPuwa--jAgara--rAgam IkzaNam kzipasi |
   kim uṣasi viyoga-kātaram asameṣur ivārdha-nārācam ||GAss_232||	kim uzasi viyoga--kAtaram asamezuH iva-arDa-nArAcam ||GAsH-_232||
   iti vibhāvyākhyā-sametā ca-kāra-vrajyā ||	iti viBAvi-a-AKyA--sametA ca-kAra--vrajyA ||
   cha-kāra-vrajyā	Ca-kAra-vrajyA
   chāyā-grāhī candraḥ kūṭatvaṃ satatam ambujaṃ vrajati |	CAyA-grAhI candraH kUwa-tvam satatam ambujam vrajati |
   hitvobhayaṃ sabhāyāṃ stauti tavaivānanaṃ lokaḥ ||GAss_233||	hitvA-uBayam saBAyAm stOti tava-eva-Ananam lokaH ||GAsH-_233||
   chāyā-mātraṃ paśyann adhomukho 'py udgatena dhairyeṇa |	CAyA--mAtram paSyan aDomuKaH api udgatena DEryeNa |
   tudati mama hṛdaya-nipuṇā rādhā-cakraṃ kirītīva ||GAss_234||	tudati mama hRdaya--nipuNAH rADA--cakram kirIti-iva ||GAsH-_234||
   iti vibhāvyākhyā-sametā cha-kāra-vrajyā ||	iti viBAvi-a-AKyA--sametA Ca-kAra--vrajyA ||
   ja-kāra-vrajyā	ja-kAra--vrajyA
   jala-bindavaḥ katipaye nayanād gamanodyame tava skhalitāḥ |	jala-bindavaH katipaye nayanAt gamana-udyame tava sKalitAH |
   kānte mama gantavyā bhūr etair eva picchilitā ||GAss_235||	kAnte mama gantavyAH BUH etEH eva picCilitAH ||GAsH-_235||
   jṛmbhottambhita-dor-yuga-yantrita-tāṭaṅka-pīḍita-kapolam |	jRmBA-uttamBita-doH---yuga-yantrita-tA-waFka--pIxita-kapolam |
   tasyāḥ smarāmi jala-kaṇa-lulitāñjanam alasa-dṛṣṭi mukham ||GAss_236||	tasyAH smarAmi jala--kaNa-lulita-aQjanam alasa-dRzwi muKam ||GAsH-_236||
   jāgaritvā puruṣaṃ paraṃ vane sarvato mukhaṃ harasi |	jAgaritvA puruzam param vane sarvatas muKam harasi |
   ati śarad-anurūpaṃ tava śīlam idaṃ jāti-śālinyāḥ ||GAss_237||	ati Sarad--anurUpam tava SIlam idam jAti--SAlinyAH ||GAsH-_237||
   iti vibhāvyākhyā-sametā ja-kāra-vrajyā ||	iti viBAvi-a-AKyA--sametAH ja-kAra--vrajyA ||
   jha-kāra-vrajyā	Ja-kAra-vrajyA
   jhaṅkṛta-kaṅkaṇa-pāṇi-kṣepaiḥ stambhāvalambanair maunaiḥ |	JaFkRta-kaFkaNa--pANi-kzepEH stamBa-avalambanEH mOnEH |
   śobhayasi śuṣka-ruditair api sundari mandira-dvāram ||GAss_246||	SoBayasi Suzka-ruditEH api sundari mandira-dvAram ||GAsH-_246||
   iti vibhāvyākhyā-sametā jha-kāra-vrajyā ||	iti viBAvi-a-AKyA--sametAH Ja-kAra-vrajyA ||
   ḍha-kāra-vrajyā	Xa-kAra-vrajyA
   ḍhakkām āhatya madaṃ vitanvate kariṇa iva ciraṃ puruṣāḥ |	XakkAm Ahatya madam vitanvate kariNaH iva ciram puruzAH |
   strīṇāṃ kariṇīnām iva madaḥ punaḥ sva-kula-nāśāya ||GAss_247||	strINAm kariNInAm iva madaH punar sva-kula-nASAya ||GAsH-_247||
   iti vibhāvyākhyā-sametā ḍha-kāra-vrajyā ||	iti viBAvi-a-AKyA--sametAH Xa-kAra--vrajyA ||
   ta-kāra-vrajyā	ta--kAra-vrajyA
   tāṃ tāpayanti manmatha-bāṇās tvāṃ prīṇayanti bata subhaga |	tAm tApayanti manmaTa--bANAH tvAm prINayanti bata suBaga |
   tapana-karās tapana-śilāṃ jvalayanti vidhuṃ madhurayanti ||GAss_248||	tapana-karAH tapana-SilAm jvalayanti viDum maDurayanti ||GAsH-_248||
   tava sutanu sānumatyā bahu-dhātu-janita-nitamba-rāgāyāḥ |	tava su-tanu sa-anumatyAH bahu-DAtu--janita--nitamba--rAgAyAH |
   giri-vara-bhuva iva lābhenāpnomi dvy-aṅgulena divam ||GAss_249||	giri-vara--BuvaH iva lABena-Apnomi dvi--aFgulena divam ||GAsH-_249||
   tyakto muñcati jīvanam ujjhati nānugrahe'pi lolutvam |	tyaktaH muQcati jIvanam ujJati na-anugrahe-api lolutvam |
   kiṃ prāvṛṣeva padmākarasya karaṇīyam asya mayā ||GAss_250||	kim prAvRzA-iva padma-Akarasya karaNIyam asya mayA ||GAsH-_250||
   tvad-virahāpadi pāṇḍus tanvaṅgī chāyayaiva kevalayā |	tvad--viraha-Apadi pANxuH tanvaFgI CAyayA-eva kevalayA |
   haṃsīva jyotsnāyāṃ sā subhaga pratyabhijñeyā ||GAss_251||	haMsI-iva jyotsnAyAm sA suBaga pratyaBijQeyAH ||GAsH-_251||
   tvayi viniveśita-cittā subhaga gatā kevalena kāyena |	tvayi viniveSita--cittA suBaga gatA kevalena kAyena |
   ghana-jāla-ruddha-mīnā nadīva sā nīra-mātreṇa ||GAss_252||	Gana--jAla--rudDa-mInAH nadI-iva sA nIra--mAtreNa ||GAsH-_252||
   tvayi saṃsaktaṃ tasyāḥ kaṭhoratara hṛdayam asama-śara-taralam |	tvayi saMsaktam tasyAH kaWoratara hRdayam asama-Sara-taralam |
   māruta-calam añcalam iva kaṇṭaka-samparkataḥ sphuṭitam ||GAss_253||	mAruta--calam aQcalam iva kaNwaka--samparkataH sPuwitam ||GAsH-_253||
   tvam asūryaṃpaśyā sakhi padam api na vināpavāraṇaṃ bhramasi |	tvam asUryaMpaSyA saKi padam api na vinA-apavAraNam Bramasi |
   chāye kim iha vidheyaṃ muñcanti na mūrtimantas tvām ||GAss_254||	CAye kim iha viDeyam muQcanti na mUrtimantaH tvAm ||GAsH-_254||
   tava virahe vistārita-rajanau janitendu-candana-dveṣe |	tava virahe vistArita-rajanO janita-indu--candana--dveze |
   visinīva māgha-māse vinā hutāśane sā dagdhā ||GAss_255||	visinI-iva mAGa--mAse vinA hutASane sA dagDAH ||GAsH-_255||
   taruṇi tvac-caraṇāhati-kusumita-kaṅkelli-koraka-prakaram |	taruNi tvac-caraNa-Ahati--kusumita-kaFkelli-koraka-prakaram |
   kuṭila-caritā sapatnī na pibati bata śoka-vikalāpi ||GAss_256||	kuwila--caritA sapatnI na pibati bata Soka-vikalA-api ||GAsH-_256||
   talpe prabhur iva gurur iva manasija-tantre śrame bhujiṣyeva |	talpe praBuH iva guruH iva manasija-tantre Srame BujizyA-iva |
   gehe śrīr iva guru-jana-purato mūrteva sā vrīḍā ||GAss_257||	gehe SrIH iva guru--jana--puratas mUrtA-iva sA vrIxAH ||GAsH-_257||
   tvam alabhyā mama tāvan moktum aśaktasya saṃmukhaṃ vrajataḥ |	tvam alaByA mama tAvat moktum aSaktasya saMmuKam vrajataH |
   chāyevāpasarantī bhittyā na nivāryase yāvat ||GAss_258||	CAyA-iva-apasarantI BittyA na nivAryase yAvat ||GAsH-_258||
   tapasā kleśita eṣa prauḍha-balo na khalu phālgune'py āsīt |	tapasA kleSitaH eza prOXa-balaH na Kalu PAlgune-api AsIt |
   madhunā pramattam adhunā ko madanaṃ mihiram iva sahate ||GAss_259||	maDunA pramattam aDunA kaH madanam mihiram iva sahate ||GAsH-_259||
   tvad-gamana-divasa-gaṇa-nāvalakṣa-rekhābhir aṅkitā subhaga |	tvad--gamana--divasa--gaNa-nAva-lakza-reKABiH aFkitA suBaga |
   gaṇḍa-sthalīva tasyāḥ pāṇḍuritā bhavana-bhittir api ||GAss_260||	gaNxa-sTalI-iva tasyAH pANxuritA Bavana-BittiH api ||GAsH-_260||
   tasyāgrāmyasyāhaṃ sakhi vakra-snigdha-madhurayā dṛṣṭyā |	tasya-agrAmyasya-aham saKi vakra--snigDa--maDurayA dRzwyA |
   viddhā tad-eka-neyā potriṇa iva daṃṣṭrayā dharaṇī ||GAss_261||	vidDA tad--eka-neyA potriNaH iva daMzwrayA DaraNI ||GAsH-_261||
   tvayi kugrāma-vaṭa-druma vaiśravaṇo vasatu vā lakṣmīḥ |	tvayi kugrAma-vawa-druma vESravaNaH vasatu vA lakzmIH |
   pāmara-kuṭhāra-pātāt kāsara-śirasaiva te rakṣā ||GAss_262||	pAmara--kuWAra--pAtAt kAsara--SirasA-eva te rakzA ||GAsH-_262||
   tava mukhara vadana-doṣaṃ sahamānā moktum akṣamā sutanuḥ |	tava muKara vadana--dozam sahamAnA moktum akzamA su-tanuH |
   sā vahati viṭa bhavantaṃ ghuṇamantaḥ śālabhañjīva ||GAss_263||	sA vahati viwa Bavantam GuNam-antar SAlaBaQjI-iva ||GAsH-_263||
   tṛṇa-mukham iva na khalu tvāṃ tyajanty amī hariṇa vairiṇaḥ śavarāḥ |	tRNa-muKam iva na Kalu tvAm tyajanti amI hariNa vEriNaH SavarAH |
   yaśasaiva jīvitam idaṃ tyaja yojita-śṛṅga-saṅgrāmaḥ ||GAss_264||	yaSasA-eva jIvitam idam tyaja yojita--SRFga--saFgrAmaH ||GAsH-_264||
   tripura-ripor iva gaṅgā mama mānini janita-madana-dāhasya |	tripura-ripoH iva gaFgA mama mAnini janita-madana-dAhasya |
   jīvanam arpita-śiraso dadāsi cikura-graheṇaiva ||GAss_265||	jIvanam arpita--SirasaH dadAsi cikura--graheNa-eva ||GAsH-_265||
   tvat-saṅkathāsu mukharaḥ saninda-sānanda-sāvahittha iva |	tu-at--saFkaTAsu muKaraH sa-ninda--sa-Ananda--sa-avahitTaH iva |
   sa khalu sakhīnāṃ nibhṛtaṃ tvayā kṛtārthīkṛtaḥ subhagaḥ ||GAss_266||	sa Kalu saKInAm niBRtam tvayA kRtArTIkRtaH suBagaH ||GAsH-_266||
   tvayi sarpati pathi dṛṣṭiḥ sundara vṛti-vivara-nirgatā tasyāḥ |	tvayi sarpati paTi dRzwiH sundara vRti-vivara--nirgatA tasyAH |
   dara-tarala-bhinna-śaivala-jālā śapharīva visphurati ||GAss_267||	dara-tarala--Binna--SEvala--jAlA SaParI-iva visPurati ||GAsH-_267||
   te sutanu śūnya-hṛdayā ye śaṅkhaṃ śūnya-hṛdayam abhidadhati |	te su-tanu SUnya--hRdayAH ye SaFKam SUnya--hRdayam aBidaDati |
   aṅgīkṛta-kara-pattro yas tava hasta-grahaṃ kurute ||GAss_268||	aFgIkRta--kara-pattraH yaH tava hasta--graham kurute ||GAsH-_268||
   te śreṣṭhinaḥ kva samprati śakra-dhvaja yaiḥ kṛtas tavocchrāyaḥ |	te SrezWinaH kva samprati Sakra-Dvaja yEH kRtaH tava-ucCrAyaH |
   īṣāṃ vā meḍhiṃ vādhunātanās tvāṃ vidhitsanti ||GAss_269||	IzAm vA meXim vA-aDunAtanAH tvAm viDitsanti ||GAsH-_269||
   tānavam etya chinnaḥ paropahita-rāga-madana-saṅghaṭitaḥ |	tAnavam etya CinnaH para-upahita-rAga--madana--saFGawitaH |
   karṇa iva kāminīnāṃ na śobhate nirbharaḥ premā ||GAss_270||	karNaH iva kAminInAm na SoBate nirBaraH premAH ||GAsH-_270||
   tasmin gatārdra-bhāve vīta-rase śuṇṭhi-śakala iva puruṣe |	tasmin gata-Ardra-BAve vIta--rase SuNWi-SakalaH iva puruze |
   api bhūti-bhāji maline nāgara-śabdo viḍambāya ||GAss_271||	api BUti-BAji maline nAgara--SabdaH vixambAya ||GAsH-_271||
   tamasi ghane viṣame pathi jambukam ulkā-mukhaṃ prapannāḥ smaḥ |	tamasi Gane vizame paTi jambukam ulkA-muKam prapannAH smaH |
   kiṃ kurmaḥ so 'pi sakhe sthito mukhaṃ mudrayitvaiva ||GAss_272||	kim kurmaH saH api saKe sTitaH muKam mudrayitvA-eva ||GAsH-_272||
   tvām abhilaṣato mānini mama garima-guṇo 'pi doṣatāṃ yātaḥ |	tvAm aBilazataH mAnini mama garima-guNaH api doza-tAm yAtaH |
   paṅkila-kūlāṃ taṭinīṃ yiyāsataḥ sindhur asy eva ||GAss_273||	paFkila--kUlAm tawinIm yiyAsataH sinDuH asi eva ||GAsH-_273||
   timire'pi dūra-dṛśyā kaṭhināśleṣe ca rahasi mukharā ca |	timire-api dUra-dRSyA kaWina-ASleze ca rahasi muKarA ca |
   śaṅkha-maya-valaya-rājī gṛha-pati-śirasā saha sphuṭatu ||GAss_274||	SaFKa--maya-valaya--rAjI gRha-pati-SirasA saha sPuwatu ||GAsH-_274||
   tava vṛttena guṇena ca samucita-sampanna-kaṇṭha-luṭhanāyāḥ |	tava vRttena guNena ca samucita--sampanna--kaNWa--luWanAyAH |
   hāra-sraja iva sundari kṛtaḥ punar nāyakas taralaḥ ||GAss_275||	hAra--srajaH iva sundari kRtaH punar nAyakaH taralaH ||GAsH-_275||
   iti vibhāvyākhyā-sametā ta-kāra-vrajyā ||	iti viBAvi-a-AKyA--sametA ta-kAra-vrajyA ||
   da-kāra-vrajyā	da-kAra-vrajyA
   darśana-vinīta-mānā gṛhiṇī harṣollasat-kapola-talam |	darSana-vinIta-mAnA gRhiNI harza-ullasat--kapola-talam |
   cumbana-niṣedha-miṣato vadanaṃ pidadhāti pāṇibhyām ||GAss_276||	cumbana--nizeDa-mizataH vadanam pidaDAti pANiByAm ||GAsH-_276||
   deha-stambhaḥ skhalanaṃ śaithilyaṃ vepathuḥ priya-dhyānam |	deha-stamBaH sKalanam SETilyam vepaTuH priya-DyAnam |
   pathi pathi gaganāśleṣaḥ kāmini kas te'bhisāra-guṇaḥ ||GAss_277||	paTi paTi gagana-ASlezaH kAmini kaH te-aBisAra--guNaH ||GAsH-_277||
   drāghayatā divasāni tvadīya-viraheṇa tīvra-tāpena |	drAGayatA divasAni tvadIya--viraheNa tIvra-tApena |
   grīṣmeṇeva nalinyā jīvanam alpīkṛtaṃ tasyāḥ ||GAss_278||	grIzmeNa-iva nalinyAH jIvanam alpIkRtam tasyAH ||GAsH-_278||
   durjana-sahavāsād api śīlotkarṣaṃ na sajjanas tyajati |	durjana--sahavAsAt api SIla-utkarzam na sat-janaH tyajati |
   pratiparva-tapana-vāsī niḥsṛta-mātraḥ śaśī śītaḥ ||GAss_279||	pratiparva-tapana-vAsI niHsRta--mAtraH SaSI SItaH ||GAsH-_279||
   dayita-prahitāṃ dūtīm ālambya kareṇa tamasi gacchantī |	dayita--prahitAm dUtIm Alambya kareNa tamasi gacCantI |
   sveda-cyuta-mṛganābhir dūrād gaurāṅgi dṛśyāsi ||GAss_280||	sveda--cyuta--mRganABiH dUrAt gOra-aFgi dRSyA-asi ||GAsH-_280||
   dayitā-guṇaḥ prakāśaṃ nītaḥ svasyaiva vadana-doṣeṇa |	dayitA--guNaH prakASam nItaH svasya-eva vadana--dozeNa |
   pratidina-vidalita-vāṭī-vṛti-gahṭanaiḥ khidyase kim iti ||GAss_281||	pratidina--vidalita--vAwI-vRti--gahwanEH Kidyase kim iti ||GAsH-_281||
   dākṣiṇyān mradimānaṃ dadhataṃ mā bhānum enam avamaṃsthāḥ |	dAkziNyAt mradimAnam daDatam mA BAnum enam avamaMsTAH |
   raudrīm upāgate'smin kaḥ kṣamate dṛṣṭim api dātum ||GAss_282||	rOdrIm upAgate-asmin kaH kzamate dRzwim api dAtum ||GAsH-_282||
   dṛṣṭyaiva viraha-kātara-tārakayā priya-mukhe samarpitayā |	dRzwyA-eva viraha-kAtara--tArakayA priya--muKe samarpitayA |
   yānti mṛga-vallabhāyāḥ pulinda-bāṇārditāḥ prāṇāḥ ||GAss_283||	yAnti mRga-vallaBAyAH pulinda--bANa-arditAH prANAH ||GAsH-_283||
   dūra-sthāpita-hṛdayo gūḍha-rahasyo nikāmam āśaṅkaḥ |	dUra-sTApita--hRdayaH gUXa--rahasyaH nikAmam ASaFkaH |
   āśleṣo bālānāṃ bhavati khalānāṃ ca sambhedaḥ ||GAss_284||	ASlezaH bAlAnAm Bavati KalAnAm ca samBedaH ||GAsH-_284||
   dvāre guravaḥ koṇe śukaḥ sakāśe śiśur gṛhe sakhyaḥ |	dvAre guravaH koNe SukaH sakASe SiSuH gRhe saKyaH |
   kālāsaha kṣamasva priya prasīda prayāta-mahaḥ ||GAss_285||	kAla-asaha kzamasva priya prasIda prayAta--m-ahaH ||GAsH-_285||
   dadhi-kaṇa-muktā-bharaṇa-śvāsottuṅga-stanārpaṇa-manojñam |	daDi-kaNa--muktA--BaraNa--SvAsa-uttuFga--stana-arpaNa--manojQam |
   priyam āliṅgati gopī manthana-śrama-mantharair aṅgaiḥ ||GAss_286||	priyam AliFgati gopI manTana--Srama-manTarEH aFgEH ||GAsH-_286||
   dalitodvegena sakhi priyeṇa lagnena rāgam āvahatā |	dalita-udvegena saKi priyeNa lagnena rAgam AvahatA |
   mohayatā śayanīyaṃ tāmbūleneva nītāsmi ||GAss_287||	mohayatA SayanIyam tAmbUlena-iva nItA-asmi ||GAsH-_287||
   dṛṣṭam adṛṣṭa-prāyaṃ dayitaṃ kṛtvā prakāśitas tanayā |	dRzwam adRzwa--prAyam dayitam kRtvA prakASitaH tanayA |
   hṛdayaṃ kareṇa tāḍitam atha mithyā vyañjita-trapayā ||GAss_288||	hRdayam kareNa tAxitam aTa miTyA vyaQjita-trapayA ||GAsH-_288||
   darśita-yamunocchrāye bhrū-vibhrama-bhāji valati tava nayane |	darSita-yamunA-ucCrAye BrU--viBrama--BAji valati tava nayane |
   kṣipta-hale haladhara iva sarvaṃ puramarjitaṃ sutanu ||GAss_289||	kzipta-hale halaDaraH iva sarvam puram-arjitam su-tanu ||GAsH-_289||
   dayita-prārthita-durlabha-mukha-madirā-sāraseka-sukumāraḥ |	dayita--prArTita--durlaBa--muKa--madirA-sAra-seka--sukumAraH |
   vyathayati virahe bakulaḥ kva paricayaḥ prakṛti-kaṭhinānām ||GAss_290||	vyaTayati virahe bakulaH kva paricayaH prakRti-kaWinAnAm ||GAsH-_290||
   dvitrair eṣyāmi dinair iti kiṃ tad vacasi sakhi tavāśvāsaḥ |	dvitrEH ezyAmi dinEH iti kim tat vacasi saKi tava-ASvAsaH |
   kathayati cira-pathikaṃ taṃ dūra-nikhāto nakhāṅkas te ||GAss_291||	kaTayati cira--paTikam tam dUra-niKAtaH naKa-aFkaH te ||GAsH-_291||
   dayita-sparśonmīlita-dharma-jala-skhalita-caraṇa-khalākṣe |	dayita--sparSa-unmIlita-Darma--jala--sKalita--caraNa--Kala-akze |
   garva-bhara-mukharite sakhi tac-cikurān kim aparādhayasi ||GAss_292||	garva--Bara--muKarite saKi tac--cikurAn kim aparADayasi ||GAsH-_292||
   duṣṭa-graheṇa gehini tena kuputreṇa kiṃ prajātena |	duzwa--graheNa gehini tena ku-putreNa kim prajAtena |
   bhaumeneva nijaṃ kulam aṅgāra-kavat-kṛtaṃ yena ||GAss_293||	BOmena-iva nijam kulam aFgAra-kavat--kRtam yena ||GAsH-_293||
   darśita-cāpocchrāyais tejovadbhiḥ sugotra-sañjātaiḥ |	darSita--cApa-ucCrAyEH tejovadBiH sugotra--saQjAtEH |
   hīrair apsv api vīrair āpatsv api gamyate nādhaḥ ||GAss_294||	hIrEH apsu api vIrEH Apatsu api gamyate na-aDas ||GAsH-_294||
   dara-nidrāṇasyāpi smarasya śilpena nirgatāsūn me |	dara-nidrANasya-api smarasya Silpena nirgata-asUn me |
   mugdhe tava dṛṣṭir asāv arjuna-yantreṣur iva hanti ||GAss_295||	mugDe tava dRzwiH asO arjuna-yantra-izuH iva hanti ||GAsH-_295||
   durgata-gṛhiṇī tanaye karuṇārdrā priyatame ca rāgamayī |	durgata-gRhiNI tanaye karuNA-ArdrA priyatame ca rAga-mayI |
   mugdhā ratābhiyogaṃ na manyate na pratikṣipati ||GAss_296||	mugDA rata-aBiyogam na manyate na pratikzipati ||GAsH-_296||
   durgata-gehini jarjara-mandira-suptaiva vandase candram |	durgata-gehini jarjara--mandira--suptA-eva vandase candram |
   vayam indu-vañcita-dṛśo niculita-dolā-vihāriṇyaḥ ||GAss_297||	vayam indu--vaQcita-dRSaH niculita--dolA--vihAriNyaH ||GAsH-_297||
   dīpa-daśā kula-yuvatir vaidagdhyenaiva malinatām eti |	dIpa-daSA kula-yuvatiH vEdagDyena-eva malina-tAm eti |
   doṣā api bhūṣāyai gaṇikāyāḥ śaśi-kalāyāś ca ||GAss_298||	dozAH api BUzAyE gaNikAyAH SaSi-kalAyAH ca ||GAsH-_298||
   dīrgha-gavākṣa-mukhāntar-nipātinas taraṇi-raśmayaḥ śoṇāḥ |	dIrGa-gavAkza--muKa-antar--nipAtinaH taraNi--raSmayaH SoNAH |
   nṛhari-nakhā iva dānava-vakṣaḥ praviśanti saudha-talam ||GAss_299||	nR-hari--naKAH iva dAnava--vakzaH praviSanti sODa-talam ||GAsH-_299||
   dara-tarale'kṣaṇi vakṣasi daronnate tava mukhe ca dara-hasite |	dara-tarale-akzaNi vakzasi dara-unnate tava muKe ca dara-hasite |
   āstāṃ kusumaṃ vīraḥ smaro 'dhunā citra-dhanuṣāpi ||GAss_300||	AstAm kusumam vIraH smaraH aDunA citra-DanuzA-api ||GAsH-_300||
   duṣṭa-sakhī-sahiteyaṃ pūrṇendu-mukhī sukhāya nedānīm |	duzwa---saKI--sahitA-iyam pUrNa-indu-muKI suKAya na-idAnIm |
   rākeva viṣṭi-yuktā bhavato 'bhimatāya niśi bhavatu ||GAss_301||	rAkA-iva vizwi-yuktA BavataH aBimatAya niSi Bavatu ||GAsH-_301||
   dalite palāla-puñje vṛṣabhaṃ paribhavati gṛha-patau kupite |	dalite palAla--puQje vRzaBam pariBavati gRha-patO kupite |
   nibhṛta-nibhālita-vadanau halika-vadhū-devarau hasataḥ ||GAss_302||	niBRta-niBAlita-vadanO halika-vaDU--devarO hasataH ||GAsH-_302||
   dīpyantāṃ ye dīptyai ghaṭitā maṇayaś ca vīra-puruṣāś ca |	dIpyantAm ye dIptyE GawitAH maNayaH ca vIra-puruzAH ca |
   tejaḥ sva-vināśāya tu nṛṇāṃ tṛṇānām iva laghūnām ||GAss_303||	tejaH sva--vinASAya tu nRNAm tRNAnAm iva laGUnAm ||GAsH-_303||
   iti vibhāvyākhyā-sametā da-kāra-vrajyā ||	iti viBAvi-a-AKyA--sametAH da-kAra-vrajyA ||
   dha-kāra-vrajyā	Da-kAra-vrajyA
   dhūmair aśru nipātaya daha śikhayā dahana-malinayāṅgāraiḥ |	DUmEH aSru nipAtaya daha SiKayA dahana--malinayA-aFgArEH |
   jāgarayiṣyati durgata-gṛhiṇī tvāṃ tad api śiśira-niśi ||GAss_304||	jAgarayizyati durgata-gRhiNI tvAm tat api SiSira-niSi ||GAsH-_304||
   dhairyaṃ nidhehi gacchatu rajanī so 'py astu sumukhi sotkaṇṭhaḥ |	DEryam niDehi gacCatu rajanI saH api astu su-muKi sa-utkaNWaH |
   praviśa hṛdi tasya dūraṃ kṣaṇa-dhṛta-muktā smareṣur iva ||GAss_305||	praviSa hRdi tasya dUram kzaNa--DRta-muktA smara-izuH iva ||GAsH-_305||
   dhavala-nakha-lakṣma durbalam akalaita-nepathyam alaka-pihitākṣyāḥ |	Davala-naKa--lakzma durbalam akala-eta--nepaTyam alaka--pihita-akzyAH |
   drakṣyāmi mad-avaloka-dvi-guṇāśru vapuḥ pura-dvāri ||GAss_306||	drakzyAmi mad--avaloka--dvi-guNa-aSru vapuH pura-dvAri ||GAsH-_306||
   dharmārambhe'py asatāṃ para-hiṃsaiva prayojikā bhavati |	Darma-AramBe-api asatAm para-hiMsA-eva prayojikA Bavati |
   kākānām abhiṣeke'kāraṇatāṃ vṛṣṭir anubhavati ||GAss_307||	kAkAnAm aBizeke-akAraNa-tAm vRzwiH anuBavati ||GAsH-_307||
   iti vibhāvyākhyā-sametā dha-kāra-vrajyā ||	iti viBAvi-a-AKyA--sametAH Da-kAra-vrajyA ||
   na-kāra-vrajyā	na-kAra-vrajyA
   nīrāvataraṇa-danturasaikata-sambheda-meduraiḥ śiśire |	nIra-avataraNa--danturasa-ekata-samBeda--medurEH SiSire |
   rājanti tūla-rāśi-sthūla-paṭair iva taṭaiḥ saritaḥ ||GAss_308||	rAjanti tUla--rASi--sTUla-pawEH iva tawEH saritaH ||GAsH-_308||
   nija-kāya-cchāyāyāṃ viśramya nidāgha-vipadam apanetum |	nija--kAya--=-CAyAyAm viSramya nidAGa--vipadam apanetum |
   bata vividhās tanu-bhaṅgīr mugdha-karaṅgīyam ācarati ||GAss_309||	bata viviDAH tanu-BaFgIH mugDa-karaFgIyam Acarati ||GAsH-_309||
   na hasanti jaraṭha iti yad vallava-vanitā namanti nandam api |	na hasanti jaraWaH iti yat vallava--vanitAH namanti nandam api |
   sakhi sa yaśodā-tanayo nityaṃ kandalita-kandarpaḥ ||GAss_310||	saKi sa yaSodA--tanayaH nityam kandalita-kandarpaH ||GAsH-_310||
   nītā svabhāvam arpita-vapur api vāmyaṃ na kāminī tyajati |	nItA svaBAvam arpita--vapuH api vAmyam na kAminI tyajati |
   hara-dehārdha-grathitā nidarśanaṃ pārvatī tatra ||GAss_311||	hara--deha-arDa--graTitA nidarSanam pArvatI tatra ||GAsH-_311||
   nāgara-bhogānumita-sva-vadhū-saundarya-garva-taralasya |	nAgara---Boga-anumita--sva--vaDU--sOndarya--garva--taralasya |
   nipatati padaṃ na bhūmau jñāti-puras tantu-vāyasya ||GAss_312||	nipatati padam na BUmO jQAti-puraH tantu--vAyasya ||GAsH-_312||
   nipatati caraṇe koṇe praviśya niśi yan nirīkṣate kas tat |	nipatati caraNe koNe praviSya niSi yat nirIkzate kaH tat |
   sakhi sa khalu loka-purataḥ khalaḥ sva-garimāṇam udgirati ||GAss_313||	saKi sa Kalu loka-puratas KalaH sva--garimANam udgirati ||GAsH-_313||
   na vimocayituṃ śakyaḥ kṣamāṃ mahān mocito yadi kathaṃcit |	na vimocayitum SakyaH kzamAm mahAn mocitaH yadi kaTaMcid |
   mandara-girir iva garalaṃ nivartate nanu samutthāpya ||GAss_314||	mandara-giriH iva garalam nivartate nanu samutTApya ||GAsH-_314||
   niyataiḥ padair niṣevyaṃ skhalite'narthāvahaṃ samāśrayati |	niyatEH padEH nizevyam sKalite-anarTa-Avaham samASrayati |
   sambhavad anya-gatiḥ kaḥ saṅkrama-kāṣṭhaṃ durīśaṃ ca ||GAss_315||	samBavat anya-gatiH kaH saFkrama-kAzWam durISam ca ||GAsH-_315||
   nija-pada-gati-guṇa-rañjita-jagatāṃ kariṇāṃ ca sat-kavīnāṃ ca |	nija-pada--gati--guNa-raQjita--jagatAm kariNAm ca sat-kavInAm ca |
   vahatām api mahimānaṃ śobhāyai sajjanā eva ||GAss_316||	vahatAm api mahimAnam SoBAyE sat-janAH eva ||GAsH-_316||
   nottapane na snehaṃ harati na nirvāti na malino bhavati |	na-uttapane na sneham harati na nirvAti na malinaH Bavati |
   tasyojjvalo niśi niśi premā ratna-pradīpa iva ||GAss_317||	tasya-ujjvalaH niSi niSi premAH ratna--pradIpaH iva ||GAsH-_317||
   nihitān nihitān ujjhati niyataṃ mama pārthivān api prema |	nihitAn nihitAn ujJati niyatam mama pArTivAn api prema |
   bhrāmaṃ bhrāmaṃ tiṣṭhati tatraiva kulāla-cakram iva ||GAss_318||	BrAmam BrAmam tizWati tatra-eva kulAla-cakram iva ||GAsH-_318||
   nirbharam api sambhuktaṃ dṛṣṭyā prātaḥ piban na tṛpyāmi |	nirBaram api samBuktam dRzwyA prAtar piban na tRpyAmi |
   jaghanam anaṃśukam asyāḥ koka ivāśiśira-kara-bimbam ||GAss_319||	jaGanam anaMSukam asyAH kokaH iva-ASiSira-kara--bimbam ||GAsH-_319||
   niviḍa-ghaṭitoru-yugalāṃ śvāsottabdha-stanārpita-vyajanām |	nivixa--Gawita-Uru--yugalAm SvAsa-uttabDa--stana-arpita--vyajanAm |
   tāṃ snigdha-kupita-dṛṣṭiṃ smarāmi rata-niḥsahāṃ sutanum ||GAss_320||	tAm snigDa---kupita--dRzwim smarAmi rata--niHsahAm su-tanum ||GAsH-_320||
   nirguṇa iti mṛta iti ca dvāv ekārthābhidhāyinau viddhi |	nirguNaH iti mRtaH iti ca dvO eka-arTa-aBiDAyinO vidDi |
   paśya dhanur-guṇa-śūnyaṃ nirjīvaṃ tad iha śaṃsanti ||GAss_321||	paSya DanuH--guNa--SUnyam nirjIvam tat iha SaMsanti ||GAsH-_321||
   nija-sūkṣma-sūtra-lambī vilocanaṃ taruṇa te kṣaṇaṃ haratu |	nija--sUkzma-sUtra--lambI vilocanam taruNa te kzaNam haratu |
   ayam udgṛhīta-vaḍiśaḥ karkaṭa iva markaṭaḥ purataḥ ||GAss_322||	ayam udgRhIta-vaxiSaH karkawaH iva markawaH puratas ||GAsH-_322||
   nāgara gītir ivāsau grāma-sthityāpi bhūṣitā sutanuḥ |	nAgara gItiH iva-asO grAma--sTityA-api BUzitA su-tanuH |
   kastūrī na mṛgodara-vāsa-vaśād visratām eti ||GAss_323||	kastUrI na mRgodara--vAsa--vaSAt visra-tAm eti ||GAsH-_323||
   nakha-likhita-stani kura-baka-maya-pṛṣṭhe bhūmi-lulita-virasāṅgi |	naKa-liKita--stani kura-baka-maya--pRzWe BUmi-lulita-virasa-aFgi |
   hṛdaya-vidāraṇa-niḥsṛta-kusumāsra-śareva harasi manaḥ ||GAss_324||	hRdaya--vidAraNa--niHsRta--kusuma-asra--SarA-iva harasi manaH ||GAsH-_324||
   nītā laghimānam iyaṃ tasyāṃ garimāṇam adhikam arpayasi |	nItA laGimAnam iyam tasyAm garimANam aDikam arpayasi |
   bhāra iva viṣama-bhāryaḥ sudurvaho bhavati gṛha-vāsaḥ ||GAss_325||	BAraH iva vizama--BAryaH su-durvahaH Bavati gRha-vAsaH ||GAsH-_325||
   na ca dūtī na ca yācñā na cāñjalir na ca kaṭākṣa-vikṣepaḥ |	na ca dUtI na ca yAcQA na ca-aQjaliH na ca kawAkza-vikzepaH |
   saubhāgya-mānināṃ sakhi kaca-grahaḥ prathamam abhiyogaḥ ||GAss_326||	sOBAgya--mAninAm saKi kaca-grahaH praTamam aBiyogaH ||GAsH-_326||
   niśi viṣama-kusuma-viśikha-preritayor mauna-labdha-rati-rasayoḥ |	niSi vizama--kusuma--viSiKa--preritayoH mOna--labDa--rati--rasayoH |
   mānas tathaiva vilasati dampatyor aśithila-granthiḥ ||GAss_327||	mAnaH taTA-eva vilasati dampatyoH aSiTila--granTiH ||GAsH-_327||
   nija-gātra-nirviśeṣa-sthāpitam api sāram akhilam ādāya |	nija--gAtra--nirviSeza--sTApitam api sAram aKilam AdAya |
   nirmokaṃ ca bhujaṅgī muñcati puruṣaṃ ca vāra-vadhūḥ ||GAss_328||	nirmokam ca BujaFgI muQcati puruzam ca vAra-vaDUH ||GAsH-_328||
   nṛtya-śrama-gharmārdraṃ muñcasi kṛcchreṇa kañcukaṃ sutanu |	nRtya--Srama--Garma-Ardram muQcasi kRcCreNa kaQcukam su-tanu |
   makarandodaka-juṣṭaṃ madana-dhanur-vallir iva colam ||GAss_329||	makaranda-udaka--juzwam madana--DanuH--valliH iva colam ||GAsH-_329||
   nāhaṃ vadāmi sutanu tvam aśīlā vā pracaṇḍa-caritā vā |	na-aham vadAmi su-tanu tvam aSIlA vA pracaNxa--caritAH vA |
   prema-svabhāva-sulabhaṃ bhayam udayati mama tu hṛdayasya ||GAss_330||	prema--svaBAva--sulaBam Bayam udayati mama tu hRdayasya ||GAsH-_330||
   na nirūpito 'si sakhyā niyataṃ netra-tribhāga-mātreṇa |	na nirUpitaH asi saKyA niyatam netra-tri-BAga--mAtreNa |
   hārayati yena kusumaṃ vimukhe tvayi kaṇṭha iva deve ||GAss_331||	hArayati yena kusumam vimuKe tvayi kaNWaH iva deve ||GAsH-_331||
   nakha-daśana-muṣṭi-pātair adayair āliṅganaiś ca subhagasya |	naKa-daSana--muzwi-pAtEH adayEH AliFganEH ca suBagasya |
   aparādhaṃ śaṃsantyaḥ śāntiṃ racayanti rāgiṇyaḥ ||GAss_332||	aparADam SaMsantyaH SAntim racayanti rAgiNyaH ||GAsH-_332||
   na guṇe na lakṣaṇe'pi ca vayasi ca rūpe ca nādaro vihitaḥ |	na guNe na lakzaNe-api ca vayasi ca rUpe ca na-AdaraH vihitaH |
   tvayi saurabheyi ghaṇṭā kapilā-putrīti baddheyam ||GAss_333||	tvayi sOraBeyi GaNwA kapilA--putrI-iti badDA-iyam ||GAsH-_333||
   niṣkāraṇāparādhaṃ niṣkāraṇa-kalaha-roṣa-paritoṣam |	nizkAraNa-aparADam nizkAraNa--kalaha--roza--paritozam |
   sāmānya-maraṇa-jīvana-sukha-duḥkhaṃ jayati dāmpatyam ||GAss_334||	sAmAnya--maraNa-jIvana--suKa--duHKam jayati dAmpatyam ||GAsH-_334||
   na prāpyase karābhyāṃ hṛdayān nāpaiṣi vitanuṣe bādhām |	na prApyase karAByAm hRdayAt na-apEzi vitanuze bADAm |
   tvaṃ mama bhagnāvastita-kusumāyudha-viśikha-phalikeva ||GAss_335||	tvam mama Bagna-avastita--kusumAyuDa--viSiKa--PalikA-iva ||GAsH-_335||
   nātheti paruṣam ucitaṃ priyeti dāsety anugraho yatra |	nATa-iti paruzam ucitam priyA-iti dAsa-iti anugrahaH yatra |
   tad-dāmpatyam ito 'nyan nārī rajjuḥ paśuḥ puruṣaḥ ||GAss_336||	tat--dAmpatyam itas anyat nArI rajjuH paSuH puruzaH ||GAsH-_336||
   nihitāyām asyām api saivaikā manasi me sphurati |	nihitAyAm asyAm api sA-eva-ekA manasi me sPurati |
   rekhāntaropadhānāt pattrākṣara-rājir iva dayitā ||GAss_337||	reKA-antara-upaDAnAt pattra-akzara--rAjiH iva dayitA ||GAsH-_337||
   nidhi-nikṣepa-sthānasyopari cihnārtham iva latā nihitā |	niDi-nikzepa--sTAnasya-upari cihna-arTam iva latA nihitAH |
   lobhayati tava tanūdari jaghana-taṭād upari romālī ||GAss_338||	loBayati tava tanu-udari jaGana--tawAt upari romAlI ||GAsH-_338||
   nihitārdha-locanāyās tvaṃ tasyā harasi hṛdaya-paryantam |	nihita-arDa--locanAyAH tvam tasyAH harasi hRdaya--paryantam |
   na subhaga samucitam īdṛśam aṅguli-dāne bhujaṃ gilasi ||GAss_339||	na suBaga samucitam IdRSam aFguli-dAne Bujam gilasi ||GAsH-_339||
   nītvāgāraṃ rajanī-jāgaram ekaṃ ca sādaraṃ dattvā |	nItvA-AgAram rajanI--jAgaram ekam ca sa-Adaram dattvA |
   acireṇa kair na taruṇair durgā-pattrīva muktāsi ||GAss_340||	acireNa kEH na taruNEH durgA-pattrI-iva muktA-asi ||GAsH-_340||
   nakṣatre'gnāv indāv udare kanake maṇau dṛśi samudre |	nakzatre-agnO indO udare kanake maNO dRSi samudre |
   yat khalu tejas tad akhilam ojāyitam abja-mitrasya ||GAss_341||	yat Kalu tejaH tat aKilam ojAyitam abja-mitrasya ||GAsH-_341||
   na savarṇo na ca rūpaṃ na saṃskriyā kāpi naiva sā prakṛtiḥ |	na savarNaH na ca rUpam na saMskriyA kA-api na-eva sA prakRtiH |
   bālā tvad-virahāpadi jātāpabhraṃśa-bhāṣeva ||GAss_342||	bAlA tvad--viraha-Apadi jAta-apaBraMSa--BAzA-iva ||GAsH-_342||
   na vibhūṣaṇe tavāsthā vapur guṇenaiva jayasi sakhi yūnaḥ |	na viBUzaNe tava-AsTA vapuH guNena-eva jayasi saKi yUnaH |
   avadhīritāstra-śastrā kusumeṣor malla-vidyeva ||GAss_343||	avaDIrita-astra--SastrA kusumezoH malla-vidyA-iva ||GAsH-_343||
   netrākṛṣṭo bhrāmaṃ bhrāmaṃ preyān yathā yathāsti tathā |	netra-AkRzwaH BrAmam BrAmam preyAn yaTA yaTA-asti taTA |
   sakhi manthayati mano mama dadhi-bhāṇḍaṃ mantha-daṇḍa iva ||GAss_344||	saKi manTayati manaH mama daDi-BANxam manTa--daNxaH iva ||GAsH-_344||
   nānā-varṇaka-rūpaṃ prakalpayantī manoharaṃ tanvī |	nAnA--varNaka-rUpam prakalpayantI manoharam tanvI |
   citrakara-tūlikeva tvāṃ sā pratibhitti bhāvayati ||GAss_345||	citrakara--tUlikA-iva tvAm sA pratiBitti BAvayati ||GAsH-_345||
   iti vibhāvyākhyā-sametā na-kāra-vrajyā ||	iti viBAvi-a-AKyA--sametAH na-kAra-vrajyA ||
   pa-kāra-vrajyā	pa-kAra-vrajyA
   pathikāsaktā kiṃcin na veda ghana-kalam agopitā gopī |	paTika-AsaktA kiMcid na veda Gana-kalam agopitA gopI |
   keli-kalā-huṅkāraiḥ kīrāvali mogham apasarasi ||GAss_346||	keli-kalA--huFkArEH kIra-Avali moGam apasarasi ||GAsH-_346||
   praṇamati paśyati cumbati saṃśliṣyati pulaka-mukulitair aṅgaiḥ |	praNamati paSyati cumbati saMSlizyati pulaka-mukulitEH aFgEH |
   priya-saṅgāya sphuritāṃ viyoginī vāma-bāhulatām ||GAss_347||	priya-saFgAya sPuritAm viyoginI vAma-bAhu-latAm ||GAsH-_347||
   praviśasi na ca nirgantuṃ jānāsi vyākulatvam ātanuṣe |	praviSasi na ca nirgantum jAnAsi vyAkula-tvam Atanuze |
   bālaka cetasi tasyāś cakra-vyūhe'bhimanyur iva ||GAss_348||	bAlaka cetasi tasyAH cakra--vyUhe-aBimanyuH iva ||GAsH-_348||
   paśyānurūpam indindireṇa mākanda-śekharo mukharaḥ |	paSya-anurUpam indindireNa mAkanda--SeKaraH muKaraH |
   api ca picu-manda-mukule maukuli-kulam ākulaṃ milati ||GAss_349||	api ca picu-manda--mukule mOkuli-kulam Akulam milati ||GAsH-_349||
   pratibimba-sambhṛtānanam ādarśaṃ sumukha mama sakhī-hastāt |	pratibimba--samBRta-Ananam AdarSam su-muKa mama saKI--hastAt |
   ādātum icchasi mudhā kiṃ līlā-kamala-mohena ||GAss_350||	AdAtum icCasi muDA kim lIlA--kamala--mohena ||GAsH-_350||
   prācīnācala-mauler yathā śaśī gagana-madhyam adhivasati |	prAcIna-acala--mOleH yaTA SaSI gagana--maDyam aDivasati |
   tvāṃ sakhi paśyāmi tathā chāyām iva saṅkucan mānām ||GAss_351||	tvAm saKi paSyAmi taTA CAyAm iva saFkucan mAnAm ||GAsH-_351||
   prāṅgaṇa-koṇe'pi niśāpatiḥ sa tāpaṃ sudhāmayo harati |	prAFgaNa-koNe-api niSApatiH sa tApam suDA-mayaH harati |
   yadi māṃ rajani-jvara iva sakhi sa na niruṇaddhi geha-patiḥ ||GAss_352||	yadi mAm rajani-jvaraH iva saKi sa na niruNadDi geha-patiH ||GAsH-_352||
   pati-pulaka-dūna-gātrī svacchāyāvīkṣaṇe'pi yā sabhayā |	pati--pulaka-dUna--gAtrI sva=-CAyA-vIkzaNe-api yA sa-BayA |
   abhisarati subhaga sā tvāṃ vidalantī kaṇṭakaṃ tamasi ||GAss_353||	aBisarati suBaga sA tvAm vidalantI kaNwakam tamasi ||GAsH-_353||
   pratibhūḥ śuko vipakṣe daṇḍaḥ śṛṅgāra-saṅkathā guruṣu |	pratiBUH SukaH vipakze daNxaH SRFgAra--saFkaTA guruzu |
   puruṣāyitaṃ paṇas tad-bāle paribhāvyatāṃ dāyaḥ ||GAss_354||	puruzAyitam paNaH tad--bAle pariBAvyatAm dAyaH ||GAsH-_354||
   para-mohanāya mukto niṣkaruṇe taruṇi tava kaṭākṣo 'yam |	para-mohanAya muktaH nizkaruNe taruNi tava kawAkzaH ayam |
   viśikha iva kalita-karṇaḥ praviśati hṛdayaṃ na niḥsarati ||GAss_355||	viSiKaH iva kalita-karNaH praviSati hRdayam na niHsarati ||GAsH-_355||
   prapadālambita-bhūmiś cumbantī prīti-bhīti-madhurākṣī |	prapada-Alambita-BUmiH cumbantI prIti-BIti--maDura-akzI |
   prācīrāgra-niveśita-cibukatayā na patitā sutanuḥ ||GAss_356||	prAcIra-agra--niveSita---cibuka-tayA na patitA su-tanuH ||GAsH-_356||
   prātar upāgatya mrṣā vadataḥ sakhi nāsya vidyate vrīḍā |	prAtar upAgatya mrzA vadataH saKi na-asya vidyate vrIxA |
   mukha-lagnayāpi yo 'yaṃ na lajjate dagdha-kālikayā ||GAss_357||	muKa--lagnayA-api yaH ayam na lajjate dagDa--kAlikayA ||GAsH-_357||
   paśyottaras tanūdari phālgunam āsādya nirjita-vipakṣaḥ |	paSya-uttaraH tanu-udari PAlgunam AsAdya nirjita-vipakzaH |
   vairāṭir iva pataṅgaḥ pratyānayanaṃ karoti gavām ||GAss_358||	vErAwiH iva pataFgaH pratyAnayanam karoti gavAm ||GAsH-_358||
   pramada-vanaṃ tava ca stana-śailaṃ mūlaṃ gabhīra-sarasāṃ ca |	pramada--vanam tava ca stana-SElam mUlam gaBIra--sarasAm ca |
   jagati nidāgha-nirastaṃ śaityaṃ durga-trayaṃ śrayati ||GAss_359||	jagati nidAGa--nirastam SEtyam durga-trayam Srayati ||GAsH-_359||
   proñchati tavāparādhaṃ mānaṃ mardayati nirvṛtiṃ harati |	proQCati tava-aparADam mAnam mardayati nirvRtim harati |
   svakṛtān nihanti śapathāñ jāgara-dīrghā niśā subhaga ||GAss_360||	sva-kRtAn nihanti SapaTAn jAgara--dIrGA niSA suBagaH ||GAsH-_360||
   priya āyāte dūrād abhūta iva saṅgamo 'bhavat pūrvaḥ |	priyaH AyAte dUrAt aBUtaH iva saFgamaH aBavat pUrvaH |
   māna-rudita-prasādāḥ punar āsanna-para-suratādau ||GAss_361||	mAna-rudita--prasAdAH punar Asanna-para--surata-AdO ||GAsH-_361||
   pūrva-mahī-dhara-śikhare tamaḥ samāsanna-mihira-kara-kalitam |	pUrva--mahI--Dara--SiKare tamaH samAsanna--mihiH-a-kara--kalitam |
   śūla-protaṃ sarudhiram idam andhaka-vapur ivābhāti ||GAss_362||	SUla--protam sa-ruDiram idam anDaka--vapuH iva-ABAti ||GAsH-_362||
   parivṛtta-nābhi lupta-trivali śyāma-stanāgram alasākṣi |	parivRtta--nABi lupta--tri-vali SyAma--stana-agram alasa-akzi |
   bahu-dhavala-jaghana-rekhaṃ vapur na puruṣāyitaṃ sahate ||GAss_363||	bahu-Davala--jaGana-reKam vapuH na puruzAyitam sahate ||GAsH-_363||
   prārabdha-nidhuvanaiva sveda-jalaṃ komalāṅgi kiṃ vahasi |	prArabDa--niDuvanA-eva sveda--jalam komala-aFgi kim vahasi |
   jyām arpayituṃ namitā kusumāstra-dhanur-lateva madhu ||GAss_364||	jyAm arpayitum namitA kusuma-astra--DanuH--latA-iva maDu ||GAsH-_364||
   puṃsāṃ darśaya sundari mukhendum īṣat trpām apākṛtya |	puMsAm darSaya sundari muKa-indum Izat trpAm apAkRtya |
   jāyājita iti rūḍhā jana-śrutir me yaśo bhavatu ||GAss_365||	jAyA-ajitaH iti rUXA jana--SrutiH me yaSaH Bavatu ||GAsH-_365||
   prasaratu śarat-triyāmā jaganti dhavalayatu dhāma tuhināṃśoḥ |	prasaratu Sarat-triyAmAH jaganti Davalayatu DAma tuhina-aMSoH |
   pañjara-cakorikāṇāṃ kaṇikākalpo 'pi na viśeṣaḥ ||GAss_366||	paQjara-cakorikANAm kaNikA-kalpaH api na viSezaH ||GAsH-_366||
   prathamāgata sotkaṇṭhā cira-caliteyaṃ vilamba-doṣe tu |	praTama-Agata sa-utkaNWA cira--calitA-iyam vilamba--doze tu |
   vakṣyanti sāṅga-rāgāḥ pathi taravas tava samādhānam ||GAss_367||	vakzyanti sa-aFga-rAgAH paTi taravaH tava samADAnam ||GAsH-_367||
   patite'ṃśuke stanārpita-hastāṃ tāṃ niviḍa-jaghana-pihitorum |	patite-aMSuke stana-arpita-hastAm tAm nivixa--jaGana--pihita-Urum |
   rada-pada-vikalita-phūtkṛti-śata-dhuta-dīpāṃ manaḥ smarati ||GAss_368||	rada-pada--vikalita-PUtkRti--Sata--Duta-dIpAm manaH smarati ||GAsH-_368||
   paritaḥ sphurita-mahauṣadhi-maṇi-nikare keli-talpa iva śaile |	paritas sPurita--mahOzaDi--maNi--nikare keli-talpaH iva SEle |
   kāñcī-guṇa iva patitaḥ sthitaika-ratnaḥ phaṇī sphurati ||GAss_369||	kAQcI--guNaH iva patitaH sTita-eka-ratnaH PaNI sPurati ||GAsH-_369||
   prāvṛṣi śaila-śreṇī-nitambam uhhan dig-antare bhramasi |	prAvRzi SEla--SreNI-nitambam uhhan diS--antare Bramasi |
   capalāntara ghana kiṃ tava vacanīyaṃ pavana-vaśyo 'si ||GAss_370||	capala-antara Gana kim tava vacanIyam pavana-vaSyaH asi ||GAsH-_370||
   prati-divasa-kṣīṇa-daśas tavaiṣa vasanāñcalo 'tikara-kṛṣṭaḥ |	prati-divasa--kzINa-daSaH tava-eza vasana-aQcalaH ati-kara-kRzwaH |
   nija-nāyakam atikṛpaṇaṃ kathayati kugrāma iva viralaḥ ||GAss_371||	nija--nAyakam ati-kRpaNam kaTayati ku-grAmaH iva viralaH ||GAsH-_371||
   pathika kathaṃ capalojjvalam ambuda-jala-bindu-nihvaham aviṣahyam |	paTika kaTam capala-ujjvalam ambuda--jala--bindu--nihvaham avizahyam |
   mayapura-kanaka-dravam iva śiva-śara-śikhi-bhāvitaṃ sahase ||GAss_372||	maya-pura-kanaka--dravam iva Siva-Sara--SiKi--BAvitam sahase ||GAsH-_372||
   pathikaṃ śrameṇa suptaṃ dara-taralā taruṇi sumadhura-cchāyā |	paTikam SrameNa suptam dara-taralA taruNi su-maDura--=-CAyA |
   vyālambamāna-veṇiḥ sukhayasi śākheva sārohā ||GAss_373||	vyAlambamAna-veNiH suKayasi SAKA-iva sa-ArohAH ||GAsH-_373||
   pradadāti nāparāsāṃ praveśam api pīna-tuṅga-jaghanorūḥ |	pradadAti na-aparAsAm praveSam api pIna--tuFga--jaGana-UrUH |
   yā lupta-kīla-bhāvaṃ yātā hṛdi bahir adṛśyāsi ||GAss_374||	yA lupta--kIla-BAvam yAtA hRdi bahis adRSyA-asi ||GAsH-_374||
   prātar nidrāti yathā yathātmajā lulita-niḥsahair aṅgaiḥ |	prAtar nidrAti yaTA yaTA-AtmajA lulita--niHsahEH aFgEH |
   jāmātari mudita-manās tathā tathā sādarā śvaśrūḥ ||GAss_375||	jAmAtari mudita--manAH taTA taTA sAdarA SvaSrUH ||GAsH-_375||
   praṇaya-calito 'pi sakapaṭa-kopa-kaṭākṣair mayāhita-stambhaḥ |	praNaya--calitaH api sakapa-wa-ka-upa-kawAkzEH mayA-ahita--stamBaH |
   trāsa-taralo gṛhītaḥ sahāsa-rabhasaṃ priyaḥ kaṇṭhe ||GAss_376||	trAsa-taralaH gRhItaH sahAsa-raBasam priyaH kaNWe ||GAsH-_376||
   priya-durnayena hṛdaya sphuṭasi yadi sphuṭanam api tava ślāghyam |	priya-durnayena hRdaya sPuwasi yadi sPuwanam api tava SlAGyam |
   tat-keli-samara-talpī-kṛtasya vasanāñcalasyeva ||GAss_377||	tat-keli--samara-talpI--kRtasya vasana-aQcalasya-iva ||GAsH-_377||
   pavanopanīta-saurabha-dūrodaka-pūra-padminī-lubdhaḥ |	pavana-upanIta--sOraBa-dUra-udaka-pUra-padminI--lubDaH |
   aparīkṣita-svapakṣo gantā hantāpadaṃ madhupaḥ ||GAss_378||	aparIkzita--sva-pakzaH gantA hanta-Apadam maDupaH ||GAsH-_378||
   prema-laghū-kṛta-keśava- vakṣo-bhara-vipula-pulaka-kuca-kalaśā |	prema-laGU-kRta-keSava vakzo-Bara--vipula--pulaka-kuca-kalaSAH |
   govardhana-giri-gurutāṃ mugdha-vadhūr nibhṛtam upahasati ||GAss_379||	govarDana--giri--guru-tAm mugDa--vaDUH niBRtam upahasati ||GAsH-_379||
   priya-viraha-niḥsahāyāḥ sahaja-vipakṣābhir api sapatnībhiḥ |	priya-viraha--niHsahAyAH sahaja--vipakzABiH api sapatnIBiH |
   rakṣyante hariṇākṣyāḥ prāṇā gṛha-bhaṅga-bhītābhiḥ ||GAss_380||	rakzyante hariNa-akzyAH prANAH gRha-BaFga-BItABiH ||GAsH-_380||
   prakaṭayasi rāgam adhikaṃ lapanam idaṃ vakrimāṇam āvahati |	prakawayasi rAgam aDikam lapanam idam vakrimANam Avahati |
   prīṇayati ca pratipadaṃ dūti śukasyeva dayitasya ||GAss_381||	prINayati ca pratipadam dUti Sukasya-iva dayitasya ||GAsH-_381||
   praviśantyāḥ priya-hṛdayaṃ bālāyāḥ prabala-yauvata-vyāptam |	praviSantyAH priya-hRdayam bAlAyAH prabala-yOvata--vyAptam |
   nava-niśita-dara-taraṅgita-nayana-mayenāsinā panthāḥ ||GAss_382||	nava--niSita--dara--taraFgita--nayana-mayena-asinA panTAH ||GAsH-_382||
   praṇayāparādha-roṣa-prasāda-viśvāsa-keli-pāṇḍityaiḥ |	praNaya-aparADa--roza--prasAda--viSvAsa--keli--pANxityEH |
   rūḍha-premā hriyate kiṃ bālā-kutuka-mātreṇa ||GAss_383||	rUXa--premAH hriyate kim bAlA--kutuka--mAtreNa ||GAsH-_383||
   pūrvair eva caritair jarato 'pi pūjyatā bhavataḥ |	pUrvEH eva caritEH jarataH api pUjyatA BavataH |
   muñca madam asya gandhād yuvabhir gaja gaūjanīyo 'si ||GAss_384||	muQca madam asya ganDAt yuvaBiH gaja gaUjanIyaH asi ||GAsH-_384||
   prathamaṃ praveśitā yā vāsāgāraṃ kathañcana sakhībhiḥ |	praTamam praveSitA yA vAsAgAram kaTaQcana saKIBiH |
   na śṛṇotīva prātaḥ sā nirgamanasya saṅketam ||GAss_385||	na SRNoti-iva prAtar sA nirgamanasya saFketam ||GAsH-_385||
   pūjā vinā pratiṣṭhāṃ nāsti na mantraṃ vinā pratiṣṭhā ca |	pUjA vinA pratizWAm na-asti na mantram vinA pratizWA ca |
   tad-ubhaya-vipratipannaḥ paśyatu gīr-vāṇa-pāṣāṇam ||GAss_386||	tad--uBaya--vipratipannaH paSyatu gIr--vANa-pAzANam ||GAsH-_386||
   pūrvādhiko gṛhiṇyāṃ bahu-mānaḥ prema-narma-viśvāsaḥ |	pUrva-aDikaH gRhiNyAm bahu-mAnaH prema--narma--viSvAsaH |
   bhīr adhikeyaṃ kathayati rāgaṃ bālā-vibhaktam iva ||GAss_387||	BIH aDikeyam kaTayati rAgam bAlA--viBaktam iva ||GAsH-_387||
   pulikata-kaṭhora-pīvara-kuca-kalaśāśleṣa-vedanābhijñaḥ |	pulikata-kaWora--pIvara--kuca-kalaSa-ASleza--vedanA-aBijQaH |
   śambhor upavīta-phaṇī vāñchati māna-grahaṃ devyāḥ ||GAss_388||	SamBoH upavIta--PaNI vAQCati mAna--graham devyAH ||GAsH-_388||
   priya āyāto dūrād iti yā prītir babhūva gehinyāḥ |	priyaH AyAtaH dUrAt iti yA prItiH baBUva gehinyAH |
   pathikebhyaḥ pūrvāgata iti garvāt sāpi śata-śikharā ||GAss_389||	paTikeByaH pUrva-AgataH iti garvAt sA-api Sata--SiKarAH ||GAsH-_389||
   pṛṣṭhaṃ prayaccha mā spṛśa dūrād apasarpa vihita-vaimukhya |	pRzWam prayacCa mA spRSa dUrAt apasarpa vihita-vEmuKya |
   tvām anudhāvati taraṇis tad api guṇākarṣa-taraleyam ||GAss_390||	tvAm anuDAvati taraNiH tat api guNa-Akarza--taraleyam ||GAsH-_390||
   priyayā kuṅkuma-piñjara-pāṇi-dvaya-yojanāṅkitaṃ vāsaḥ |	priyayA kuFkuma--piQjara--pANi--dvaya--yojana-aFkitam vAsaH |
   prahitaṃ māṃ yācñāñjali-sahasra-karaṇāya śikṣayati ||GAss_391||	prahitam mAm yAcQA-aQjali--sahasra-karaNAya Sikzayati ||GAsH-_391||
   prācīrāntariteyaṃ priyasya vadane'dharaṃ samarpayati |	prAcIra-antaritA-iyam priyasya vadane-aDaram samarpayati |
   prāg-giri-pihitā rātriḥ sandhyā-rāgaṃ dinasyeva ||GAss_392||	prAg-giri--pihitA rAtriH sanDyA-rAgam dinasya-iva ||GAsH-_392||
   para-pati-nirdaya-kulaṭāśoṣita śaṭha neṣyatā na kopena |	para-pati--nirdaya--kulawA-Sozita SaWa na-izyatA na kopena |
   dagdha-mamatopataptā rodimi tava tānavaṃ vīkṣya ||GAss_393||	dagDa-mamatA-upataptAH rodimi tava tAnavam vIkzya ||GAsH-_393||
   prāṅgaṇa eva kadā māṃ śliṣyantī many-kampi-kuca-kalaśā |	prAFgaNaH eva kadA mAm SlizyantI many--kampi--kuca-kalaSA |
   aṃsa-niṣaṇṇa-mukhī sā snapayati bāṣpeṇa mama pṛṣṭham ||GAss_394||	aMsa-nizaNNa--muKI sA snapayati bAzpeNa mama pRzWam ||GAsH-_394||
   pretaiḥ praśasta-sattvā sāśru vṛkair vīkṣitā skhalad-grāsaiḥ |	pretEH praSasta--sattvA sa-aSru vRkEH vIkzitA sKalat--grAsEH |
   cumbati mṛtasya vadanaṃ bhūta-mukholkekṣitaṃ bālā ||GAss_395||	cumbati mRtasya vadanam BUta-muKa-ulka-Ikzitam bAlAH ||GAsH-_395||
   piśunaḥ khalu sujanānāṃ khalam eva puro vidhāya jetavyaḥ |	piSunaH Kalu su-janAnAm Kalam eva puras viDAya jetavyaH |
   kṛtvā jvaram ātmīyaṃ jigāya bāṇaṃ raṇe viṣṇuḥ ||GAss_396||	kRtvA jvaram AtmIyam jigAya bANam raNe vizNuH ||GAsH-_396||
   piba madhupa bakula-kalikāṃ dūre rasanāgra-mātram ādhāya |	piba maDupa bakula-kalikAm dUre rasanA-agra--mAtram ADAya |
   adhara-vilepa-samāpye madhuni mudhā vadanam arpayasi ||GAss_397||	aDara--vilepa--samApye maDuni muDA vadanam arpayasi ||GAsH-_397||
   prāyeṇaiva hi malinā malinānām āśrayatvam upayānti |	prAyeNa-eva hi malinAH malinAnAm ASraya-tvam upayAnti |
   kālindī-puṭa-bhedaḥ kāliya-puṭa-bhedanaṃ bhavati ||GAss_398||	kAlindI--puwa-BedaH kAliya--puwa--Bedanam Bavati ||GAsH-_398||
   paśya priya-tanu-vighaṭana-bhayena śaśi-mauli-deha-saṃlagnā |	paSya priya-tanu--viGawana-Bayena SaSi--mOli-deha--saMlagnA |
   subhagaika-daivatam umā śirasā bhāgīrathīṃ vahati ||GAss_399||	suBaga-eka-dEvatam umA SirasA BAgIraTIm vahati ||GAsH-_399||
   pathika-vadhū-jana-locana-nīra-nadī-mātṛka-pradeśeṣu |	paTika-vaDU-jana--locana--nIra--nadI--mAtRka--pradeSezu |
   dhana-maṇḍalam ākhaṇḍala-dhanuṣā kuṇḍalitam iva vidhinā ||GAss_400||	Dana--maNxalam AKaNxala--DanuzA kuNxalitam iva viDinA ||GAsH-_400||
   prativeśi-mitra-bandhuṣu dūrāt kṛcchrāgato 'pi gehinyā |	prativeSi-mitra--banDuzu dUrAt kRcCra-AgataH api gehinyA |
   atikeli-lampaṭayā dinam ekam agopi geha-patiḥ ||GAss_401||	ati-keli-lampawayA dinam ekam agopi geha-patiH ||GAsH-_401||
   para-paṭa iva rajakībhir malino bhuktvāpi nirdayaṃ tābhiḥ |	para-pawaH iva rajakIBiH malinaH BuktvA-api nirdayam tABiH |
   artha-grahaṇena vinā jaghanya mukto 'si kulaṭābhiḥ ||GAss_402||	arTa-grahaNena vinA jaGanya muktaH asi kulawABiH ||GAsH-_402||
   iti vibhāvyākhyā-sametā pa-kāra-vrajyā ||	iti viBAvi-a-AKyA--sametA pa-kAra-vrajyA ||
   ba-kāra-vrajyā	ba-kAra-vrajyA
   bahu-yoṣiti lākṣāruṇa-śirasi vayasyena dayita upahasite |	bahu-yoziti lAkzA-aruNa--Sirasi vayasyena dayitaH upahasite |
   tat-kāla-kalita-lajjā piśunayati sakhīṣu saubhāgyam ||GAss_403||	tat-kAla--kalita--lajjA piSunayati saKIzu sOBAgyam ||GAsH-_403||
   bandhana-bhājo 'muṣyāś cikura-kalāpasya muktamānasya |	banDana-BAjaH amuzyAH cikura--kalApasya mukta-mAnasya |
   sindūrita-sīmanta-cchalena hṛdayaṃ vidīrṇam iva ||GAss_404||	sindUrita--sImanta--cCalena hRdayam vidIrNam iva ||GAsH-_404||
   balam api vasati mayīti śreṣṭhini guru-garva-gadgadaṃ vadati |	balam api vasati mayi-iti SrezWini guru--garva--gadgadam vadati |
   taj-jāyayā janānāṃ mukham īkṣitam āvṛta-smitayā ||GAss_405||	taj-jAyayA janAnAm muKam Ikzitam AvRta-smitayA ||GAsH-_405||
   balavad anilopanīta-sphuṭita-navāmbhoja-saurabho madhupaḥ |	balavat anila-upanIta--sPuwita-nava-amBoja--sOraBaH maDupaH |
   ākṛṣyate nalinyā nāsā-nikṣipta-baḍiśa-rajjur iva ||GAss_406||	AkRzyate nalinyAH nAsA-nikzipta--baxiSa--rajjuH iva ||GAsH-_406||
   bāṇaṃ harir iva kurute sujano bahudoṣam apy adoṣam iva |	bANam hariH iva kurute su-janaH bahu-dozam api adozam iva |
   yāvad doṣaṃ jāgrati malimlucā iva punaḥ piśunāḥ ||GAss_407||	yAvat dozam jAgrati malimlucAH iva punar piSunAH ||GAsH-_407||
   bauddhasyeva kṣaṇiko yadyapi bahu-vallabhasya tava bhāvaḥ |	bOdDasya-iva kzaNikaH yadi-api bahu-vallaBasya tava BAvaH |
   bhagnā bhagnā bhrūr iva na tu tasyā vighaṭate maitrī ||GAss_408||	BagnA BagnA BrUH iva na tu tasyAH viGawate mEtrI ||GAsH-_408||
   bāṣpākulaṃ pralapator gṛhiṇi nivartasva kānta gaccheti |	bAzpa-Akulam pralapatoH gRhiNi nivartasva kAnta gacCa-iti |
   yātaṃ dampatyor dinam anugamanāvadhi saras-tīre ||GAss_409||	yAtam dampatyoH dinam anugamana-avaDi saras--tIre ||GAsH-_409||
   bālā-vilāsa-bandhān aprabhavan manasi cintayan pūrvam |	bAlA--vilAsa--banDAn apraBavan manasi cintayan pUrvam |
   saṃmāna-varjitāṃ tāṃ gṛhiṇīm evānuśocāmi ||GAss_410||	saMmAna--varjitAm tAm gRhiNIm eva-anuSocAmi ||GAsH-_410||
   iti vibhāvyākhyā-sametā ba-kāra-vrajyā ||	iti viBAvi-a-AKyA--sametAH ba-kAra-vrajyA ||
   bha-kāra-vrajyā	Ba-kAra-vrajyA
   bhramasi prakaṭayasi radaṃ karaṃ prasārayasi tṛṇam api śrayasi |	Bramasi prakawayasi radam karam prasArayasi tRNam api Srayasi |
   dhiṅ mānaṃ tava kuñjara jīvaṃ na juhoṣi jaṭharāgnau ||GAss_411||	Dik mAnam tava kuQjara jIvam na juhozi jaWara-agnO ||GAsH-_411||
   bhūtimayaṃ kurute'gnis tṛṇam api saṃlagnam enam api bhajataḥ |	BUti-mayam kurute-agniH tRNam api saMlagnam enam api BajataH |
   saiva suvarṇa daśā te śaṅke garimoparodhena ||GAss_412||	sA-eva suvarNa daSA te SaFke garima-uparoDena ||GAsH-_412||
   bhavati nidāghe dīrghe yatheha yamuneva yāminī tanvī |	Bavati nidAGe dIrGe yaTA-iha yamunA-iva yAminI tanvI |
   dvīpā iva divasā api tathā krameṇa prathīyāṃsaḥ ||GAss_413||	dvIpAH iva divasAH api taTA krameNa praTIyAMsaH ||GAsH-_413||
   bhavatā mahati snehānale'rpitā pathika hema-guṭikeva |	BavatA mahati sneha-anale-arpitA paTika hema-guwikA-iva |
   tanvī hastenāpi spraṣṭum aśuddhair na sā śakyā ||GAss_414||	tanvI hastena-api sprazwum aSudDEH na sA SakyAH ||GAsH-_414||
   bhūmi-lulitaika-kuṇḍalam uttaṃsita-kāṇḍa-paṭam iyaṃ mugdhā |	BUmi-lulita-eka--kuNxalam uttaMsita--kANxa-pawam iyam mugDA |
   paśyantī niḥśvāsaiḥ kṣipati manoreṇu-pūram api ||GAss_415||	paSyantI niHSvAsEH kzipati manaH-reNu--pUram api ||GAsH-_415||
   bhavatāliṅgi bhujaṅgī jātaḥ kila bhogi-cakravartī tvam |	BavatA-AliFgi BujaFgI jAtaH kila Bogi--cakravartI tvam |
   kañcuka vanecarī-stanam abhilaṣataḥ sphurati laghimā te ||GAss_416||	kaQcuka vanecarI--stanam aBilazataH sPurati laGimA te ||GAsH-_416||
   bhaikṣa-bhujā pallī-patir iti stutas tad-vadhū-sudṛṣṭena |	BEkza-BujA pallI--patiH iti stutaH tad--vaDU--su-dRzwena |
   rakṣaka jayasi yad ekaḥ śūnye sura-sadasi sukham asmi ||GAss_417||	rakzaka jayasi yat ekaH SUnye sura--sadasi suKam asmi ||GAsH-_417||
   bhogākṣamasya rakṣāṃ dṛṅ-mātreṇaiva kurvato 'nabhimukhasya |	Boga-akzamasya rakzAm dRF--mAtreNa-eva kurvataH anaBimuKasya |
   vṛddhasya pramadāpi śrīr api bhṛtyasya bhogāya ||GAss_418||	vRdDasya pramadA-api SrIH api BRtyasya BogAya ||GAsH-_418||
   bhavitāsi rajani yasyām adhva-śrama-śāntaye padaṃ dadhatīm |	BavitAsi rajani yasyAm aDva-Srama--SAntaye padam daDatIm |
   sa balād valayita-jaṅghā-baddhāṃ mām urasi pātayati ||GAss_419||	sa balAt valayita-jaFGA--badDAm mAm urasi pAtayati ||GAsH-_419||
   bhūṣaṇatāṃ bhajataḥ sakhi kaṣaṇa-viśuddhasya jāta-rūpasya |	BUzaNa-tAm BajataH saKi kazaNa--viSudDasya jAta--rUpasya |
   puruṣasya ca kanakasya ca yukto garimā sarāgasya ||GAss_420||	puruzasya ca kanakasya ca yuktaH garimA sa-rAgasya ||GAsH-_420||
   bhasma-puruṣe'pi giriśe snehamayī tvam ucitena subhagāsi |	Basma-puruze-api giriSe sneha-mayI tvam ucitena suBagA-asi |
   moghas tvayi janavādo yad oṣadhi-prastha-duhiteti ||GAss_421||	moGaH tvayi janavAdaH yat ozaDi-prasTa-duhitA-iti ||GAsH-_421||
   bhaya-pihitaṃ bālāyāḥ pīvaram ūru-dvayaṃ smaronnidraḥ |	Baya--pihitam bAlAyAH pIvaram Uru--dvayam smara-unnidraH |
   nidrāyāṃ premārdraḥ paśyati niḥśvasya niḥśvasya ||GAss_422||	nidrAyAm prema-ArdraH paSyati niHSvasya niHSvasya ||GAsH-_422||
   bhramarīva koṣa-garbhe gandha-hṛtā kusumam anusarantī tvām |	BramarI-iva koza-garBe ganDa--hRtA kusumam anusarantI tvAm |
   avyaktaṃ kūjantī saṅketaṃ tamasi sā bhramati ||GAss_423||	avyaktam kUjantI saFketam tamasi sA Bramati ||GAsH-_423||
   bhrāmaṃ bhrāmaṃ sthitayā snehe tava payasi tatra tatraiva |	BrAmam BrAmam sTitayA snehe tava payasi tatra tatra-eva |
   āvarta-patita-naukāyitam anayā vinayam apanīya ||GAss_424||	Avarta-patita-nOkAyitam anayA vinayam apanIya ||GAsH-_424||
   bhramayasi guṇamayi kaṇṭha-graha-yogyānātma-mandiropānte |	Bramayasi guNa-mayi kaNWa--graha--yogyAn-Atma--mandira-upAnte |
   hālika-nandini taruṇān kakudmino meḍhi-rajjur iva ||GAss_425||	hAlika-nandini taruNAn kakudminaH meXi--rajjuH iva ||GAsH-_425||
   bhāla-nayane'gnir indur maulau gātre bhujaṅga-maṇi-dīpāḥ |	BAla--nayane-agniH induH mOlO gAtre BujaFga-maNi--dIpAH |
   tad api tamo-maya eva tvam īśa kaḥ prakṛtim atiśete ||GAss_426||	tat api tamaH--mayaH eva tvam ISa kaH prakRtim atiSete ||GAsH-_426||
   iti vibhāvyākhyā-sametā bha-kāra-vrajyā ||	iti viBAvi-a-AKyA--sametAH Ba-kAra--vrajyA ||
   ma-kāra-vrajyā	ma-kAra-vrajyA
   madhu-mada-vīta-vrīḍā yathā yathā lapati saṃmukhaṃ bālā |	maDu-mad-a-vIta--vrIxA yaTA yaTA lapati saMmuKam bAlAH |
   tan-mukham ajāta-tṛptis tathā tathā vallabhaḥ pibati ||GAss_427||	tan-muKam ajAta-tRptiH taTA taTA vallaBaH pibati ||GAsH-_427||
   mitrair ālocya samaṃ guru kṛtvā kadanam api samārabdhaḥ |	mitrEH Alocya samam guru kRtvA kadanam api samArabDaH |
   arthaḥ satām iva hato mukha-vailakṣyeṇa māno 'yam ||GAss_428||	arTaH satAm iva hataH muKa--vElakzyeNa mAnaH ayam ||GAsH-_428||
   mama rāgiṇo manasvini karam arpayato dadāsi pṛṣṭham api |	mama rAgiNaH manasvini karam arpayataH dadAsi pRzWam api |
   yadi tad api kamala-bandhor iva manye svasya saubhāgyam ||GAss_429||	yadi tat api kamala-banDoH iva manye svasya sOBAgyam ||GAsH-_429||
   mā spṛśa mām iti sakupitam iva bhaṇitaṃ vyañjitā na ca vrīḍā |	mA spRSa mAm iti sa-kupitam iva BaNitam vyaQjitA na ca vrIxA |
   āliṅgitayā sasmitamuktam anācāra kiṃ kuruṣe ||GAss_430||	AliFgitayA sa-smitam-uktam anAcAra kim kuruze ||GAsH-_430||
   mūlāni ca niculānāṃ hṛdayāni ca kūla-vasati-kulaṭānām |	mUlAni ca niculAnAm hRdayAni ca kUla--vasati--kulawAnAm |
   mudira-madirā-pramattā godāvari kiṃ vidārayasi ||GAss_431||	mudira-madirA--pramattAH godAvari kim vidArayasi ||GAsH-_431||
   malaya-druma-sārāṇām iva dhīrāṇāṃ guṇa-prakarṣo 'pi |	malaya-druma--sArANAm iva DIrANAm guNa--prakarzaH api |
   jaḍa-samaya-nipatitānām anādarāyaiva na guṇāya ||GAss_432||	jaxa--samaya--nipatitAnAm anAdarAya-eva na guNAya ||GAsH-_432||
   madhumathana-mauli-māle sakhi tulayasi tulasi kiṃ mudhā rādhām |	maDumaTana--mOli--mAle saKi tulayasi tulasi kim muDA rADAm |
   yat tava padam adasīyaṃ surabhayituṃ saurabhodbhedaḥ ||GAss_433||	yat tava padam adasIyam suraBayitum sOraBa-udBedaH ||GAsH-_433||
   mayi yāsyati kṛtvāvadhi-dina-saṅkhyaṃ cumbanaṃ tathāśleṣam |	mayi yAsyati kRtvA-avaDi-dina--saFKyam cumbanam taTA-ASlezam |
   priyayānuśocitā sā tāvat suratākṣamā rajanī ||GAss_434||	priyayA-anuSocitA sA tAvat surata-akzamA rajanI ||GAsH-_434||
   mṛgamada-nidānam aṭavī kuṅkumam api kṛṣaka-vāṭikā vahati |	mRga-mada--nidAnam awavI kuFkumam api kRzaka-vAwikAH vahati |
   haṭṭavilāsini bhavatī param ekā paura-sarvasvam ||GAss_435||	hawwa-vilAsini BavatI param ekA pOra--sarvasvam ||GAsH-_435||
   madhu-divaseṣu bhrāmyan yathā viśati mānasaṃ bhramaraḥ |	maDu--divasezu BrAmyan yaTA viSati mAnasam BramaraH |
   sakhi loha-kaṇṭaka-nibhas tathā madana-viśikho 'pi ||GAss_436||	saKi loha-kaNwaka-niBaH taTA madana--viSiKaH api ||GAsH-_436||
   mayi calite tava muktā dṛśaḥ svabhāvāt priye sa-pānīyāḥ |	mayi calite tava muktAH dRSaH svaBAvAt priye sa-pAnIyAH |
   satyam amūlyāḥ sadyaḥ prayānti mama hṛdaya-hāratvam ||GAss_437||	satyam amUlyAH sadyas prayAnti mama hRdaya-hAra-tvam ||GAsH-_437||
   mugdhe mama manasi śarāḥ smarasya pañcāpi santataṃ lagnāḥ |	mugDe mama manasi SarAH smarasya paQca-api santatam lagnAH |
   śaṅke stana-guṭikā-dvayam arpitam etena tava hṛdaye ||GAss_438||	SaFke stana--guwikA--dvayam arpitam etena tava hRdaye ||GAsH-_438||
   madhumathana-vadana-vinihita-vaṃśī-suṣirānusāriṇo rāgāḥ |	maDumaTana--vadana--vinihita-vaMSI--suzira-anusAriNaH rAgAH |
   hanta haranti mano mama nalikā-viśikhāḥ smarasyeva ||GAss_439||	hanta haranti manaH mama nalikA--viSiKAH smarasi-a-iva ||GAsH-_439||
   mahatoḥ suvṛttayoḥ sakhi hṛdaya-graha-yogyayoḥ samucchritayoḥ |	mahatoH su-vRttayoH saKi hRdaya--graha--yogyayoH samucCritayoH |
   sajjanayoḥ stanayor iva nirantaraṃ saṅgataṃ bhavati ||GAss_440||	sat-janayoH stanayoH iva nirantaram saFgatam Bavati ||GAsH-_440||
   mama vāritasya bahubhir bhūyo bhūyaḥ svayaṃ ca bhāvayataḥ |	mama vAritasya bahuBiH BUyas BUyas svayam ca BAvayataH |
   jāto diśīva tasyāṃ sakhe na vinivartate mohaḥ ||GAss_441||	jAtaH diSi-iva tasyAm saKe na vinivartate mohaH ||GAsH-_441||
   magno 'si narmadāyā rase hṛto vīci-locana-kṣepaiḥ |	magnaH asi narmadAyAH rase hRtaH vIci--locana-kzepEH |
   yady ucyase taruvara bhraṣṭo bhraṃśo 'pi te ślāghyaḥ ||GAss_442||	yadi ucyase taru-vara BrazwaH BraMSaH api te SlAGyaH ||GAsH-_442||
   menām ullāsayati smerayati hariṃ giriṃ ca vimukhayati |	menAm ullAsayati smerayati harim girim ca vimuKayati |
   kṛta-kara-bandha-vilambaḥ pariṇayane giriśa-kara-kampaḥ ||GAss_443||	kRta-kara--banDa--vilambaH pariNayane giri-Sa-kara--kampaH ||GAsH-_443||
   madhu-gandhi gharma-timyat-tilakaṃ skhalad-uktiṃ ghūrṇa-daruṇākṣam |	maDu-ganDi Garma-timyat--tilakam sKalat--uktim GUrNa-daruNa-akzam |
   tasyāḥ kadādharāmṛtam ānanam avadhūya pāsyāmi ||GAss_444||	tasyAH kadA-aDara-amRtam Ananam avaDUya pAsyAmi ||GAsH-_444||
   medinyāṃ tava nipatati na padaṃ bahu-vallabheti garveṇa |	medinyAm tava nipatati na padam bahu-vallaBa-iti garveNa |
   āśliṣya kair na taruṇais turīva vasanair vimuktāsi ||GAss_445||	ASlizya kEH na taruNEH turI-iva vasanEH vimuktA-asi ||GAsH-_445||
   mūle nisarga-madhuraṃ samarpayanto rasaṃ puro virasāḥ |	mUle nisarga--maDuram samarpayantaH rasam puras virasAH |
   ikṣava iva para-puruṣā vividheṣu raseṣu vinidheyāḥ ||GAss_446||	ikzavaH iva para--puruzAH viviDezu rasezu viniDeyAH ||GAsH-_446||
   mahati snehe nihitaḥ kusumaṃ bahu dattam arcito bahuśaḥ |	mahati snehe nihitaH kusumam bahu dattam arcitaH bahuSas |
   vakras tad api śanaiścara iva sakhi duṣṭa-graho dayitaḥ ||GAss_447||	vakraH tat api SanEScaraH iva saKi duzwa--grahaH dayitaH ||GAsH-_447||
   mā śabara-taruṇi pīvara-vakṣoruhayor bhareṇa bhaja garvam |	mA Sabara-taruNi pIvara--vakzoruhayoH BareNa Baja garvam |
   nirmokair api śobhā yayor bhujaṅgībhir unmuktaiḥ ||GAss_448||	nirmokEH api SoBA yayoH BujaFgIBiH unmuktEH ||GAsH-_448||
   mama kupitāyāś chāyāṃ bhūmāv āliṅgya sakhi milat-pulakaḥ |	mama kupitAyAH CAyAm BUmO AliFgya saKi milat--pulakaH |
   snehamayatvam anujjhan karoti kiṃ naiṣa mām aruṣam ||GAss_449||	sneha-maya-tvam anujJan karoti kim na-eza mAm aruzam ||GAsH-_449||
   muṣita iva kṣaṇa-virahe ripur iva kusumeṣu-keli-saṅgrāme |	muzitaH iva kzaNa--virahe ripuH iva kusumezu--keli--saFgrAme |
   dāsa iva śrama-samaye bhajan natāṅgīṃ na tṛpyāmi ||GAss_450||	dAsaH iva Srama--samaye Bajan nata-aFgIm na tRpyAmi ||GAsH-_450||
   muñcasi kiṃ mānavatīṃ vyavasāyād dviguṇa-manyu-vegeti |	muQcasi kim mAnavatIm vyavasAyAt dviguNa-manyu--vega-iti |
   sneha-bhavaḥ payasāgniḥ sāntvena ca roṣa unmiṣati ||GAss_451||	sneha--BavaH payasA-agniH sAntvena ca rozaH unmizati ||GAsH-_451||
   malayajam apasārya ghanaṃ vījana-vighnaṃ vidhāya bāhubhyām |	malayajam apasArya Ganam vIjana--viGnam viDAya bAhuByAm |
   smara-santāpād agaṇita-nidāgham āliṅgate mithunam ||GAss_452||	smara--santApAt agaNita-nidAGam AliFgate miTunam ||GAsH-_452||
   mahato 'pi hi viśvāsān mahāśayā dadhati nālpam api laghavaḥ |	mahataH api hi viSvAsAt mahA-ASayAH daDati na-alpam api laGavaH |
   saṃvṛṇute'drī-nudadhir nidāgha-nadyo na bhekam api ||GAss_453||	saMvRNute-adrI-n-udaDiH nidAGa--nadyaH na Bekam api ||GAsH-_453||
   madhu-dhāreva na muñcasi mānini rūkṣāpi mādhurīṃ sahajām |	maDu-DArA-iva na muQcasi mAnini rUkzA-api mADurIm sahajAm |
   kṛta-mukha-bhaṅgāpi rasaṃ dadāsi mama sarid ivāmbhodheḥ ||GAss_454||	kRta--muKa--BaFgA-api rasam dadAsi mama sarit iva-amBoDeH ||GAsH-_454||
   madanākṛṣṭa-nurjyā-ghātair iva gṛhiṇi pathika-taruṇānām |	madana-AkRzwa-nuH-jyA--GAtEH iva gRhiNi paTika-taruNAnAm |
   vīṇā-tantrī-kvāṇaiḥ keṣāṃ na vikampate cetaḥ ||GAss_455||	vINA--tantrI--kvANEH kezAm na vikampate cetaH ||GAsH-_455||
   mama bhayam asyāḥ kopo nirvedo 'syā mamāpi mandākṣam |	mama Bayam asyAH kopaH nirvedaH asyAH mama-api manda-akzam |
   jātaṃ kva cāntarikṣe smita-saṃvṛti-namita-kandharayoḥ ||GAss_456||	jAtam kva ca-antarikze smita--saMvRti-namita--kanDarayoH ||GAsH-_456||
   muktāmbaraiva dhāvatu nipatatu sahasā trimārgagā vāstu |	mukta-ambarA-eva DAvatu nipatatu sahasA tri-mArga-gAH vA-astu |
   iyam eva narmadā mama vaṃśa-prabhavānurūpa-rasā ||GAss_457||	iyam eva narmadA mama vaMSa--praBava-anurUpa-rasAH ||GAsH-_457||
   mṛgamada-lepanam enaṃ nīla-nicolaiva niśi niṣeva tvam |	mRgamada--lepanam enam nIla--nicolA-eva niSi nizeva tvam |
   kālindyām indīvaram indindira-sundarīva sakhi ||GAss_458||	kAlindyAm indIvaram indindira--sundarI-iva saKi ||GAsH-_458||
   mama sakhyā nayana-pathe militaḥ śakto na kaścid api calitum |	mama saKyA nayana--paTe militaH SaktaH na kaScid api calitum |
   patito 'si pathika viṣame ghaṭṭa-kuṭīyaṃ kusuma-ketoḥ ||GAss_459||	patitaH asi paTika vizame Gawwa-kuwI-iyam kusuma-ketoH ||GAsH-_459||
   mahatā priyeṇa nirmitam apriyam api subhaga sahyatāṃ yāti |	mahatA priyeNa nirmitam apriyam api suBaga sahyatAm yAti |
   suta-sambhavena yauvana-vināśanaṃ na khalu khedāya ||GAss_460||	suta--samBavena yOvana--vinASanam na Kalu KedAya ||GAsH-_460||
   māna-graha-guru-kopād anu dayitāty eva rocate mahyam |	mAna--graha-guru--kopAt anu dayitA-ati eva rocate mahyam |
   kāñcanamayī vibhūṣā dāhāñcita-śuddha-bhāveva ||GAss_461||	kAQcana-mayI viBUzA dAha-AQcita--SudDa-BAvA-iva ||GAsH-_461||
   iti vibhāvyākhyā-sametā ma-kāra-vrajyā ||	iti viBAvi-a-AKyA--sametAH ma-kAra--vrajyA ||
   ya-kāra-vrajyā	ya-kAra-vrajyA
   yūnaḥ kaṇṭaka-viṭapāni viāñcala-grāhiṇas tyajantī sā |	yUnaH kaNwaka-viwapAni viAQcala--grAhiNaH tyajantI sA |
   vana iva pure'pi vicarati puruṣaṃ tvām eva jānantī ||GAss_462||	vanaH iva pure-api vicarati puruzam tvAm eva jAnantI ||GAsH-_462||
   yuṣmāsūpagatāḥ smo vibudhā vāṅ-mātra-pāṭavena vayam |	yuzmAsu-upagatAH smaH vibuDAH vAF--mAtra--pAwavena vayam |
   antarbhavati bhavatsv api nābhaktas tan na vijñātam ||GAss_463||	antarBavati Bavatsu api na-aBaktaH tat na vijQAtam ||GAsH-_463||
   yatra na dūtī yatra snigdhā na dṛśo 'pi nipuṇayā nihitāḥ |	yatra na dUtI yatra snigDAH na dRSaH api nipuNayA nihitAH |
   na giro 'dyāpi vyaktīkṛtaḥ sa bhāvo 'nurāgeṇa ||GAss_464||	na giraH adya-api vyaktIkRtaH sa BAvaH anurAgeNa ||GAsH-_464||
   yā nīyate sapatny praviśya yāvarjitā bhujaṅgena |	yA nIyate sapatnI praviSya yAvarjitAH BujaFgena |
   yamunāyā iva tasyāḥ sakhi malinaṃ jīvanaṃ manye ||GAss_465||	yamunAyAH iva tasyAH saKi malinam jIvanam manye ||GAsH-_465||
   yasminn ayaśo 'pi yaśo hrīr vighno māna eva dauḥśīlyam |	yasmin ayaSaH api yaSaH hrIH viGnaH mAnaH eva dOHSIlyam |
   laghutā guṇajñatā kiṃ navo yuvā sakhi na te dṛṣṭaḥ ||GAss_466||	laGu-tA guNa-jQa-tA kim navaH yuvA saKi na te dRzwaH ||GAsH-_466||
   yad vīkṣyate khalānāṃ māhātmyaṃ kvāpi daiva-yogena |	yat vIkzyate KalAnAm mAhAtmyam kvApi dEva--yogena |
   kākānām iva śauklyaṃ tad api hi na cirād anarthāya ||GAss_467||	kAkAnAm iva SOklyam tat api hi na cirAt anarTAya ||GAsH-_467||
   yat khalu khala-mukha-huta-vaha-vinihitam api śuddhim eva parameti |	yat Kalu Kala--muKa--huta--vaha--vinihitam api SudDim eva parama-iti |
   tad anala-śaucam ivāṃśukam iha loke durlabhaṃ prema ||GAss_468||	tat anala--SOcam iva-aMSukam iha loke durlaBam prema ||GAsH-_468||
   yan nāvadhim arthayate pātheyārthaṃ dadāti sarvasvam |	yat na-avaDim arTayate pATeya-arTam dadAti sarva-svam |
   tenānayāti-dāruṇa-śaṅkām āropitaṃ cetaḥ ||GAss_469||	tena-anayA-ati-dAruNa--SaFkAm Aropitam cetaH ||GAsH-_469||
   yūnām īrṣyā-vairaṃ vitanvatā taruṇi cakra-rucireṇa |	yUnAm IrzyA-vEram vitanvatA taruNi cakra-rucireNa |
   tava jagahnenākulitā nikhilā pallī khaleneva ||GAss_470||	tava jagahnena-AkulitA niKilA pallI Kalena-iva ||GAsH-_470||
   yāvaj jīvana-bhāvī tulyāśayoyor nitānta-nirbhedaḥ |	yAvat jIvana-BAvI tulya-ASayoyoH nitAnta--nirBedaH |
   nadayor ivaiṣa yuvayoḥ saṅgo rasam adhikam āvahatu ||GAss_471||	nadayoH iva-eza yuvayoH saFgaH rasam aDikam Avahatu ||GAsH-_471||
   yan nihitāṃ śekharayasi mālāṃ sā yātu śaṭha bhavantam iti |	yat nihitAm SeKarayasi mAlAm sA yAtu SaWa Bavantam iti |
   praharantīṃ śirasi padā smarāmi tāṃ garva-guru-kopām ||GAss_472||	praharantIm Sirasi padA smarAmi tAm garva--guru-kopAm ||GAsH-_472||
   yauvana-guptiṃ patyau bandhuṣu mugdhatvam ārjavaṃ guruṣu |	yOvana-guptim patyO banDuzu mugDa-tvam Arjavam guruzu |
   kurvāṇā halika-vadhūḥ praśasyate vyājato yuvabhiḥ ||GAss_473||	kurvANA halika-vaDUH praSasyate vyAjataH yuvaBiH ||GAsH-_473||
   yo na gurubhir na mitrair na vivekenāpi naiva ripu-hasitaiḥ |	yaH na guruBiH na mitrEH na vivekena-api na-eva ripu--hasitEH |
   niyamita-pūrvaḥ sundari sa vinītatvaṃ tvayā nītaḥ ||GAss_474||	niyamita--pUrvaH sundari sa vinIta-tvam tvayA nItaH ||GAsH-_474||
   yan-mūlam ārdram udakaiḥ kusumaṃ pratiparva phala-bharaḥ paritaḥ |	yan-mUlam Ardram udakEH kusumam pratiparva Pala--BaraH paritas |
   druma tan mādyasi vīcī-paricaya-pariṇāmam avicintya ||GAss_475||	druma tat mAdyasi vIcI--paricaya--pariNAmam avicintya ||GAsH-_475||
   yasyāṅke smara-saṅgara-viśrānti-prāñjalā sakhī svapiti |	yasya-aFke smara--saFgara--viSrAnti--prAQjalA saKI svapiti |
   sa vahatu guṇābhimānaṃ madana-dhanur-valli-cola iva ||GAss_476||	sa vahatu guNa-aBimAnam madana--DanuH--valli-colaH iva ||GAsH-_476||
   yadi dāna-gandha-mātrād vasanti sapta-cchade'pi dantinyaḥ |	yadi dAna--ganDa--mAtrAt vasanti sapta--cCade-api dantinyaH |
   kim iti mada-paṅka-malināṃ karī kapola-sthalīṃ vahati ||GAss_477||	kim iti mada--paFka-malinAm karI kapola--sTalIm vahati ||GAsH-_477||
   yad-avadhi vivṛddha-mātrā vikasita-kusumotkarā śaṇa-śreṇī |	yat--avaDi vivRdDa--mAtrA vikasita-kusuma-utkarA SaNa-SreNI |
   pītāṃśuka-priyeyaṃ tadavadhi pallī-pateḥ putrī ||GAss_478||	pIta-aMSuka-priyA-iyam tat-avaDi pallI--pateH putrI ||GAsH-_478||
   yamunā-taraṅga-taralaṃ na kuvalayaṃ kusuma-lāvi tava sulabham |	yamunA--taraFga--taralam na kuvalayam kusuma--lAvi tava sulaBam |
   yadi saurabhānusārī jhaṅkārī bhramati na bhramaraḥ ||GAss_479||	yadi sOraBa-anusArI JaFkArI Bramati na BramaraH ||GAsH-_479||
   iti vibhāvyākhyā-sametā ya-kāra-vrajyā ||	iti viBAvi-a-AKyA--sametAH ya-kAra-vrajyA ||
   ra--kāra-vrajyā	ra--kAra-vrajyA
   rājyābhiṣeka-salila-kṣālita-mauleḥ kathāsu kṛṣṇasya |	rAjya-aBizeka--salila--kzAlita-mOleH kaTAsu kRzNasya |
   garva-bhara-mantharākṣī paśyati pada-paṅkajaṃ rādhā ||GAss_490||	garva--Bara--manTara-akzI paSyati pada--paFkajam rADAH ||GAsH-_490||
   rati-kalaha-kupita-kāntā-kara-cikurākarṣa-mudita-gṛha-nātham |	rati-kalaha-kupita-kAnta-a-kara-cikura-Akarza--mudita-gRha-nATam |
   bhavati bhavanaṃ tad anyat prāg-vaṃśaḥ parṇa-śālā vā ||GAss_491||	Bavati Bavanam tat anyat prAc--vaMSaH parNa--SAlAH vA ||GAsH-_491||
   rogo rājāyata iti janavādaṃ satyam adya kalayāmi |	rogaH rAjAyate iti janavAdam satyam adya kalayAmi |
   ārogya-pūrvakaṃ tvayi talpa-prāntāgate subhaga ||GAss_492||	Arogya--pUrvakam tvayi talpa--prAnta-Agate suBagaH ||GAsH-_492||
   ruddha-svarasa-prasarasyālibhir agre nataṃ priyaṃ prati me |	rudDa--svarasa--prasarasya-AliBiH agre natam priyam prati me |
   srotasa iva nimnaṃ prati rāgasya dviguṇa āvegaḥ ||GAss_493||	srotasaH iva nimnam prati rAgasya dviguNaH AvegaH ||GAsH-_493||
   rūpam idaṃ kāntir asāv ayam utkarṣaḥ suvarṇa-racaneyam |	rUpam idam kAntiH asO ayam utkarzaH suvarNa-racanA-iyam |
   durgata-militā lalite bhramasi pratimandira-dvāram ||GAss_494||	durgata-militAH lalite Bramasi pratimandira-dvAram ||GAsH-_494||
   racite nikuñja-patrair bhikṣuka-pātre dadāti sāvajñam |	racite nikuQja--patrEH Bikzuka--pAtre dadAti sa-avajQam |
   paryuṣitam api sutīkṣṇa-śvāsa-kaduṣṇaṃ vadhūr annam ||GAss_495||	paryuzitam api su-tIkzNa---SvAsa--kaduzNam vaDUH annam ||GAsH-_495||
   rakṣati na khalu nija-sthitim alaghuḥ sthāpayati nāyakaḥ sa yathā |	rakzati na Kalu nija--sTitim alaGuH sTApayati nAyakaH sa yaTA |
   tiṣṭhati tathaiva tad-guṇa-viddheyaṃ hāra-yaṣṭhir iva ||GAss_496||	tizWati taTA-eva tad--guNa--vidDA-iyam hAra-yazWiH iva ||GAsH-_496||
   rājasi kṛśāṅgi maṅgala-kalaśī sahakāra-pallaveneva |	rAjasi kRSa-aFgi maFgala--kalaSI sahakAra--pallavena-iva |
   tenaiva cumbita-mukhī prathamāvirbhūta-rāgeṇa ||GAss_497||	tena-eva cumbita-muKI praTama-AvirBUta--rAgeNa ||GAsH-_497||
   rūpa-guṇa-hīna-hāryā bhavati laghur dhūlir anila-capaleva |	rUpa-guNa--hIna-hAryA Bavati laGuH DUliH anila-capalA-iva |
   prathayati pṛghu-guṇa-neyā taruṇī taraṇir iva garimāṇam ||GAss_498||	praTayati pRGu-guNa--neyA taruNI taraNiH iva garimANam ||GAsH-_498||
   rāge nave vijṛmbhati viraha-krama-manda-manda-mandākṣe |	rAge nave vijRmBati viraha-krama--manda-manda-manda-akze |
   sasmita-salajjam īkṣitam idam iṣṭaṃ siddham ācaṣṭe ||GAss_499||	sa-smita-salajjam Ikzitam idam izwam sidDam Acazwe ||GAsH-_499||
   roṣo 'pi rasavatīnāṃ na karkaśo vā cirānubandhī vā |	rozaH api rasavatInAm na karkaSaH vA cira-anubanDI vA |
   varṣāṇām upalo 'pi hi susnigdhaḥ kṣaṇika-kalpaś ca ||GAss_500||	varzANAm upalaH api hi su-snigDaH kzaNika-kalpaH ca ||GAsH-_500||
   rodanam etad dhanyaṃ sakhi kiṃ bahu mṛtyur api mamānarghaḥ |	rodanam etat Danyam saKi kim bahu mRtyuH api mama-anarGaH |
   svapneneva hi vihito nayana-mano-hāriṇā tena ||GAss_501||	svapnena-iva hi vihitaH nayana--mano--hAriNA tena ||GAsH-_501||
   roṣeṇaiva mayā sakhi vakro 'pi granthilo 'pi kaṭhino 'pi |	rozeNa-eva mayA saKi vakraH api granTilaH api kaWinaH api |
   ṛjutām anīyatāyaṃ sadyaḥ svedena vaṃśa iva ||GAss_502||	Rju-tAm anIyatA-ayam sadyas svedena vaMSaH iva ||GAsH-_502||
   rajanīm iyam upanetuṃ pitṛ-prasūḥ prathamam upatasthe |	rajanIm iyam upanetum pitR-prasUH praTamam upatasTe |
   rañjayati svayam induṃ kunāyakaṃ duṣṭa-dūtīva ||GAss_503||	raQjayati svayam indum kunAyakam duzwa-dUtI-iva ||GAsH-_503||
   iti vibhāvyākhyā-sametā ra-kāra-vrajyā ||	iti viBAvi-a-AKyA--sametAH ra-kAra-vrajyA ||
   la-kāra-vrajyā	la-kAra-vrajyA
   lagnāsi kṛṣṇa-vartmani susnigdhe varti hanta dagdhāsi |	lagnA-asi kRzNa--vartmani su-snigDe varti hanta dagDA-asi |
   ayam akhila-nayana-subhago nu bhukta-muktāṃ punaḥ spṛśati ||GAss_504||	ayam aKila--nayana--suBagaH nu Bukta-muktAm punar spRSati ||GAsH-_504||
   lakṣmīḥ śikṣayati guṇān amūn punar durgatir vidhūnayati |	lakzmIH Sikzayati guNAn amUn punar durgatiH viDUnayati |
   pūrṇo bhavati suvṛttas tuṣāra-rucir apacaye vakraḥ ||GAss_505||	pUrNaH Bavati su-vRttaH tuzAra-ruciH apacaye vakraH ||GAsH-_505||
   lūnā-tantu-niruddha-dvāraḥ śūnyālayaḥ patat-patagaḥ |	lUnA--tantu--nirudDa--dvAraH SUnya-AlayaH patat--patagaH |
   pathike tasminn añcala-pihita-mukho roditīva sakhi ||GAss_506||	paTike tasmin aQcala--pihita-muKaH roditi-iva saKi ||GAsH-_506||
   lagnaṃ jaghane tasyāḥ suviśāle kalita-kari-kara-krīḍe |	lagnam jaGane tasyAH su-viSAle kalita-kari--kara--krIxe |
   vapre saktaṃ dvipam iva śṛṅgāras tvāṃ vibhūṣayati ||GAss_507||	vapre saktam dvipam iva SRFgAraH tvAm viBUzayati ||GAsH-_507||
   liptaṃ na mukhaṃ nāṅgaṃ na pakṣatī na caraṇāḥ parāgeṇa |	liptam na muKam na-aFgam na pakzatI na caraNAH parAgeNa |
   aspṛśateva nalinyā vidagdha-madhupena madhu pītam ||GAss_508||	aspRSata-iva nalinyAH vidagDa---maDupena maDu pItam ||GAsH-_508||
   lagnaṃ jaghane tasyāḥ śuṣyati nakha-lakṣma mānasaṃ ca mama |	lagnam jaGane tasyAH Suzyati naKa-lakzma mAnasam ca mama |
   bhuktam aviśadam avedanam idam adhika-sarāga-sābādham ||GAss_509||	Buktam aviSadam avedanam idam aDika-sarAga--sa-AbADam ||GAsH-_509||
   lajjayitum akhila-gopī-nipīta-manasaṃ madhudviṣaṃ rādhā |	lajjayitum aKila--gopI--nipIta-manasam maDudvizam rADA |
   ajñeva pṛcchati kathāṃ śambhor dayitārdha-tuṣṭasya ||GAss_510||	ajQA-iva pRcCati kaTAm SamBoH dayitA-arDa-tuzwasya ||GAsH-_510||
   lakṣmī-niḥśvāsānala-piṇḍī-kṛta-dugdha-jaladhi-sāra-bhujaḥ |	lakzmI--niHSvAsa-anala--piNxI-kRta--dugDa--jalaDi--sAra-BujaH |
   kṣīra-nidhi-tīra-sudṛśo yaśāṃsi gāyanti rādhāyāḥ ||GAss_511||	kzIra-niDi-tIra--su-dRSaH yaSAMsi gAyanti rADAyAH ||GAsH-_511||
   līlāgārasya bahiḥ sakhīṣu caraṇātithau mayi priyayā |	lIlA-AgArasya bahis saKIzu caraNa-atiTO mayi priyayA |
   prakaṭīkṛtaḥ prasādo dattvā vātāyane vyajanam ||GAss_512||	prakawIkRtaH prasAdaH dattvA vAtAyane vyajanam ||GAsH-_512||
   iti vibhāvyākhyā-sametā la-kāra-vrajyā ||	iti viBAvi-a-AKyA--sametAH la-kAra-vrajyA ||
   va-kāra-vrajyā	va-kAra-vrajyA
   varṇa-hṛtir na lalāṭe na lulitam aṅgaṃ na cādhare daṃśaḥ |	varNa-hRtiH na lalAwe na lulitam aFgam na ca-aDare daMSaH |
   utpalam ahāri vāri ca na spṛṣṭam upāya-catureṇa ||GAss_513||	utpalam ahAri vAri ca na spRzwam upAya-catureNa ||GAsH-_513||
   vividhāyudha-vraṇārbuda-viṣame vakṣaḥ-sthale priyatamasya |	viviDa-AyuDa--vraNa-arbuda--vizame vakzaH-sTale priyatamasya |
   śrīr api vīra-vadhūr api garvotpulakā sukhaṃ svapiti ||GAss_518||	SrIH api vIra-vaDUH api garva-utpulakA suKam svapiti ||GAsH-_518||
   vaimukhye'pi vimuktāḥ śarā ivānyāya-yodhino vitanoḥ |	vEmuKye-api vimuktAH SarAH iva-anyAya--yoDinaH vitanoH |
   bhindanti pṛṣṭha-patitāḥ priya hṛdayaṃ mama tava śvāsāḥ ||GAss_519||	Bindanti pRzWa-patitAH priya hRdayam mama tava SvAsAH ||GAsH-_519||
   vyaktam adhunā sametaḥ khaṇḍo madirākṣi daśana-vasane te |	vyaktam aDunA sametaH KaNxaH madirA-akzi daSana-vasane te |
   yan nava-sudhaika-sāre lobhini tat kim api nādrākṣam ||GAss_520||	yat nava--suDA-eka--sAre loBini tat kim api na-adrAkzam ||GAsH-_520||
   vījayator anyonyaṃ yūnor viyutāni sakala-gātrāṇi |	vIjayatoH anyonyam yUnoH viyutAni sakala--gAtrANi |
   san maitrīva śroṇī paraṃ nidāghe'pi na vighaṭitā ||GAss_521||	san mEtrI-iva SroNI param nidAGe-api na viGawitAH ||GAsH-_521||
   vyāroṣaṃ māninyās tamo divaḥ kāsaraṃ kalam abhūmeḥ |	vyArozam mAninyAH tamaH divaH kAsaram kalam aBUmeH |
   baddham aliṃ ca nalinyāḥ prabhāta-sandhyāpasārayati ||GAss_522||	badDam alim ca nalinyAH praBAta--sanDyA-apasArayati ||GAsH-_522||
   vakṣasi vijṛmbhamāṇe stana-bhinnaṃ truṭati kañcukaṃ tasyāḥ |	vakzasi vijRmBamANe stana--Binnam truwati kaQcukam tasyAH |
   pūrva-dayitānurāgas tava hṛdi na manāg api truṭati ||GAss_523||	pUrva-dayitA-anurAgaH tava hRdi na manAk api truwati ||GAsH-_523||
   vyaktim avekṣya tad anyāṃ tasyām eveti viditam adhunā tu |	vyaktim avekzya tat anyAm tasyAm eva-iti viditam aDunA tu |
   harmya-hari-mukham iva tvām ubhayoḥ sādhāraṇaṃ vedmi ||GAss_524||	harmya--hari--muKam iva tvAm uBayoH sADAraNam vedmi ||GAsH-_524||
   vyajanasyeva samīpe gatāgatais tāpa-hāriṇo bhavataḥ |	vyajanasya-iva samIpe gatAgatEH tApa--hAriNaH BavataH |
   añcalam iva cañcalatāṃ mama sakhyāḥ prāpitaṃ cetaḥ ||GAss_525||	aQcalam iva caQcala-tAm mama saKyAH prApitam cetaH ||GAsH-_525||
   vitarantī rasam antar mamārdra-bhāvaṃ tanoṣi tanu-gātri |	vitarantI rasam antar mama-Ardra-BAvam tanozi tanu--gAtri |
   antaḥ-salilā sarid iva yan nivasasi bahir adṛśyāpi ||GAss_526||	antaH--salilA sarit iva yat nivasasi bahis adRSya-api ||GAsH-_526||
   vihita-vividhānubandho mānonnatayāvadhīrito mānī |	vihita--viviDa-anubanDaH mAna-unnatayA-avaDIritaH mAnI |
   labhate kutaḥ prabodhaṃ sa jāgaritvaiva nidrāṇaḥ ||GAss_527||	laBate kutas praboDam sa jAgaritvA-eva nidrANaH ||GAsH-_527||
   vrīḍā-vimukhīṃ vīta-snehām āśaṅkya kāku-vāṅ-madhuraḥ |	vrIxA--vimuKIm vIta-snehAm ASaFkya kAku-vAF-maDuraH |
   premārdra-sāparādhāṃ diśati dṛśaṃ vallabhe bālā ||GAss_528||	prema-Ardra--sa-aparADAm diSati dRSam vallaBe bAlAH ||GAsH-_528||
   vakṣaḥ-praṇayini sāndra-śvāse vāṅ-mātra-subhaṭi ghana-gharme |	vakzaH--praNayini sAndra--SvAse vAF-mAtra--suBawi Gana-Garme |
   sutanu lalāṭa-niveśita-lalāṭike tiṣṭha vijitāsi ||GAss_529||	su-tanu lalAwa--niveSita-lalAwike tizWa vijitA-asi ||GAsH-_529||
   vicarati paritaḥ kṛṣṇe rādhāyāṃ rāga-capala-nayanāyām |	vicarati paritas kRzNe rADAyAm rAga--capala-nayanAyAm |
   daśa-dig-vedha-viśuddhaṃ viśikhaṃ vidadhāti viṣameṣuḥ ||GAss_530||	daSa-diS---veDa--viSudDam viSiKam vidaDAti vizama-izuH ||GAsH-_530||
   vimukhe caturmukhe śritavati cānīśa-bhāvam īśe'pi |	vimuKe caturmuKe Sritavati ca-anISa-BAvam ISe-api |
   magna-mahī-nistāre hariḥ paraṃ stabdha-romābhūt ||GAss_532||	magna--mahI--nistAre hariH param stabDa-romA-aBUt ||GAsH-_532||
   vāpī-kacche vāsaḥ kaṇṭaka-vṛtayaḥ sajāgarā bhramarāḥ |	vApI--kacCe vAsaH kaNwaka--vRtayaH sa-jAgarAH BramarAH |
   ketaka-viṭapa kim etair nanu vāraya mañjarī-gandham ||GAss_533||	ketaka--viwapa kim etEH nanu vAraya maQjarI--ganDam ||GAsH-_533||
   vicalasi mugdhe vidhṛtā yathā tathā viśasi hṛdaya-madaye me |	vicalasi mugDe viDRtA yaTA taTA viSasi hRdaya-madaye me |
   śaktiḥ prasūna-dhanuṣaḥ prakampa-lakṣyaṃ spṛśantīva ||GAss_534||	SaktiH prasUna--DanuzaH prakampa--lakzyam spRSanti-iva ||GAsH-_534||
   vihitaāsama-śara-samaro jita-gāṅgeya-cchaviḥ kṛtāṭopaḥ |	vihitaa-asama-Sara--samaraH jita--gAFgeya-=-CaviH kRta-AwopaH |
   puruṣāyite virājati dehas tava sakhi śikhaṇḍīva ||GAss_535||	puruzAyite virAjati dehaH tava saKi SiKaNxI-iva ||GAsH-_535||
   vṛti-vivara-nirgatasya pramadā-bimbādharasya madhu pibate |	vRti-vivara--nirgatasya pramadA--bimba-aDarasya maDu pibate |
   avadhīrita-pīyūṣaḥ spṛhayati devādhirājo 'pi ||GAss_536||	avaDIrita--pIyUzaH spRhayati deva-aDirAjaH api ||GAsH-_536||
   vāsita-madhuni vadhūnām avataṃse mauli-maṇḍane yūnām |	vAsita--maDuni vaDUnAm avataMse mOli-maNxane yUnAm |
   vilasati sā puru-kusume madhupīva vana-prasūneṣu ||GAss_537||	vilasati sA puru-kusume maDupI-iva vana--prasUnezu ||GAsH-_537||
   vrīḍā-prasaraḥ prathamaṃ tad anu ca rasa-bhāva-puṣṭa-ceṣṭeyam |	vrIxA--prasaraH praTamam tat anu ca rasa-BAva--puzwa--cezwA-iyam |
   javanī-vinirgamād anu naṭīva dayitā mano harati ||GAss_538||	javanI--vinirgamAt anu nawI-iva dayitA manaH harati ||GAsH-_538||
   vāsasi haridrayeva tvayi gaurāṅgyā niveśito rāgaḥ |	vAsasi haridrayA-iva tvayi gOra-aFgyAH niveSitaH rAgaH |
   piśunena so 'panītaḥ sahasā patatā jaleneva ||GAss_539||	piSunena saH apanItaH sahasA patatA jalena-iva ||GAsH-_539||
   viṣvag-vikāsi-saurabha-rāgāndha-vyāgha-bādhanīyasya |	vizvak--vikAsi--sOraBa--rAga-anDa-vyAGa--bADanIyasya |
   kvacid api kuraṅga bhavato nābhīm ādāya na sthānam ||GAss_540||	kvacid api kuraFga BavataH nABIm AdAya na sTAnam ||GAsH-_540||
   vaṭa-kuṭaja-śāla-śālmali-rasāla-bahu-sāra-sindhu-vārāṇām |	vawa-kuwaja--SAla--SAlmali--rasa-ala--bahu--sAra--sinDu--vArANAm |
   asti bhidā malayācala-sambhava-saurabhya-sāmye'pi ||GAss_541||	asti BidAH malaya-acala--samBava--sOraBya--sAmye-api ||GAsH-_541||
   vinihita-kaparda-koṭiṃ cāpala-doṣeṇa śaṅkaraṃ tyaktvā |	vinihita-ka-parda--kowim cApala--dozeNa SaFkaram tyaktvA |
   vaṭam ekam anusarantī jāhnavi luṭhasi prayāga-taṭe ||GAss_542||	vawam ekam anusarantI jAhnavi luWasi prayAga--tawe ||GAsH-_542||
   veda caturṇāṃ kṣaṇadā praharāṇāṃ saṅgamaṃ viyogaṃ ca |	veda caturNAm kzaNadA praharANAm saFgamam viyogam ca |
   caraṇānām iva kūrmī saṅkocam api prasāram api ||GAss_543||	caraNAnAm iva kUrmI saFkocam api prasAram api ||GAsH-_543||
   vṛti-vivareṇa viśantī subhaga tvām īkṣituṃ sakhī dṛṣṭiḥ |	vRti-vivareNa viSantI suBaga tvAm Ikzitum saKI dRzwiH |
   harati yuva-hṛdaya-pañjara-madhyasthā manmatheṣur iva ||GAss_544||	harati yuva--hRdaya--paQjara--maDya-sTAH manmaTa-izuH iva ||GAsH-_544||
   vipaṇitulā-sāmānye mā gaṇayainaṃ nirūpaṇe nipuṇa |	vipaNi-tulA--sAmAnye mA gaNaya-enam nirUpaNe nipuNa |
   dharma-ghaṭo 'sāv adharīkaroti laghum upari nayati gurum ||GAss_545||	Darma-GawaH asO aDarIkaroti laGum upari nayati gurum ||GAsH-_545||
   vāsara-gamyam anūror ambaram avanī ca vāmanaika-padam |	vAsara--gamyam anUroH ambaram avanI ca vAmana-eka-padam |
   jaladhir api potalaṅghyaḥ satāṃ manaḥ kena tulayāmaḥ ||GAss_546||	jalaDiH api pota-laFGyaH satAm manaH kena tulayAmaH ||GAsH-_546||
   vitata-tamo-maṣilekhālakṣmotsaṅga-sphuṭāḥ kuraṅgākṣi |	vitata-tamaH--mazi-leKA-lakzma-utsaFga--sPuwAH kuraFga-akzi |
   patrākṣara-nikarā iva tārā nabhasi prakāśante ||GAss_547||	patra-akzara--nikarAH iva tArAH naBasi prakASante ||GAsH-_547||
   vividhāṅga-bhaṅgiṣu gurur nūtana-śiṣyāṃ manobhavācāryaḥ |	viviDa-aFga-BaFgizu guruH nUta-na--SizyAm manoBava-AcAryaH |
   vetra-latayeva bālāṃ talpe nartayati rata-rītyā ||GAss_548||	vetra--latayA-iva bAlAm talpe nartayati rata--rItyA ||GAsH-_548||
   viparītam api rataṃ te sroto nadyā ivānukūlam idam |	viparItam api ratam te srotaH nadyAH iva-anukUlam idam |
   taṭa-tarum iva mama hṛdayaṃ samūlam api vegato harati ||GAss_549||	tawa-tarum iva mama hRdayam sa-mUlam api vegataH harati ||GAsH-_549||
   vaibhava-bhājāṃ dūṣaṇam api bhūṣaṇa-pakṣa eva nikṣiptam |	vEBava--BAjAm dUzaNam api BUzaNa-pakzaH eva nikziptam |
   ugṇam ātmanām adharmaṃ dveṣaṃ ca gṛṇanti kāṇādāḥ ||GAss_550||	ugNam AtmanAm aDarmam dvezam ca gRNanti kANAdAH ||GAsH-_550||
   vakrāḥ kapaṭa-snigdhāḥ malināḥ karṇāntike prasajjantaḥ |	vakrAH kapawa--snigDAH malinAH karNa-antike prasajjantaH |
   kaṃ vañcayanti na sakhe khalāś ca gaṇikā-kaṭākṣāś ca ||GAss_551||	kam vaQcayanti na saKe KalAH ca gaNikA-kawAkzAH ca ||GAsH-_551||
   vidyuj-jvālā-valayita-jaladhara-piṭharodarād viniryānti |	vidyuj--jvAlA---valayita--jalaDara--piWara-udarAt viniryAnti |
   viśadaudana-dyuti-muṣaḥ preyasi payasā samaṃ karakāḥ ||GAss_552||	viSadOdana--dyuti--muzaH preyasi payasA samam karakAH ||GAsH-_552||
   vyajanādibhir upacāraiḥ kiṃ maru-pathikasya gṛhiṇi vihitair me |	vyajana-AdiBiH upacArEH kim maru-paTikasya gRhiNi vihitEH me |
   tāpas tvad-ūru-kadalī-dvaya-madhye śānti-mayam eti ||GAss_553||	tApaH tvad--Uru--kadalI--dvaya--maDye SAnti-mayam eti ||GAsH-_553||
   vaiguṇye'pi hi mahatā vinirmitaṃ bhavati karma śobhāyai |	vEguNye-api hi mahatA vinirmitam Bavati karma SoBAyE |
   durvaha-nitamba-mantharam api harati nitambinī-nṛtyam ||GAss_554||	durvaha--nitamba-manTaram api harati nitambinI--nRtyam ||GAsH-_554||
   vīkṣya satīnāṃ gaṇane rekhām ekāṃ tayā sva-nāmāṅkām |	vIkzya satInAm gaNane reKAm ekAm tayA sva-nAma-aFkAm |
   santu yuvāno hasituṃ svayam evāpāri nāvaritum ||GAss_555||	santu yuvAnaH hasitum svayam eva-apAri na-Avaritum ||GAsH-_555||
   vindhyācala iva dehas tava vividhāvarta-narmada-nitambaḥ |	vinDya-acalaH iva dehaH tava viviDa-Avarta-narmada--nitambaH |
   sthagayati gatiṃ muner api sambhāvita-ravi-ratha-stambhaḥ ||GAss_556||	sTagayati gatim muneH api samBAvita--ravi-raTa-stamBaH ||GAsH-_556||
   vṛti-bhañjana gañjana-saha nikāmam uddāma durnayārāma |	vRti-BaQjana gaQjana-saha nikAmam uddAma durnaya-ArAma |
   paravāṭī-śata-lampaṭa duṣṭa-vṛṣa smarasi geham api ||GAss_557||	para-vAwI--Sata-lampawa duzwa-vRza smarasi geham api ||GAsH-_557||
   vaṃśāvalambanaṃ yad yo vistāro guṇasya yāvanatiḥ |	vaMSa-avalambanam yat yaH vistAraH guNasya yA-avanatiH |
   taj jālasya khalasya ca nijāṅka-supta-praṇāśāya ||GAss_558||	tat jAlasya Kalasya ca nija-aFka-supta--praNASAya ||GAsH-_558||
   vindhya-mahīdhara-śikhare mudira-śreṇī-kṛpāṇa-mayam anilaḥ |	vinDya--mahIDara--SiKare mudira--SreNI--kRpANa-mayam anilaH |
   udyad-vidyuj-jyotiḥ pathika-vadhāyaiva śātayati ||GAss_559||	udyad-vidyuj--jyotiH paTika-vaDAya-eva SAtayati ||GAsH-_559||
   vyālambamāna-veṇī-dhuta-dhūli prathamam aśrubhir dhautam |	vyAlambamAna--veNI--Duta-DUli praTamam aSruBiH DOtam |
   āyātasya padaṃ mama gehinyā tad anu salilena ||GAss_560||	AyAtasya padam mama gehinyA tat anu salilena ||GAsH-_560||
   vakṣaḥ-sthala-supte mama mukham upadhātuṃ na maulim ālabhase |	vakzaH-sTala--supte mama muKam upaDAtum na mOlim AlaBase |
   pīnottuṅga-stana-bhara-dūrī-bhūtaṃ rata-śrāntau ||GAss_561||	pIna-uttuFga--stana--Bara-dUrI--BUtam rata--SrAntO ||GAsH-_561||
   vadana-vyāpārāntarbhāvād anuraktamānayantī tvam |	vadana--vyApAra-antarBAvAt anuraktam-AnayantI tvam |
   dūti satī-nāśārthaṃ tasya bhujaṅgasya daṃṣṭrāsi ||GAss_562||	dUti satI--nASa-arTam tasya BujaFgasya daMzwrA-asi ||GAsH-_562||
   iti vibhāvyākhyā-sametā va-kāra-vrajyā ||	iti viBAvi-a-AKyA--sametAH va-kAra-vrajyA ||
   śa-kāra-vrajyā	Sa-kAra-vrajyA
   śrīr api bhujaṅga-bhoge mohana-vijñena śīlitā yena |	SrIH api BujaFga--Boge mohana--vijQena SIlitAH yena |
   so 'pi hariḥ puruṣo yadi puruṣā itare'pi kiṃ kurmaḥ ||GAss_563||	saH api hariH puruzaH yadi puruzAH itare-api kim kurmaH ||GAsH-_563||
   śaṅke yā sthairyamayī ślathayati bāhū manobhavasyāpi |	SaFke yA sTErya-mayI SlaTayati bAhU manoBavasya-api |
   darpa-śilām iva bhavatīṃ kataras taruṇo vicālayati ||GAss_564||	darpa-SilAm iva BavatIm kataraH taruNaH vicAlayati ||GAsH-_564||
   śārdūla-nakhara-bhaṅgura kaṭhoratara-jāta-rūpa-racano 'pi |	SArdUla-naKara-BaFgura kaWoratara--jAta--rUpa-racanaH api |
   bālānām api bālāsā yasyās tvam api hṛdi vasasi ||GAss_565||	bAlAnAm api bAlAsA yasyAH tvam api hRdi vasasi ||GAsH-_565||
   śruta eva śruti-hāriṇi rāgotkarṣeṇa kaṇṭham adhivasati |	SrutaH eva Sruti-hAriNi rAga-utkarzeNa kaNWam aDivasati |
   gīta iva tvayi madhure karoti nārtha-grahaṃ sutanuḥ ||GAss_566||	gItaH iva tvayi maDure karoti na-arTa-graham su-tanuH ||GAsH-_566||
   śrīḥ śrī-phalena rājyaṃ tṛṇa-rājenālpa-sāmyato labdham |	SrIH SrI-Palena rAjyam tRNa-rAjena-alpa--sAmyataH labDam |
   kucayoḥ samyak-sāmyād gato ghaṭaś cakravartitvam ||GAss_567||	kucayoH samyak--sAmyAt gataH GawaH cakravarti-tvam ||GAsH-_567||
   śroṇī bhūmāv aṅke priyo bhayaṃ manasi pati-bhuje mauliḥ |	SroNI BUmO aFke priyaH Bayam manasi pati-Buje mOliH |
   gūḍhaśvāso vadane suratam idaṃ cet tṛṇaṃ tridivam ||GAss_568||	gUXa-SvAsaH vadane suratam idam ced tRNam tridivam ||GAsH-_568||
   śliṣyann iva cumbann iva paśyann iva collikhann ivātṛptaḥ |	Slizyan iva cumban iva paSyan iva ca-ulliKan iva-atRptaH |
   dadhad iva hṛdayasyāntaḥ smarāmi tasyā muhur jaghanam ||GAss_569||	daDat iva hRdayasya-antar smarAmi tasyAH muhur jaGanam ||GAsH-_569||
   śirasi caraṇa-prahāraṃ pradāya niḥsāryatāṃ sa te tad api |	Sirasi caraNa--prahAram pradAya niHsAryatAm sa te tat api |
   cakrāṅkito bhujaṅgaḥ kāliya iva sumukhi kālindyāḥ ||GAss_570||	cakra-aFkitaH BujaFgaH kAliyaH iva su-muKi kAlindyAH ||GAsH-_570||
   śocyaiva sā kṛśāṅgī bhūtimayī bhavatu guṇamayī vāpi |	SocyA-eva sA kRSAFgI BUti-mayI Bavatu guNa-mayI vA-api |
   snehaika-vaśya bhavatā tyaktā dīpena vartir iva ||GAss_571||	sneha-eka-vaSya BavatA tyaktAH dIpena vartiH iva ||GAsH-_571||
   śuka iva dāru-śalākā-piñjaram anudivasa-vardhamāno me |	SukaH iva dAru-SalAkA-piQjaram anudivasa-varDamAnaH me |
   kṛntati dayitā-hṛdayaṃ śokaḥ smara-viśikha-tīkṣṇa-mukhaḥ ||GAss_572||	kRntati dayitA--hRdayam SokaH smara--viSiKa--tIkzNa-muKaH ||GAsH-_572||
   śrutvākasmika-maraṇaṃ śuka-sūnoḥ sakala-kautukaika-nidheḥ |	SrutvA-kasmika--maraNam Suka-sUnoH sakala--kOtuka-eka--niDeH |
   jñāto gṛhiṇī-vinaya-vyaya āgatyaiva pathikena ||GAss_573||	jQAtaH gRhiNI--vinaya--vyayaH Agatya-eva paTikena ||GAsH-_573||
   śīlita-bhujaṅga-bhogā kroḍenābhuddhṛtāpi kṛṣṇena |	SIlita--BujaFga--BogA kroxena-aBut-DRtA-api kRzNena |
   acalaiva kīrtyate bhūḥ kim aśakyaṃ nāma vasumatyāḥ ||GAss_574||	acalA-eva kIrtyate BUH kim aSakyam nAma vasumatyAH ||GAsH-_574||
   śyāmā vilcana-harī bāleyaṃ manasi hanta sajjantī |	SyAmA vilcana--harI bAlA-iyam manasi hanta sajjantI |
   lumpati pūrva-kalatraṃ dhūma-latā bhitti-citram iva ||GAss_575||	lumpati pUrva--kalatram DUma-latA Bitti-citram iva ||GAsH-_575||
   śataśo gatir āvṛttiḥ śataśaḥ kaṇṭhāvalambanaṃ śataśaḥ |	SataSas gatiH AvRttiH SataSas kaNWa-avalambanam SataSas |
   śataśo yāmīti vacaḥ smarāmi tasyāḥ pravāsa-dine ||GAss_576||	SataSas yAmi-iti vacaH smarAmi tasyAH pravAsa--dine ||GAsH-_576||
   śruta-para-puṣṭa-ravābhiḥ pṛṣṭo gopībhir abhimataṃ kṛṣṇaḥ |	Sruta--para--puzwa--ravABiH pRzwaH gopIBiH aBimatam kRzNaH |
   śaṃsati vaṃśa-stanitaiḥ stana-vinihita-locano 'numatam ||GAss_577||	SaMsati vaMSa--stanitEH stana--vinihita--locanaH anumatam ||GAsH-_577||
   śaṅkara-śirasi niveśita-padeti mā garvam udvahendu-kale |	SaFkara--Sirasi niveSita-padA-iti mA garvam udvaha-indu--kale |
   phalam etasya bhaviṣyati tava caṇḍī-caraṇa-reṇumṛjā ||GAss_578||	Palam etasya Bavizyati tava caNxI-caraNa--reNu-mRjAH ||GAsH-_578||
   śākhi-śikhare samīraṇa-dolāyita-nīḍa-nirvṛtaṃ vasati |	SAKi--SiKare samIraNa-dolAyita-nIxa--nirvRtam vasati |
   karmaika-śarāṇam agaṇita-bhayam aśithila-keli khaga-mithunam ||GAss_579||	karma-eka-SarANam agaNita-Bayam aSiTila--keli Kaga--miTunam ||GAsH-_579||
   śuka surata-samara-nārada hṛdaya-rahasyaika-sāra sarvajña |	Suka surata--samara--nArada hRdaya-rahasya-eka-sAra sarvajQa |
   guru-jana-samakṣa-mūka prasīda jambū-phalaṃ dalaya ||GAss_580||	guru--jana--samakza--mUka prasIda jambU-Palam dalaya ||GAsH-_580||
   śirasā vahasi kapardaṃ rudra ruditvāpi rajatam arjayasi |	SirasA vahasi kapardam rudra ruditvA-api rajatam arjayasi |
   asyāpy udarasyārdhaṃ bhajatas tava vetti kas tattvam ||GAss_581||	asya-api udarasya-arDam BajataH tava vetti kaH tattvam ||GAsH-_581||
   śrotavyaiva sudheva śvetāṃśu-kaleva dūra-dṛśyaiva |	SrotavyA-eva suDA-iva Sveta-aMSu-kalA-iva dUra--dRSyA-eva |
   duṣṭa-bhujaṅga-parīte tvaṃ ketaki na khalu naḥ spṛśyā ||GAss_582||	duzwa--BujaFga--parIte tvam ketaki na Kalu naH spRSyAH ||GAsH-_582||
   śravaṇopanīta-guṇayā samarpayantyā praṇamya kusumāni |	SravaNa-upanIta--guNayA samarpayantyA praNamya kusumAni |
   madana-dhanur-latayeva tvayā vaśaṃ dūti nīto 'smi ||GAss_583||	madana--DanuH--latayA-iva tvayA vaSam dUti nItaH asmi ||GAsH-_583||
   śākhoṭaka-śākhoṭaja-vaikhānasa-karaṭa-pūjya raṭa suciram |	SAKowaka-SAKA-uwa-ja--vEKAnasa-karawa--pUjya rawa su-ciram |
   nādara-padam iha gaṇakāḥ pramāṇa-puruṣo bhavān ekaḥ ||GAss_584||	na-Adara-padam iha gaNakAH pramANa--puruzaH BavAn ekaH ||GAsH-_584||
   śaśi-rekhopama-kāntes tavānya-pāṇi-grahaṃ prayātāyāḥ |	SaSi-reKA-upama--kAnteH tava-anya-pANi-graham prayAtAyAH |
   madanāsi-putrikāyā ivāṅga-śobhāṃ kadarthayati ||GAss_585||	madana-asi-putrikAyAH iva-aFga--SoBAm kadarTayati ||GAsH-_585||
   śaithilyena bhṛtā api bhartuḥ kāryaṃ tyajanti na suvṛttāḥ |	SETilyena BRtAH api BartuH kAryam tyajanti na su-vRttAH |
   balinākṛṣṭe bāhau valayāḥ kūjanti dhāvanti ||GAss_586||	balinA-AkRzwe bAhO valayAH kUjanti DAvanti ||GAsH-_586||
   iti vibhāvyākhyā-sametā śa-kāra-vrajyā |	iti viBAvi-a-AKyA--sametA Sa-kAra--vrajyA |
   ṣa-kāra-vrajyā	za-kAra-vrajyA
   ṣaṭ-caraṇa-kīṭa-juṣṭaṃ parāga-ghuṇa-pūrṇam āyudhaṃ tyaktvā |	zaw--caraNa--kIwa--juzwam parAga--GuNa--pUrNam AyuDam tyaktvA |
   tvāṃ muṣṭimeya-madhyām adhunā śaktiṃ smaro vahati ||GAss_587||	tvAm muzwi-meya--maDyAm aDunA Saktim smaraH vahati ||GAsH-_587||
   iti vibhāvyākhyā-sametā ṣa-kāra-vrajyā |	iti viBAvi-a-AKyA--sametA za-kAra-vrajyA |
   sa-kāra-vrajyā	sa--kAra-vrajyA
   sā divasa-yogya-kṛtya-vyapadeśā kevalaṃ gṛhiṇī |	sA divasa-yogya-kRti-a--vyapadeSA kevalam gRhiNI |
   dvitither divasasya parā tithir iva sevyā niśi tvam asi ||GAss_588||	dvi-tiTeH divasasya parA tiTiH iva sevyAH niSi tvam asi ||GAsH-_588||
   stana-nūtana-nakha-lekhālambī tava gharma-bindu-sandohaḥ |	stana-nUta-na-naKa--leKA-AlambI tava Garma-bindu--sandohaH |
   ābhāti paṭṭa-sūtre praviśann iva mauktika-prasaraḥ ||GAss_589||	ABAti pawwa-sUtre praviSan iva mOktika-prasaraH ||GAsH-_589||
   saubhāgya-garvam ekā karotu yūthasya bhūṣaṇaṃ kariṇī |	sOBAgya--garvam ekA karotu yUTasya BUzaNam kariNI |
   atyāyām avator yā madāndhayor madhyam adhivasati ||GAss_590||	atyAyAm avatoH yA mada-anDayoH maDyam aDivasati ||GAsH-_590||
   sva-caraṇa-pīḍānumita-tvan-mauli-rujā-vinīta-mātsaryā |	sva---caraNa--pIxA-anumita-tu-an--mOli--rujA--vinIta--mAtsaryA |
   aparāddhā subhaga tvāṃ svayam aham anunetum āyātā ||GAss_591||	aparAdDA suBaga tvAm svayam aham anunetum AyAtAH ||GAsH-_591||
   snehamayān pīḍayataḥ kiṃ cakreṇāpi tailakārasya |	sneha-mayAn pIxayataH kim cakreNa-api tEla-kArasya |
   cālayati pārthivān api yaḥ sa kulālaḥ paraṃ cakrī ||GAss_592||	cAlayati pArTivAn api yaH sa kulAlaH param cakrI ||GAsH-_592||
   sarale na veda bhavatī bahu-bhaṅgā bahu-rasā bahu-vivartā |	sarale na veda BavatI bahu-BaFgAH bahu-rasAH bahu-vivartA |
   gatir asatī-netrāṇāṃ premṇāṃ srotasvatīnāṃ ca ||GAss_593||	gatiH asatI--netrANAm premNAm srotasvatInAm ca ||GAsH-_593||
   sakhi madhyāhna-dvi-gu;na-dyumaṇi-kara-śreṇi-pīḍitā chāyā |	saKi maDyAhna--dvi--gu;-na-dyumaNi-kara--SreNi--pIxitA CAyA |
   majjitum ivāla-vāle paritas taru-mūlam āśrayati ||GAss_594||	majjitum iva-Ala-vAle paritas taru--mUlam ASrayati ||GAsH-_594||
   sakhi śṛṇu mama priyo 'yaṃ gehaṃ yenaiva vartmanāyātaḥ |	saKi SRNu mama priyaH ayam geham yena-eva vartmanA-AyAtaH |
   tan-nagara-grāma-nadīḥ pṛcchati samam āgatān anyān ||GAss_595||	tan-nagara--grAma--nadIH pRcCati samam AgatAn anyAn ||GAsH-_595||
   sāyaṃ ravir analam asau madana-śaraṃ sa ca viyoginī-cetaḥ |	sAyam raviH analam asO madana--Saram sa ca viyoginI--cetaH |
   idam api tamaḥ-samūhaṃ so 'pi nabho nirbharaṃ viśati ||GAss_596||	idam api tamaH--samUham saH api naBaH nirBaram viSati ||GAsH-_596||
   smara-samara-samaya-pūrita-kambhu-nibho dviguṇa-pīna-gala-nālaḥ |	smara--samara--samaya--pUrita--kamBu--niBaH dviguNa---pIna-gala-nAlaH |
   śīrṇa-prāsādopari jigīṣur iva kala-ravaḥ kvaṇati ||GAss_597||	SIrNa--prAsAda-upari jigIzuH iva kala-ravaH kvaNati ||GAsH-_597||
   sphurad-adharam aviratāśru dhvani-rodhotkampa-kucam idaṃ ruditam |	sPurat--aDaram avirata-aSru Dvani-roDa-utkampa-kucam idam ruditam |
   jānūpanihita-hasta-nyasta-mukhaṃ dakṣiṇa-prakṛteḥ ||GAss_598||	jAnu-upanihita-hasta-nyasta-muKam dakziNa--prakRteH ||GAsH-_598||
   svayam upanītair aśanaiḥ puṣṇantī nīḍa-nirvṛtaṃ dayitam |	svayam upanItEH aSanEH puzNantI nIxa--nirvRtam dayitam |
   sahaja-prema-rasajñā subhagā-garvaṃ bakī vahatu ||GAss_599||	sahaja--prema--rasa-jQA suBagA--garvam bakI vahatu ||GAsH-_599||
   sva-rasena badhnatāṃ karam ādāne kaṇṭakotkarais tudatām |	sva-rasena baDnatAm karam AdAne kaNwaka-utkarEH tudatAm |
   piśunānāṃ panasānāṃ koṣābhogo 'py aviśvāsyaḥ ||GAss_600||	piSunAnAm panasAnAm koza-ABogaH api aviSvAsyaH ||GAsH-_600||
   saubhāgyaṃ dākṣiṇyān nety upadiṣṭaṃ hareṇa taruṇīnām |	sOBAgyam dAkziNyAt na-iti upadizwam hareNa taruNInAm |
   vāmārdham eva devyāḥ sva-vapuḥ-śilpe niveśayatā ||GAss_601||	vAma-arDam eva devyAH sva--vapuH-Silpe niveSayatA ||GAsH-_601||
   subhaga sva-bhavana-bhittau bhavatā saṃmardya pīḍitā sutanuḥ |	suBaga sva-Bavana--BittO BavatA saMmardya pIxitA su-tanuH |
   sā pīḍayaiva jīvati dadhatī vaidyeṣu vidveṣam ||GAss_602||	sA pIxayA-eva jIvati daDatI vEdyezu vidvezam ||GAsH-_602||
   sā guṇa-mayī svabhāva-svacchā sutanuḥ kara-grahāyattā |	sA guNa-mayI svaBAva-su-acCA su-tanuH kara-graha-AyattA |
   bhramitā bahu-mantra-vidā bhavatā kāśmīra-māleva ||GAss_603||	BramitA bahu-mantra-vidA BavatA kASmIra--mAlA-iva ||GAsH-_603||
   sa-vrīḍa-smita-subhage spṛṣṭāspṛṣṭeva kiṃcid apayāntī |	sa--vrIxa--smita-suBage spRzwA-aspRzwA-iva kiMcid apayAntI |
   apasarasi sundari yathā yathā tathā spṛśasi mama hṛdayam ||GAss_604||	apasarasi sundari yaTA yaTA taTA spRSasi mama hRdayam ||GAsH-_604||
   sakhi sukhayaty avakāśa-prāptaḥ preyān yathā tathā na gṛhī |	saKi suKayati avakASa--prAptaH preyAn yaTA taTA na gRhI |
   vātād avāritād api bhavati gavākṣānilaḥ śītaḥ ||GAss_605||	vAtAt avAritAt api Bavati gavAkza-anilaH SItaH ||GAsH-_605||
   satatam aruṇita-mukhe sakhi nigirantī garalam iva girāṃ gumpham |	satatam aruNita-muKe saKi nigirantI garalam iva girAm gumPam |
   avagaṇitauṣadhi-mantrā bhujaṅgi raktaṃ virañjayasi ||GAss_606||	avagaNita-ozaDi-mantrAH BujaFgi raktam viraQjayasi ||GAsH-_606||
   sthala-kamala-mugdha-vapuṣā sātaṅkāṅka-sthitaika-caraṇena |	sTala--kamala--mugDa--vapuzA sa-AtaFka-aFka--sTita-eka-caraNena |
   āśvāsayati visinyāḥ kūle visa-kaṇṭhikā śapharam ||GAss_607||	ASvAsayati visinyAH kUle visa-kaNWikA SaParam ||GAsH-_607||
   sa-nakha-padam adhika-gauraṃ nābhī-mūlaṃ niraṃśukaṃ kṛtvā |	sa-naKa-padam aDika-gOram nABI--mUlam niraMSukam kRtvA |
   anayā sevita pavana tvaṃ kiṃ kṛta-malaya-bhṛgupātaḥ ||GAss_608||	anayA sevita pavana tvam kim kRta--malaya--BRgupAtaH ||GAsH-_608||
   sarvāṅgam arpayantī lolā suptaṃ śrameṇa śayyāyām |	sarva-aFgam arpayantI lolA suptam SrameNa SayyAyAm |
   alasam api bhāgyavantaṃ bhajate puruṣayiteva śrīḥ ||GAss_609||	alasam api BAgyavantam Bajate puruzayitA-iva SrIH ||GAsH-_609||
   suditaṃ tad eva yatra smāraṃ smāraṃ viyoga-duḥkhāni |	suditam tat eva yatra smAram smAram viyoga--duHKAni |
   āliṅgati sā gāḍhaṃ punaḥ punar yāminī-prathame ||GAss_610||	AliFgati sA gAXam punar punar yAminI--praTame ||GAsH-_610||
   sāntar-bhayaṃ bhujiṣyā yathā yathācarati samadhikāṃ sevām |	sa-antar--Bayam BujizyAH yaTA yaTA-Acarati samaDikAm sevAm |
   sāśaṅka-serṣya-sabhayā tathā tathā gehinī tasya ||GAss_611||	sa-ASaFka--sa-Irzya--saBayA taTA taTA gehinI tasya ||GAsH-_611||
   sundari darśayati yathā bhavad-vipakṣasya tat-sakhī kāntim |	sundari darSayati yaTA Bavat--vipakzasya tat--saKI kAntim |
   patati tathā mama dṛṣṭis tvad-eka-dāsasya sāsūyā ||GAss_612||	patati taTA mama dRzwiH tvad--eka-dAsasya sa-asUyAH ||GAsH-_612||
   svādhīnair adhara-vraṇa-nakhāṅka-patrāvalopa-dina-śayanaiḥ |	sva-aDInEH aDara-vraNa-naKa-aFka-patrAvalopa-dina--SayanEH |
   subhagā subhagety anayā sakhi nikhilā mukharitā pallī ||GAss_613||	suBagA suBagA-iti anayA saKi niKilA muKaritA pallI ||GAsH-_613||
   sarita iva yasya gehe śuṣyanti viśāla-gotrajā nāryaḥ |	saritaH iva yasya gehe Suzyanti viSAla--gotra-jAH nAryaH |
   kṣārāsv eva sa tṛpyati jala-nidhi-laharīṣu jalada iva ||GAss_614||	kzArAsu eva sa tRpyati jala-niDi--laharIzu jaladaH iva ||GAsH-_614||
   sakala-kaṭakaika-maṇḍani kaṭhinī-bhūtāśaye śikhara-danti |	sakala--kawaka-eka-maNxani kaWinI--BUta-ASaye SiKara-danti |
   giribhuva iva tava manye manaḥ śilā samabhavac caṇḍi ||GAss_615||	giri-BuvaH iva tava manye manaH SilA samaBavat caNxi ||GAsH-_615||
   sakhi duravagāha-gahano vidadhāno vipriyaṃ priya-jane'pi |	saKi duravagAha--gahanaH vidaDAnaH vipriyam priya-jane-api |
   khala iva durlakṣyas tava vinata-mukhasyopari sthitaḥ kopaḥ ||GAss_616||	KalaH iva durlakzyaH tava vinata-muKasya-upari sTitaH kopaH ||GAsH-_616||
   sveda-sacela-snātā sapta-padī sapta maṇḍalīr yāntī |	sveda--sa-cela--snAtA sapta-padI sapta maNxalIH yAntI |
   sa-madana-dahana-vikārā manoharā vrīḍitā namati ||GAss_617||	sa--madana--dahana--vikArAH manoharAH vrIxitAH namati ||GAsH-_617||
   surasa-pravartamānaḥ saṅghāṭo 'yaṃ samāna-vṛttānām |	surasa-pravartamAnaH saFGAwaH ayam samAna--vRttAnAm |
   etyaiva bhinna-vṛttair bhaṅguritaḥ kāvya-sarga iva ||GAss_618||	etya-eva Binna-vRttEH BaFguritaH kAvya--sargaH iva ||GAsH-_618||
   sarvāsām eva sakhe paya iva surataṃ manohāri |	sarvAsAm eva saKe payaH iva suratam manohAri |
   tasyā eva punaḥ punar āvṛttau dugdham iva madhuram ||GAss_619||	tasyAH eva punar punar AvRttO dugDam iva maDuram ||GAsH-_619||
   svapne'pi yāṃ na muñcasi yā te'nugrāhiṇī hṛdi-sthāpi |	svapne-api yAm na muQcasi yA te-anugrAhiNI hRdi-sTA-api |
   duṣṭāṃ na buddhim iva tāṃ gūḍha-vyabhicāriṇīṃ vetsi ||GAss_620||	duzwAm na budDim iva tAm gUXa--vyaBicAriNIm vetsi ||GAsH-_620||
   saparāvṛti carantī vāty eva tṛṇaṃ mano 'navadyāṅgi |	sa-parAvRti carantI vAti eva tRNam manaH anavadya-aFgi |
   harasi kṣipasi taralayasi bhramayasi tolayasi pātayasi ||GAss_621||	harasi kzipasi taralayasi Bramayasi tolayasi pAtayasi ||GAsH-_621||
   sā bahu-lakṣaṇa-bhāvā strī-mātraṃ veti kitava tava tulyam |	sA bahu-lakzaNa-BAvA strI--mAtram vA-iti kitava tava tulyam |
   koṭir varāṭikā vā dyūta-vidheḥ sarva eva paṇaḥ ||GAss_622||	kowiH varAwikAH vA dyUta-viDeH sarve eva paNaH ||GAsH-_622||
   sā viraha-dahana-dūnā mṛtvā mṛtvāpi jīvati varākī |	sA viraha--dahana-dUnA mRtvA mRtvA-api jIvati varAkI |
   śārīva kitava bhavatānukūlitā pātitākṣeṇa ||GAss_623||	SArI-iva kitava BavatA-anukUlitA pAtita-akzeNa ||GAsH-_623||
   sparśād eva svedaṃ janayati na ca me dadāti nidrātum |	sparSAt eva svedam janayati na ca me dadAti nidrAtum |
   pirya iva jaghanāṃśukam api na nidāghaḥ kṣaṇam api kṣamate ||GAss_624||	piryaH iva jaGana-aMSukam api na nidAGaH kzaNam api kzamate ||GAsH-_624||
   sā bhavato bhāvanayā samaya-viruddhaṃ manobhavaṃ bālā |	sA BavataH BAvanayA samaya-virudDam manoBavam bAlAH |
   nūtana-lateva sundara dohada-śaktyā phalaṃ vahati ||GAss_625||	nUta-na-latA-iva sundara dohada--SaktyA Palam vahati ||GAsH-_625||
   spṛśati nakhair na ca vilikhati sicayaṃ gṛhṇāti na ca vimocayati |	spRSati naKEH na ca viliKati sicayam gRhNAti na ca vimocayati |
   na ca muñcati na ca madayati nayati niśāṃ sā na nidrāti ||GAss_626||	na ca muQcati na ca madayati nayati niSAm sA na nidrAti ||GAsH-_626||
   stana-jaghana-dvayam asyā laṅghita-madhyaḥ sakhe mama kaṭākṣaḥ |	stana--jaGana--dvayam asyAH laFGita--maDyaH saKe mama kawAkzaH |
   nojjhati rodhasvatyās taṭa-dvayaṃ tīrtha-kāka iva ||GAss_627||	na-ujJati roDasvatyAH tawa--dvayam tIrTa-kAkaH iva ||GAsH-_627||
   sa-vrīḍa-smita-manda-śvasitaṃ māṃ mā spṛśeti śaṃsantyā |	sa--vrIxa--smita-manda--Svasitam mAm mA spRSa-iti SaMsantyAH |
   ākopam etya vātāyanaṃ pidhāya sthitaṃ priyayā ||GAss_628||	Akopam etya vAtAyanam piDAya sTitam priyayA ||GAsH-_628||
   sa-kara-grahaṃ sa-ruditaṃ sākṣepaṃ sa-nakha-muṣṭi sa-jigīṣam |	sa-kara-graham sa-ruditam sa-Akzepam sa-naKa--muzwi sa-jigIzam |
   tasyāḥ surataṃ surataṃ prājāpatya-kratur ato 'nyaḥ ||GAss_629||	tasyAH suratam suratam prAjApatya-kratuH atas anyaH ||GAsH-_629||
   sakhi na khalu nimalānāṃ vidadhaty abhidhānam api mukhe malināḥ |	saKi na Kalu nimalAnAm vidaDati aBiDAnam api muKe malinAH |
   kenāśrāvi pikānāṃ kuhūṃ vihāyetaraḥ śabdaḥ ||GAss_630||	kena-ASrAvi pikAnAm kuhUm vihAya-itaraH SabdaH ||GAsH-_630||
   svalpā iti rāma-balair ye nyastā nāśaye payo-rāśeḥ |	su-alpAH iti rAma-balEH ye nyastAH na-ASaye payo-rASeH |
   te śailāḥ sthitimanto hanta laghimnaiva bahu-mānaḥ ||GAss_631||	te SElAH sTitimantaH hanta laGimnA-eva bahu-mAnaH ||GAsH-_631||
   sā śyāmā tanvaṅgī dahatā śītopacāra-tīvreṇa |	sA SyAmA tanvaFgI dahatA SIta-upacAra--tIvreNa |
   viraheṇa pāṇḍimānaṃ nītā tuhinena dūrvaiva ||GAss_632||	viraheNa pANximAnam nItA tuhinena dUrvA-eva ||GAsH-_632||
   sunirīkṣita-niścala-kara-vallabha-dhārā-jalokṣitā na tathā |	su-nirIkzita--niScala--kara--vallaBa--DArA--jala-ukzitA na taTA |
   sotkampena mayā sakhi dṛṣṭā sā mādyati sma yathā ||GAss_633||	sa-utkampena mayA saKi dRzwA sA mAdyati sma yaTA ||GAsH-_633||
   sakhi moghīkṛta-madane pativrate kas tavādaraṃ kurute |	saKi moGIkRta-madane pativrate kaH tava-Adaram kurute |
   nāśrauṣīr bhagavān api sa kāma-viddho haraḥ pūjyaḥ ||GAss_634||	na-aSrOzIH BagavAn api sa kAma-vidDaH haraH pUjyaH ||GAsH-_634||
   sā mayi na dāsa-buddhir na ratir nāpi trapā na viśvāsaḥ |	sA mayi na dAsa-budDiH na ratiH na-api trapAH na viSvAsaH |
   hanta nirīkṣya navoḍhāṃ manye vayam apiryā jātāḥ ||GAss_635||	hanta nirIkzya na-va-UXAm manye vayam apiH-yAH jAtAH ||GAsH-_635||
   sucirāyāte gṛhiṇī niśi bhuktā dina-mukhe vidagdheyam |	sucira-AyAte gRhiNI niSi BuktA dina--muKe vidagDA-iyam |
   dhavala-nakhāṅkaṃ nija-vapur akuṅkumārdraṃ na darśayati ||GAss_636||	Davala-naKa-aFkam nija-vapuH akuFkuma-Ardram na darSayati ||GAsH-_636||
   stana-jaghanoru-praṇayī gāḍhaṃ lagno niveśita-snehaḥ |	stana--jaGana-Uru--praNayI gAXam lagnaH niveSita-snehaH |
   priya kāla-pariṇatir iyaṃ virajyase yan nakhāṅka iva ||GAss_637||	priya kAla--pariNatiH iyam virajyase yat naKa-aFkaH iva ||GAsH-_637||
   sā vicchāyā niśi niśi sutanur bahu-tuhina-śītale talpe |	sA vicCAyA niSi niSi su-tanuH bahu-tu-hina--SItale talpe |
   jvalati tvadīya-virahād oṣadhir iva himavataḥ pṛṣṭhe ||GAss_638||	jvalati tvadIya--virahAt ozaDiH iva himavataH pRzWe ||GAsH-_638||
   sā nīrase tava hṛdi praviśati niryāti na labhate sthairyam |	sA nIrase tava hRdi praviSati niryAti na laBate sTEryam |
   sundara sakhī divasakara-bimbe tuhināṃśu-rekheva ||GAss_639||	sundara saKI divasakara--bimbe tuhina-aMSu--reKA-iva ||GAsH-_639||
   sukumāratvaṃ kāntir nitānta-saraatvam āntarāś ca guṇāḥ |	sukumAra-tvam kAntiH nitAnta-saraa-tvam AntarAH ca guNAH |
   kiṃ nāma nendulekhe śaśa-graheṇaiva tava kathitam ||GAss_640||	kim nAma na-indu-leKe SaSa-graheNa-eva tava kaTitam ||GAsH-_640||
   saurabhya-mātra-manasām āstāṃ malaya-drumasya na viśeṣaḥ |	sOraBya--mAtra--manasAm AstAm malaya-drumasya na viSezaH |
   dharmārthināṃ tathāpi sa mṛgyaḥ pūjārtham aśvatthaḥ ||GAss_641||	Darma-arTinAm taTA-api sa mRgyaH pUjA-arTam aSvatTaH ||GAsH-_641||
   saṃvāhayati śayānaṃ yathopavījayati gṛhapatiṃ gṛhiṇī |	saMvAhayati SayAnam yaTA-upavIjayati gRhapatim gRhiNI |
   gṛha-vṛti-vivara-niveśita-dṛśas tathāśvāsanaṃ yūnaḥ ||GAss_642||	gRha-vRti--vivara--niveSita-dRSaH taTA-ASvAsanam yUnaH ||GAsH-_642||
   satyaṃ svalpa-guṇeṣu stabdhā sadṛśe punar bhujaṅge sā |	satyam su-alpa--guNezu stabDA sadRSe punar BujaFge sA |
   arpita-koṭiḥ praṇamati sundara hara-cāpa-yaṣṭir iva ||GAss_643||	arpita-kowiH praNamati sundara hara-cApa-yazwiH iva ||GAsH-_643||
   sarvaṃsahāṃ mahīm iva vidhāya tāṃ bāṣpa-vāribhiḥ pūrṇām |	sarvaMsahAm mahIm iva viDAya tAm bAzpa-vAriBiH pUrNAm |
   bhavanāntara-mayam adhunā saṅkrāntas te guruḥ premā ||GAss_644||	Bavana-antara--mayam aDunA saFkrAntaH te guruH premAH ||GAsH-_644||
   sambhavati na khalu rakṣā sarasānāṃ prakṛti-capala-caritānām |	samBavati na Kalu rakzA sarasAnAm prakRti-capala--caritAnAm |
   anubhavati hara-śirasy api bhujaṅga-pariśīlanaṃ gaṅgā ||GAss_645||	anuBavati hara-Sirasi api BujaFga--pariSIlanam gaFgA ||GAsH-_645||
   sulabheṣu kamala-kesara-ketaka-mākanda-kunda-kusumeṣu |	sulaBezu kamala--kesara-ketaka-mA-kanda--kunda--kusumezu |
   vāñchati manorathāndhā madhupī smara-dhanuṣi guṇī-bhāvam ||GAss_646||	vAQCati manoraTa-anDA maDupI smara--Danuzi guNI-BAvam ||GAsH-_646||
   sā lajjitā sapatnī kupitā bhītaḥ priyaḥ sakhī sukhitā |	sA lajjitA sapatnI kupitA BItaH priyaH saKI suKitAH |
   bālāyāḥ pīḍāyāṃ nidānite jāgare vaidyaiḥ ||GAss_647||	bAlAyAH pIxAyAm nidAnite jAgare vEdyEH ||GAsH-_647||
   sucirāgatasya saṃvāhana-cchalenāṅgam aṅgam āliṅgya |	sucira-Agatasya saMvAhana-=-Calena-aFgam aFgam AliFgya |
   puṣyati ca māna-carcāṃ gṛhiṇī saphalayait cotkalikām ||GAss_648||	puzyati ca mAna-carcAm gRhiNI sa-PalayEt ca-utkalikAm ||GAsH-_648||
   sā sarvathaiva raktā rāgaṃ guñjeva na tu mukhe vahati |	sA sarvaTA-eva raktA rAgam guQjA-iva na tu muKe vahati |
   vacana-paṭos tava rāgaḥ kevalam āsye śukasyeva ||GAss_649||	vacana--pawoH tava rAgaH kevalam Asye Sukasya-iva ||GAsH-_649||
   sāyaṃ kānta-bhujāntara-patitā rati-nīta-sakala-rajanīkā |	sAyam kAnta--BujAntara--patitA rati--nIta--sakala--rajanIkA |
   uṣasi dadatī pradīpaṃ sakhībhir upahasyate bālā ||GAss_650||	uzasi dadatI pradIpam saKIBiH upahasyate bAlAH ||GAsH-_650||
   sā tīkṣṇa-māna-dahanā mahataḥ snehasya durlabhaḥ pākaḥ |	sA tIkzNa--mAna--dahanAH mahataH snehasya durlaBaH pAkaH |
   tvāṃ darvīm iva dūti prayāsayann asmi viśvastaḥ ||GAss_651||	tvAm darvIm iva dUti prayAsayan asmi viSvastaH ||GAsH-_651||
   sneha-kṣatir jigīṣā samaraḥ prāṇa-vyayāvadhiḥ kariṇām |	sneha--kzatiH jigIzA samaraH prANa--vyaya-avaDiH kariNAm |
   na vitanute kam anarthaṃ dantini tava yauvanodbhaṭaḥ ||GAss_652||	na vitanute kam anarTam dantini tava yOvana-udBawaH ||GAsH-_652||
   sadanād apaiti dayito hasati sakhī viśati gharaṇim iva bālā |	sadanAt apEti dayitaH hasati saKI viSati GaraNim iva bAlA |
   jvalati sapatnī kīre jalpati mugdhe prasīdati ||GAss_653||	jvalati sapatnI kIre jalpati mugDe prasIdati ||GAsH-_653||
   saṅkucitāṅgīṃ dviguṇāṃśukāṃ mano-mātra-visphuran-madanām |	saFkucita-aFgIm dviguNa-aMSukAm mano--mAtra--visPuran--madanAm |
   dayitāṃ bhajāmi mugdhām iva tuhina tava prasādena ||GAss_654||	dayitAm BajAmi mugDAm iva tuhina tava prasAdena ||GAsH-_654||
   sakhi lagnaiva vasantī sadāśaye mahati rasa-maye tasya |	saKi lagnA-eva vasantI sadASaye mahati rasa--maye tasya |
   bāḍava-śikheva sindhor na manāg apy ārdratāṃ bhajasi ||GAss_655||	bAxa-va--SiKA-iva sinDoH na manAk api Ardra-tAm Bajasi ||GAsH-_655||
   sakhi mihirodgamanādi-pramodam apidhāya so 'yam avasāne |	saKi mihira-udgamana-Adi-pramodam apiDAya saH ayam avasAne |
   bandhyo 'vadhi-vāsara iva tuṣāra-divasaḥ kadarthayati ||GAss_656||	banDyaH avaDi-vAsaraH iva tuzAra--divasaH kadarTayati ||GAsH-_656||
   sura-bhavane taruṇābhyāṃ parasparākṛṣṭa-dṛṣṭi-hṛdayābhyām |	sura--Bavane taruNAByAm paraspara-AkRzwa-dRzwi--hRdayAByAm |
   devārcanārtham udyatam anyonyasyārpitaṃ kusumam ||GAss_657||	deva-arcana-arTam udyatam anyonyasya-arpitam kusumam ||GAsH-_657||
   sāyaṃ kuśeśayāntar-madhupānāṃ niryatāṃ nādaḥ |	sAyam kuSeSaya-antar--maDupAnAm niryatAm nAdaH |
   mitra-vyasana-viṣaṇṇaiḥ kamalair ākranda iva muktaḥ ||GAss_658||	mitra--vyasana--vizaNNEH kamalEH AkrandaH iva muktaH ||GAsH-_658||
   sumahati manyu-nimitte mayaiva vihite'pi vepamānoruḥ |	su-mahati manyu--nimitte mayA-eva vihite-api vepamAna-UruH |
   na sakhīnām api rudatī mamaiva vakṣaḥ-sthale patitā ||GAss_659||	na saKInAm api rudatI mama-eva vakzaH-sTale patitAH ||GAsH-_659||
   subhaga vyajana-vicālana-śithila-bhujābhūd iyaṃ vayasyāpi |	suBaga vyajana--vicAlana--SiTila--BujA-aBUt iyam vayasya-api |
   udvartanaṃ na sakhyāḥ samāpyate kiñcid apagaccha ||GAss_660||	udvartanam na saKyAH samApyate kiQcid apagacCa ||GAsH-_660||
   sa-vrīḍā nakha-radanārpaṇeṣu kupitā pragāḍham aciroḍhā |	sa--vrIxA naKa-radana-arpaNezu kupitA pragAXam acira-UXA |
   bahu-yācñā-caraṇa-graha-sādhyā roṣeṇa jāteyam ||GAss_661||	bahu-yAcQA--caraNa-graha--sADyAH rozeNa jAtA-iyam ||GAsH-_661||
   sugṛhīta-malina-pakṣā laghavaḥ para-bhedinaḥ paraṃ tīkṣṇāḥ |	su-gRhIta-malina--pakzAH laGavaH para-BedinaH param tIkzNAH |
   puruṣā api viśikhā api guṇa-cyutāḥ kasya na bhayāya ||GAss_662||	puruzAH api viSiKAH api guNa-cyutAH kasya na BayAya ||GAsH-_662||
   sva-kapolena prakaṭīkṛtaṃ pramattatva-kāraṇaṃ kim api |	sva--kapolena prakawIkRtam pramatta-tva--kAraNam kim api |
   dviradasya durjanasya ca madaṃ cakāraiva dānam api ||GAss_663||	dviradasya durjanasya ca madam cakAra-eva dAnam api ||GAsH-_663||
   satyaṃ patir avidagdhaḥ sā tu sva-dhiyaiva nidhuvane nipuṇā |	satyam patiH avidagDaH sA tu sva-DiyA-eva niDuvane nipuNA |
   mārttikam ādhāya guruṃ dhanur adhigatam ekalavyena ||GAss_664||	mArttikam ADAya gurum DanuH aDigatam ekalavyena ||GAsH-_664||
   saubhāgya-mānavān sa tvayāvadhīryāpamānam ānītaḥ |	sOBAgya--mAnavAn sa tvayA-avaDIrya-apamAnam AnItaH |
   svaṃ viraha-pāṇḍimānaṃ bhasma-snānopamaṃ tanute ||GAss_665||	svam viraha--pANximAnam Basma--snAna-upamam tanute ||GAsH-_665||
   sakhi mama karañja-tailaṃ bahu-sandeśaṃ praheṣyasīty uditā |	saKi mama karaQja--tElam bahu-sandeSam prahezyasi-iti uditA |
   śvaśura-gṛha-gamana-militaṃ bāṣpa-jalaṃ saṃvṛṇoty asatī ||GAss_666||	SvaSura--gRha--gamana--militam bAzpa--jalam saMvRNoti asatI ||GAsH-_666||
   sandarśayanti sundari kulaṭānāṃ tamasi vitatam avikalpe |	sandarSayanti sundari kulawAnAm tamasi vitatam avikalpe |
   maulimaṇidīpa-kalikā varti-nibhā bhogino 'dhvānam ||GAss_667||	mOli-maNi-dIpa-kalikA varti-niBAH BoginaH aDvAnam ||GAsH-_667||
   sarvaṃ vanaṃ tṛṇālyā pihitaṃ pītāḥ sitāṃśu-ravi-tārāḥ |	sarvam vanam tRNAlyA pihitam pItAH sita-aMSu--ravi-tArAH |
   pradhvaṃsāḥ panthāno malinenodgamya meghena ||GAss_668||	praDvaMsAH panTAnaH malinena-udgamya meGena ||GAsH-_668||
   samyag aniṣpannaḥ san yo 'rthas tvarayā svayaṃ sphuṭīkriyate |	samyak anizpannaH san yaH arTaH tvarayA svayam sPuwIkriyate |
   sa vyaṅga eva bhavati prathamo vinatā-tanūja iva ||GAss_669||	sa vyaFgaH eva Bavati praTamaH vinatA--tanUjaH iva ||GAsH-_669||
   sajjana eva hi vidyā śobhanāyai bhavati durjane moghā |	sat-janaH eva hi vidyA SoBanAyE Bavati durjane moGAH |
   na vidūra-darśanatayā kaiścid upādīyate gṛdhraḥ ||GAss_670||	na vidUra-darSana-tayA kEScid upAdIyate gRDraH ||GAsH-_670||
   subhagaṃ vadati janas taṃ nija-patir iti naiṣa rocate mahyam |	suBagam vadati janaH tam nija-patiH iti na-eza rocate mahyam |
   pīyūṣe'pi hi bheṣaja-bhāvopanate bhavaty aruciḥ ||GAss_671||	pIyUze-api hi Bezaja--BAva-upanate Bavati aruciH ||GAsH-_671||
   saudha-gavākṣa-gatāpi hi dṛṣṭis taṃ sthiti-kṛta-prayatnam api |	sODa--gavAkza--gatA-api hi dRzwiH tam sTiti-kRta--prayatnam api |
   hima-giri-śikhara-skhalitā gaṅgevairāvataṃ harati ||GAss_672||	hima-giri--SiKara--sKalitAH gaFgA-iva-ErAvatam harati ||GAsH-_672||
   saha-gharma-cāriṇī mama paricchadaḥ sutanu neha sandehaḥ |	saha-Garma--cAriNI mama paricCadaH su-tanu na-iha sandehaH |
   na tu sukhayati tuhina-dina-cchatra-cchāyeva sajjantī ||GAss_673||	na tu suKayati tuhina-dina-=-Catra-=-CAyA-iva sajjantI ||GAsH-_673||
   sakala-guṇaika-niketana dānava-vāsena gharaṇiruharājaḥ |	sakala--guNa-eka-niketana dAnava--vAsena GaraNiruha-rAjaH |
   jāto 'si bhūtale tvaṃ satām anādeya-phala-kusumaḥ ||GAss_674||	jAtaH asi BU-tale tvam satAm anAdeya-Pala-kusumaH ||GAsH-_674||
   sundari tāṭaṅkamayaṃ cakram ivodvahati tāvake karṇe |	sundari tAwaFka-mayam cakram iva-udvahati tAvake karNe |
   nipatati nikāma-tīkṣṇaṃ kaṭākṣa-bāṇo 'rjuna-praṇayī ||GAss_675||	nipatati nikAma-tIkzNam kawAkza-bANaH arjuna--praNayI ||GAsH-_675||
   svādhīnaiva phala-rddhir janopajīvyatvam ucchraya-cchāyā |	svADInA-eva Pala--RdDiH jana-upajIvya-tvam ucCraya-=-CAyA |
   sat-puṃso maru-bhūruha iva jīvana-mātram āśāsyam ||GAss_676||	sat-puMsaH maru-BUruhaH iva jIvana--mAtram ASAsyam ||GAsH-_676||
   santāpa-moha-kampān sampādayituṃ nihantum api jantūn |	santApa--moha--kampAn sampAdayitum nihantum api jantUn |
   sakhi durjanasya bhūtiḥ prasarati dūraṃ jvarasyeva ||GAss_677||	saKi durjanasya BUtiH prasarati dUram jvarasya-iva ||GAsH-_677||
   sukhayitatarāṃ na rakṣati paricaya-leśaṃ gaṇāṅganeva śrīḥ |	suKayitatarAm na rakzati paricaya-leSam gaNa-aFganA-iva SrIH |
   kuka-kāminīva nojjhati vāg-devī janma-janmāpi ||GAss_678||	kuka-kAminI-iva na-ujJati vAc--devI janma--janma-api ||GAsH-_678||
   sva-sadana-nikaṭe nalinīm abhinava-jāta-cchadāṃ nirīkṣyaiva |	sva--sadana--nikawe nalinIm aBinava--jAta--cCadAm nirIkzya-eva |
   hā gṛhiṇīti pralapaṃś cirāgataḥ sakhi patiḥ patitaḥ ||GAss_679||	hA gRhiNI-iti pralapan cira-AgataH saKi patiH patitaH ||GAsH-_679||
   saci caturānana-bhāvād vaimukhyaṃ kvāpi naiva darśayati |	saci caturAnana--BAvAt vEmuKyam kvApi na-eva darSayati |
   ayam eka-hṛdaya eva druhiṇa iva priyatamas tad api ||GAss_680||	ayam eka-hRdayaH eva druhiNaH iva priyatamaH tat api ||GAsH-_680||
   satyaṃ madhuro niyataṃ vakro nūnaṃ kalādharo dayitaḥ |	satyam maDuraH niyatam vakraH nUnam kalA-DaraH dayitaH |
   sa tu veda na dvitīyām akalaṅkaḥ pratipad-indur iva ||GAss_681||	sa tu veda na dvitIyAm akalaFkaH pratipad--induH iva ||GAsH-_681||
   sva-sthānād api vicalati majjati jaladhau ca nīcam api bhajate |	sva--sTAnAt api vicalati majjati jalaDO ca nIcam api Bajate |
   nija-pakṣa-rakṣaṇa-manāḥ sujano maināka-śaila iva ||GAss_682||	nija--pakza--rakzaNa-manAH su-janaH mEnAka-SElaH iva ||GAsH-_682||
   saṃvṛṇu bāṣpa-jalaṃ sakhi dṛśam uparajyāñjanena valayainām |	saMvRNu bAzpa--jalam saKi dRSam uparajya-aQjanena valaya-enAm |
   dayitaḥ paśyatu pallava-paṅkajayor yugapad eva rucam ||GAss_683||	dayitaH paSyatu pallava--paFkajayoH yugapad eva rucam ||GAsH-_683||
   sā pāṇḍu-durbalāṅgī nayasi tvaṃ yatra yāti tatraiva |	sA pANxu-durbala-aFgI nayasi tvam yatra yAti tatra-eva |
   kaṭhinīva kaitava-vido hasta-graha-mātra-sādhyā te ||GAss_684||	kaWinI-iva kEtava--vidaH hasta--graha--mAtra--sADyA te ||GAsH-_684||
   sakhi viśva-gañjanīyā lakṣmīr iva kamala-mukhi kadaryasya |	saKi viSva-gaQjanIyA lakzmIH iva kamala--muKi kadaryasya |
   tvaṃ pravayaso 'sya rakṣā-vīkṣaṇa-mātropayogyāsi ||GAss_685||	tvam pravayasaH asya rakzA--vIkzaNa--mAtrA-upayogyA-asi ||GAsH-_685||
   iti vibhāvyākhyā-sametā sa-kāra-vrajyā |	iti viBAvi-a-AKyA--sametA sa--kAra-vrajyA |
   ha-kāra-vrajyā	ha-kAra--vrajyA
   hṛdayajñayā gavākṣe visadṛkṣaṃ kim api kūjitaṃ sakhyā |	hRdaya-jQayA gavAkze visadRkzam kim api kUjitam saKyA |
   yat kalaha-bhinna-talpā bhaya-kapaṭād eti māṃ sutanu ||GAss_686||	yat kalaha--Binna-talpAH Baya-kapawAt eti mAm su-tanu ||GAsH-_686||
   harati hṛdayaṃ śalākā-nihito 'ñjana-tantur eṣa sakhi mugdhe |	harati hRdayam SalAkA--nihitaH aQjana-tantuH eza saKi mugDe |
   locana-bāṇa-mucāntar-bhrūdhanuṣā kiṇa ivollikhitaḥ ||GAss_687||	loca-na--bANa-mucA-antar--BrU-DanuzA kiNaH iva-ulliKitaH ||GAsH-_687||
   hasasi caraṇa-prahāre talpād apasārito bhuvi svapiṣi |	hasasi caraNa--prahAre talpAt apasAritaH Buvi svapizi |
   nāsadṛśe'pi kṛte priya mama hṛdayāt tvaṃ viniḥsarasi ||GAss_688||	na-asadRSe-api kRte priya mama hRdayAt tvam viniHsarasi ||GAsH-_688||
   hasati sapatnī śvaśrū roditi vadanaṃ ca pidadhate sakhyaḥ |	hasati sapatnI SvaSruH roditi vadanam ca pidaDate saKyaH |
   svapnāyitena tasyāṃ subhaga tvan-nāma jalpantyām ||GAss_689||	svapnAyitena tasyAm suBaga tvan-nAma jalpantyAm ||GAsH-_689||
   hṛdayaṃ mama pratikṣaṇa-vihitāvṛttiḥ sakhe priyāśokaḥ |	hRdayam mama pratikzaNa--vihita-AvRttiH saKe priya-aSokaH |
   prabalo vidārayiṣyati jala-kalaśaṃ nīra-lekheva ||GAss_690||	prabalaH vidArayizyati jala-kalaSam nIra--leKA-iva ||GAsH-_690||
   hanta virahaḥ samantāj jvalayati durvāra-tīvra-saṃvegaḥ |	hanta virahaH samantAt jvalayati durvAra-tIvra--saMvegaH |
   aruṇas tapana-śilām iva punar na māṃ bhasmatāṃ nayati ||GAss_691||	aruNaH tapana-SilAm iva punar na mAm Basma-tAm nayati ||GAsH-_691||
   hṛtvā taṭini taraṅgair bhramitaś cakreṣu nāśaye nihitaḥ |	hRtvA tawini taraFgEH BramitaH cakrezu na-ASaye nihitaH |
   phala-dala-valkala-rahitas tvayāntarikṣe tarus tyaktaḥ ||GAss_692||	Pala--dala-valkala--rahitaH tvayA-antarikze taruH tyaktaH ||GAsH-_692||
   hṛta-kāñci-valli-bandhottara-jaghanād apara-bhoga-bhuktāyāḥ |	hRta--kAQci-valli-banDa-uttara--jaGanAt apara--Boga-BuktAyAH |
   ullasati roma-rājiḥ stana-śambhor garala-lekheva ||GAss_693||	ullasati roma-rAjiH stana--SamBoH garala-leKA-iva ||GAsH-_693||
   iti vibhāvyākhyā-sametā ha-kāra-vrajyā |	iti viBAvi-a-AKyA--sametAH ha-kAra--vrajyA |
   kṣa-kāra-vrajyā	kza-kAra-vrajyA
   kṣīrasya tu dayitatvaṃ yato 'pi śāntopacāram āsādya |	kzIrasya tu dayita-tvam yatas api SAnta-upacAram AsAdya |
   śailo 'ṅgāny ānamayati premṇaḥ śeṣo jvarasyeva ||GAss_694||	SElaH aFgAni Anamayati premNaH SezaH jvarasya-iva ||GAsH-_694||
   kṣāntam apasārito yac caraṇāv upadhāya supta evāsi |	kzAntam apasAritaH yat caraNO upaDAya suptaH eva-asi |
   udghāṭayasi kim ūru niḥśvāsaiḥ pulakayann uṣṇaiḥ ||GAss_695||	udGAwayasi kim Uru niHSvAsEH pulakayan uzNEH ||GAsH-_695||
   kṣudrodbhavasya kaṭutāṃ prakaṭayato yac chataś ca madam uccaiḥ |	kzudra-udBavasya kawu-tAm prakawayataH yat SataH ca madam uccEs |
   madhuno laghu-puruṣasya ca garimā laghimā ca bhedāya ||GAss_696||	maDunaH laGu-puruzasya ca garimA laGimA ca BedAya ||GAsH-_696||
   pūrvair vibhinna-vṛttāṃ guṇāḍhya-bhava-bhūti-bāṇa-raghukāraiḥ |	pUrvEH viBinna--vRttAm guNa-AXya--Bava--BUti-bANa--raGukArEH |
   vāg-devīṃ bhajato mama santaḥ paśyantu ko doṣaḥ ||GAss_697||	vAc--devIm BajataH mama santaH paSyantu kaH dozaH ||GAsH-_697||
   sat-pātropanayocita-sat-pratibimbābhinava-vastu |	sat-pAtra-upanaya-ucita--sat--pratibimba-aBinava-vastu |
   kasya na janayati harṣaṃ sat-kāvyaṃ madhura-vacanaṃ ca ||GAss_698||	kasya na janayati harzam sat-kAvyam maDura-vacanam ca ||GAsH-_698||
   ekā dhvain-dvitīyā tirbhuvana-sārā sphuṭokti-cāturyā |	ekA DvEn-dvitIyA tiH-Buvana--sArA sPuwa-ukti-cAturyAH |
   pañceṣu-ṣaṭpada-hitā bhūṣā śravaṇasya sapta-śatī ||GAss_699||	paQca-izu--zawpada-hitA BUzA SravaNasya sapta-SatI ||GAsH-_699||
   kavi-samara-siṃha-nādaḥ svarānuvādaḥ sudhaika-saṃvādaḥ |	kavi-samara--siMha-nAdaH svara-anuvAdaH suDA-eka--saMvAdaH |
   vidvad-vinoda-kandaḥ sandarbho 'yaṃ mayā sṛṣṭaḥ ||GAss_700|||	vidva-d-vinoda--kandaH sandarBaH ayam mayA sRzwaH ||GAsH-_700|||
   udayana-balabhadrābhyāṃ saptaśatī śiṣya-sodarābhyāṃ me |	udayana-balaBadrAByAm saptaSatI Sizya--sodarAByAm me |
   dyaur iva ravi-candrābhyāṃ prakāśitā nirmalīkṛtya ||GAss_701||	dyOH iva ravi-candrAByAm prakASitAH nirmalIkRtya ||GAsH-_701||
   hari-caraṇāñjalim alaṃ kavi-vara-harṣāya buddhimān satatam |	hari-caraNa-aQjalim alam kavi--vara--harzAya budDimAn satatam |
   kṛtāryā-sapta-śatīm etāṃ govardhanācāryaḥ ||GAss_702||	kRta-AryA-sapta-SatIm etAm govarDana-AcAryaH ||GAsH-_702||
   iti govardhanācārya-viracitā āryā-saptaśatī samāptā	iti govarDana-AcArya--viracitA AryA-saptaSatI samAptA
