   nāgānandam	nAga-Anandam
   prathamo 'ṅkaḥ	praTamaH aFkaH
   nāndī	nAndI
   dhyānavyājamupetya cintayasi kāmunmīlya cakṣuḥ kṣaṇaṃ	DyAna-vyAjam-upetya cintayasi kAm-unmIlya cakzuH kzaNam
   padhyānaṅgaśarāturaṃ janamimaṃ trātā 'pi no rakṣasi /	paDya-anaFga-Sara-Aturam janam-imam trAtA api naH rakzasi /
   mithyākāruṇiko 'si nirghṛṇātarastvattaḥ kuto 'nyaḥ pumān	miTyAkAruNikaH asi nirGRNAtaraH-tvattaH kutas anyaH pumAn
   serṣyaṃ māravadhūbhirityabhihito bodhau jinaḥ pātu vaḥ // Nā_1.1 //	sa-Irzyam mAra-vaDUBiH-iti-aBihitaH boDO jinaH pAtu vaH // NA_1.1 //
   api ca-	api ca-
   kāmenākṛṣya cāpaṃ hatapaṭuhāvalgibhirmāravīrair	kAmena-AkRzya cApam hata-pawu-hA-valgiBiH-mAra-vIrEH-
   bhrabhaṅgotkalpajṛmbhāsmitacalitaddṛśā divyanārījanena /	BraBaFga-utkalpa-jRmBA-asmita-cali-tad-dRSA divya-nArI-janena /
   siddhaiḥ prahvottamāṅgaiḥ pulakitavapuṣā vismayād vāsavena	sidDEH prahva-uttamAFgEH pulakita-vapuzA vismayAt vAsavena
   dhyāyan bodheravāptāvacalita iti vaḥ pātu dṛṣṭo munīndraḥ // Nā_1.2 //	DyAyan boDeH-avAptO=-acalitaH iti vaH pAtu dRzwaH muni-indraH // NA_1.2 //
   śrīharṣo nipuṇaḥ kaviḥ pariṣadapyeṣā guṇāgrāhiṇī	SrI-harzaH nipuNaH kaviH parizad-api-ezA guNa-agrAhiNI
   loke hāri ca bodhisattvacaritaṃ nāṭye ca dakṣā vayam /	loke hAri ca boDisattva-caritam nAwye ca dakzAH vayam /
   vastvekaikamapīha vāñchitaphalaprāpteḥ padaṃ kiṃ puna-	vastu-ekEkam-api-iha vAQCita-Pala-prApteH padam kim punar-
   rmadūbhāgyopacayādayaṃ samuditaḥ sarvo guṇānāṃ gaṇaḥ // Nā_1.3 //	rma-dU-BAgya-upacayAt-ayam samuditaH sarvaH guNAnAm gaNaH // NA_1.3 //
   dvijaparijanabandhuhite madbhavanataṭākahaṃsi mṛduśīle /	dvija-parijana-banDu-hite mad-Bavana-tawAkahaMsi mRdu-SIle /
   parapuruṣacandrakamalinyārye kāryāditastāvat // Nā_1.4 //	para-puruza-candra-kamalinI-Arye kAryAt-itaH-tAvat // NA_1.4 //
   pitrorvidhātuṃ śuśrūṣāṃ tyaktvaiśvarya kramāgatam /	pitroH-viDAtum SuSrUzAm tyaktvA-ESvarya krama-Agatam /
   vanaṃ yāmyahamadyaiva yathā jīmūtavāhanaḥ // Nā_1.5 //	vanam yAmi-aham-adya-eva yaTA jImUtavAhanaH // NA_1.5 //
   rāgasyāspadamityavaimi na hi me dhvaṃsīti na pratyayaḥ	rAgasya-Aspadam-iti-avEmi na hi me DvaMsi-iti na pratyayaH
   kṛtyākṛtyavicāraṇāsu vimukhaṃ ko vā na vetti kṣitau /	kRtyA-kRtya-vicAraNAsu vimuKam kaH vA na vetti kzitO /
   evaṃ nindyamapīdamindriyavaśaṃ prītyai bhaved yauvanaṃ	evam nindyam-api-idam-indriya-vaSam prItyE Bavet yOvanam
   bhaktyā yāti yadītthameva pitarau śuśrūṣamāṇasya me // Nā_1.6 //	BaktyA yAti yadi-itTam-eva pitarO SuSrUzamANasya me // NA_1.6 //
   tiṣṭhan bhāti pituḥ puro bhuvi yathā siṃhāsane kiṃ tathā?	tizWan BAti pituH puras Buvi yaTA siMhAsane kim taTA?
   yat saṃvāhayataḥ sukhaṃ tu caraṇau tātasya kiṃ rājake?	yat saMvAhayataH suKam tu caraNO tAtasya kim rAjake?
   kiṃ bhukte bhuvanatraye dhṛtirasau bhuktojjhite yā guroḥ?	kim Bukte Buvanatraye DRtiH-asO Bukta-ujJite yA guroH?
   āyāsaḥ khalu rājyamujjhitagurustatrāsti kaścid guṇaḥ? // Nā_1.7 //	AyAsaH Kalu rAjyam-ujJita-guruH-tatra-asti kaScid guNaH? // NA_1.7 //
   nyāyye vartmani yojitāḥ prakṛtayaḥ santaḥ sukhaṃ sthāpitā	nyAyye vartmani yojitAH prakRtayaH santaH suKam sTApitA
   nīto bandhujanastathātmasamatāṃ rājye ca rakṣā kṛtā /	nItaH banDu-janaH-taTA-Atma-samatAm rAjye ca rakzA kRtA /
   datto dattamanorathādhikaphalaḥ kalpadrumo 'pyarthine	dattaH datta-manoraTa-aDika-PalaH kalpadrumaH api-arTine
   kiṃ karttavyamataḥ paraṃ kathaya vā yatte sthitaṃ cetasi // Nā_1.8 //	kim karttavyam-atas param kaTaya vA yat-te sTitam cetasi // NA_1.8 //
   mādyaddiggajagaṇḍabhittikaṣaṇairbhanasravaccandanaḥ	mAdyat-diggaja-gaNxa-Bittika-zaNEH-Banasravat-candanaH
   krandatkandaragahvaro jalanidherāsphālito vīcibhiḥ /	krandat-kandara-gahvaraH jalaniDeH-AsPAlitaH vIciBiH /
   pādālaktakaraktamauktikaśilaḥ siddhāṅganānāṃ gataiḥ	pAda-alaktaka-rakta-mOktika-SilaH sidDa-aFganAnAm gatEH
   sevyo 'yaṃ malayācalaḥ kimapi me cetaḥ karotyutsukam // Nā_1.9 //	sevyaH ayam malaya-acalaH kim-api me cetaH karoti-utsukam // NA_1.9 //
   dakṣiṇaṃ spandate cakṣuḥ phalākāṅkṣā na me kvacit /	dakziNam spandate cakzuH Pala-AkAFkzA na me kvacid /
   na ca mithyā munivacaḥ kathayiṣyati kiṃ nvidam // Nā_1.10 //	na ca miTyA muni-vacaH kaTayizyati kim nu-idam // NA_1.10 //
   vāso 'rthaṃ dayayaiva nātipṛthavaḥ kṛttāstarūṇāṃ tvaco	vAsaH arTam dayayA-eva na-ati-pRTavaH kRttAH-tarUNAm tvacaH-
   bhagnālakṣyajaratkamaṇḍalu nabhaḥsvacchaṃ payo nairjharam /	Bagna-Alakzya-jarat-kamaNxalu naBaH-svacCam payaH nErJaram /
   dṛśyante truṭitojjhitāśca baṭubhiormauñjyaḥ kvacinmekhalā	dRSyante truwita-ujJitAH-ca bawuBioH-mOQjyaH kvacid-meKalA
   nityākarṇanayā śukena ca padaṃ sāmnāmidaṃ paṭhayate // Nā_1.11 //	nityAkarNanayA Sukena ca padam sAmnAm-idam paWayate // NA_1.11 //
   madhuramiva vadanti svāgataṃ bhṛṅgaśabdai-	maDuram-iva vadanti svAgatam BRFga-SabdE-
   rnatimiva phalanamraiḥ kurvate 'mī śirobhiḥ /	rnatim-iva Pala-namrEH kurvate amI SiroBiH /
   mama dadata ivārghyaṃ puṣpavṛṣṭīḥ kirantaḥ	mama dadataH iva-arGyam puzpa-vRzwIH kirantaH
   kathamatithisaparyyāṃ śikṣitāḥ śākhino 'pi // Nā_1.12 //	kaTam-atiTi-saparyyAm SikzitAH SAKinaH api // NA_1.12 //
   sthānaprāptyā dadhānaṃ prakaṭitagamakāṃ mandratāravyavasthāṃ	sTAna-prAptyA daDAnam prakawita-gamakAm mandra-tAra-vyavasTAm
   nirhrādinyā vipañcyā militamaliruteneva tantrīsvareṇa /	nirhrAdinyAH vipaQcyE militam-ali-rutena-iva tantrI-svareNa /
   ete dantāntarālasthitatṛṇakavalacchedaśabdaṃ niyamya	ete danta-antarAla-sTita-tRNa-kavala=-Ceda-Sabdam niyamya
   vyājihyāṅgāḥ kuraṅgāḥ sphuṭalalitapadaṃ gītamākarṇayanti // Nā_1.13 //	vyAjihya-aFgAH kuraFgAH sPuwa-lalita-padam gItam-AkarNayanti // NA_1.13 //
   ulphullakalamalakesaraparāgagauradyute ! mama hi gauri !	ulPulla-kalamala-kesara-parAga-gOra-dyute ! mama hi gOri !
   abhivāñchitaṃ prasidhyatu bhagavati ! yuṣmatprasādena // Nā_1.14 //	aBivAQCitam prasiDyatu Bagavati ! yuzmad-prasAdena // NA_1.14 //
   vyaktirvyañcanadhātunā daśavidhenāpyatra labdhāmunā	vyaktiH-vyaQcana-DAtunA daSaviDena-api-atra labDa-amunA
   vispaṣṭo drutamadhyalambitaparicchinnastridhāyaṃ layaḥ /	vispazwaH druta-maDya-lambita-paricCinnaH-triDAyam layaH /
   gopucchapramukhāḥ krameṇa yatayastistro 'pi sampāditā-	go-pucCa-pramuKAH krameNa yatayaH-tistraH api sampAditA-
   stattvaughānugatāśca vādyavidhayaḥ samyak trayo darśitāḥ // Nā_1.15 //	stattva-oGa-anugatAH-ca vAdya-viDayaH samyak trayaH darSitAH // NA_1.15 //
   svargastrī yadi tatkṛtārthamabhavaccakṣuḥsahastra hare-	svarga-strI yadi tad-kRtArTam-aBavat-cakzuH-sahastra hare-
   rnāgī cenna rasātalaṃ śaśabhṛtā śūnyaṃ mukhe 'syāḥ sthite /	rnAgI ced-na rasAtalam SaSaBRtA SUnyam muKe asyAH sTite /
   jātirnaḥ sakalānyajātijayinī vidyādharī cediyaṃ	jAtiH-naH sakalAni-ajAti-jayinI vidyADarI ced-iyam
   syātsiddhānvayajā yadi tribhuvane siddhā prasiddhāstataḥ // Nā_1.16 //	syAt-sidDa-anvaya-jAH yadi triBuvane sidDA prasidDAH-tatas // NA_1.16 //
   tanuriyaṃ taralāyatalocane ! śvasitakampitapīnaghanastani !	tanuH-iyam tarala-Ayata-locane ! Svasita-kampita-pIna-Ganastani !
   śramamalaṃ tapasaiva gatā punaḥ kimiti sambhramakāriṇi ! khidyate //	Srama-malam tapasA-eva gatA punar kim-iti samBrama-kAriNi ! Kidyate //
   Nā_1.17 //	NA_1.17 //
   uṣṇīṣaḥ sphuṭa eṣa mūrddhani vibhātyūrṇeyamantarbhruvo-	uzNIzaH sPuwaH eza mUrdDani viBAti-UrNeyam-antar-Bruvo-
   ścakṣustāmarasānukāri hariṇā vakṣaḥsthalaṃ sparddhate /	ScakzuH-tAmarasa-anukAri hariNA vakzaH-sTalam spardDate /
   cakrāṅkañca yathā padadvayamidaṃ manye tathā ko 'pyayaṃ	cakrAFkaQca yaTA pada-dvayam-idam manye taTA kaH api-ayam
   no vidyādharacakravarttipadavīmaprāpya viśrāmyati // Nā_1.18 //	naH vidyADara-cakravartti-padavIm-aprApya viSrAmyati // NA_1.18 //
   ekkato guruvaaṇaṃ aṇṇato daiadaṃsaṇasuhāiṃ /	ekkatas guru-vaaNam aNNataH dEadaMsaNa-suhAim /
   gamaṇāgamaṇādhirūḍhaṃ ajja bi dolaedi me hiaaṃ // Nā_1.19 //	gamaNa-AgamaNa-aDirUXam ajja bi dolaedi me hiaam // NA_1.19 //
   ekato guruvacanamanyato dayitadarśanasukhāni /	ekatas guru-vacanam-anyatas dayita-darSana-suKAni /
   gamanāgamanādhirūḍhamadyāpi dolāyate me hṛdayam // Nā_1.19 //	gamana-Agamana-aDirUXam-adya-api dolAyate me hRdayam // NA_1.19 //
   anayā jaghanābhogamantharayānayā /	anayA jaGana-ABoga-manTarayA-anayA /
   anyato 'pi vrajantyā me hṛdaye nihitaṃ padam // Nā_1.20 //	anyatas api vrajantyA me hRdaye nihitam padam // NA_1.20 //
   tāpāt tatkṣaṇaghṛṣṭacandanarasāpāṇḍū kapālau vahan	tApAt tad-kzaNa-GRzwa-candana-rasa-ApANxU kapAlO vahan
   saṃsavaktairnijakarṇatālapavanaiḥ saṃvijyamānānanaḥ /	saMsa-vaktEH-nija-karNa-tAla-pa-vanEH saMvijyamAna-AnanaH /
   sampratyeṣa viśeṣasiktahṛdayā hastojjhitaiḥ śīkarai-	samprati-eza viSeza-sikta-hRdayAH hasta-ujJitEH SIkarE-
   rgāḍhāyallakaduḥsahāmiva daśāṃ dhatte gajānāṃ patiḥ // Nā_1.21 //	rgAXAyallaka-duHsahAm-iva daSAm Datte gajAnAm patiH // NA_1.21 //
   iti prathamo 'ṅkaḥ /	iti praTamaH aFkaH /
   dvitīyo 'ṅkaḥ	dvitIyaH aFkaH
   kuṇasi ghaṇacandaṇaladāpallavasaṃsaggasīalaṃ pi imaṃ /	kuNasi GaNa-candaNa-ladA-pallava-saMsaggasIalam pi imam /
   ṇīsāsehiṃ tumaṃ evva kaalīdalamāruaṃ uṇhaṃ // Nā_2.1 //	NI-sAsehim tumam evva kaalI-dala-m-Aruam uNham // NA_2.1 //
   vyāvṛtyaiva sitāsitekṣaṇarucā tānāaśrame śākhinaḥ	vyAvRtya-eva sita-asita-IkzaNa-rucA tAnAa-Srame SAKinaH
   kurvatyā viṭapāvasaktavilasatkṛṣṇājinaudhāniva /	kurvatyAH viwapa-avasakta-vilasat-kRzNAjinODAn-iva /
   yad dṛṣṭosmi tayā munerapi purastenaiva mayyāhate	yat dRzwosmi tayA muneH-api purastena-eva mayi-Ahate
   puṣpeṣo ! bhavatā mudhaiva kimiti kṣipyanta ete śarāḥ? // Nā_2.2 //	puzpezaH ! BavatA muDA-eva kim-iti kzipyante ete SarAH? // NA_2.2 //
   nītāḥ kiṃ na niśāḥ śaśāṅkadhavalā nāghrātamindīvaraṃ?	nItAH kim na niSAH SaSAFka-DavalA na-AGrAtam-indI-varaM?
   kiṃ nonmīlitamālatīsurabhayaḥ soḍhāḥ pradoṣānilāḥ?	kim na-unmIlita-mAlatI-suraBayaH soXAH pradoza-anilAH?
   jhaṅkāraḥ kamalākare madhulihāṃ kiṃ vā mayā na śruto?	JaFkAraH kamala-Akare maDu-lihAm kim vA mayA na SrutaH-?
   nirvyājaṃ vidhureṣvadhīra iti māṃ yenābhidhatte bhavān? // Nā_2.3 //	nirvyAjam viDurezu-aDIraH iti mAm yena-aBiDatte BavAn? // NA_2.3 //
   strīhṛdayena na soḍhāḥ kṣiptāḥ kusumeṣavo 'pyanaṅgena /	strI-hRdayena na soXAH kziptAH kusumezavaH api-anaFgena /
   yenādyaiva purastava vadāmi dhīra iti sa kathamaham? // Nā_2.4 //	yena-adya-eva puras-tava vadAmi DIraH iti sa kaTam-aham? // NA_2.4 //
   candanalatāgṛhamidaṃ sacandramaṇiśilamapi priyaṃ na mama /	candana-latA-gRham-idam sa-candra-maNi-Silam-api priyam na mama /
   candrānanayā rahitaṃ candrikayā mukhamiva niśāyāḥ // Nā_2.5 //	candrAn-anayA rahitam candrikayA muKam-iva niSAyAH // NA_2.5 //
   śaśimaṇiśilā seyaṃ yasyāṃ vipāṇḍuramānanaṃ	SaSi-maNi-SilA sA-iyam yasyAm vipANxuram-Ananam
   karakisalaye kṛtvā vāme ghanaśvasitodgamā /	kara-kisalaye kRtvA vAme Gana-Svasita-udgamAH /
   cirayati mayi vyaktākūtā manāk sphuritairbhruvo-	cirayati mayi vyakta-akUtAH manAk sPuritEH-Bruvo-
   rviramitamanomanyurdṛṣṭā mayā rudatī priyā // Nā_2.6 //	rviramita-manaH-manyuH-dRzwA mayA rudatI priyA // NA_2.6 //
   niṣyandata ivānena mukhacandrodayena te /	nizyandate iva-anena muKa-candra-udayena te /
   etad vāṣpāmbunā siktaṃ candrakāntaśilātalam // Nā_2.7 //	etat vA-azpa-ambunA siktam candrakAnta-SilA-talam // NA_2.7 //
   akliṣṭabimbaśobhādharasya nayanotsavasya śaśina iva /	aklizwa-bimba-SoBADarasya nayana-utsavasya SaSinaH iva /
   dayitāmukhasya sukhayati rekhāpi prathamadṛṣṭayem // Nā_2.8 //	dayitA-muKasya suKayati reKA-api praTama-dRzwayem // NA_2.8 //
   priyā sannihitaiveyaṃ saṅkalpasthāpitā puraḥ /	priyA sannihitA-eva-iyam saFkalpa-sTApitA puras /
   dṛṣṭvā dṛṣṭvā likhāmyenāṃ yadi tat ko 'tra vismayaḥ ! // Nā_2.9 //	dRzwvA dRzwvA liKAmi-enAm yadi tat kaH atra vismayaH ! // NA_2.9 //
   yaddhidyādhararājavaṃśatilakaḥ prājñaḥ satāṃ sambhato	yat-hidyADara-rAja-vaMSa-tilakaH prAjQaH satAm samBataH-
   rūpeṇāpratimaḥ parākramadhano viddhān vinīto yuva /	rUpeNa-apratimaH parAkrama-DanaH vidDAn vinItaH yuva /
   yaccasūnapi santyajet karuṇayā sattvārthamabhyudyata-	yat-casUn-api santyajet karuNayA sattva-arTam-aByudyata-
   stenāsmai dadataḥ svasāramatulāṃ tuṣṭirviṣādaśca me // Nā_2.10 //	stena-asmE dadataH sva-sAram-atulAm tuzwiH-vizAdaH-ca me // NA_2.10 //
   na khalu na khalu mugdhe ! sāhasaṃ kāryamīdṛk	na Kalu na Kalu mugDe ! sAhasam kAryam-IdRS-
   vyapanaya karametaṃ pallavābhaṃ latāyāḥ /	vyapanaya karam-etam pallava-ABam latAyAH /
   kusumamapi vicetuṃ yo na manye samarthaḥ	kusumam-api vicetum yaH na manye samarTaH
   kalayati sa kathaṃ te pāśamudbandhanāya? // Nā_2.11 //	kalayati sa kaTam te pASam-udbanDanAya? // NA_2.11 //
   kaṇṭhe hāralatāyogye yena pāśastvayārpitaḥ /	kaNWe hAra-latA-yogye yena pASaH-tvayA-arpitaH /
   gṛhītaḥ sāparādho 'yaṃ kathaṃ te mucyate karaḥ? // Nā_2.12 //	gRhItaH sa-aparADaH ayam kaTam te mucyate karaH? // NA_2.12 //
   vṛṣṭayā piṣṭātakasya dyutimiha malaye meyutulyāṃ dadhānaḥ	vRzwayA pizwAtakasya dyutim-iha malaye meyu-tulyAm daDAnaH
   sadyaḥ sindūradūrīkṛtadivasasamārambhasandhyātapaśrīḥ /	sadyas sindUra-dUrIkRta-divasa-samAramBa-sanDi-Atapa-SrIH /
   udūgitairaṅganānāṃ calacaraṇaraṇannūpurahrādahṛdyai-	udUgitEH-aFganAnAm cala-caraNa-raNat-nUpura-hrAda-hRdyE-
   rūdvāhasnānavelāṃ kathayati bhavataḥ siddhaye siddhalokaḥ // Nā_2.13 //	rUdvAha-snAna-velAm kaTayati BavataH sidDaye sidDa-lokaH // NA_2.13 //
   anyonyadarśanakṛtaḥ samānarūpānurāgakulavayasām /	anyonya-darSana-kRtaH samAna-rUpa-anurAga-kula-vayasAm /
   keṣāñcideva manye samāgamo bhavati puṇyavatām // Nā_2.14 //	kezAQcid-eva manye samAgamaH Bavati puNyavatAm // NA_2.14 //
   iti dvitiyo 'ṅkaḥ /	iti dvi-tiyaH aFkaH /
   tṛtīyo 'ṅkaḥ	tRtIyaH aFkaH
   ṇiccaṃ jo pibai suraṃ jaṇassa piasagamaṃ ca jo kuṇai /	Niccam jaH pibE suram jaNassa piasagamam ca jaH kuNEH /
   maha de do abi devā baladeo kāmadeo a // Nā_3.1 //	maha de daH abi devAH bala-deaH kAma-deaH a // NA_3.1 //
   vacchatthalamhi daiā diṇṇuppalavāsiā muhe mairā /	vacCatTalamhi dEAH diNNuppalavAsiA muhe mErAH /
   sīsammi a seharao ṇiccaṃ via saṃṭhiā jassa // Nā_3.2 //	sIsammi a seharaaH Niccam via saMWiA jassaH // NA_3.2 //
   hariharapidāmahāṇaṃ pi gavvido jo ṇa jāṇai ṇamiduṃ /	hari-hara-pidAmahANam pi gavvidaH jaH Na jANE Nam-idum /
   so seharao calaṇesu tujja ṇomālie padai // Nā_3.3 //	saH seharaaH calaNesu tujja NaH-mAlie padE // NA_3.3 //
   dṛṣṭā dṛṣṭimadho dadāti kurute nālāpamābhāṣitā	dRzwA dRzwim-aDas dadAti kurute na-AlApam-ABAzitA
   śayyāyāṃ parivṛtya tiṣṭhati balādāliṅgitā vepate /	SayyAyAm parivRtya tizWati balAt-AliFgitAH vepate /
   niryantīṣu sakhīṣu vāsabhavanānnirgantumevehate	niryantIzu saKIzu vAsa-BavanAt-nirgantum-eva-Ihate
   jātā vāmatayaiva me 'dya sutarāṃ prityai navoḍhā priyā // Nā_3.4 //	jAtAH vAma-tayA-eva me adya sutarAm prityE na-voXA priyA // NA_3.4 //
   huṅkāraṃ dadatā mayā prativaco yanmaunamāsevitaṃ	huFkAram dadatA mayA prativacaH yat-mOnam-Asevitam
   yad dāvānaladīptibhistanuriyaṃ candrātapaistāpitā /	yat dAva-anala-dIptiBiH-tanuH-iyam candra-AtapEH-tApitA /
   dhyātaṃ yat subahūnyanamanasā naktandināni priye !	DyAtam yat su-bahUni-anamanasA naktandinAni priye !
   tasyaitat tapasaḥ phalaṃ mukhamidaṃ paśyāmi yatte 'dhunā // Nā_3.5 //	tasya-etat tapasaH Palam muKam-idam paSyAmi yat-te aDunA // NA_3.5 //
   khedāya stanabhāra eva kimu te madhyasya hāro 'paraḥ?	KedAya stana-BAraH eva kimu te maDyasya hAraH aparaH?
   śrāmyatyūruyugaṃ nitambabharataḥ kāñcyānayā kiṃ punaḥ?	SrAmyati-Uru-yugam nitamba-BarataH kAQcya-anayA kim punar-?
   śaktiḥ pādayugatya norupugalaṃ voḍhu kuto nūpurau?	SaktiH pAdayugatya na-uru-pugalam voXu kutas nUpurO?
   svāṅgaireva vimūṣitāsi vahasi kleśāya kiṃ maṇḍanam? // Nā_3.6 //	sva-aFgEH-eva vimUzitA-asi vahasi kleSAya kim maNxanam? // NA_3.6 //
   niṣyandaścandanānāṃ śiśirayati latāmaṇḍape kuṭṭimāntā-	nizyandaH-candanAnAm SiSirayati latA-maNxape kuwwima-antA-
   nārād dhārāgṛhāṇāṃ dhvanimanu tatute tāṇḍavaṃ nolakaṇṭhaḥ /	nArAt DArAgRhANAm Dvanim-anu tatute tANxavam nola-kaNWaH /
   yantronmuktaśca vegād calati viṭapināṃ pūrayannālavālā-	yantra-unmuktaH-ca vegAt calati viwapinAm pUrayat-=-Ala-vAlA-
   nāpātotpīḍahelāhṛta kusumarajaḥpiñjaro 'yaṃ jalaughaḥ // Nā_3.7 //	na-apAta-utpIxa-hela-AhRta kusuma-rajaH-piQjaraH ayam jala-oGaH // NA_3.7 //
   api ca-	api ca-
   amī gītārambhaimukharitalatāmaṇḍapabhuvaḥ	amI gIta-AramBEmu-Karita-latA-maNxapa-BuvaH
   parāgaiḥ puṣpāṇāṃ prakaṭapaṭavāsavyatikarāḥ /	parAgEH puzpANAm prakawa-pawa-vAsa-vyatikarAH /
   pibantaḥ paryyāptaṃ saha sahacarībhirmaghurasaṃ	pibantaH paryyAptam saha sahacarIBiH-maGu-H-asam
   samantādāpānotsavamanabhavantīva madhupāḥ // Nā_3.8 //	samantAt-ApAna-utsavam-anaBavanti-iva maDupAH // NA_3.8 //
   digdhāṅgā haricandanena dadhataḥ santānakānāṃ srajo	digDa-aFgAH haricandanena daDataH santAnakAnAm srajaH-
   māṇikyābharaṇaprabhāvyatikaraiścitrīkṛtācchāṃśukāḥ /	mANikya-ABaraNa-praBA-vi-atikarEH-citrIkRta-acSAMSukAH /
   sārddha siddhajanairmadhūni dayitāpītāvaśiṣṭānyamī	sArdDa sidDa-janEH-maDUni dayitA-pIta-avaSizwAni-amI
   miśrībhūya pibanti candanatarucchāyāsu vidyādharāḥ // Nā_3.9 //	miSrIBUya pibanti candana-taru=-CAyAsu vidyADarAH // NA_3.9 //
   etanmukhaṃ priyāyāḥ śaśinaṃ jitvā kapolayāḥ kāntyā /	etat-muKam priyAyAH SaSinam jitvA kapolayAH kAntyA /
   tāpānurktamadhunā kamalaṃ dhruvamīhate jetum // Nā_3.10 //	tApa-anurktam-aDunA kamalam Druvam-Ihate jetum // NA_3.10 //
   etatte bhrulatollāsi pāṭalādharapallavam /	etat-te Brula-tA-ullAsi pAwalA-aDara-pallavam /
   mukhaṃ nandanamudyānamato 'nyatkevalaṃ vanam // Nā_3.11 //	muKam nandanam-udyAnam-atas anyat-kevalam vanam // NA_3.11 //
   smitapuṣpodgamo 'yaṃ te dṛśyate 'dharapallave /	smita-puzpa-udgamaH ayam te dRSyate aDara-pallave /
   phalaṃ tvanyatra mugdhākṣi ! cakṣuṣormama paśyataḥ // Nā_3.12 //	Palam tu-anyatra mugDa-akzi ! cakzuzoH-mama paSyataH // NA_3.12 //
   dinakarakarāmṛṣṭaṃ bibhrat dyutiṃ paripāṭalāṃ	dinakara-kara-amRzwam biBrat dyutim paripAwalAm
   daśanakiraṇauḥ saṃsarpadbhiḥ sphuṭīkṛtakesaram /	daSana-kiraNOH saMsarpadBiH sPuwIkRta-kesaram /
   ayi makhamidaṃ mugdhe ! satyaṃ samaṃ kamalena te	ayi maKam-idam mugDe ! satyam samam kamalena te
   madhu madhukaraḥ kintvetasmin pibbanna vibhāvyate? // Nā_3.13 //	maDu maDukaraH kintu-etasmin pibban-na viBAvyate? // NA_3.13 //
   anihatya taṃ sapatnaṃ kathamiva jīmūtavāhanasyāham /	anihatya tam sapatnam kaTam-iva jImUtavAhanasya-aham /
   kathayiṣyāmi hṛtaṃ tava rājyaṃ rīpuṇeti nirlajjaḥ? // Nā_3.14 //	kaTayizyAmi hRtam tava rAjyam rIpuNA-iti nirlajjaH? // NA_3.14 //
   saṃsarpadbhiḥ samantāt kṛtasakalaviyanmārgayānairvimānaiḥ	saMsarpadBiH samantAt kRta-sakala-viyat-mArga-yAnEH-vimAnEH
   kurvāṇāḥ prāvṛṣīva sthagitaravirucaḥ śyāmatāṃ vāsarasya /	kurvANAH prAvRzi-iva sTagita-ravi-rucaH SyAma-tAm vAsarasya /
   ete yātāśca sadyastava vacanamitaḥ prāpya yuddhāya siddhāḥ	ete yAtAH-ca sadyas-tava vacanam-itas prApya yudDAya sidDAH
   siddhañcodvṛttaśatrukṣayabhayavinamudrājakaṃ te svarājyam // Nā_3.15 //	sidDaQca-udvRtta-Satru-kzaya-Baya-vinam-udrAjakam te sva-rAjyam // NA_3.15 //
   ekākināpi hi mayā rabhasāvakṛṣṭanistriṃśadīdhitisaṭābharabhāsureṇa /	ekAkinA-api hi mayA raBasA-avakRzwa-nistriMSa-dIDiti-sawA-BaraBAsureNa /
   ārānnipatya hariṇeva mataṅgajendramājau mataṅgahatakaṃ viddhi // Nā_3.16	ArAt-nipatya hariNA-iva mataFgaja-indram-AjO mataFga-hatakam vidDi // NA_3.16
   svaśarīramapi parārthe yaḥ khalu dadyādayācitaḥ kṛpayā /	sva-SarIram-api para-arTe yaH Kalu dadyAt-ayAcitaH kRpayA /
   rājyasya kṛte sa kathaṃ prāṇivadhakrauryamanumanute // Nā_3.17 //	rAjyasya kRte sa kaTam prANi-vaDa-krOryam-anum-anute // NA_3.17 //
   nidrāmudrāvabandhānmadhukaramaniśaṃ padmakāśādapāsya-	nidrA-mudrA-avabanDAn-maDukaram-aniSam padmakASAt-apAsya-
   nnāśāpūraikakarmapravaṇanijakaraprīṇitāśeṣaviśvaḥ /	nnASA-pUra-eka-karma-pravaNa-nija-kara-prINita-aSeza-viSvaH /
   dṛṣṭaḥ siddhaiḥ prasaktastutimukharamukhairastamapyeṣa gacchan	dRzwaH sidDEH prasakta-stuti-muKara-muKEH-astam-api-eza gacCan
   ekaḥ ślāghyo vivasvān parahitakaraṇāyaiva yasya prayāsaḥḥ // Nā_3.18 //	ekaH SlAGyaH vivasvAn para-hita-karaNAya-eva yasya prayAsaHH // NA_3.18 //
   iti tṛtīyo 'ṅka /	iti tRtIyaH aFkaH /
   caturtho 'ṅkaḥ	caturTaH aFkaH
   kañcukī-	kaQcukI-
   antaḥpurāṇāṃ vihitavyavasthaḥ pade pade 'haṃ skhalanāni rakṣan /	antaHpurANAm vihita-vyavasTaH pade pade aham sKalanAni rakzan /
   jarāturaḥ samprati daṇḍanītyā sarvāṃ nṛpasyānukaromi vṛttim // Nā_4.1 //	jarA-AturaH samprati daNxanItyA sarvAm nRpasya-anukaromi vRttim // NA_4.1 //
   śayyā śādvalamāsanaṃ śuciśilā sadma drumāṇāmadhaḥ	SayyA SAdvalam-Asanam Suci-SilA sadma drumANAm-aDas-
   śītaṃ nirjharavāri pānamaśanaṃ kandāḥ sahāyā mṛgāḥ /	SItam nirJara-vAri pAnam-aSanam kandAH sahAyAH mRgAH /
   ityaprārthitalabhyasarvavibhave doṣo 'yameko vane	iti-aprArTita-laBya-sarva-viBave dozaH ayam-ekaH vane
   duṣprāpārthini yat parārthaghaṭanāvandhyairvṛthā sthīyate // Nā_4.2 //	duzprApa-arTini yat para-arTa-GawanA-vanDyEH-vRTA sTIyate // NA_4.2 //
   unmajjajjalakuñjarendrarabhasāsphālānubandhoddhataḥ	unmajjat-jala-kuQjara-indra-raBasa-AsPAla-anubanDa-udDataH
   sarvāḥ parvatakandarodarabhuvaḥ kurvan pratidhvānitāḥ /	sarvAH parvata-kandara-udara-BuvaH kurvan pratiDvAnitAH /
   uccairuccarati dhvaniḥ śrutipathonmāthī yathāyaṃ tathā	uccEs-uccarati DvaniH Sruti-paTa-unmATI yaTA-ayam taTA
   prāyaḥ preṅkhadasaṃkhyaśaṅkhadhavalā veleyamāgachati // Nā_4.3 //	prAyas preFKada-saMKya-SaFKa-DavalA velA-iyam-AgaCati // NA_4.3 //
   kavalitalavaṅgapallakarimakarodūgārisurabhiṇā payasā /	kavalita-lavaFga-palla-karima-kara-udUgAri-suraBiNA payasA /
   eṣā samudravelā ratnadyutirañjitā bhāti // Nā_4.4 //	ezA samudra-velA ratnadyuti-raQjitAH BAti // NA_4.4 //
   jihvāsahasradvitayasya madhye naikāpi sā tasya kimasti jihvā /	jihvA-sahasra-dvitayasya maDye na-ekA-api sA tasya kim-asti jihvA /
   ekāhirakṣārthamahidviṣe 'dya datto mayātmeti yayā bravīti // Nā_4.5 //	eka-ahi-rakza-arTam-ahidvize adya dattaH mayA-AtmA-iti yayA bravIti // NA_4.5 //
   ityeṣa bhogipatinā vihitavyavastho yān bhakṣayatyahipatīn patagādhirājaḥ /	iti-eza BogipatinA vihita-vyavasTaH yAn Bakzayati-ahipatIn pataga-aDirAjaH /
   yāsyanti yānti ca gatāśca dinairbivṛddhiṃ teṣāmamī tuhinaśailaruco	yAsyanti yAnti ca gatAH-ca dinEH-bivRdDim tezAm-amI tuhina-SEla-rucaH-
   'sthikūṭāḥ // Nā_4.6 //	asTi-kUwAH // NA_4.6 //
   sarvāśucinidhānasya kṛtaghnasya vināśinaḥ /	sarva-aSuci-niDAnasya kRtaGnasya vinASinaH /
   śarīrakasyāpi kṛte mūḍhāḥ pāpāni kurvate ! // Nā_4.7 //	SarIrakasya-api kRte mUXAH pApAni kurvate ! // NA_4.7 //
   kroḍīkaroti prathamaṃ yadā jātamanityatā /	kroxIkaroti praTamam yadA jAtam-anitya-tA /
   dhātrīva jananī paścāttadā śokasya kaḥ kramaḥ? // Nā_4.8 //	DAtrI-iva jananI paScAt-tadA Sokasya kaH kramaH? // NA_4.8 //
   mūḍhāyā muhuraśrusantatimucaḥ kṛtvā pralāpān bahūn	mUXAyAH muhur-aSru-santati-mucaH kRtvA pralApAn bahUn
   kastrātā tava putraketi kṛpaṇaṃ dikṣu kṣipantyā dṛśam /	kaH-trAtA tava putraka-iti kRpaNam dikzu kzipantyAH dRSam /
   aṅke māturavasthitaṃ śiśumimaṃ tyaktvā ghṛṇāmaśnataḥ	aFke mAtuH-avasTitam SiSum-imam tyaktvA GRNAm-aSnataH
   cañcurnaiva khagādhipasya hṛdayaṃ vajreṇa manye kṛtam/9 //	caQcuH-na-eva Kaga-aDipasya hRdayam vajreNa manye kRtam/9 //
   yairatyantadayāparairna vihitā vandhyārthināṃ prārthanā	yEH-atyanta-dayA-parEH-na vihitA vanDyA-arTinAm prArTanA
   yaiḥ kāruṇyaparigrahānna gaṇitaḥ svārthaḥ parārtha prati /	yEH kAruNya-parigrahAt-na gaNitaH sva-arTaH para-arTa prati /
   ye nityaṃ paraduḥkhaduḥkhitadhiyaste sādhavo 'staṃ gatā	ye nityam para-duHKa-duHKita-DiyaH-te sADavaH astam gatA
   mātaḥ ! saṃhara bāṣpavegamadhunā kasyāgrato rudyate? // Nā_4.10 //	mAtar ! saMhara bAzpa-vega-maDunA kasya-agratas rudyate? // NA_4.10 //
   ārtta kaṇṭhagataprāṇaṃ parityaktaṃ svabandhubhiḥ /	Artta kaNWa-gata-prANam parityaktam sva-banDuBiH /
   trāye nainaṃ yadi tataḥ kaḥ śarīreṇa me guṇaḥ // Nā_4.11 //	trAye na-enam yadi tatas kaH SarIreNa me guNaH // NA_4.11 //
   asyā vilokya manye putrasnehena viklavatvamidam /	asyAH vilokya manye putra-snehena viklava-tvam-idam /
   akaruṇahṛdayaḥ karuṇāṃ kurvīta bhujaṅgaśatrurapi // Nā_4.12 //	akaruNa-hRdayaH karuNAm kurvIta BujaFga-SatruH-api // NA_4.12 //
   mahāhimastiṣkavibhedamuktaraktacchaṭācarccitacaṇḍacañcuḥ /	mahA-ahi-maH-tizka-viBeda-mukta-rakta=-CawA-carccita-caNxa-caQcuH /
   kvāsau garutmān kva ca nāma saumyasvabhāvarūpākṛtireṣa sādhuḥ? // Nā_4.13	kva-asO garutmAn kva ca nAma sOmya-svaBAva-rUpa-AkRtiH-eza sADuH? // NA_4.13
   mamaitadambārpaya vadhyacihnaṃ prāvṛtya yāvadvinatātmajāya /	mama-etat-amba-arpaya vaDya-cihnam prAvRtya yAvat-vinatA-AtmajAya /
   putrasya te jīvitarakṣaṇāya svadehamāhārayituṃ dadāmi // Nā_4.14 //	putrasya te jIvita-rakzaNAya sva-deham-AhArayitum dadAmi // NA_4.14 //
   viśvāmitraḥ śvamāṃsaṃ śvapaca iva purābhakṣayadyannimittaṃ	viSvAmitraH Sva-mAMsam SvapacaH iva purA-Bakzayat-yat-nimittam
   nādijaṅgho nijadhne kṛtatadupakṛtiryatkṛte gautamena /	na-Adi-jaFGaH nijaDne kRta-tad-upakRtiH-yat-kRte gOtamena /
   putro 'yaṃ kaśyapasya pratidinamuragānatti tārkṣyo yadarthaṃ	putraH ayam kaSyapasya pratidinam-uragAn-atti tArkzyaH yad-arTam
   prāṇāṃstāneṣa sādhustṛṇamiva kṛpayā yaḥ parārtha dadāti // Nā_4.15 //	prANAn=-tAn-eza sADuH-tRNam-iva kRpayA yaH para-arTa dadAti // NA_4.15 //
   jāyante ca mriyante ca mādṛśāḥ kṣudrajantavaḥ /	jAyante ca mriyante ca mAdRSAH kzudra-jantavaH /
   parārthebaddhakakṣāṇāṃ tvādṛśāmudbhavaḥ kutaḥ? // Nā_4.16 //	para-arTebadDa-kakzANAm tvAdRSAm-udBavaH kutas-? // NA_4.16 //
   mriyate mriyamāṇe yā tvayi jīvati jīvati /	mriyate mriyamANe yA tvayi jIvati jIvati /
   tāṃ yadīcchasi jīvantīṃ rakṣātmānaṃ mamāsubhiḥ // Nā_4.17 //	tAm yadi-icCasi jIvantIm rakzA-AtmAnam mama-asuBiH // NA_4.17 //
   cañcaccañcūddhṛtārddha cyutapiśitalavagrāsasaṃvṛddhagarddhai-	caQcat-caQcu-udDRta-ardDa cyuta-piSita-lava-grAsa-saMvRdDa-gardDE-
   rgṛddhairārabdhapakṣadvitayavidhutibhirbaddhasāndrāndhakāre /	rgRdDEH-ArabDa-pakza-dvitaya-viDutiBiH-badDa-sAndra-anDakAre /
   vaktroddhāntāḥ patantyaśchamiti śikhiśikhāśreṇayosmin śivānā-	vaktra-udDAntAH patanti-aSCam-iti SiKi-SiKA-SreNayosmin SivAnA-
   masrasrotasmajasrasru tabahalavasāvāsavisre svananti // Nā_4.18 //	masra-srotasmajasrasru tabahala-vasA-vAsa-visre svananti // NA_4.18 //
   pratidinamaśūnyamahikāhāreṇa vināyakāhitaprīti /	pratidinam-aSUnya-mahika-AhAreNa vinAyaka-ahita-prIti /
   śaśidhavalāsthikapālaṃ vapuriva raudraṃ śmaśānamidam // Nā_4.19 //	SaSi-Davala-asTi-kapAlam vapuH-iva rOdram SmaSAnam-idam // NA_4.19 //
   samutpasyāmahe mātaryasyāṃ yasyāṃ gatau vayam /	samutpasyAmahe mAtari-asyAm yasyAm gatO vayam /
   tasyāṃ tasyāṃ priyasute ! mātā bhūyāstvameva naḥ // Nā_4.20 //	tasyAm tasyAm priya-sute ! mAtA BUyAH-tvam-eva naH // NA_4.20 //
   vāsoyugamidaṃ raktaṃ prāpte āle samāgatam /	vAsaH-yugam-idam raktam prApte Ale samAgatam /
   mahatīṃ prītimādhatte parārthe dehamujjhataḥ // Nā_4.21 //	mahatIm prItim-ADatte para-arTe deham-ujJataH // NA_4.21 //
   tulyāḥ saṃvarttakābhraīḥ pidadhati gaganaṃ paṅktayaḥ pakṣatīnāṃ	tulyAH saMvarttaka-ABraIH pidaDati gaganam paFktayaH pakzatInAm
   tīre vegānilo 'mbhaḥ kṣipati bhuva iva lāvanāyāmburāśeḥ /	tIre vega-anilaH amBaH kzipati BuvaH iva lAvanAya-ambu-rASeH /
   kurvan kalpāntaśaṅkāṃ sapadi ca sabhayaṃ vīkṣito digdvipendrai-	kurvan kalpa-anta-SaFkAm sapadi ca sa-Bayam vIkzitaH diS-dvipa-indrE-
   rdehodyoto daśāśāḥ kapiśayati muhurdvādaśādityadīptiḥ // Nā_4.22 //	rdeha-udyotaH daSa-ASAH kapiSayati muhur-dvAdaSa-Aditya-dIptiH // NA_4.22 //
   na tathā sukhayati manye malayavatī malayacandanarasārdrā /	na taTA suKayati manye malayavatI malaya-candana-rasa-ArdrAH /
   abhivāñchitārthasiddhatyai vadhyaśileyaṃ yathāśliṣṭā // Nā_4.23 //	aBivAQCita-arTa-sidDatyE vaDya-SilA-iyam yaTASlizwAH // NA_4.23 //
   śayitena māturaṅke visrabdhaṃ śaiśave na tat prāptam /	Sayitena mAtuH-aFke visrabDam SESave na tat prAptam /
   labdhaṃ sukhaṃ mayāsyā vadhyaśilāyā yadutsaṅge // Nā_4.24 //	labDam suKam mayA-asyAH vaDya-SilAyAH yad-utsaFge // NA_4.24 //
   kṣiptvā bimbaṃ himaṃśorbhayakṛtavalayāṃ saṃmarañcheṣamūrtti	kziptvA bimbam himaMSoH-Baya-kRta-valayAm saMmaran-Seza-mUrtti
   sānandaṃ syandanāśvatrasanavicalite pūṣṇi dṛṣṭo 'grajena /	sa-Anandam syandana-aSva-trasana-vicalite pUzNi dRzwaH agrajena /
   eṣa prāntāvasajjajjaladharapaṭalaiarāyatībhūtapakṣaḥ	eza prAnta-avasat-jat-jalaDara-pawala-eara-AyatIBUta-pakzaH
   prāpto velāmahīdhraṃ malayamahigrāsagṛdhnuḥ kṣaṇena // Nā_4.25 //	prAptaH velAm-ahIDram malaya-mahi-grAsa-gRDnuH kzaNena // NA_4.25 //
   saṃrakṣatā pannagamadya puṇyaṃ mayārjitaṃ yatsvaśarīradānāt /	saMrakzatA pannagam-adya puNyam mayA-arjitam yat-sva-SarIra-dAnAt /
   bhave bhave tena mamaivamevaṃ bhūyāt parārthaḥ khalu dehalābhaḥ // Nā_4.26	Bave Bave tena mama-evam-evam BUyAt para-arTaH Kalu deha-lABaH // NA_4.26
   asminvadhyaśilātale nipatitaṃ śeṣānahīn rakṣituṃ	asmin-vaDya-SilA-tale nipatitam SezAn-ahIn rakzitum
   nirbhidyāśanidaṇḍacaṇḍatarayā cañcvādhunā vakṣasi /	nirBidya-aSani-daNxa-caNxatarayA caQcvA-aDunA vakzasi /
   bhoktuṃ bhoginamuddharāmi tarasā raktāmbaraprāvṛtaṃ	Boktum Boginam-udDarAmi tarasA rakta-ambara-prAvRtam
   digdhaṃ madbhayadīryyamāṇahṛdayaprasyandinevāsṛjā // Nā_4.27 //	digDam mad-Baya-dIryyamANa-hRdaya-prasyandinA-iva-asRjA // NA_4.27 //
   āmodānanditālirnipatati kimiyaṃ puspavṛṣṭirnabhastaḥ?	Ama-uda-Anandita-AliH-nipatati kim-iyam puspa-vRzwiH-naBastaH?
   svarge kiṃ vaiṣa cakraṃ mukharayati diśāṃ dundubhīnāṃ ninādaḥ?	svarge kim vA-eza cakram muKarayati diSAm dunduBInAm ninAdaH?
   āṃ jñātaṃ ! so 'pi manye mama javamarutā kampitaḥ pārijātaḥ	Am jQAtam ! saH api manye mama java-marutA kampitaH pArijAtaH
   sarvaiḥ saṃvarttakābhrairidamapi rasitaṃ jātasaṃhāraśaṅkaiḥ // Nā_4.28 //	sarvEH saMvarttaka-aBrEH-idam-api rasitam jAta-saMhAra-SaFkEH // NA_4.28 //
   nāgānāṃ rakṣitā bhāti gurureṣa yathā mama /	nAgAnAm rakzitA BAti guruH-eza yaTA mama /
   tathā sarpāśinākāṅkṣāṃ vyaktamadyāpaneṣyati // Nā_4.29 //	taTA sarpa-ASinA-kAFkzAm vyaktam-adya-apanezyati // NA_4.29 //
   iti caturtho 'ṅkaḥ /	iti caturTaH aFkaH /
   pañcamo 'ṅkaḥ	paQcamaH aFkaH
   pratīhāraḥ-	pratIhAraH-
   svagṛhodyānagate 'pi snigdhe pāpaṃ viśaṅkyate snehāt /	sva-gRha-udyAna-gate api snigDe pApam viSaFkyate snehAt /
   kimu dṛṣtavahvapāyapratibhayakāntāramadhyasthe? // Nā_5.1 //	kimu dRzta-vahu-apAya-pratiBaya-kAntAra-maDya-sTe? // NA_5.1 //
   kṣaume bhaṅgavatīi taraṅgitadaśe phenāmbutulye vahan	kzOme BaFgavatIi taraFgita-daSe Pena-ambu-tulye vahan
   jāhnavyeva virājitaḥ savayasā devyā mahāpuṇyayā /	jAhnavI-A-iva virAjitaH savayasA devyA mahA-puNyayA /
   dhatte toyanidherayaṃ susadṛśīṃ jīmūtaketuḥ śriyaṃ	Datte toya-niDeH-ayam su-sadRSIm jImUtaketuH Sriyam
   yasyaiṣāntikavarttinī malayavatyābhāti velā yathā // Nā_5.2 //	yasya-ezA-antika-varttinI malayavatI-ABAti velA yaTA // NA_5.2 //
   bhuktāni yauvanasukhāni yaśo 'vakīrṇaṃ	BuktAni yOvana-suKAni yaSaH avakIrNam
   rājye sthitaṃ sthiradhiyā caritaṃ tapo 'pi /	rAjye sTitam sTira-DiyA caritam tapaH api /
   ślādhyaḥ sutaḥ susadṛśānvayajā snuṣeyaṃ	SlADyaH sutaH su-sadRSa-anvaya-jA snuzA-iyam
   cintyo māya nanu kṛtārthatayādya mṛtyuḥ // Nā_5.3 //	cintyaH mAya nanu kRtArTa-tayA-adya mRtyuH // NA_5.3 //
   sphurasi kimu dakṣiṇetara ! muhurmuhuḥ sūcayanmamāniṣṭam /	sPurasi kimu dakziNA-itara ! muhur-muhur sUcayat-mama-anizwam /
   hatacakṣurapahataṃ te sphuritaṃ mama putrakaḥ kuśalī // Nā_5.4 //	hata-cakzuH-apahatam te sPuritam mama putrakaH kuSalI // NA_5.4 //
   ālokyakyamānamatilocanaduḥkhadāyiraktacchaṭānijamarīciruco vimuñcat /	AlokyakyamAnam-ati-locana-duHKa-dAyi-rakta=-CawA-nija-marIci-rucaH vimuQcat /
   utpātavātatalīkṛtatārakābhametatpuraḥ patati kiṃ sahasā nabhastaḥ? //	utpAta-vAta-talIkRta-tAraka-ABam-etat-puras patati kim sahasA naBastaH? //
   Nā_5.5 //	NA_5.5 //
   tārkṣyeṇa bhakṣyamāṇānāṃ pannagānāmanekaśaḥ /	tArkzyeNa BakzyamANAnAm pannagAnAm-anekaSas /
   ulkārūpāḥ patantyete śiromaṇaya īdṛśāḥ // Nā_5.6 //	ulkA-rUpAH patanti-ete SiromaNayaH IdRSAH // NA_5.6 //
   gokarṇamarṇavataṭe tvaritaṃ praṇamya prāpto 'smi tāṃ khalu	gokarNam-arNava-tawe tvaritam praNamya prAptaH asmi tAm Kalu
   bhujaṅgamavadhyabhūmim /	BujaFgam-avaDya-BUmim /
   āḍhāya taṃ nakhamukhakṣatasañca vidyādharaṃ gaganamutpatito garutmān ! //	AXAya tam naKa-muKa-kzata-saQca vidyADaram gaganam-utpatitaH garutmAn ! //
   Nā_5.7 //	NA_5.7 //
   nāhitrāṇatkīrtirekā mayāptā nāpi ślāghyā svāmino 'nuṣṭhitājñā /	na-ahi-trANat-kIrtiH-ekA mayA-AptA na-api SlAGyA svAminaH anuzWita-AjQA /
   dattvātmānaṃ rakṣito 'nyena śocyo hā dhik ! kaṣṭaṃ ! vañcito vañcito 'smi	dattvA-AtmAnam rakzitaH anyena SocyaH hA Dik ! kazwam ! vaQcitaH vaQcitaH asmi
   // Nā_5.8 //	// NA_5.8 //
   ādāvutpīḍapṛthvīṃ praviralapatitāṃ sthūlabinduṃ tato 'gre	AdO=-utpIxa-pRTvIm pravirala-patitAm sTUlabindum tatas agre
   grāvasvāpātaśīrṇaprasṛtatanukaṇāṃ kīṭakīrṇā sthalīṣu /	grAvasu-ApAta-SIrNa-prasRta-tanu-kaNAm kIwa-kIrNA sTalIzu /
   durlakṣyāṃ dhātubhittau ghatanaruśikhare styānanīlasvarūpā-	durlakzyAm DAtu-BittO Gata-naru-SiKare styAna-nIla-svarUpA-
   menāṃ tākṣya didṛkṣurnipuṇamanusaran raktadhārāṃ vrajāmi // Nā_5.9 //	menAm tAkzya didRkzuH-nipuNam-anusaran rakta-DArAm vrajAmi // NA_5.9 //
   āvedaya mamātmīyaṃ putra ! dukhaṃ suduḥsaham	Avedaya mama-AtmIyam putra ! duKam su-duHsaham
   mayi saṅkrāntametatte yena sahyaṃ bhaviṣyati // Nā_5.10 //	mayi saFkrAntam-etat-te yena sahyam Bavizyati // NA_5.10 //
   vidyādhareṇa kenāpi karuṇāviṣṭacetasā /	vidyADareNa kena-api karuNA-Avizwa-cetasA /
   mama saṃrakṣitāḥ prāṇā dattvātmānaṃ garutmatte // Nā_5.11 //	mama saMrakzitAH prANAH dattvA-AtmAnam garutmatte // NA_5.11 //
   cūḍāmaṇiṃ caraṇayormama pātayatā tvayā /	cUxAmaNim caraNayoH-mama pAtayatA tvayA /
   lokāntaragatenāpi nojjhito vinayakramaḥ ! // Nā_5.12 //	loka-antara-gatena-api na-ujJitaH vinaya-kramaH ! // NA_5.12 //
   bhaktyā sudūramavanāmitanamramauleḥ śaśvattava praṇamataścaraṇau madīyau /	BaktyA su-dUram-avanAmita-namra-mOleH SaSvat-tava praNamataH-caraNO madIyO /
   cūḍāmaṇirnikaṣaṇaurmasṛṇo 'pyahiṃstraḥ gāḍhaṃ vidārayati me hṛdayaṃ kathaṃ	cUxAmaNiH-nikazaNOH-masRNaH api-ahiMstraH gAXam vidArayati me hRdayam kaTam
   nu? // Nā_5.13 //	nu? // NA_5.13 //
   kurvāṇo rudhirārdracañcukaṣaṇairdroṇīrivādrestaṭīḥ	kurvANaH ruDira-Ardra-caQcu-kazaNEH-droNIH-iva-adreH-tawIH
   pluṣṭopāntavatāntaraḥ svanayanajyotiḥśikhāśreṇibhiḥ /	pluzwa-upAntavata-antaraH sva-nayana-jyotiH-SiKA-SreNiBiH /
   sajjadvajrakaṭhoghoranakharaprāntāvagāḍhāvaniḥ	sajjat-vajra-kaWaH-Gora-naKara-prAnta-avagAXa-avaniH
   śrṛṅgāgre malayasya pannagaripurdūrādayaṃ dṛśyate // Nā_5.14 //	SrRFga-agre malayasya pannaga-ripuH-dUra-At-ayam dRSyate // NA_5.14 //
   glānirnādhikapīyamānarudhirasyāpyasti dhairyyodadhe-	glAniH-na-aDikapIyamAna-ruDirasya-api-asti DEryya-udaDe-
   rmāsotkarttanajā rūjo 'pi vahataḥ prasannaṃ mukham /	rmAsa-utkarttana-jAH rUjaH api vahataH prasannam muKam /
   gātraṃ yanna viluptameṣa pulakastatra sphuṭo lakṣyate	gAtram yat-na viluptam-eza pulakaH-tatra sPuwaH lakzyate
   dṛṣṭirmayyupakāriṇīva nipatatyasyāpakāriṇyapi // Nā_5.15 //	dRzwiH-mayI-upakAriNI-iva nipatati-asya-apakAriNI-api // NA_5.15 //
   śirāmukhaiḥ syandata eva raktamadyāpi dehe mama māṃsabhasti /	SirA-muKEH syandate eva raktam-adya-api dehe mama mAMsa-Basti /
   tṛptiṃ na paśyāmi tavāpi tāvat kiṃ bhakṣaṇāttvaṃ virato garutman! //	tRptim na paSyAmi tava-api tAvat kim BakzaNAt-tvam virataH garutman! //
   Nā_5.16 //	NA_5.16 //
   āvarjitaṃ mayā cañcvā hṛdayāt tava śoṇitam /	Avarjitam mayA caQcvA hRdayAt tava SoNitam /
   anena dhairyyeṇa punastvayā hṛdayameva naḥ // Nā_5.17 //	anena DEryyeNa punar-tvayA hRdayam-eva naH // NA_5.17 //
   āstāṃ svastikalakṣma vakṣasi tanau nālokyate kañcukaḥ	AstAm svastika-lakzma vakzasi tanO na-Alokyate kaQcukaH
   jihve jalpata eva me na gaṇite nāma tvayā dve api !	jihve jalpate eva me na gaNite nAma tvayA dve api !
   tistrastīvraviṣāgnidhūmapaṭalavyājihyaratnatviṣo	tistraH-tIvra-viza-agni-DUma-pawala-vyAjihya-ratna-tvizaH-
   naitā duḥsahaśokaśūtkṛtamarutsphītāḥ phaṇāḥ paśyasi ! // Nā_5.18 //	na-etAH duHsaha-Soka-SUtkRta-marut-sPItAH PaNAH paSyasi ! // NA_5.18 //
   merau mandarakandarāsu himavatsānau mahendrācale /	merO mandara-kandarAsu himavatsAnO mahA-indra-acale /
   kailāsasya śilātaleṣu malayaprāgbhāradeśeṣvapi /	kElAsasya SilA-talezu malaya-prAgBAra-deSezu-api /
   uddeśeṣvapi teṣu teṣu bahuśo yasya śrutaṃ tanmayā /	uddeSezu-api tezu tezu bahuSas yasya Srutam tat-mayA /
   lokālokavicāraṇagaṇairudugīyamānaṃ yaśaḥ // Nā_5.19 //	lokAloka-vicAraNa-gaNEH-udugIyamAnam yaSaH // NA_5.19 //
   svaśarīreṇa śarīraṃ tārkṣyāt parirakṣatā madīyamidam /	sva-SarIreNa SarIram tArkzyAt parirakzatA madIyam-idam /
   yuktaṃ netuṃ bhavatā pātālatalādapi talaṃ mām? // Nā_5.20 //	yuktam netum BavatA pAtAla-talAt-api talam mAm? // NA_5.20 //
   ātmīyaḥ para ityayaṃ khalu kutaḥ satyaṃ kṛpāyāḥ kramaḥ?	AtmIyaH paraH iti-ayam Kalu kutas satyam kRpAyAH kramaH?
   kiṃ rakṣāmi bahūn kimekamiti te jātā na cintā katham?	kim rakzAmi bahUn kim-ekam-iti te jAtA na cintA kaTam?
   tārkṣyāttrātumahiṃ svajīvitaparityāgaṃ tvayā kurvatā	tArkzyAt-trAtu-m-ahim sva-jIvita-parityAgam tvayA kurvatA
   yenātmā pitarau vadhūriti hataṃ niḥśeṣametatkulam // Nā_5.21 //	yena-AtmA pitarO vaDUH-iti hatam niHSezam-etat-kulam // NA_5.21 //
   jvālābhaṅgaistrikagrasanarasacalatkālajihvāgrakalpaiḥ	jvAlA-BaFgEH-trika-grasana-rasa-calat-kAla-jihvA-agra-kalpEH
   sarpadbhiḥ sapta sarpiṣkaṇamiva kavalīkarttumīśe samudrān /	sarpadBiH sapta sarpizkaNam-iva kavalIkarttum-ISe samudrAn /
   svairevotpātavātaprasarapaṭutarairdhukṣite pakṣavātai-	svEH-eva-utpAta-vAta-prasara-pawutarEH-Dukzite pakza-vAtE-
   rasmin kalpāvasānajvalanabhayakare vāḍavāgnau patāmi // Nā_5.22 //	rasmin kalpa-avasAna-jvalana-Baya-kare vAxava-agnO patAmi // NA_5.22 //
   viluptaśeṣāṅgatayā prayātān nirāśrayatvādiva kaṇṭhadeśam /	vilupta-Seza-aFga-tayA prayAtAt nirASraya-tvAt-iva kaNWa-deSam /
   prāṇāṃstyajantaṃ tanayaṃ nirīkṣya kathaṃ na pāpaḥ śatadhā vrajāmi //	prANAn=-tyajantam tanayam nirIkzya kaTam na pApaH SataDA vrajAmi //
   Nā_5.23 //	NA_5.23 //
   medosthimāṃsamajjāsṛksaṅghāte 'smiṃstvacāvṛte /	medA-usTimAMsa-majjA-asRj-saFGAte asmin=-tvacA-AvRte /
   śarīranāmni kā śobhā sadā bībhatsadarśane? // Nā_5.24 //	SarIra-nAmni kA SoBA sadA bIBatsa-darSane? // NA_5.24 //
   nityaṃ prāṇābhighātāt prativirama kuru prākkṛtasyānutāpaṃ	nityam prANa-aBiGAtAt prativirama kuru prAk-kRtasya-anutApam
   yatnāt puṇyapravāhaṃ samupacinu diśann sarvasattveṣvabhītim /	yatnAt puNya-pravAham samupacinu diSan sarva-sattvezu-aBItim /
   magnaṃ yenātra nainaḥ phalati pariṇataṃ prāṇihiṃsāsamutthaṃ	magnam yena-atra na-enaH Palati pariNatam prANi-hiMsA-samutTam
   durgādhe vāripūre lavaṇapalamiva kṣiptamantarhradasya // Nā_5.25 //	durgADe vAri-pUre lavaNa-palam-iva kziptam-antarhradasya // NA_5.25 //
   ajñānanidrāśayito bhavatā pratibodhitaḥ /	ajQAna-nidrA-SayitaH BavatA pratiboDitaH /
   sarvaprāṇivadhādeṣa virato 'dya prabhṛtyaham // Nā_5.26 //	sarva-prANi-vaDAt-eza virataH adya praBRti-aham // NA_5.26 //
   kvacidūdvīpākāraḥ pulinavipulairbhoganivahaiḥ	kvacid-UdvIpa-AkAraH pulina-vipulEH-Boga-nivahEH
   kṛtāvarttabhrāntirvalayitaśarīraḥ kvacidapi /	kRta-Avartta-BrAntiH-valayita-SarIraH kvacid-api /
   vrajan kūlāt kūlaṃ kvacidapi ca setupratisamaḥ	vrajan kUlAt kUlam kvacid-api ca setu-pratisamaH
   samājo nāgānāṃ viharatu mahodanvati sukham // Nā_5.27 //	samAjaH nAgAnAm viharatu mahA-udanvati suKam // NA_5.27 //
   srastānāpādalambān ghanatimiranibhān keśapāśān vahantyaḥ	srastAn-ApAda-lambAn Gana-timira-niBAn keSa-pASAn vahantyaH
   sindūreṇeva digdhaiḥ prathamaravikarasparśatāmraiḥ kapolaiḥ /	sindUreNa-iva digDEH praTama-ravi-kara-sparSa-tAmrEH kapolEH /
   āyāsenālasāṅgayo 'pyavagaṇitarujaḥ kānane candanānā-	AyAsena-alasa-aFgayaH api-avagaNita-rujaH kAnane candanAnA-
   masmin gāyantu rāgāduragayuvatayaḥ kīrtimetāṃ tavaiva // Nā_5.28 //	masmin gAyantu rAgAt-uraga-yuvatayaH kIrtim-etAm tava-eva // NA_5.28 //
   utprekṣamāṇā tvāṃ tārkṣyacañcukoṭivipāṭitam /	utprekzamANA tvAm tArkzya-caQcu-kowi-vipAwitam /
   tvadūduḥkhaduḥkhitā nūnamāste sā jananī tava // Nā_5.29 //	tvad-U-duHKa-duHKitAH nUnam-Aste sA jananI tava // NA_5.29 //
   gātrāṇyamūni na vahanti sacetanatvaṃ śrātraṃ sphuṭākṣarapadāṃ na diraṃ	gAtrANi-amUni na vahanti sa-cetana-tvam SrAtram sPuwa-akzara-padAm na diram
   śrṛṇoti /	SrRNoti /
   kaṣṭaṃ nimītilamidaṃ sahasaiva cakṣurhā tāta ! yānti vivaśasya mamāsavo	kazwam nimItilam-idam sahasA-eva cakzuH-hA tAta ! yAnti vivaSasya mama-AsavaH-
   'mī // Nā_5.30 //	amI // NA_5.30 //
   nirādhāraṃ dhairyya kamiva śaraṇaṃ yātu vinayaḥ?	nirADAram DEryya kam-iva SaraNam yAtu vinayaH?
   kṣamaḥ kṣāntiṃ voḍhuṃ ka iha viratā dānaparatā /	kzamaH kzAntim voXum kaH iha viratA dAna-para-tA /
   hataṃ satyaṃ satyaṃ vrajatu kṛpaṇā kvādya karuṇā?	hatam satyam satyam vrajatu kRpaNA kva-adya karuNA?
   jagajjātaṃ śūnyaṃ tvayi tanaya lokāntaragate // Nā_5.31 //	jagat-jAtam SUnyam tvayi tanaya loka-antara-gate // NA_5.31 //
   pakṣotkṣiptāmbunāthaḥ paṭutarajavanaiḥ preryyamāṇaiḥ samīraiḥ	pakza-utkzipta-ambu-nATaH pawutara-javanEH preryyamANEH samIrEH
   netrāgniploṣamūrcchāvidhuravinipatatsānaladvādaśārkaḥ /	netra-agni-ploza-mUrcCA-viDura-vinipatat-sA-anala-dvAdaSa-arkaH /
   cañcvā sañcūrṇya śakrāśanidhanadagadāpretalokeśadaṇḍān	caQcvA saQcUrNya Sakra-aSani-Danada-gadA-preta-loka-ISa-daNxAn
   ājau nirjatya devān kṣaṇamamṛtamayīṃ vṛsṭimabhyutsṛjāmi // Nā_5.32 //	AjO nirjatya devAn kzaNam-amRta-mayIm vRswim-aByutsRjAmi // NA_5.32 //
   uṣṇīṣaḥ sphuṭa eṣa mūrdhani vibhātyūrṇoyamantarbhruvo-	uzNIzaH sPuwaH eza mUrDani viBAti-UrNoyam-antar-Bruvo-
   ścakṣustāmarasānukāri hariṇā vakṣaḥsthalaṃ spardhate /	ScakzuH-tAmarasa-anukAri hariNA vakzaH-sTalam sparDate /
   cakrāṅkau caraṇau tathāpi hi kathaṃ hā vatsa madūduṣkṛtai-	cakra-aFkO caraNO taTA-api hi kaTam hA vatsa mad-U-duzkRtE-
   stvaṃ vidyādharacakravartipadavīmaprāpya viśrāmyasi // Nā_5.33 //	stvam vidyADara-cakravarti-padavIm-aprApya viSrAmyasi // NA_5.33 //
   nijena jīvitenāpi jagatāmupakāriṇaḥ /	nijena jIvitena-api jagatAm-upakAriNaH /
   parituṣṭāsmi te vatsa ! jīva jīmūtavāhana // Nā_5.34 //	parituzwA-asmi te vatsa ! jIva jImUtavAhana // NA_5.34 //
   abhilaṣitādhikavarade ! praṇipatitajanārttihāriṇi ! śaraṇye !	aBilazita-aDika-vara-de ! praNipatita-jana-Artti-hAriNi ! SaraNye !
   caraṇau namāmyahaṃ te vidyāvarapūjite ! gauri ! // Nā_5.35 //	caraNO namAmi-aham te vidyA-vara-pUjite ! gOri ! // NA_5.35 //
   samprāptākhaṇḍadehāḥ sphuṭaphaṇamaṇibhirbhāsurairuttanāṅgai-	samprApta-aKaNxa-dehAH sPuwa-PaNa-maNiBiH-BAsurEH-uttana-aFgE-
   rjihvākoṭidvayena kṣitimamṛtarasāsvādalobhāllihantaḥ /	rjihvA-kowi-dvayena kzitim-amRta-rasa-AsvAda-loBAt-lihantaH /
   sampratyābaddhavegā malayagirisaridvāripūrā ivāmī	samprati-AbadDa-vegAH malaya-giri-sarit-vAri-pUrAH iva-AmI
   vakraiḥ prasthānamārgerviṣadharapatayastoyarāśiṃ viśanti // Nā_5.36 //	vakrEH prasTAna-mArgeH-vizaDara-patayaH-toya-rASim viSanti // NA_5.36 //
   haṃsāsevitemapaṅkajarajaḥsamparkapaṅkojjhitai-	haMsa-Asevita-ima-paFkaja-rajaH-samparka-paFka-ujJitE-
   rutpannairmama mānasādupanataistoyairmahāpāvanaiḥ /	rud-pannEH-mama mAnasAt-upanatEH-toyEH-mahA-pAvanEH /
   svecchānirmitaratnakumbhanihitaireṣābhiṣicya svayaṃ	sva-icCA-nirmita-ratna-kumBa-nihitEH-ezA-aBizicya svayam
   tvāṃ vidyādharacakravarttinamahaṃ prītyā karomi kṣaṇāt // Nā_5.37 //	tvAm vidyADara-cakravarttinam-aham prItyA karomi kzaNAt // NA_5.37 //
   agresarībhavatu kāñcanakrametadeṣa dvipaśca dhavalo daśanaiścaturbhiḥ /	agresarIBavatu kAQcana-krametat-eza dvipaH-ca DavalaH daSanEH-caturBiH /
   śyāmo harirmalayavatyapi cetyamūni ratnāni te samavalokya cakravarttin !	SyAmaH hariH-malayavati-api ca-iti-amUni ratnAni te samavalokya cakravarttin !
   // Nā_5.38 //	// NA_5.38 //
   trāto 'yaṃ śaṅkhacūḍaḥ patagapatimukhādvainateyo vinīta-	trAtaH ayam SaFKacUxaH pataga-pati-muKAt-vEnateyaH vinIta-
   stena prāgbhakṣitā ye viṣadharapatayo jīvitāste 'pi sarve /	stena prAk-BakzitAH ye vizaDara-patayaH jIvitAH-te api sarve /
   matprāṇāptyā vimuktā na gurubhirasavaścakravarttitvamāptaṃ	mad-prANAptyA vimuktA na guruBiH-asavaH-cakravartti-tvam-Aptam
   sākṣāttvaṃ devi ! dṛṣṭā priyamaparamataḥ kiṃ punaḥ prārthyate yat //	sAkzAt-tvam devi ! dRzwA priyam-aparamatas kim punar prArTyate yat //
   Nā_5.39 //	NA_5.39 //
   vṛṣṭiṃ hṛṣṭaśikhaṇḍatāṇḍavabhṛto muñcantu kāle dhanāḥ	vRzwim hRzwa-SiKaNxa-tANxava-BRtaH muQcantu kAle DanAH
   kurvantu pratirūḍhasantataharicchasyottarīyāṃ kṣitim /	kurvantu pratirUXa-santata-haricCasya-uttarIyAm kzitim /
   cinvānāḥ sukṛtāni vītavipado nirmansarairmānisai-	cinvAnAH su-kRtAni vIta-vipadaH nirmansarEH-mAni-sE-
   rmodantāṃ satataṃ ca bāndhavasuhṛdgoṣṭhipramodāḥ prajāḥ // Nā_5.40 //	rma-udantAm satatam ca bAnDava-suhRd-gozWi-pramodAH prajAH // NA_5.40 //
   śivamastu sarvajagatāṃ parahitaniratā bhavantu bhūtagaṇāḥ /	Sivam-astu sarva-jagatAm para-hita-niratAH Bavantu BUta-gaNAH /
   doṣāḥ prayāntu nāśaṃ sarvatra sukhī bhavatu lokaḥ // Nā_5.41 //	dozAH prayAntu nASam sarvatra suKI Bavatu lokaH // NA_5.41 //
   iti pañcamo 'ṅkaḥ	iti paQcamaH aFkaH
