   PADA INDEX	PADAH INDEX
   antarbhinnataraṅgadyotarucakajyotsnāni gṛhṇāti kaḥ Js_2d	antar-Binna-taraFga-dyota-rucaka-jyotsnAni gRhNAti kaH Js_2d
   ārūḍhaḥ sphuṭavisphuliṅgam analaṃ tenādhunāpi kṣitāv Js_10c	ArUXaH sPuwa-visPuliFgam analam tena-aDunA-api kzitO Js_10c
   ālokyāvyativartinā praṇihitā bodhau dhiyo yat tvayā Js_4b	Alokya-avyativartinA praNihitAH boDO DiyaH yat tvayA Js_4b
   āsīl lokahitodaye jina kṛpāviṣyandinī santatiḥ Js_3b	AsIt loka-hita-udaye jina kRpA-AvizyandinI santatiH Js_3b
   ity ātmārthanibandhinedam ṛṣivākyālaṃkṛtaṃ darśitaṃ Js_19a	iti Atma-arTa-nibanDinA-idam Rzi-vAkya-alaMkRtam darSitam Js_19a
   indor maṇḍalalāñchanaṃ śaśamayaṃ yuṣmadyaśo laksyate Js_10d	indoH maNxala-lAQCanam SaSa-mayam yuzmad-yaSaH laksyate Js_10d
   utpāṭyākṣatalocanadvayam adād viprāya niścakṣuṣe Js_18c	utpAwya-akzata-locana-dvayam adAt viprAya niScakzuze Js_18c
   uddāmadviradasya rāgavaśino vṛttiṃ puronmādinīm Js_4a	uddAma-dviradasya rAgavaSinaH vRttim pura-unmAdinIm Js_4a
   kalmāṣāntaśikhaṃ śikhāmaṇirucā dattaṃ dvijāyārthine Js_7b	kalmAza-anta-SiKam SiKA-maNi-rucA dattam dvijAya-arTine Js_7b
   kāntārāntaravartināṃ tanubhṛtām ucchittaye vyāpadām Js_6b	kAntAra-antara-vartinAm tanuBRtAm ucCittaye vyApadAm Js_6b
   kośākarṣaṇavāntabhūrirudhirakṣodāruṇais tena vaḥ Js_12c	koSa-AkarzaNa-vAnta-BUri-ruDi-rakzodAruNEH tena vaH Js_12c
   kvedaṃ dāśabalaṃ guṇair aśabalaṃ caryāvibhutvaṃ vibho Js_1a	kva-idam dASa-balam guNEH aSabalam caryA-viBu-tvam viBo Js_1a
   kṣudduḥkhaglapitodarīṃ giridarīrandhrāntarālasthitāṃ Js_5a	kzuD-duHKa-glapita-udarIm giri-darI-ranDra-antarAla-sTitAm Js_5a
   khaḍgotkṛttadalair vipāṭitaśirārandhrasravallohitaiḥ Js_15b	Kaxga-utkRtta-dalEH vipAwita-SirA-ranDra-sravat-lohitEH Js_15b
   cakre marmabhidāṃ rujāṃ svapiśitaiḥ prābandhakīnāṃ śamaṃ Js_17c	cakre marma-BidAm rujAm sva-piSitEH prAbanDakInAm Samam Js_17c
   cittālambanalaṅghinaḥ śamadṛśām āveṇikāḥ sadguṇā Js_2a	citta-AlambanalaFGinaH Sama-dRSAm AveNikAH sat-guNAH Js_2a
   janmasyandanikāvivartanajaḍaṃ cetaḥ kva cedaṃ mama Js_1b	janma-syandanikA-vivartana-jaxam cetaH kva ca-idam mama Js_1b
   jñeyābhogavisāriṇo gatamalāḥ prāg eva bodhau guṇāḥ Js_3d	jQeya-ABoga-visAriNaH gata-malAH prAk eva boDO guNAH Js_3d
   tatkarmātiśayena tena nikhilā lokāḥ kalatrīkrtāḥ Js_13d	tad-karma-atiSayena tena niKilAH lokAH kalatrIkrtAH Js_13d
   tatkālātithaye kṛpāparicayād ātithyam āvedayan Js_10b	tad-kAla-atiTaye kRpA-paricayAt AtiTyam Avedayan Js_10b
   tārābdhānavatāṃ jalaṃ jalapurām ākarṣatā vāridher Js_19c	tArAbDAnavatAm jalam jala-purAm AkarzatA vAriDeH Js_19c
   tena kleśaviṣacchidāṃ tava dhiyāṃ avyāhatāḥ śaktayaḥ Js_17d	tena kleSa-viza=-CidAm tava DiyAm avyAhatAH SaktayaH Js_17d
   tena stutyanubandhinā mukharatām ālambate bhāratī Js_1d	tena stuti-anubanDinA muKara-tAm Alambate BAratI Js_1d
   tenākampitakeśarāntam asṛjan puṣpopahāraṃ divaḥ Js_4d	tena-akampita-keSara-antam asRjan puzpa-upahAram divaH Js_4d
   tenājñānarujāṃ kirīṭakiraṇacchāyās padaṃ vo gatāḥ Js_9d	tena-ajQAna-rujAm kirIwa-kiraNa=-CAyAH padam vaH gatAH Js_9d
   tenātyantaparopakāranirataḥ svārthe 'pi mandādaro Js_20c	tena-atyanta-para-upakAra-nirataH sva-arTe api manda-AdaraH Js_20c
   tenāndhasya tamasvato 'sya jagatas tuṅgaikadīpo bhavān Js_18d	tena-anDasya tamasvataH asya jagataH tuFga-eka-dIpaH BavAn Js_18d
   tenaiṣāṃ jagatāṃ gato 'si gurutām usṇīṣavan mūrdhani Js_7d	tena-ezAm jagatAm gataH asi guru-tAm usNIza-vat mUrDani Js_7d
   trāṇaṃ tena bhavān bhavādrivivaravyāvartināṃ dehinām Js_5d	trANam tena BavAn Bava-adri-vivara-vyAvartinAm dehinAm Js_5d
   tvaccaryātiśayāṃśaleśaracanād yaḥ śreyasām udbhavaḥ Js_20a	tvad-caryA-atiSaya-aMSa-leSa-racanAt yaH SreyasAm udBavaH Js_20a
   tvattas tena samudbhavanti viduṣāṃ saddharmaratnāṅkurāḥ Js_14d	tvattaH tena samudBavanti viduzAm sat-Darma-ratna-aFkurAH Js_14d
   tvām āsīt kṣaṇam apy avikṣatadhiyaṃ tyaktukṣamā na kṣamā Js_11c	tvAm AsIt kzaNam api avikzata-Diyam tyaktu-kzamA na kzamA Js_11c
   digdhaṃ raktakaṇaiḥ sphuratkuvalayacchāyābhinīlāyitam Js_18b	digDam rakta-kaNEH sPurat-kuvalaya=-CAyA-aBinIlAyitam Js_18b
   dṛṣtvā śāvakaghālanaikarabhasāṃ vyāghrīṃ dayāghrātadhīḥ Js_5b	dRztvA SAvaka-GAla-na-eka-raBasAm vyAGrIm dayA-AGrAta-DIH Js_5b
   nālāl lūnam ivāravindam asinā vyutkṛttamūlaṃ śiras Js_7c	nAlAt lUnam iva-aravindam asinA vyutkRtta-mUlam SiraH Js_7c
   patyur yan makaracchaṭāvilulitāt paryastanaukā narāḥ Js_13b	patyuH yat makarat-SawA-vilulitAt paryasta-nOkAH narAH Js_13b
   paryastākṣacalacchikhaṇḍakabhṛto dārāṃs ca bhāvanugān Js_8b	paryasta-akza-calat-SiKaNxaka-BRtaH dArAn ca BAvanugAn Js_8b
   pātāle 'pi bhujaṃgamaiḥ ślathaphaṇair adyāpi daṃṣtrārcyate Js_12d	pAtAle api BujaMgamEH SlaTa-PaNEH adya-api daMztrA-arcyate Js_12d
   prādās tvaṃ jina tena nūnam ahhavan mārāṅganānāṃ mukhaṃ Js_8c	prAdAH tvam jina tena nUnam ahhavat mAra-aFganAnAm muKam Js_8c
   premṇā kāyamahāplavena bhavatā tīrāntam āpāditās Js_13c	premNA kAya-mahA-plavena BavatA tIra-antam ApAditAH Js_13c
   bālān bālasarojakomalatanūn yat putrakān arthine Js_8a	bAlAn bAla-saroja-komala-tanUn yat putrakAn arTine Js_8a
   bhinnāśeṣakale jagaty avikale jyāyaḥpathāśaṃsinā Js_9b	Binna-aSeza-kale jagati avikale jyAyaH-paTa-ASaMsinA Js_9b
   bhūyāt sarvavidāṃ parārthaviduṣāṃ yānaikatāno janaḥ Js_20d	BUyAt sarva-vidAm para-arTa-viduzAm yAna-ekatAnaH janaH Js_20d
   manye tena niraṅkuśāḥ smaraśarāḥ puṅkheṣu bhaṅgaṃ gatāḥ Js_11d	manye tena niraFkuSAH smara-SarAH puFKezu BaFgam gatAH Js_11d
   manye matsariṇāṃ nitāntamalinās tena kṣatā vṛttayaḥ Js_6d	manye matsariNAm nitAnta-malinAH tena kzatAH vRttayaH Js_6d
   māras tena dukūlapakṣmataralaṃ nītas tulālāghavam Js_16d	mAraH tena dukUla-pakzma-taralam nItaH tulA-lAGavam Js_16d
   yac cintāmaṇinā narendra badaradvīpāntarālodarāt Js_14b	yat cintAmaNinA narendra badaradvIpa-antarAla-udarAt Js_14b
   yat kopāruṇadṛṣṭinā kalabhuvā kṛtvā bhruvor bhaṅginīṃ Js_11a	yat kopa-aruNa-dRzwinA kala-BuvA kRtvA BruvoH BaFginIm Js_11a
   yat tiryakpratisandhibandham adhamaṃ kṛtvā bhavāñ janmanām Js_17b	yat tiryak-pratisanDi-banDam aDamam kRtvA BavAn janmanAm Js_17b
   yat tvaṃ valkalinīṃ jaṭājanavatīṃ mūrtiṃ samutsṛṣṭavāṃs Js_5c	yat tvam valkalinIm jawA-janavatIm mUrtim samutsRzwavAn Js_5c
   yat parṇāmbuphalāśinīṃ śaśatanuṃ tvaṃ nātha bibhrat purā Js_10a	yat parNa-ambu-Pala-ASinIm SaSa-tanum tvam nATa biBrat purA Js_10a
   yat prāleyasitopalādribahalāṃ mātaṅgatāṃ bibhratā Js_6a	yat prAleya-sitopala-adri-bahalAm mAtaFga-tAm biBratA Js_6a
   yat sandoham iva śriyāḥ phalam iva procchrāyi puṇyaujasāṃ Js_18a	yat sandoham iva SriyAH Palam iva procCrAyi puNya-ojasAm Js_18a
   yad dveṣī kariṇā cirātatadhanur dantais tvayābhyarcitaḥ Js_12a	yat dvezI kariNA cira-Atata-DanuH dantEH tvayA-aByarcitaH Js_12a
   yan niḥsaṅgaratā śivāya śibinā rājñā satā pakṣiṇaḥ Js_16b	yat niHsaFga-ratA SivAya SibinA rAjQA satA pakziNaH Js_16b
   yan māṃsair akṛthāḥ kṣudhāvyupaśamaṃ svair avyapetoṣmabhir Js_15c	yat mAMsEH akRTAH kzuDA-vyupaSamam svEH avyapeta-UzmaBiH Js_15c
   yal lokāmbaracandracandravapuṣā candraprabhatve tvayā Js_7a	yat loka-ambara-candra-candra-vapuzA candra-praBa-tve tvayA Js_7a
   yā vo bodhipathānuyānamahatām utsāhinī karmaṇām Js_3a	yA vaH boDi-paTa-anuyAna-mahatAm utsAhinI karmaNAm Js_3a
   yenāvandhyaphalodayās tvayi bhavanty abhyāhitāḥ pāṃsavas Js_1c	yena-avanDya-Pala-udayAH tvayi Bavanti aByAhitAH pAMsavaH Js_1c
   yogā janmarudho bhavodbhavatṛṣām ucchedinas tena vaḥ Js_15d	yogAH janma-ruDaH BavodBava-tRzAm ucCedinaH tena vaH Js_15d
   raktodgārakalaṅkitātulatulām āropitā te tanur Js_16c	rakta-udgAra-kalaFkita-atula-tulAm AropitA te tanuH Js_16c
   ratnāny ambunidher upāmbupulineṣv āvir bhavanty arthinām Js_2c	ratnAni ambuniDeH upa-ambu-pulinezu Avis Bavanti arTinAm Js_2c
   lakṣmīm apy avadhūya vāñchitaphalām ākhaṇḍam ādhvaṃsinīṃ Js_17a	lakzmIm api avaDUya vAQCita-PalAm AKaNxam ADvaMsinIm Js_17a
   labdhvā pūrṇaphalās tvayā praṇayinām āśāvabandhāḥ kṛtās Js_14c	labDvA pUrNa-PalAH tvayA praNayinAm ASA-avabanDAH kRtAH Js_14c
   lekhām ullasitāsinā vidalitapratyaṅgam āśaṅkinā Js_11b	leKAm ullasita-asinA vidalita-pratyaFgam ASaFkinA Js_11b
   leśasyāpi na kīrtanaṃ jina kṛtaṃ tvadvarṇarāśer mama Js_19b	leSasya-api na kIrtanam jina kRtam tvad-varNa-rASeH mama Js_19b
   vācāṃ gocaratāṃ tu yānti kalayā sthūlā hi vo mādṛśām Js_2b	vAcAm gocaratAm tu yAnti kalayA sTUlAH hi vaH mAdRSAm Js_2b
   vinyasyanta ivāmarās tvayi ciraṃ dharmābhiṣekaśriyaṃ Js_4c	vinyasyante iva-amarAH tvayi ciram Darma-aBizeka-Sriyam Js_4c
   vistāraṃ gamitaṃ vrataṃ vratabhṛtāṃ yan nātha kāpiñjalaṃ Js_9c	vistAram gamitam vratam vrata-BRtAm yat nATa kApiQjalam Js_9c
   velānteṣv iva rodhasāṃ jalalavacchedo hi saṃlakṣyate Js_19d	velA-antezu iva roDasAm jalalava=-CedaH hi saMlakzyate Js_19d
   śayyāsvapnavicāriṇā vanabhuvāṃ bhūtvā purā pakṣiṇā Js_9a	SayyA-svapna-vicAriNA vana-BuvAm BUtvA purA pakziNA Js_9a
   śailān maṇḍalino vilaṅghya viṣayāṃs toyāvalīmekhalān Js_14a	SElAn maNxalinaH vilaFGya vizayAn toya-AvalI-meKalAn Js_14a
   śailendraṃ pṛthulopalaṃ calayatā muktas tvayātmā taṭān Js_6c	SElendram pRTula-upalam calayatA muktaH tvayA-AtmA tawAn Js_6c
   śyenottrāsaviśuṣkakampitagalasyotsaṅgasaṃsarpiṇo Js_16a	Syena-uttrAsa-viSuzka-kampita-galasya-utsaFga-saMsarpiNaH Js_16a
   ṣaḍdantena satā sitonnatabṛhajjīmūtapuñjatviṣā Js_12b	zaz-dantena satA sita-unnata-bRhat-jImUta-puQja-tvizA Js_12b
   sambhāro vipulaprasādavikasadbhaktyācitāṃśasya me Js_20b	samBAraH vipula-prasAda-vikasat-BaktyA-Acita-aMSasya me Js_20b
   saṃkocāñcitapakṣmalocanadalaṃ lajjālasāmantharam Js_8d	saMkoca-AQcita-pakzma-locana-dalam lajjA-alasA-manTaram Js_8d
   saṃrambhāt phaṇināṃ phaṇāhaticalād bhīmormimālād apāṃ Js_13a	saMramBAt PaNinAm PaNa-Ahati-calAt BIma-Urmi-mAlAt apAm Js_13a
   sānekāpacitaḥ punāti bhagavan saṃkīrtyamānādhunā Js_3c	sa-aneka-apacitaH punAti Bagavan saMkIrtyamAna-aDunA Js_3c
   sāndrābhrāntavitānanīlavapuṣām ojomuṣāṃ rakṣasāṃ Js_15a	sAndra-aBra-anta-vitAna-nIla-vapuzAm ojaH-muzAm rakzasAm Js_15a
