   Mahāmaṇivipulavimānaviśvasupratiṣṭhitaguhyaparamarahasyakalparājadhāraṇī	MahAmaNi-vipula-vimAna-viSva-su-pratizWita-guhya-parama-rahasya-kalparAja-DAraNI
   GBM 1724 (fol. 53r)	GBm 1724 (fol. 53r)
   1 yitavyāḥ || dvātṛṃśati śarāvā pūrayitavyāḥ || catvāri tailāni catvāri	1 yitavyAH || dvAtRMSati SarAvAH pUrayitavyAH || catvAri tElAni catvAri
   ghṛtaṃ | catvāri	GRtam | catvAri
   2 guḍapiṇḍāni | catvāri tilapūrṇāni | catvāry aṭhalapūrṇaṃ | catvāri	2 guxa-piNxAni | catvAri tila-pUrNAni | catvAri aWala-pUrNam | catvAri
   saptavījakapūrṇaṃ	saptavIjaka-pUrNam
   3 nānābaliḥ kartavyaḥ bhakṣyaveṣṭimakapūpamudgapūpatilapūpa |	3 nAnA-baliH kartavyaH Bakzya-vezwimaka-pUpa-mudga-pUpa-tila-pUpa |
   aśokavartikālāvaṇaṃ	aSoka-vartikA-lAvaNam
   4 ghṛtagarjakaṃ guḍapūpaṃ sarvasukṛtakāryāṇi yathā lābhaṃ saṃjñātavyaṃ	4 GRta-garjakam guxa-pUpam sarva-su-kRta-kAryANi yaTA lABam saMjQAtavyam
   5 maṇḍalakaṃ suracitaṃ kṛtvā tato praveśadvāreṇa gatvodakapūrṇaṃ dvau	5 maNxalakam su-racitam kRtvA tatas praveSa-dvAreNa gatvA-udaka-pUrNam dvO
   kalaśausthāpya	kalaSa-OsTApya
   GBM 1725 (53v)	GBm 1725 (53v)
   1 tathā lābhaṃ ca baliṃ sthāpya tathāvat praveśavidhiṃ ca kārayet tataḥ	1 taTA lABam ca balim sTApya taTAvat praveSa-viDim ca kArayet tatas-
   anena mantreṇābhiṣiṃcya	anena mantreNa-aBiziMcya
   2 praveśayet* oṃ maṇi vipula supratiṣṭhita siddha abhiṣiṃca māṃ	2 praveSayet* om maNi vipula su-pratizWita sidDaH aBiziMca mAm
   sarvatathāgatābhiṣekai	sarva-taTAgata-aBizekE
   3 bhara bhara saṃbhara hūṃ hūṃ || yathābhiṣiktamātraś ca sarvāṇi	3 Bara Bara saMBara hUm hUm || yaTA-aBizikta-mAtraH ca sarvANi
   nivaraṇāni	nivaraNAni
   4 pūrvajanmasaṃjātāni karmāvaraṇāni vuśuddhāni bhavanti bhavanti	4 pUrva-janma-saMjAtAni karma-AvaraNAni vuSudDAni Bavanti Bavanti
   sarvaśuddhaparigṛhito bhavati :	sarva-SudDa-parigRhitaH Bavati :
   5 sarvatathāgatādhiṣṭhitaḥ sarvatathāgatābhiṣiktaḥ	5 sarva-taTAgata-aDizWitaH sarva-taTAgata-aBiziktaH
   sarvatathāgatasamāśvastaḥ	sarva-taTAgata-samASvastaH
   GBM 1726 (54r)	GBm 1726 (54r)
   1 sarvasiddhiś cābhyāmukhībhavati | yaṃ cintayati yaṃ prārthayati tat	1 sarva-sidDiH ca-aByAmuKIBavati | yam cintayati yam prArTayati tat-
   tathaiva karoti ||	taTA-eva karoti ||
   2 sarvatathāgatasamayānupraviṣṭaḥ sarvatathāgatabharmatānugataḥ	2 sarva-taTAgata-samaya-anupravizwaH sarva-taTAgata-BarmatA-anugataH
   gaṃbhiradharmakṣānti	gaMBiH-aDarma-kzAnti
   3 pratilabdhaḥ bodhimaṇḍopasaṃkramaṇo bhavati | evam ādīni	3 pratilabDaH boDimaNxa-upasaMkramaNaH Bavati | evam AdIni
   4 guṇaviśeṣāṇi pratilabhate | yāvad avaivartiko bhaviṣyati | anuttarā	4 guNa-viSezANi pratilaBate | yAvat avEvartikaH Bavizyati | anuttarA
   bodhimārgaparipūriḥ || § ||	boDi-mArga-paripUriH || § ||
   5 maṇḍalavidhisādhanaṃ tritīyo paṭalavidhiḥ § ||	5 maNxala-viDi-sADanam tritIyaH pawala-viDiH § ||
   GBM 1727 (54v)	GBm 1727 (54v)
   1 athāto mudrālakṣaṇaṃ vakṣye | catvāri mahāhṛdayamudrāṇi prayojyā	1 aTa-atas mudrA-lakzaNam vakzye | catvAri mahA-hRdaya-mudrANi prayojyA
   sarvatathāgataiḥ	sarva-taTAgatEH
   2 kulasāmānyaṃ prayojayet* || catvāry āryavajrahṛdayamudrāṇi upayojyā	2 kula-sAmAnyam prayojayet* || catvAri Arya-vajra-hRdaya-mudrANi upayojyA
   sarvamaṇḍalaiḥ ||	sarva-maNxalEH ||
   3 āśvāsanamudrā samābāhyapaśyadanyamudraṃ samārabhe eṣaiva tathāgatakule	3 ASvAsana-mudrA samA-bAhi-a-paSyat-anyamudram samAraBe ezA-eva taTAgata-kule
   4 mudrā upayojyā yathāvidhi || bāhyamudrā na grahetavyā : anyamudrā yathā	4 mudrA upayojyAH yaTAviDi || bAhya-mudrA na grahetavyAH : anya-mudrA yaTA
   5 sukhaṃ sarvatra upayoktavyaḥ yathā upayujyate tathāgatakule || oṃ	5 suKam sarvatra upayoktavyaH yaTA upayujyate taTAgata-kule || om
   sarvatathāgatahṛdaya	sarva-taTAgata-hRdaya
   GBM 1728 (55r)	GBm 1728 (55r)
   1 maṇijvālani āreṣṭaya hūṃ || tathāgatahṛdayamudrā : || oṃ sarvatathāgata	1 maNi-jvAlani Arezwaya hUm || taTAgata-hRdaya-mudrA : || om sarva-taTAgata
   2 pravarāgramaṇi hūṃ || tathāgatasamayamudrā : || oṃ	2 pravara-agra-maNi hUm || taTAgata-samaya-mudrA : || om
   sarvatathāgatābhisaṃbodhanavajre 3 hūṃ hūṃ || tathāgataāśvāsanamudrā || oṃ	sarva-taTAgata-aBisaMboDana-vajre 3 hUm hUm || taTAgataa-ASvAsana-mudrA || om
   sarvatathāgatādhiṣṭhāna	sarva-taTAgata-aDizWAna
   4 maṇi maṇi hūṃ hūṃ phat* || tathāgatādhiṣṭhānamudrā || oṃ sarvatathāgata	4 maNi maNi hUm hUm Pat* || taTAgata-aDizWAna-mudrA || om sarva-taTAgata
   pravara maṇi	pravara maNi
   5 rucire hūṃ hūṃ phat* || tathāgatavajrasiṃhāsanamudrā || oṃ	5 rucire hUm hUm Pat* || taTAgata-vajra-siMhAsana-mudrA || om
   sarvatathāgata vipula saṃbhave	sarva-taTAgata vipula saMBave
   GBM 1729 (55v)	GBm 1729 (55v)
   1 hūṃ hūṃ || tathāgatābhiṣekamudrā || oṃ sarvatathāgata samaya maṇi vajre	1 hUm hUm || taTAgata-aBizeka-mudrA || om sarva-taTAgata samaya maNi vajre
   hūṃ hūṃ ||	hUm hUm ||
   2 dharmacakramudrā : || oṃ sarvatathāgata jaya ajitavajre hūṃ hūṃ ||	2 Darma-cakra-mudrA : || om sarva-taTAgata jaya ajita-vajre hUm hUm ||
   aparājitamudrā || oṃ sarvatathāgatadharmadhātu	aparAjita-mudrA || om sarva-taTAgata-Darma-DAtu
   3 mahāmaṇi śikhare hara hara hūṃ hūṃ || tathāgatacakravartimudrā : ||	3 mahA-maNi SiKare hara hara hUm hUm || taTAgata-cakravarti-mudrA : ||
   4 oṃ sarvatathāgata vajrā hvaya ddhara dhara hūṃ hūṃ phat* ||	4 om sarva-taTAgata vajrAH hvaya dDara Dara hUm hUm Pat* ||
   āryavajramaṇigrahaṇamudrā : |	Arya-vajra-maNi-grahaNa-mudrA : |
   5 oṃ dhuru dhuru maṇi mahāvidyuta maṇi svāhā || cintāmaṇimudrā	5 om Duru Duru maNi mahAvidyuta maNi svAhA || cintAmaNi-mudrA
   āryavajrasya mudrā || oṃ lokapālite	Arya-vajrasya mudrA || om loka-pAlite
   GBM 1730 (56r)	GBm 1730 (56r)
   1 jaya jaya hūṃ hūṃ || caturmahārājānāṃ mudrā grahetavyā : || oṃ vipulā	1 jaya jaya hUm hUm || catur-mahA-rAjAnAm mudrA grahetavyA : || om vipulA
   gravati	gravati
   2 saṃbhara hūṃ || śriyā mahādevyā mudrā grahetavyā || oṃ daṃṣṭriṇi visara	2 saMBara hUm || SriyA mahAdevyA mudrA grahetavyAH || om daMzwriNi visara
   hūṃ || tarjanīmudrā	hUm || tarjanI-mudrA
   3 śaṃkhinī || oṃ āgamaya dhīra mucāṭṭa hāsinī hūṃ dūtīmudrā baddhitavyā :	3 SaMKinI || om Agamaya DIra mucAwwa hAsinI hUm dUtI-mudrA badDitavyAH :
   || oṃ samantākāra	|| om samantAkAra
   4 paripūraṇe dhaka dhaka hūṃ hūṃ phat* maṇḍalanivāsinīnāṃ mudrā : ||	4 paripUraNe Daka Daka hUm hUm Pat* maNxala-nivAsinInAm mudrA : ||
   ābāhanamudrā	AbAhana-mudrA
   5 grahetavyā : || oṃ sara sara visara hūṃ hūṃ padmamudrā || mudrāvidhāna	5 grahetavyAH : || om sara sara visara hUm hUm padma-mudrA || mudrA-viDAna
   caturtho paṭalavistaraḥ || § ||	caturTaH pawala-vistaraH || § ||
   GBM 1731 (56v)	GBm 1731 (56v)
   1 athāta paṭalavidhānaṃ vakṣye sarvakāryeṣu sādhakaṃ | paṭe acchinnadaśake	1 aTa-atas pawala-viDAnam vakzye sarva-kAryezu sADakam | pawe acCinna-daSake
   keśāpagate	keSa-apagate
   2 ekahastaṃ dvihastaṃ vā samantena caturaśrakaṃ poṣadhikena citrakareṇa	2 eka-hastam dvi-hastam vA samantena caturaSrakam pozaDikena citrakareNa
   3 navabhājane na śleṣai raṃgair buddhaṃ bhagavantaṃ citrāpayitavyam	3 nava-BAjane na SlezEH raMgEH budDam Bagavantam citrApayitavyam
   siṃhāsanasyopariniṣaṇṇaṃ	siMhAsanasya-upari-nizaNNam
   4 sarvālaṃkāravibhūṣitaṃ kūṭāgāraparivṛtaṃ dharmaddeśayamānaṃ |	4 sarva-alaMkAra-viBUzitam kUwa-AgAra-parivRtam Darma-ddeSayamAnam |
   5 dakṣiṇena vajrapāṇiṃ dvādaśabhujaṃ kāryā śaratkāṇḍagaurā	5 dakziNena vajrapANim dvAdaSa-Bujam kAryA Sarad-kANxa-gOrA
   nānāpraharaṇahastaṃ caturmukhaṃ saumyaṃ dvitīlavistaraḥ || § ||	nAnA-praharaNa-hastam caturmuKam sOmyam dvi-tIla-vistaraH || § ||
   GBM 1732 (57r)	GBm 1732 (57r)
   1 athāta paṭalavidhānaṃ vakṣye sarvakāryeṣu sādhakaṃ | paṭe acchinnadaśake	1 aTa-atas pawala-viDAnam vakzye sarva-kAryezu sADakam | pawe acCinna-daSake
   2 keśāpagate ekahastaṃ dvihastaṃ vā samantena caturaśrakaṃ poṣadhikena	2 keSa-apagate eka-hastam dvi-hastam vA samantena caturaSrakam pozaDikena
   citrakareṇa	citrakareNa
   3 navabhājanena aśleṣai raṃgair buddhaṃ bhagavantaṃ citrāpayitavyaṃ	3 nava-BAjanena aSlezEH raMgEH budDam Bagavantam citrApayitavyam
   siṃhāsanasyopariniṣaṇṇaṃ	siMhAsanasya-upari-nizaNNam
   4 sarvālaṃkāravibhūṣitaṃ kūṭāgāraparivṛtaṃ dharmaddeśayamānaṃ | dakṣiṇena	4 sarva-alaMkAra-viBUzitam kUwa-AgAra-parivRtam Darma-ddeSayamAnam | dakziNena
   vajrapāṇi	vajrapANi
   5 dvādaśabhujāṃ kāryā śaratkāṇḍagaurā nānāpraharaṇahastaṃ caturmukhaṃ	5 dvAdaSa-BujAm kAryA Sarad-kANxa-gOrAH nAnA-praharaNa-hastam caturmuKam
   saumyaṃ | dvitīyaṃ	sOmyam | dvitIyam
   GBM 1733 (57v)	GBm 1733 (57v)
   1 raudraṃ tṛtīyaṃ daṃṣṭrākarālaṃ caturthe mukhe bhṛkuṭījaṭāmakuṭāmaṇḍitaṃ	1 rOdram tRtIyam daMzwrA-karAlam caturTe muKe BRkuwI-jawA-makuwA-maNxitam
   sarvālaṃkāravibhūṣitaṃ	sarva-alaMkAra-viBUzitam
   2 padmasyopariniṣaṇṇaṃ ardhaṃ paryaṃkayā || bāmapārśve maṇivajro nāma	2 padmasya-upari-nizaNNam arDam paryaMkayA || bAma-pArSve maNivajraH nAma
   bodhisatvo	boDisatvaH-
   3 kartavyaḥ caturmukhaṃ ṣoḍaśabāhuṃ || dakṣiṇabāhūṃ cintāmaṇiddhārayaṃ	3 kartavyaH caturmuKam zoxaSa-bAhum || dakziNa-bAhUm cintAmaNidDArayam
   tathāgatasyopanāmayati ||	taTAgatasya-upanAmayati ||
   4 bāmabāhūṃ padmaddhārayantaḥ dve haste aṃjaliṃ gṛhītavyaṃ : || śeṣaṃ	4 bAma-bAhUm padmadDArayantaH dve haste aMjalim gRhItavyam : || Sezam
   5 prahastaṃ kartavyaṃ tṛśūlaṃ cakraṃ khadgaṃ vajraṃ puṣpapuṭaṃ	5 prahastam kartavyam tR-SUlam cakram Kadgam vajram puzpa-puwam
   gaṇendakakaṇḍulaṃ aṣiḥ pu	gaNa-indaka-kaNxulam aziH pu
