   oṃ namo bhagavate mañjuśriye kumārabhūtāya	om namaH Bagavate maQju-Sriye kumAra-BUtAya
   śaṅkhakṣīrendukundasphaṭikahimadalakṣaumaśubhrābhragauraiś	SaFKa-kzIra-indu-kunda-sPawika-hima-dala-kzOma-SuBra-aBra-gOrEH-
   cañcatspaṣṭāṭṭahāsair gaganatalagataiś chattrapaṅkty [ātapatraiḥ] stavyair	caQcat-spazwa-awwahAsEH gagana-tala-gatEH Cattra-paFkti [AtapatrEH] stavyEH-
   bhūr bhāti yasya tridaśanaragarutsiddhagandharvājuṣṭaiḥ prahvās taṃ sarva	BUH BAti yasya tridaSa-nara-garutsidDa-ganDarva-ajuzwEH prahvAH tam sarva
   eva praṇamata satataṃ buddham ādityabandhum.	eva praNamata satatam budDam Aditya-banDum.
   divyaiś candanacūrṇamiśranikarair mandānilodbhāsitair	divyEH candana-cUrNa-miSra-nikarEH manda-anila-udBAsitEH-
   vīṇāveṇumṛdaṅgadundubhiravair gandharvagītisvaraiḥ	vINA-veNu-mRdaFga-dunduBi-H-avEH ganDarva-gIti-svarEH
   yo jātaḥ kṣitipālakaḥ pracalayan kṛtsnaṃ trilokālayaṃ	yaH jAtaH kzitipAlakaH pracalayan kRtsnam triloka-Alayam
   sarvajñāya niruddhasarvagataye buddhāya tasmai namaḥ.	sarvajQAya nirudDa-sarva-gataye budDAya tasmE namaH.
   bhagavatā sūtraṃ bhāṣitam.	BagavatA sUtram BAzitam.
   evaṃ mayā śrutam ekasmin samaye bhagavān śrāvastyāṃ viharati sma. jetavane	evam mayA Srutam ekasmin samaye BagavAn SrAvastyAm viharati sma. jetavane
   anāthapiṇḍadasyārāme. atha bhagavān pūrvāhṇe nivāsya pātracīvaram ādāya	anATapiNxadasya-ArAme. aTa BagavAn pUrvAhNe nivAsya pAtra-cIvaram AdAya
   śrāvastyāṃ piṇḍāya prāvikṣat. sāvadānaṃ śrāvastyāṃ piṇḍopacaraṇam. yena	SrAvastyAm piNxAya prAvikzat. sa-avadAnam SrAvastyAm piNxa-upacaraNam. yena
   śukasya māṇavasya taudeyaputrasya (MKV 22) niveśanaṃ tenopasaṃkrāntaḥ.	Sukasya mANavasya tOdeya-putrasya (MKV 22) niveSanam tena-upasaMkrAntaH.
   tena khalu punaḥ samayena śukasya māṇavasya taudeyaputrasya niveśane	tena Kalu punar samayena Sukasya mANavasya tOdeya-putrasya niveSane
   śaṅkhakuñjaro gonikāstṛte paryaṅke niṣaṇṇaḥ. aśmantakopadhānāyāṃ	SaFKa-kuQjaraH gonikAstRte paryaFke nizaNNaH. aSmantaka-upaDAnAyAm
   kāṃsyapātryāṃ śālimāṃsodanaṃ bhuṅkte. bhagavān adrākṣīt śaṅkhakuñjaraṃ	kAMsya-pAtryAm SAli-mAMsodanam BuFkte. BagavAn adrAkzIt SaFKa-kuQjaram
   goṇikāstṛte paryaṅke niṣaṇṇam aśmantakopādhānāyāṃ kāṃsyapātryāṃ	goNikAstRte paryaFke nizaNNam aSmantaka-upADAnAyAm kAMsya-pAtryAm
   paribhuñjānam. adrākṣīt śaṅkhakuñjaro bhagavantaṃ dvāramūle gatvā ca punar	pariBuQjAnam. adrAkzIt SaFKa-kuQjaraH Bagavantam dvAra-mUle gatvA ca punar-
   bukkati. atha bhagavān śaṅkhakuñjaram etad avocat. etad api te śaṅkha	bukkati. aTa BagavAn SaFKa-kuQjaram etat avocat. etat api te SaFKa
   [cittaṃ] na damayati yad asi bhokārād bukkāram āgataḥ. evam ukte	[cittaM] na damayati yat asi BokArAt bukkAram AgataH. evam ukte
   śaṅkhakuñjaro 'tiśayitaroṣaś caṇḍībhūto 'nāttamanā goṇikāstṛtāt paryaṅkād	SaFKa-kuQjaraH atiSayita-rozaH caNxIBUtaH anAtta-manAH goNikAstRtAt paryaFkAt-
   avatīryādhastāt paryaṅkasya dārusyandanikāyāṃ niṣaṇṇaḥ. tena khalu punaḥ	avatIrya-aDastAt paryaFkasya dAru-syandanikAyAm nizaNNaH. tena Kalu punar-
   samayena śuko māṇavas (MKV 23) taudeyaputro bahir gato 'bhūt kenacid eva	samayena SukaH mANavaH (MKV 23) tOdeya-putraH bahis gataH aBUt kenacid eva
   karaṇīyena. athāgacchac chuko māṇavas taudeyaputraḥ. adrākṣīt śuko māṇavas	karaNIyena. aTa-agacCat SukaH mANavaH tOdeya-putraH. adrAkzIt SukaH mANavas
   taudeyaputraś (MKV 24) śaṅkhakuñjaram adhastād dārusyandanikāyāṃ	tOdeya-putraH (MKV 24) SaFKa-kuQjaram aDastAt dAru-syandanikAyAm
   prapatitam. dṛṣṭvā ḥ janam āmantrayate. kena vo yuṣmākaṃ śaṇkhakuñjaraḥ	prapatitam. dRzwvA H janam Amantrayate. kena vaH yuzmAkam SaNKa-kuQjaraH
   (MKV 25) kiṃcid uktaḥ. ko 'smākaṃ madhye madīyaputraṃ śaṅkhakuñjaraṃ	(MKV 25) kiMcid uktaH. kaH asmAkam maDye madIya-putram SaFKa-kuQjaram
   kiṃcid vakṣyati. api tv āgato 'bhūt śramaṇo gautamaḥ. dvāramūle (MKV 26)	kiMcid vakzyati. api tu AgataH aBUt SramaNaH gOtamaH. dvAra-mUle (MKV 26)
   'vasthitaṃ tam itthaṃ bukkati. tam enaṃ śramaṇo gautama evam āha. etad api	avasTitam tam itTam bukkati. tam enam SramaNaH gOtamaH evam Aha. etat api
   te śaṅkha na damayati yad asi bhokārād bukkāram āgataḥ. evam ukte	te SaFKa na damayati yat asi BokArAt bukkAram AgataH. evam ukte
   śaṇkhakuñjaro 'tiśayitakupitaś caṇḍībhūto 'nāttamanā goṇikāstṛtāt	SaNKa-kuQjaraH atiSayita-kupitaH caNxIBUtaH anAtta-manAH goNikAstRtAt-
   paryaṅkād avatīryādhastāt paryaṅkasya dārusyandanikāyāṃ niṣaṇṇaḥ. atha	paryaFkAt avatIrya-aDastAt paryaFkasya dAru-syandanikAyAm nizaNNaH. aTa
   śukaḥ (kro)dhābhiṣaktaḥ kupitas caṇḍībhūto 'nāttamanā goṇikān niṣkramya	SukaH (kro)DA-aBizaktaH kupitaH caNxIBUtaH anAtta-manAH goNikAn nizkramya
   yena jetavanam anāthapiṇḍadasyārāmas tenopasaṃkrāntaḥ. tena khalu punaḥ	yena jetavanam anATapiNxadasya-ArAmaH tena-upasaMkrAntaH. tena Kalu punar-
   samayena bhagavān anekaśatāyāṃ bhikṣuparṣadi purastān niṣaṇṇo dharmaṃ	samayena BagavAn aneka-SatAyAm Bikzu-parzadi purastAt nizaNNaH Darmam
   deśayati. adrākṣīd bhagavān śukaṃ māṇavakaṃ taudeyaputraṃ dūrād	deSayati. adrAkzIt BagavAn Sukam mANavakam tOdeya-putram dUrAt-
   evāgacchantam. dṛṣṭvā ca punar bhikṣūn āmantrayate sma. paśyata yūyaṃ	eva-AgacCantam. dRzwvA ca punar BikzUn Amantrayate sma. paSyata yUyam
   bhikṣavaḥ śukaṃ māṇavaṃ taudeyaputram ita evāgacchantam. evaṃ bhadanta.	BikzavaH Sukam mANavam tOdeya-putram itas eva-AgacCantam. evam Badanta.
   sacec chuko māṇavas taudeyaputro 'smin samaye kālaṃ kuryāt. yathā bhallo	saced SukaH mANavaH tOdeya-putraH asmin samaye kAlam kuryAt. yaTA BallaH-
   nikṣiptaḥ evaṃ kāyasya bhedāt paraṃ maraṇād apāyadurgativinipāte 'vicau	nikziptaH evam kAyasya BedAt param maraNAt apAya-durgati-vinipAte avicO
   narakeṣūpapadyeta. tathā hy anena mamāntike cittaṃ pradūṣitam.	narakezu-upapadyeta. taTA hi anena mama-antike cittam pradUzitam.
   cittapradūṣanād dhetor evam iha [ke] satvāḥ kāyasya bhedāt paraṃ maraṇād	citta-pradUzanAt DetoH evam iha [ke] satvAH kAyasya BedAt param maraNAt-
   apāyadurgatyavīcau narakeṣūpapadyante. athānyatamo bhikṣus tasyāṃ velāyāṃ	apAya-durgati-avIcO narakezu-upapadyante. aTa-anyatamaH BikzuH tasyAm velAyAm
   gāthāṃ bhāṣate sma.	gATAm BAzate sma.
   praduṣṭacittaṃ dṛṣṭvaiva ekatyam iha pudgalam	praduzwa-cittam dRzwvA-eva ekatyam iha pudgalam
   etam arthaṃ vyākārṣīc chāstā bhikṣugaṇāntike.	etam arTam vyAkArzIt SAstA Bikzu-gaNa-antike.
   idānīṃ batāvikṣepaṃ kālaṃ kurvīta māṇavaḥ	idAnIm bata-avikzepam kAlam kurvIta mANavaH
   narakeṣūpapadyeta cittaṃ hy etena dūṣitam.	narakezu-upapadyeta cittam hi etena dUzitam.
   yathā hy ucitaṃ nikṣiptam evam eva tathāgate	yaTA hi ucitam nikziptam evam eva taTAgate
   cittapradūṣaṇād dhetoḥ satvā gacchanti durgatim.	citta-pradUzaNAt DetoH satvAH gacCanti durgatim.
   adhikṣepya māṇavas taudeyaputro yena bhagavān tenopasaṃkrāntaḥ. (MKV 27)	aDikzepya mANavaH tOdeya-putraH yena BagavAn tena-upasaMkrAntaH. (MKV 27)
   upasaṃkramya bhagavatā sārdhaṃ sukhasaṃbhāvanāyāṃ saṃrajanīyāṃ vividhāṃ	upasaMkramya BagavatA sArDam suKa-saMBAvanAyAm saMrajanIyAm viviDAm
   kathāṃ vyatisāryaikānte niṣaṇṇaḥ śuko māṇavas taudeyaputro bhagavantam	kaTAm vyatisArya-ekAnte nizaNNaH SukaH mANavaH tOdeya-putraH Bagavantam
   idam evāvocat. āgato bhagavān gautamo 'smākaṃ niveśanam. āgamane bhagavatā	idam eva-avocat. AgataH BagavAn gOtamaH asmAkam niveSanam. Agamane BagavatA
   gautamena śaṅkhakuñjaraḥ kiṃcid uktaḥ. ihāhaṃ māṇava pūrvāhṇe nivāsya	gOtamena SaFKa-kuQjaraH kiMcid uktaH. iha-aham mANava pUrvAhNe nivAsya
   pātracīvaram ādāya śrāvastyāṃ piṇḍāya prāvikṣat. sāvadānaṃ śrāvastyāṃ	pAtra-cIvaram AdAya SrAvastyAm piNxAya prAvikzat. sa-avadAnam SrAvastyAm
   piṇḍopacaraṇam. yena bhavato 'tra niveśanaṃ tenopasaṃkrāntaḥ. upasaṃkramya	piNxa-upacaraNam. yena BavataH atra niveSanam tena-upasaMkrAntaH. upasaMkramya
   dvāramūle 'vasthitaḥ. tena khalu punaḥ samayena śaṅkhakuñjaro	dvAra-mUle avasTitaH. tena Kalu punar samayena SaFKa-kuQjaraH-
   goṇikāstṛtamañcake 'dhirūḍho 'śmantakopadhānāyāṃ kāṃsyapātryāṃ	goNikAH-tRta-maQcake aDirUXaH aSmantakopaDAnAyAm kAMsya-pAtryAm
   śālimāṃsodanaṃ paribhuṅkte. adrākṣīt śaṅkhakuñjaro māṃ dvāramūle	SAli-mAMsodanam pariBuFkte. adrAkzIt SaFKa-kuQjaraH mAm dvAra-mUle
   'vasthitaṃ dṛṣṭvā ca punar bukkati. tam enam evaṃ vadā[mi. etad api te]	avasTitam dRzwvA ca punar bukkati. tam enam evam vada-a[mi. etat api te]
   śaṅkha na damayati yad asi bhokārād bukkāram āgataḥ. evam ukte	SaFKa na damayati yat asi BokArAt bukkAram AgataH. evam ukte
   śaṅkhakuñjaro 'bhiṣaktaḥ kupitaś caṇḍībhūto 'nāttamanā goṇikāstṛtāt	SaFKa-kuQjaraH aBizaktaH kupitaH caNxIBUtaH anAtta-manAH goNikAstRtAt-
   paryaṅkād avatīryādhastāt paryaṅkasya dārusyandanikāyāṃ niṣaṇṇaḥ. kiṃ	paryaFkAt avatIrya-aDastAt paryaFkasya dAru-syandanikAyAm nizaNNaH. kim
   punar bhagavān gautamaḥ śaṅkhakuñjarasyāsmākaṃ pūrvasyāṃ jātaṃ jānīte.	punar BagavAn gOtamaH SaFKa-kuQjarasya-asmAkam pUrvasyAm jAtam jAnIte.
   alaṃ māṇava tiṣṭha mā etam arthaṃ pariprākṣīt. mā te bhaviṣyati āghātaś	alam mANava tizWa mA etam arTam pariprAkzIt. mA te Bavizyati AGAta-S
   cākṣāntiś ca cetaso daurmanasyam. dvir api trir api śuko māṇavas	cAkzAntiH ca cetasaH dOrmanasyam. dvis api tris api SukaH mANavas
   taudeyaputro bhagavantam etad avocat. kiṃ punar bhagavān gautamo 'smākaṃ	tOdeya-putraH Bagavantam etat avocat. kim punar BagavAn gOtamaH asmAkam
   śaṅkhakuñjaraṃ pūrvikāyāṃ jātaṃ saṃjānīte. alaṃ māṇava tiṣṭha mā mām etam	SaFKa-kuQjaram pUrvikAyAm jAtam saMjAnIte. alam mANava tizWa mA mAm etam
   arthaṃ pariprākṣīt. mā ihaiva ca te bhaviṣyaty āghātaś cākṣāntiś ca cetaso	arTam pariprAkzIt. mA iha-eva ca te Bavizyati AGAtaH ca-akzAntiH ca cetasaH-
   daurmanasyam. anātha tvaṃ māṇava yāvad dvir api trir apy eta marthaṃ nā	dOrmanasyam. anATa tvam mANava yAvat dvis api tris api eta marTam nA
   ...... māṇava śṛṇu sādhu ca suṣṭhu ca manasi kuru. bhāṣiṣye. yas te māṇava	...... mANava SRNu sADu ca suzWu ca manasi kuru. BAzizye. yaH te mANava
   pitā taudeyaḥ sa eṣa kāyasya bhedād dhīnāyāṃ śvayonāv upapannaḥ. tad bho	pitA tOdeyaH saH eza kAyasya BedAt DInAyAm Sva-yonO upapannaH. tat Bo
   gautama evaṃ bhaviṣyati. asmākaṃ pitā ya iṣṭayajña āhitāgnir ucchritayūpaḥ	gOtamaH evam Bavizyati. asmAkam pitA yaH izwa-yajQaH AhitAgniH ucCrita-yUpaH
   sannīyate kāyasya bhedāt śubhre brahmaloke upapanno bhaviṣyaty. anenaiva	sannIyate kAyasya BedAt SuBre brahma-loke upapannaH Bavizyaty. anena-eva
   te māṇava mānābhimānena pitā taudeyo mahādānapatiḥ śvayonāv upapannaḥ.	te mANava mAna-aBimAnena pitA tOdeyaH mahA-dAna-patiH Sva-yonO upapannaH.
   pitur māṇava yadi me bhāṣitaṃ na (MKV 28) śraddadhāsi tena hi tvaṃ māṇava	pituH mANava yadi me BAzitam na (MKV 28) SraddaDAsi tena hi tvam mANava
   yena te niveśanaṃ tenopasaṃkrama. upasaṃkramya śaṅkhakuñjaram evaṃ vada.	yena te niveSanam tena-upasaMkrama. upasaMkramya SaFKa-kuQjaram evam vada.
   saced bhavāñ chaṅkhakuñjaro 'smākaṃ pūrvikāyāṃ jātaḥ pitābhūt taudeyo	saced BavAn CaFKa-kuQjaraH asmAkam pUrvikAyAm jAtaH pitA-aBUt tOdeyaH-
   'dhiroha goṇikāstṛtaṃ paryaṅkam. adhirokṣyati. adhirūḍhaṃ caivaṃ vada.	aDiroha goNikAstRtam paryaFkam. aDirokzyati. aDirUXam ca-evam vada.
   saced bhavāñ chaṅkhakuñjaro 'smākaṃ pūrvikāyāṃ jātaḥ pitābhūt taudeyaḥ	saced BavAn CaFKa-kuQjaraH asmAkam pUrvikAyAm jAtaH pitA-aBUt tOdeyaH
   paribhuñjīta bhavān. aśmantakopadhānāyāṃ kāṃsyapātryāṃ śālimāṃsodanaṃ	pariBuQjIta BavAn. aSmantakopaDAnAyAm kAMsya-pAtryAm SAli-mAMsodanam
   paribhokṣyate. bhuktavantam enaṃ vada. saced bhavāñ chaṅkhakuñjaro 'smākaṃ	pariBokzyate. Buktavantam enam vada. saced BavAn CaFKa-kuQjaraH asmAkam
   pūrvikāyāṃ jātaḥ pitābhūt taudeyaḥ yat te 'smākaṃ maraṇasamaye mama santaṃ	pUrvikAyAm jAtaH pitA-aBUt tOdeyaH yat te asmAkam maraNa-samaye mama santam
   svāpateyaṃ nopadarśitaṃ tad upadarśaya. upadarśayiṣyati.	svApateyam na-upadarSitam tat upadarSaya. upadarSayizyati.
   atha śuko māṇavas taudeyaputro bhagavatā bhāṣitam udgṛhya paryavāpya yena	aTa SukaH mANavaH tOdeya-putraH BagavatA BAzitam udgRhya paryavApya yena
   svakaṃ niveśanaṃ tenopasaṃkrāntaḥ. upasaṃkramya śaṅkhakuñjaram etad	svakam niveSanam tena-upasaMkrAntaH. upasaMkramya SaFKa-kuQjaram etat-
   avocat. saced bhavāñ chaṅkhakuñjaro 'smākaṃ pūrvikāyāṃ jātaḥ pitābhūt	avocat. saced BavAn CaFKa-kuQjaraH asmAkam pUrvikAyAm jAtaH pitA-aBUt-
   taudeyaḥ adhiroha. goṇikāstṛtaparyaṅke 'dhirūḍhaṃ cainam evam āha. saced	tOdeyaH aDiroha. goNikAstRta-paryaFke aDirUXam ca-enam evam Aha. saced-
   bhavāñ chaṅkhakuñjaro 'smākaṃ pūrvikāyāṃ jātaḥ pitābhūt taudeyaḥ	BavAn CaFKa-kuQjaraH asmAkam pUrvikAyAm jAtaH pitA-aBUt tOdeyaH
   paribhuñjīta bhavān aśmantakopadhānāyāṃ kāṃsyapātryāṃ śālimāṃsodanam.	pariBuQjIta BavAn aSmantakopaDAnAyAm kAMsya-pAtryAm SAli-mAMsodanam.
   paribhuktavān. bhuktavantaṃ cainam evam āha. saced bhavāñ chaṅkhakuñjaro	pariBuktavAn. Buktavantam ca-enam evam Aha. saced BavAn CaFKa-kuQjaraH-
   'smākaṃ pūrvikāyāṃ jātaḥ pitābhūt taudeyaḥ yat te 'smākaṃ maraṇasamaye	asmAkam pUrvikAyAm jAtaH pitA-aBUt tOdeyaH yat te asmAkam maraNa-samaye
   mama santaṃ svāpateyaṃ nopadarśitaṃ tad upadarśaya. atha śaṅkhakuñjaro	mama santam svApateyam na-upadarSitam tat upadarSaya. aTa SaFKa-kuQjaraH-
   goṇikāstṛtaparyaṅkād avatīrya yenānyatamapurāṇavāsagṛhaṃ tenopasaṃkrāntaḥ.	goNikAstRta-paryaFkAt avatIrya yena-anyatama-purANa-vAsa-gRham tena-upasaMkrAntaH.
   upasaṃkramya caturaḥ paryaṅkapādukān pādanakharikābhir avalikhitamadhyaṃ	upasaMkramya caturaH paryaFka-pAdukAn pAdana-KarikABiH avaliKita-maDyam
   ca mukhatuṇḍakenopajighrati. yataḥ sa śuko māṇavas taudeyaputraḥ	ca muKa-tuNxakena-upajiGrati. yatas sa SukaH mANavaH tOdeya-putraH
   kṛtākṛtasya hiraṇyasuvarṇasya caturo lohasaṃghāṭān adhigatavān madhyāc ca	kRta-akRtasya hiraNya-suvarNasya caturaH loha-saMGAwAn aDigatavAn maDyAt ca
   sauvarṇakamaṇḍalum.	sOvarNa-kamaNxalum.
   atha śuko māṇavas taudeyaputras tat suvarṇaṃ gopayitvā	aTa SukaH mANavaH tOdeya-putraH tat suvarNam gopayitvA
   hṛṣṭatuṣṭodagraprītisaumanasyajātaḥ śrāvastyā niṣkramya yena bhagavāṃs	hRzwa-tuzwa-udagra-prIti-sOmanasya-jAtaH SrAvastyAH nizkramya yena BagavAn=-
   tenopasaṃkrāntaḥ. tena khalu punaḥ samayena bhagavān anekaśatāyāṃ	tena-upasaMkrAntaH. tena Kalu punar samayena BagavAn aneka-SatAyAm
   bhikṣuparṣadi purastān niṣaṇṇo dharmaṃ deśayati. adrākṣīd (MKV 29)	Bikzu-parzadi purastAt nizaNNaH Darmam deSayati. adrAkzIt (MKV 29)
   bhagavāñ chukaṃ māṇavaṃ taudeyaputraṃ dūrata evāgacchantaṃ dṛṣṭvā ca punar	BagavAn Cukam mANavam tOdeya-putram dUratas eva-AgacCantam dRzwvA ca punar-
   bhikṣūn āmantrayate sma. paśyatha yūyaṃ bhikṣavaḥ śukaṃ māṇavaṃ	BikzUn Amantrayate sma. paSyaTa yUyam BikzavaH Sukam mANavam
   taudeyaputraṃ dūrata evāgacchantam. evaṃ bhadanta. sacec chuko māṇavas	tOdeya-putram dUratas eva-AgacCantam. evam Badanta. saced SukaH mANavas
   taudeyaputro 'smin samaye kālaṃ kuryād yathā bhallo nikṣiptaḥ evaṃ kāyasya	tOdeya-putraH asmin samaye kAlam kuryAt yaTA BallaH nikziptaH evam kAyasya
   bhedāt sugatau svargalokeṣūpapadyeta. tathā hy anena mamāntike cittaṃ	BedAt sugatO svarga-lokezu-upapadyeta. taTA hi anena mama-antike cittam
   prasāditam. cittaprasādanahetor bhikṣavaḥ evam ihaike satvā kāyasya bhedāt	prasAditam. citta-prasAdana-hetoH BikzavaH evam iha-eke satvA kAyasya BedAt-
   sugatau svargalokeṣūpapadyante. athānyatamo bhikṣus tasyāṃ velāyāṃ gāthāṃ	sugatO svarga-lokezu-upapadyante. aTa-anyatamaH BikzuH tasyAm velAyAm gATAm
   bhāṣate.	BAzate.
   prasannacittaṃ dṛṣṭvaiva ekatyam iha pudgalam	prasanna-cittam dRzwvA-eva ekatyam iha pudgalam
   etam arthaṃ vyākārṣīc chāstā bhikṣugaṇāntike.	etam arTam vyAkArzIt SAstA Bikzu-gaNa-antike.
   idānīṃ gatadoṣo 'yaṃ kālaṃ kurvīta mānavaḥ	idAnIm gata-dozaH ayam kAlam kurvIta mAnavaH
   upapadyeta deveṣu cittam asya prasāditam.	upapadyeta devezu cittam asya prasAditam.
   yathā duritaṃ nikṣiptam evam eva tathāgate	yaTA duritam nikziptam evam eva taTAgate
   cittaprasādanād dhetoḥ satvā gacchanti sadgatim.	citta-prasAdanAt DetoH satvAH gacCanti sat-gatim.
   atha śuko māṇavas taudeyaputro yena bhagavān tenopasaṃkrāntaḥ.	aTa SukaH mANavaH tOdeya-putraH yena BagavAn tena-upasaMkrAntaH.
   upasaṃkramya bhagavatā sārdhaṃ saṃmukhaṃ saṃmodanīṃ saṃrañjanīṃ vividhāṃ	upasaMkramya BagavatA sArDam saMmuKam saMmodanIm saMraQjanIm viviDAm
   kathāṃ vyatisāryaikānte niṣaṇṇaḥ. evaṃ niṣaṇṇaṃ śukaṃ māṇavaṃ	kaTAm vyatisArya-ekAnte nizaNNaH. evam nizaNNam Sukam mANavam
   taudeyaputraṃ bhagavān idam avocat. kaccin māṇava tathaiva yathā mayā	tOdeya-putram BagavAn idam avocat. kaccit mANava taTA-eva yaTA mayA
   śaṅkhakuñjaro vyākṛtaḥ. bho gautama tat tathaiva yathā bhagavatā gautamena	SaFKa-kuQjaraH vyAkRtaH. Bo gOtama tat taTA-eva yaTA BagavatA gOtamena
   śaṅkhakunjaro vyākṛtaḥ. anyad api tāvad vayaṃ bhagavantaṃ gautamaṃ	SaFKa-kunjaraH vyAkRtaH. anyat api tAvat vayam Bagavantam gOtamam
   pṛcchema kaṃcid eva pradeśaṃ saced avakāśaṃ kuryāt praśnavyākaraṇāya.	pRcCema kaMcid eva pradeSam saced avakASam kuryAt praSna-vyAkaraNAya.
   pṛccha māṇava yady evaṃ kāṅkṣasi. ko bho gautama hetuḥ kaḥ pratyayaḥ	pRcCa mANava yadi evam kAFkzasi. kaH Bo gOtama hetuH kaH pratyayaH
   yenehaike satvā alpāyuṣo 'pi dīrghāyuṣo 'pi bahvābādhā api alpābādhā api	yena-iha-eke satvAH alpa-AyuzaH api dIrGa-AyuzaH api bahu-AbADAH api alpa-AbADAH api
   durvarṇā api suvarṇā api alpeśākhyā api maheśākhyā api nīcakulīnā api	durvarNAH api suvarNAH api alpa-ISa-AKyA api maheSa-AKyAH api nIca-kulInAH api
   uccakulīnā api anādeyavākyā api ādeyavākyā api alpabhogā api mahābhogā api	ucca-kulInAH api anAdeya-vAkyAH api Adeya-vAkyAH api alpa-BogAH api mahA-BogAH api
   duṣprajñā api mahāprajñā api. kasya nu bho gautama karmaṇo vipākenedaṃ	duzprajQAH api mahA-prajQAH api. kasya nu Bo gOtama karmaNaH vipAkena-idam
   satvānāṃ nānātvaṃ prajnāyate.	satvAnAm nAnAtvam prajnAyate.
   tatra bhagavāñ chukaṃ māṇavakaṃ taudeyaputram idam avocat. karmavibhaṅgaṃ	tatra BagavAn Cukam mANavakam tOdeya-putram idam avocat. karma-viBaFgam
   te māṇavaka dharmaparyāyaṃ deśayiṣyami. tenahi (MKV 30) śṛṇu sādhu suṣṭhu	te mANavaka Darma-paryAyam deSayizyami. tena-hi (MKV 30) SRNu sADu suzWu
   ca manasi kuru. bhāṣiṣye. evaṃ bhagavann iti śuko māṇavakas taudeyaputro	ca manasi kuru. BAzizye. evam Bagavan iti SukaH mANavakaH tOdeya-putraH-
   bhagavataḥ pratyaśrauṣīt. bhagavān idam avocat. karmasvakān ahaṃ māṇava	BagavataH pratyaSrOzIt. BagavAn idam avocat. karma-svakAn aham mANava
   satvān vadāmi karmadāyādān karmayonīn karmapratiśaraṇān. karma māṇava	satvAn vadAmi karma-dAyAdAn karma-yonIn karma-pratiSaraNAn. karma mANava
   satvān vibhajati. yad idaṃ hīnotkṛṣṭamadhyamatāyām. tadyathā. asti karma	satvAn viBajati. yat idam hIna-utkRzwa-maDyamatA-AyAm. tat-yaTA. asti karma
   alpāyuḥsaṃvartanīyam. asti karma dīrghāyuḥsaṃvartanīyam. asti karma	alpa-AyuH-saMvartanIyam. asti karma dIrGa-AyuH-saMvartanIyam. asti karma
   bahvābādhāsaṃvartanīyam. asti karma alpābādhāsaṃŚ. a. k. durvarṇas. a. k.	bahu-AbADA-saMvartanIyam. asti karma alpa-AbADa-asaMŚ. a. k. durvarNas. a. k.
   prāsādikas. a. k. alpeśākhyas. a. k. maheśākhyas. a. k. nīcākulopapattis.	prAsAdikas. a. k. alpa-ISa-AKyas. a. k. maheSa-AKyas. a. k. nIca-Akula-upapatti-s.
   a. k. uccakulopapattis. a. k. alpabhogas. a. k. mahābhogas. a. k.	a. k. ucca-kula-upapatti-s. a. k. alpa-Bogas. a. k. mahA-Bogas. a. k.
   duṣprajnas. a. k. mahāprajñas. a. k. narakopapattis. a. k.	duzprajnas. a. k. mahA-prajQas. a. k. nara-ka-upapattis. a. k.
   tiryagyonyupapattis. a. k. pretalokopapattis. a. k. asuralokopapattis. a.	tiryagyoni-upapattis. a. k. preta-loka-upapattis. a. k. asura-loka-upapattis. a.
   k. manuṣyalokopapattis. a. k. kāmāvacaradevopapattis. a. k.	k. manuzya-loka-upapatti-s. a. k. kAma-avacaradeva-upapattis. a. k.
   rūpāvacaradevopapattis. a. k. ārūpyāvacaradevopapattis. a. k. kṛtaṃ	rUpAvacara-deva-upapattis. a. k. ArUpya-avacaradeva-upapatti-s. a. k. kRtam
   nopacitam. a. k. upacitaṃ na kṛtam. a. k. kṛtam upacitaṃ ca. a. k. naiva	na-upacitam. a. k. upacitam na kRtam. a. k. kRtam upacitam ca. a. k. na-eva
   kṛtaṃ nopacitam. a. k. yena samanvāgataḥ pudgalo narakeṣūpapannaḥ	kRtam na-upacitam. a. k. yena samanvAgataH pudgalaH narakezu-upapannaH
   paripūrṇaṃ nairayikam āyuḥ kṣapayitvā cyavati. a. k. yena samanvāgataḥ	paripUrNam nErayikam AyuH kzapayitvA cyavati. a. k. yena samanvAgataH
   pudgalo narakeṣūpapannaḥ sārdhanairayikam āyuḥ kṣapayitvā cyavati. a. k.	pudgalaH narakezu-upapannaH sArDa-nErayikam AyuH kzapayitvA cyavati. a. k.
   y. s. p. narakeṣūpapannamātra eva cyavati. a. k. niyatopapattis. a. k.	y. s. p. narakezu-upapanna-mAtraH eva cyavati. a. k. niyata-upapattis. a. k.
   aniyatopapattis. a. k. deśāntaravipakṣam. a. k. y. s. p. pūrvaṃ sukhito	aniyata-upapattis. a. k. deSa-antara-vipakzam. a. k. y. s. p. pUrvam suKitaH-
   bhūtvā paścād duḥkhito bhavati. a. k. y. s. p. pūrvaṃ duḥkhito bhūtvā	BUtvA paScAt duHKitaH Bavati. a. k. y. s. p. pUrvam duHKitaH BUtvA
   paścād api sukhito bhavati. a. k. y. s. p. pūrvaṃ sukhito bhūtvā paścāt	paScAt api suKitaH Bavati. a. k. y. s. p. pUrvam suKitaH BUtvA paScAt-
   sukhito bhavati. a. k. y. s. p. pūrvaṃ duḥkhito bhūtvā paścād api duḥkhito	suKitaH Bavati. a. k. y. s. p. pUrvam duHKitaH BUtvA paScAt api duHKitaH-
   bhavati. a. k. (MKV 31) y. s. p. āḍhyo bhavati matsarī. a. k. y. s. p.	Bavati. a. k. (MKV 31) y. s. p. AXyaH Bavati matsarI. a. k. y. s. p.
   daridro bhavati tyāgavān. a. k. y. s. p. āḍhyo bhavati tyāgavān. a. k. y.	daridraH Bavati tyAgavAn. a. k. y. s. p. AXyaH Bavati tyAgavAn. a. k. y.
   s. p. [sic] asti pudgalo yasya karma kṣīṇaṃ bhavati nāyuḥ. asti pudgalo	s. p. [sic] asti pudgalaH yasya karma kzINam Bavati na-AyuH. asti pudgalaH-
   yasyāyuḥ kṣīṇaṃ na karma. a. p. y. āyuḥ karmāṇi ca kṣīṇāni. a. p. y. āyuḥ	yasya-AyuH kzINam na karma. a. p. y. AyuH karmANi ca kzINAni. a. p. y. AyuH
   kṣīṇaṃ puṇyāni ca. a. p. yasya nāyuḥ kṣīṇaṃ bhavati na karma. api tu	kzINam puNyAni ca. a. p. yasya na-AyuH kzINam Bavati na karma. api tu
   kleśāḥ kṣīṇāḥ. a. p. kāyena sukhī na cittena. a. p. cittena sukhī na	kleSAH kzINAH. a. p. kAyena suKI na cittena. a. p. cittena suKI na
   kāyena. a. p. kāyena ca sukhī cittena ca. a. p. naiva kāyena sukhī na	kAyena. a. p. kAyena ca suKI cittena ca. a. p. na-eva kAyena suKI na
   cittena. a. k. y. s. pudgalo 'pāyeṣūpapanno 'bhirūpo bhavati snigdhakāyaḥ	cittena. a. k. y. s. pudgalaH apAyezu-upapannaH aBirUpaH Bavati snigDa-kAyaH
   snigdhacchavir nayanābhirāmo darśanīyaḥ. a. k. y. s. pudgalo	snigDa=-CaviH nayana-aBirAmaH darSanIyaH. a. k. y. s. pudgalaH-
   'pāyeṣūpapanno durvarṇo bhavati rūkṣakāyo ghoradarśanaḥ pratikūladarśanaḥ.	apAyezu-upapannaH durvarNaH Bavati rUkza-kAyaH Gora-darSanaH pratikUla-darSanaH.
   a. k. y. s. p. apāyeṣūpapanno durgandho bhavati jihmendriyo bhavaty	a. k. y. s. p. apAyezu-upapannaH durganDaH Bavati jihma-indriyaH Bavati-
   avyaktendriyaḥ. daśānām akuśalānāṃ karmapathānāṃ vipākena daśānāṃ bāhyānāṃ	avyakta-indriyaH. daSAnAm akuSalAnAm karma-paTAnAm vipAkena daSAnAm bAhyAnAm
   bhāvānām abhivṛddhiḥ prajñāyate. daśānāṃ kuśalānāṃ karmapathānāṃ vipākena	BAvAnAm aBivRdDiH prajQAyate. daSAnAm kuSalAnAm karma-paTAnAm vipAkena
   daśānāṃ bāhyānāṃ bhāvānāṃ vipattiḥ prajñāyate. daśānuśaṃsās	daSAnAm bAhyAnAm BAvAnAm vipattiH prajQAyate. daSa-anuSaMsAs
   tathāgatacaityāñjalikarmaṇaḥ. daśānuśaṃsās tathāgatacaityavandanāyāḥ.	taTAgata-cEtya-aQjali-karmaNaH. daSa-anuSaMsAH taTAgata-cEtya-vandanAyAH.
   daśānuśaṃsāś chattrapradānasya. daśānuśaṃsā ghaṇṭāpradānasya. daśānuśaṃsā	daSa-anuSaMsAH Cattra-pradAnasya. daSa-anuSaMsA GaNwA-pradAnasya. daSa-anuSaMsA
   vastrapradānasya. daśānuśaṃsā āsanapradānasya. daśānuśaṃśā	vastra-pradAnasya. daSa-anuSaMsAH Asana-pradAnasya. daSa-anuSaMSA
   bhājanapradānasya. daśānuśaṃsā bhojanapradānasya. daśānūśaṃsā yānapradāne.	BAjana-pradAnasya. daSa-anuSaMsAH Bojana-pradAnasya. daSa-anu-uSaMsAH yAna-pradAne.
   dasānuśaṃsāḥ pratiśrayapradānasya. daśānuśaṃsāḥ pānakapradāne.	dasa-anuSaMsAH pratiSraya-pradAnasya. daSa-anuSaMsAH pAnaka-pradAne.
   daśānuśaṃsāḥ phalapradāne. daśānuśaṃsā mālāpradānasya. daśānusaṃsā	daSa-anuSaMsAH Pala-pradAne. daSa-anuSaMsA mAlA-pradAnasya. daSa-anusaMsA
   muktapuṣpapradānasya. daśānuśaṃsāḥ pradīpapradānasya. daśānuśaṃsā	mukta-puzpa-pradAnasya. daSa-anuSaMsAH pradIpa-pradAnasya. daSa-anuSaMsA
   gandhapradānasya. (MKV 32) daśānuśaṃsāḥ pravrajyāyāḥ. daśānnśaṃsā	ganDa-pradAnasya. (MKV 32) daSa-anuSaMsAH pravrajyAyAH. daSAnnSaMsA
   araṇyavāse. dasānuśaṃsāḥ paiṇḍapātikatve. daśa vaiśāradyāni.	araNya-vAse. dasa-anuSaMsAH pENxapAtika-tve. daSa vESAradyAni.
   uddeśaḥ karmavibhaṅgasya dharmaparyāyasya.	uddeSaH karma-viBaFgasya Darma-paryAyasya.
   I. tatra katamat karma alpāyuḥsaṃvartanīyam? ucyate. prāṇātipātaḥ.	I. tatra katamat karma alpa-AyuH-saMvartanIyam? ucyate. prANa-atipAtaH.
   prāṇātipātasya anumodanam. prāṇātipātasya varṇavāditā.	prANa-atipAtasya anumodanam. prANa-atipAtasya varNa-vAdi-tA.
   amitramaraṇābhinandanam. amitramaraṇasya samādāpanam. amitramaraṇasya	amitra-maraNa-aBinandanam. amitra-maraNasya samAdApanam. amitra-maraNasya
   varṇavāditā. garbhaśātanam. garbhaśātanasya varṇavāditā.	varNa-vAdi-tA. garBa-SAtanam. garBa-SAtanasya varNa-vAdi-tA.
   sthaṇḍilapratiṣṭhāpanaṃ yatra bahavaḥ prāṇino ghātyante	sTaNxila-pratizWApanam yatra bahavaH prANinaH GAtyante
   mahiṣapaśuśūkarakukkuṭādayaḥ tasya yajñapravartakasya putrāḥ pautrāś cānye	mahiza-paSu-SUkara-kukkuwa-AdayaH tasya yajQa-pravartakasya putrAH pOtrAH ca-anye
   ca janāḥ phalārthino bhayabhītāś cānuvṛttiṃ kurvāṇāḥ sattvān	ca janAH Pala-arTinaH Baya-BItAH ca-anuvRttim kurvANAH sattvAn
   nirghātayanti.	nirGAtayanti.
   a) yathā kāśmīrāyāṃ mahānagaryāṃ bhikṣuḥ kilārhann anyatarasmin gṛhadvāre	a) yaTA kASmIrAyAm mahA-nagaryAm BikzuH kila-arhan anyatarasmin gRha-dvAre
   tiṣṭhati. tasya gṛhasya pārśvena rājapathas tena paśū ravamāṇo nīyate. sa	tizWati. tasya gRhasya pArSvena rAja-paTaH tena paSuH ravamANaH nIyate. sa
   bhikṣus taṃ dṛṣṭvā hāhā dhik kaṣṭam iti vadati. puruṣās taṃ pṛcchanti.	BikzuH tam dRzwvA hAhA Dik kazwam iti vadati. puruzAH tam pRcCanti.
   ārya kim ayaṃ hādhikkaṣṭam iti śabdaḥ. sa āha. na vaktavyam etad	Arya kim ayam ha-aDikkazwam iti SabdaH. saH Aha. na vaktavyam etat-
   aśrāddhānām. kāryārthaṃ tu bravīmi. ya eṣa paśū ravamāṇo nīyate. anena	aSrAdDAnAm. kArya-arTam tu bravImi. yaH eza paSuH ravamANaH nIyate. anena
   purā vaṇigīśvareṇa bhūtvā sthaṇḍilaṃ pratiṣṭhāpitam. sāṃvatsarikaś ca	purA vaNij-ISvareNa BUtvA sTaNxilam pratizWApitam. sAMvatsarikaH ca
   paśuyajñaḥ pravartitaḥ. tatrānena bahavaḥ paśavo ghātitāḥ. maraṇakāle ca	paSu-yajQaH pravartitaH. tatra-anena bahavaH paSavaH GAtitAH. maraNa-kAle ca
   putrān āhūya prāha. putrāḥ. yady asti mayi sneho ya eṣa mayā sāṃvatsarikaḥ	putrAn AhUya prAha. putrAH. yadi asti mayi snehaH yaH eza mayA sAMvatsarikaH
   paśuyajñaḥ pravartitaḥ. eṣa mayi kālagate 'nupravartayitavya iti. putrais	paSu-yajQaH pravartitaH. eza mayi kAlagate anupravartayitavyaH iti. putrEH-
   tathāstv iti pratiśrutam. sa kālagatas tena mohajena prāṇātipātena (MKV	taTA-astu iti pratiSrutam. sa kAlagataH tena moha-jena prANa-atipAtena (MKV
   33) samanvāgataḥ svagṛhe paśuḥ pratyājātaḥ. sa tatra jātau jātau ghātyate.	33) samanvAgataH sva-gRhe paSuH pratyAjAtaH. sa tatra jAtO jAtO GAtyate.
   adhunā ekaṣaṣṭitamaṃ vāraṃ nīyate. atha sa bhikṣus taṃ paśuṃ karuṇāyamāṇa	aDunA eka-zazwitamam vAram nIyate. aTa sa BikzuH tam paSum karuNAyamANa-
   āha. svayam eva te sthaṇḍilaṃ kṛtaṃ svayam eva yajñaḥ pravartitaḥ bahavaḥ	Aha. svayam eva te sTaNxilam kRtam svayam eva yajQaH pravartitaH bahavaH
   paśavaś ca ghātitāḥ. kiṃ ravase. sarvam idaṃ nirarthakam.	paSavaH ca GAtitAH. kim ravase. sarvam idam nirarTakam.
   b) yathaivaṃvidhaṃ sthaṇḍilapratiṣṭhāpanam. tathā yuddhadarśanam. yatra	b) yaTA-evaMviDam sTaNxila-pratizWApanam. taTA yudDa-darSanam. yatra
   bahavaḥ sattvā ghātyante hastyaśvamanuṣyādayaḥ. yuddhapratibaddhānāṃ ca	bahavaH sattvAH GAtyante hasti-aSva-manuzya-AdayaH. yudDa-pratibadDAnAm ca
   śastrāṇām abhinandanam.	SastrANAm aBinandanam.
   c) yathā coktaṃ bhagavatā vaiśālyāṃ kālikasūtre. prāṇātipāta ānanda sevito	c) yaTA ca-uktam BagavatA vESAlyAm kAlika-sUtre. prANa-atipAtaH Ananda sevitaH-
   bahulīkṛto niraya saṃvartanīyo bhavati. tiryagyonisaṃvartanīyo 'pi	bahulIkRtaH niraya saMvartanIyaH Bavati. tiryagyoni-saMvartanIyaH api
   bhavati. pretaviṣayasaṃvartanīyo 'pi bhavati. yasmād alpaprāṇātipātasya	Bavati. preta-vizaya-saMvartanIyaH api Bavati. yasmAt alpa-prANa-atipAtasya
   vipāko manuṣyabhūtasya sato alpāyuḥsaṃvartanīyo 'pi bhavati.	vipAkaH manuzya-BUtasya sataH alpa-AyuH-saMvartanIyaH api Bavati.
   d) tathā daśādīnavā nandikasūtra uktāḥ prāṇātipātasya.	d) taTA daSa-AdInavAH nandika-sUtraH uktAH prANa-atipAtasya.
   idaṃ karma alpāyuḥsaṃvartanīyam.	idam karma alpa-AyuH-saMvartanIyam.
   II. tatra katamat karma dīrghāyuḥsaṃvartanīyam. ucyate. prāṇātipātān	II. tatra katamat karma dIrGa-AyuH-saMvartanIyam. ucyate. prANa-atipAtAn
   nivṛttiḥ. prāṇātipātanivṛttau varṇavāditā. tatra samādāpanam.	nivRttiH. prANa-atipAta-nivRttO varNa-vAditA. tatra samAdApanam.
   tadvarṇavāditā. vadhyaprāptānāṃ manuṣyapaśusūkarakukkuṭādīnāṃ parimocanam.	tad-varNa-vAditA. vaDya-prAptAnAm manuzya-paSu-sUkara-kukkuwa-AdInAm parimocanam.
   bhītānāṃ sattvānām abhayapradānam (MKV 34) anāthānāṃ sattvānāṃ madhye	BItAnAm sattvAnAm aBaya-pradAnam (MKV 34) anATAnAm sattvAnAm maDye
   kāruṇyacittatā. glānānāṃ sattvānāṃ madhye maitracittatā. anyeṣāṃ ca	kAruNya-citta-tA. glAnAnAm sattvAnAm maDye mEtra-citta-tA. anyezAm ca
   bālavṛddhānām. teṣām eva bhojanapradānam. pratigrāhakeṣu ca maitracittatā.	bAla-vRdDAnAm. tezAm eva Bojana-pradAnam. pratigrAhakezu ca mEtra-citta-tA.
   yat pūrvoktaṃ kuśalapakṣeṇa yuddhadarśanādi. tathā stūpacaityavihārāṇāṃ	yat pUrva-uktam kuSala-pakzeNa yudDa-darSana-Adi. taTA stu-upacEtya-vihArANAm
   śīrṇānāṃ pratisaṃskaraṇam. ataevoktam.	SIrNAnAm pratisaMskaraNam. ataeva-uktam.
   akālamṛtyur na bhavet tasya	akAla-mRtyuH na Bavet tasya
   yo bhagnaśīrṇaṃ pratisaṃskaroti.	yaH Bagna-SIrNam pratisaMskaroti.
   a) tathā bakapratyekabrahmasūtraṃ varṇayanti sma. tena kila ṛṣibhūtena	a) taTA baka-pratyeka-brahmasUtram varNayanti sma. tena kila Rzi-BUtena
   pañcābhijñena tṛṣṇārtasya sārthasya pathabhraṣṭasya upari ṛddhyā varṣaṃ	paQca-aBijQena tRzNA-Artasya sArTasya paTa-Brazwasya upari RdDyA varzam
   pātitam. tadarthaṃ ca bhagavatā gāthā bhāṣitā.	pAtitam. tad-arTam ca BagavatA gATA BAzitA.
   tat te purāṇaṃ vrataśīlavṛttaṃ	tat te purANam vrata-SIla-vRttam
   svapnād vibuddho 'ham iha smarāmi.	svapnAt vibudDaH aham iha smarAmi.
   tatra ca sārthe bodhisattvaḥ sārthavāho 'bhūt.	tatra ca sArTe boDisattvaH sArTavAhaH aBUt-.
   ya eṇīkūlej anatāṃ gṛhītām.	yaH eNI-kUlet anatAm gRhItAm.
   eṇī nāma nadī yasyā anukūle rājā kaścid gṛhītaḥ pratyamitreṇa (MKV 35)	eNI nAma nadI yasyAH anukUle rAjA kaScid gRhItaH pratyamitreNa (MKV 35)
   himavantam anupraviśya sa nīyamāna eva vadhyaṃ prāptaḥ sabalavāhanaḥ. tena	himavantam anupraviSya sa nIyamAnaH eva vaDyam prAptaH sa-bala-vAhanaH. tena
   ṛṣibhūtena ṛddhyā vātavarṣaṃ muktam. sa copāyena pratyamitrajanakāyo	Rzi-BUtena RdDyA vAta-varzam muktam. sa ca-upAyena pratyamitra-janakAyaH-
   vibhrāmitaḥ. sa rājā mokṣitaḥ.	viBrAmitaH. sa rAjA mokzitaH.
   tat te dvitīyaṃ vrataśīlavṛttaṃ	tat te dvitIyam vrata-SIla-vRttam
   svapnād vibuddho 'nusmarāmi.	svapnAt vibudDaH anusmarAmi.
   sa ca rājā bodhisattvo babhūva.	sa ca rAjA boDisattvaH baBUva.
   gaṅgāsrotasi nāvā gṛhītā	gaFgA-srotasi nAvA gRhItA
   nāgena ghoreṇa ṛddhikena.	nAgena GoreNa RdDikena.
   sa ca tadā ṛṣir gaṅgākūle maharddhikaḥ pañcābhijñaḥ pratiśarati. tena ca	sa ca tadA RziH gaFgA-kUle mahardDikaH paQca-aBijQaH pratiSarati. tena ca
   kāyaḥ krandamāno jīvitena nirāśas tato mokṣitaḥ.	kAyaH krandamAnaH jIvitena nirASaH tatas mokzitaH.
   tat te tṛtīyaṃ vrataśīlavṛttaṃ	tat te tRtIyam vrata-SIla-vRttam
   svapnād vibuddho 'nusmarāmi.	svapnAt vibudDaH anusmarAmi.
   tasyāṃ ca nāvāyāṃ nausvāmī bodhisattvas tena kālenābhūt. evaṃ vidhaṃ te	tasyAm ca nAvAyAm na-osvAmI boDisattvaH tena kAlena-aBUt. evam viDam te
   trividhaṃ karma kṛtam, tato 'tīva dīrghāyuḥ.	triviDam karma kRtam, tatas atIva dIrGa-AyuH.
   b) yathā kecid ācāryāḥ kathayanti. bhagavān āha. bhūtapūrvaṃ bhikṣavo	b) yaTA kecid AcAryAH kaTayanti. BagavAn Aha. BUta-pUrvam BikzavaH-
   jambudvīpe sarvajanapadamārī vartate sma. athānyatareṇa	jambudvIpe sarva-janapada-mArI vartate sma. aTa-anyatareNa
   sattvenānyalokadhātau sthitena ṛddhimataḥ sakāśāc chrutam. yathā	sattvena-anya-lokaDAtO sTitena RdDimataH sakASAt Srutam. yaTA
   jambudvīpe sarvamārī pātiteti. tena kṛtapuṇyena praṇidhānaṃ kṛtam. (MKV	jambudvIpe sarva-mArI pAtita-iti. tena kRta-puNyena praNiDAnam kRtam. (MKV
   36) jambudvīpe upapadyāhaṃ sarvasattvānāṃ vyādhipraṇāśāya jāyeyeti. sa	36) jambudvIpe upapadya-aham sarva-sattvAnAm vyADi-praNASAya jAyeyA-iti. sa
   tatropapannaḥ. ye ca sattvās tṛṣitās teṣāṃ pānīyena vyādhiṃ nāśayati. ye	tatra-upapannaH. ye ca sattvAH tRzitAH tezAm pAnIyena vyADim nASayati. ye
   ca bubhukṣitās teṣāṃ bhaktena vyādhiṃ nāśayati. evaṃ yena yasyārthas	ca buBukzitAH tezAm Baktena vyADim nASayati. evam yena yasya-arTa-s
   tenaiva tasya vyādhiṃ nāśayati. na nāma tasya kiṃcid apy anauṣadhaṃ. yad	tena-eva tasya vyADim nASayati. na nAma tasya kiMcid api anOzaDan. yat-
   yad eva gṛhya prayacchati tat tad evauṣadham. tasya jambudvīpakair	yat eva gRhya prayacCati tat tat eva-OzaDam. tasya jambudvIpakEH-
   manuṣyaiḥ sarvauṣadhir ekanāma kṛtam. atha bhikṣavaḥ sarvauṣadhivaidyarājo	manuzyEH sarva-ozaDiH eka-nAma kRtam. aTa BikzavaH sarva-ozaDi-vEdya-rAjaH-
   bahūnāṃ sattvasahasrāṇāṃ jīvitāni dattvā kālagataḥ. kālāntareṇa mithilāyāṃ	bahUnAm sattva-sahasrANAm jIvitAni dattvA kAlagataH. kAla-antareNa miTilAyAm
   rājakule upapannaḥ. tato 'pi tena mahādevabhūtena aśītikṣatriyasahasrāṇi	rAja-kule upapannaH. tatas api tena mahAdeva-BUtena aSIti-kzatriya-sahasrANi
   dharmadeśanayā pravrajitāni. jambudvīpe 'śītivarṣasahasrāṇi manuṣyāṇām	Darma-deSanayA pravrajitAni. jambudvIpe aSIti-varza-sahasrANi manuzyANAm
   āyur na parikṣīṇam. tataś cyutaḥ kālāntareṇa kuśīnagaryāṃ māndhātā	AyuH na parikzINam. tatas cyutaH kAla-antareNa kuSInagaryAm mAnDAtA
   saṃvṛttaḥ. bhūyaś ca saptasūryopadeśe (MKV 37) sunetro nāma mānavo	saMvRttaH. BUyas ca sapta-sUrya-upadeSe (MKV 37) sunetraH nAma mAnavaH-
   vijñeyaḥ. ahaṃ sa bhikṣavas tena kālena sarvauṣadhivaidyarājo 'bhūt. tasya	vijQeyaH. aham sa BikzavaH tena kAlena sarva-ozaDi-vEdya-rAjaH aBUt. tasya
   karmaṇo vipākena mahādevasyāyuḥpramāṇaṃ yojayitavyam. māndhātṛsunetrābhyām	karmaNaH vipAkena mahAdevasya-AyuH-pramANam yojayitavyam. mAnDAtR-sunetrAByAm
   apy evāyuḥpramāṇaṃ yojayitavyam. idaṃ karma dīrghāyuḥsaṃvartanīyam.	api eva-AyuH-pramANam yojayitavyam. idam karma dIrGa-AyuH-saMvartanIyam.
   III. katamat karma bahvābādhāsaṃvartanīyam. ucyate. khaṭacapeṭapradānam.	III. katamat karma bahu-AbADA-saMvartanIyam. ucyate. Kawa-capewa-pradAnam.
   khaṭacapeṭapradānasyānumodanam. khaṭacapeṭapradānasya varṇavāditā. teṣāṃ	Kawa-capewa-pradAnasya-anumodanam. Kawa-capewa-pradAnasya varNa-vAdi-tA. tezAm
   pradānena tuṣṭiḥ. mātāpitroś cittaśarīre pīḍākaraṇaṃ tathānyeṣāṃ	pradAnena tuzwiH. mAtA-pitroH citta-SarIre pIxA-karaNam taTA-anyezAm
   pravrajitānāṃ śīlavatāṃ cittasaṃkleśaḥ. amitravyādhinā tuṣṭiḥ.	pravrajitAnAm SIlavatAm citta-saMkleSaH. amitra-vyADinA tuzwiH.
   amitravyādhivyutthānenātuṣṭiḥ. vyādditānām abhaiṣajyapradānam.	amitra-vyADi-vyutTAnena-atuzwiH. vyAdditAnAm aBEzajya-pradAnam.
   tathāparijīrṇabhojanam. idaṃ karma bahvābādhāsaṃvartanīyam.	taTA-aparijIrNa-Bojanam. idam karma bahu-AbADA-saMvartanIyam.
   IV. katamat karma alpābādhāsaṃvartanīyam. ucyate. khaṭacapeṭapradānān	IV. katamat karma alpa-AbADA-saMvartanIyam. ucyate. Kawa-capewa-pradAnAn
   nivṛttiḥ. tatra samādāpanam. tadvarṇavāditā. tadabhyanumodanam. glānānāṃ	nivRttiH. tatra samAdApanam. tad-varNa-vAditA. tad-aByanumodanam. glAnAnAm
   mātāpitṝṇām upasthānakaraṇam. tad apy anyeṣāṃ gṛhasthapravrajitānām.	mAtA-pitLNAm upasTAna-karaNam. tat api anyezAm gRhasTa-pravrajitAnAm-.
   amitravyādhinānāttamanaskatā. tasya vyutthānena cāttamanaskatā.	amitra-vyADinA-anAtta-manaskatA. tasya vyutTAnena ca-Atta-manaskatA.
   bhaiṣajyapradānam. parijīrṇabhojanaṃ ca. idaṃ karma	BEzajya-pradAnam. parijIrNa-Bojanam ca. idam karma
   alpābādhāsaṃvartanīyam.	alpa-AbADA-saMvartanIyam.
   V. katamat karma durvarṇasaṃvartanīyam. ucyate. krodhaḥ. upanāhaḥ mrakṣaḥ.	V. katamat karma durvarNa-saMvartanIyam. ucyate. kroDaH. upanAhaH mrakzaH.
   pradāśaḥ. mātāpitror avarṇavāditā. anyeṣāṃ ca (MKV 38)	pradASaH. mAtA-pitroH avarNa-vAdi-tA. anyezAm ca (MKV 38)
   gṛhasthapravrajitānāṃ bālavṛddhānām. stūpāṅgaṇacaityagṛhavihārāṇāṃ ca	gRhasTa-pravrajitAnAm bAla-vRdDAnAm. stu-upAFgaNa-cEtya-gRha-vihArANAm ca
   bhūmer aviśodhanam. stūpānāṃ pratimāṇāṃ ca dīpavyucchedaḥ. durvarṇānāṃ	BUmeH aviSoDanam. stUpAnAm pratimANAm ca dIpa-vyucCedaH. durvarNAnAm
   sattvānām avahasanam. tathā caukṣasamudācāratā. idaṃ karma	sattvAnAm avahasanam. taTA cOkza-samudAcAra-tA. idam karma
   durvarṇasaṃvartanīyam.	durvarNa-saMvartanIyam.
   VI. katamat karma prāsādikasaṃvartanīyam. ucyate. akrodhaḥ. anupanāhaḥ.	VI. katamat karma prAsAdika-saMvartanIyam. ucyate. akroDaH. anupanAhaH.
   amrakṣaḥ. vastrapradānam. stūpacaityagṛheṣu ca sudhādānam. suvarṇapātra	amrakzaH. vastra-pradAnam. stu-upacEtya-gRhezu ca suDA-dAnam. suvarNa-pAtra
   dānam. gandhalepapradānam. alaṃkārapradānam. mātāpitror varṇavāditā.	dAnam. ganDa-lepa-pradAnam. alaMkAra-pradAnam. mAtA-pitroH varNa-vAdi-tA.
   āryāṇāṃ śīlavatāṃ varṇavāditā stūpāṅgaṇavihārāṇāṃ saṃmārjanam. satataṃ	AryANAm SIlavatAm varNa-vAdi-tA stu-upAFgaNa-vihArANAm saMmArjanam. satatam
   gṛhasaṃmārjanam. virūpāṇāṃ sattvānām anavahasanaṃ tathānyeṣāṃ	gRha-saMmArjanam. virUpANAm sattvAnAm anavahasanam taTA-anyezAm
   bālavṛddhānām. tathā caukṣasamudācāratā.	bAla-vRdDAnAm. taTA cOkza-samudAcAra-tA.
   a) yathā āryasundaranandena kila krakucchande samyaksaṃbuddhe bhikṣusaṃghe	a) yaTA Arya-sundara-nandena kila krakucCande samyaksaMbudDe Bikzu-saMGe
   jentākasnānaṃ kṛtam. tāṃś ca dṛṣṭvā cittaṃ prasāditam. bhūyaś ca suvarṇena	jentAka-snAnam kRtam. tAn ca dRzwvA cittam prasAditam. BUyas ca suvarNena
   haritālena pratyekabuddhastūpe lepo dattaḥ. idam api dṛṣṭvā cittaṃ	haritAlena pratyekabudDastUpe lepaH dattaH. idam api dRzwvA cittam
   prasāditam. abhirūpatāyāṃ ca pariṇāmitam. bhūyaś ca stūpe kriyamāṇe	prasAditam. aBirUpa-tAyAm ca pariNAmitam. BUyas ca stUpe kriyamANe
   prathamaṃ chattraṃ kāritam. yathā paścimabhave sa eva vyākaroti.	praTamam Cattram kAritam. yaTA paScima-Bave saH eva vyAkaroti.
   jentākasya ca snānena haritālasya lepanena ca	jentAkasya ca snAnena haritAlasya lepanena ca
   ekacchattrapradānāc ca prāptā me suvarṇavarṇatā.	eka=-Cattra-pradAnAt ca prAptA me suvarNa-varNa-tA.
   tathaivāyaṃ śobhitavān. idaṃ karma prāsādikasaṃvartaniyam.	taTA-eva-ayam SoBitavAn. idam karma prAsAdika-saMvarta-niyam.
   (MKV 39)	(MKV 39)
   VII. katamat karma alpeśākhyasaṃvartanīyam. ucyate. īrṣyā. mātsaryam.	VII. katamat karma alpa-ISa-AKya-saMvartanIyam. ucyate. IrzyA. mAtsaryam.
   parasya lābhenātuṣṭiḥ. parasya varṇavāditāyā atuṣṭiḥ. mātāpitroḥ	parasya lABena-atuzwiH. parasya varNa-vAdi-tAyAH atuzwiH. mAtA-pitroH
   paribhavaḥ. āryāṇāṃ śīlavatāṃ paribhavaḥ. tathānyeṣāṃ	pariBavaH. AryANAm SIlavatAm pariBavaH. taTA-anyezAm
   vyādhitabālavṛddhānām. hīne dharmahīne 'kuśalamūle varṇavāditā.	vyADita-bAla-vRdDAnAm. hIne Darma-hIne akuSala-mUle varNa-vAdi-tA.
   bodhicittotpādasya nivāraṇam. tadabhyanumodanam. idaṃ karma	boDi-citta-utpAdasya nivAraNam. tad-aByanumodanam. idam karma
   alpeśākhyasaṃvartanīyam.	alpa-ISa-AKya-saMvartanIyam.
   VIII. katamat karma maheśākhyasaṃvartanīyam. ucyate. anīrṣyā. amātsaryam.	VIII. katamat karma maheSa-AKya-saMvartanIyam. ucyate. anIrzyA. amAtsaryam.
   paralābhena tuṣṭiḥ. parasya yaśovarṇaśabdaślokaśravaṇena tuṣṭiḥ. parasya	para-lABena tuzwiH. parasya yaSaH-varNa-Sabda-Sloka-SravaNena tuzwiH. parasya
   varṇavāditāyā āttamanaskatā. bhagavataś caityastūpakārāpaṇam. hīne	varNa-vAdi-tAyAH Atta-manaskatA. BagavataH cEtyaH-tu-upakAra-ApaNam. hIne
   dharmahīne 'kuśalamūle nivāraṇam. maheśākhyakuśalamūle samādāpanam.	Darma-hIne akuSala-mUle nivAraNam. maheSa-AKya-kuSala-mUle samAdApanam.
   bodhicittotpādanam. sarvamaheśākhyakuśalamūle bodhicittotpādanam.	boDi-citta-utpAdanam. sarva-maheSa-AKya-kuSala-mUle boDi-citta-utpAdanam.
   a) yathoktaṃ bhagavatā vārāṇasyāṃ pūrvāparāntake sūtre (MKV 40) 'jitasya	a) yaToktam BagavatA vArANasyAm pUrva-aparAntake sUtre (MKV 40) ajitasya
   bodhisattvasya samuttejanaṃ kṛtam. mahate khalu te 'jita autsukyāya cittaṃ	boDisattvasya samuttejanam kRtam. mahate Kalu te ajita OtsukyAya cittam
   damayati. yad idaṃ saṃghaparihāpaṇāya. vakṣyatehi.	damayati. yat idam saMGa-parihApaNa-aya. vakzyatehi.
   maitreyas tuṣitasurālayādhivāsī	mEtreyaH tuzita-surAlayA-aDivAsI
   prāptavyā divi bhuvi ceha yena pūjā	prAptavyA divi Buvi ca-iha yena pUjA
   sa śrīmān daśabalatām avāpya śīghraṃ	sa SrImAn daSa-balatAm avApya SIGram
   lokānāṃ bhavatu śaśīva nityapūjyaḥ.	lokAnAm Bavatu SaSI-iva nitya-pUjyaH.
   idaṃ karma maheśākhyasaṃvartanīyam.	idam karma maheSa-AKya-saMvartanIyam.
   IX. katamat karma nīcakulasaṃvartanīyam. ucyate. stabdhatā. abhimānitā ca.	IX. katamat karma nIca-kula-saMvartanIyam. ucyate. stabDa-tA. aBimAnitA ca.
   amātāpitṛjñatā. aśrāmaṇyatā. abrāhmaṇyatā. akulajyeṣṭhāpacāyitā.	amAtA-pitR-jQa-tA. aSrAmaNya-tA. abrAhmaNya-tA. akula-jyezWa-apacAyitA.
   mātāpitror apratyupasthānam. āryāṇāṃ śīlavatām apratyupasthānam. anyeṣāṃ	mAtA-pitroH apratyupasTAnam. AryANAm SIlavatAm apratyupasTAnam. anyezAm
   ca gurusthānīyānām ācāryopādhyāyānām apratyupasthānam. nīcakulānāṃ	ca guru-sTAnIyAnAm AcArya-upADyAyAnAm apratyupasTAnam. nIca-kulAnAm
   satvānāṃ paribhavaḥ. idaṃ karma nīcakulasaṃvartanīyam.	satvAnAm pariBavaH. idam karma nIca-kula-saMvartanIyam.
   X. katamat karma uccakulasaṃvartanīyam. ucyate. astabdhatā. anabhimānitā.	X. katamat karma uccakula-saMvartanIyam. ucyate. astabDa-tA. anaBimAnitA.
   mātāpitṛjñatā. śrāmaṇyatā. brāhmaṇyatā. kulajyeṣṭhāpacāyitā. mātāpitroḥ	mAtA-pitR-jQa-tA. SrAmaNyatA. brAhmaNya-tA. kula-jyezWa-apacAyitA. mAtA-pitroH
   pratyupasthānam. āryāṇāṃ śīlavatāṃ pratyupasthānam. anyeṣāṃ ca	pratyupasTAnam. AryANAm SIlavatAm pratyupasTAnam. anyezAm ca
   gurusthānīyānām ācāryopādhyāyānāṃ pratyupasthānam. nīcakulānāṃ satvānām	guru-sTAnIyAnAm AcArya-upADyAyAnAm pratyupasTAnam. nIca-kulAnAm satvAnAm
   aparibhavaḥ.	apariBavaH.
   a) yathā ca bhagavatā sūtra uktam. yato bhikṣavaḥ kuśalaśīlavanto	a) yaTA ca BagavatA sUtre uktam. yatas BikzavaH kuSala-SIlavantaH-
   brahmacārinaḥ kalyāṇadharmāṇaḥ pravrajitā upasaṃkramanti pañca tasmin kule	brahmacArinaH kalyANa-DarmANaH pravrajitAH upasaMkramanti paQca tasmin kule
   'nuśaṃsāḥ pratyanuśaṃsitavyāḥ. katame pañca. iha bhikṣavaḥ upasaṃkrānteṣu	anuSaMsAH pratyanuSaMsitavyAH. katame paQca. iha BikzavaH upasaMkrAntezu
   śīlavatsu cittāni prasādayanti svargasaṃvartanīyaṃ (MKV 41) tad bhikṣavaḥ	SIlavatsu cittAni prasAdayanti svarga-saMvartanIyam (MKV 41) tat BikzavaH
   kulaṃ tasmin samaye pratipadaṃ pratipannaṃ bhavati. punar aparaṃ bhikṣavaḥ	kulam tasmin samaye pratipadam pratipannam Bavati. punar aparam BikzavaH
   upasaṃkrānteṣu śīlavatsu abhivādayanti pratyuttiṣṭhanti.	upasaMkrAntezu SIlavatsu aBivAdayanti pratyuttizWanti.
   uccakulasaṃvartanīyaṃ bhikṣavaḥ. tasmin samaye pratipadaṃ pratipannaṃ	ucca-kula-saMvartanIyam BikzavaH. tasmin samaye pratipadam pratipannam
   bhavati. evaṃ sarvasūtraṃ yojyam. idaṃ karma uccakulasaṃvartanīyam.	Bavati. evam sarva-sUtram yojyam. idam karma uccakula-saMvartanIyam.
   XI. katamat karma alpabhogasaṃvartanīyam. ucyate. adattādānam.	XI. katamat karma alpa-Boga-saMvartanIyam. ucyate. adatta-AdAnam.
   adattādānasamādāpanam. cauryavarṇavāditā. tadabhyanumodanam. mātāpitror	adatta-AdAna-samAdApanam. cOrya-varNa-vAditA. tad-aByanumodanam. mAtA-pitroH-
   vṛttyupacchedaḥ. tathānyeṣāṃ vyādhitabālavṛddhakṛpaṇānāṃ vṛttyupacchedaḥ.	vRtti-upacCedaH. taTA-anyezAm vyADita-bAla-vRdDa-kRpaNAnAm vRtti-upacCedaH.
   parasya lābhenātuṣṭiḥ. paralābhāntarāyakriyā durbhikṣābhinandanaṃ ca. idaṃ	parasya lABena-atuzwiH. para-lABa-antarAya-kriyA durBikza-aBinandanam ca. idam
   karma alpabhogasaṃvartanīyam.	karma alpa-Boga-saMvartanIyam.
   XII. tatra katamat karma mahābhogasaṃvartanīyam. ucyate. adattādānān	XII. tatra katamat karma mahA-Boga-saMvartanIyam. ucyate. adatta-AdAnAn
   nivṛttiḥ pareṣāṃ cādattādānān nivāraṇam. pareṣām adattādānanivṛttānāṃ	nivRttiH parezAm ca-Adatta-AdAnAt nivAraNam. parezAm adatta-AdAna-nivRttAnAm
   samanumodanam. mātāpitror vṛttipradānam. āryāṇāṃ ca śīlavatāṃ	samanumodanam. mAtA-pitroH vRtti-pradAnam. AryANAm ca SIlavatAm
   vṛttipradānam. tathānyeṣāṃ vyādhitabālavṛddhakṛpaṇānāṃ vṛttipradānam.	vRtti-pradAnam. taTA-anyezAm vyADita-bAla-vRdDa-kRpaNAnAm vRtti-pradAnam.
   paralābhena tuṣṭiḥ. parasyālābhenātuṣdḥ. paralābhasamanumodanam.	para-lABena tuzwiH. parasya-alABena-atuzdH. para-lABa-samanumodanam.
   subhikṣābhinandanam.	su-Bikza-aBinandanam.
   a) tad eva sūtraṃ yojyam. punar aparaṃ bhikṣavaḥ upasaṃkrānteṣu śīlavatsu	a) tat eva sUtram yojyam. punar aparam BikzavaH upasaMkrAntezu SIlavatsu
   dānāni dadanti puṇyāni ca kurvanti. mahābhogasaṃvartanīyaṃ bhikṣavas tat	dAnAni dadanti puNyAni ca kurvanti. mahA-Boga-saMvartanIyam BikzavaH tat-
   kulaṃ tasmin samaye pratipadaṃ pratipannaṃ bhavati. idaṃ karma	kulam tasmin samaye pratipadam pratipannam Bavati. idam karma
   mahābhogasaṃvartanīyam.	mahA-Boga-saMvartanIyam.
   XIII. tatra katamat karma duṣprajñasaṃvartanīyam. ucyate. ihaikatyo na	XIII. tatra katamat karma duzprajQa-saMvartanIyam. ucyate. iha-ekatyaH na
   parān pṛcchati. paṇḍitān. śramaṇān. brāhmaṇān. ko dharmaḥ kiṃ dharmaṃ	parAn pRcCati. paNxitAn. SramaNAn. brAhmaNAn. kaH DarmaH kim Darmam
   kurvataḥ śreyaskaram iti. api tu duṣprajñān sevati. paṇḍitān	kurvataH Sreyaskaram iti. api tu duzprajQAn sevati. paNxitAn
   parivarjayati. asaddharmaṃ dīpayati. saddharmaṃ vigarhati.	parivarjayati. asat-Darmam dIpayati. sadDarmam vigarhati.
   saddharmabhāṇakānāṃ vaiśāradyopacchedaṃ karoti. saddharmabhāṇakānām	sat-Darma-BANakAnAm vESAradya-upacCedam karoti. sat-Darma-BANakAnAm
   abhiniveśena na sādhukāraṃ dadāti. asaddharmabhāṇakānāṃ (MKV 42)	aBiniveSena na sADu-kAram dadAti. asat-Darma-BANakAnAm (MKV 42)
   sādhukāraṃ dadāti. mithyādṛṣṭiṃ varṇayati. samyagdṛṣṭiṃ vigarhati. tathā	sADu-kAram dadAti. miTyA-dRzwim varNayati. samyak-dRzwim vigarhati. taTA
   pustakalekhakavācakānāṃ vṛttyupacchedaṃ karoti.	pustaka-leKaka-vAcakAnAm vRtti-upacCedam karoti.
   a) sūtre coktam. unmattakasaṃvartanīyam ... karoti. saṃmūḍhakaś ca kālaṃ	a) sUtre ca-uktam. unmattaka-saMvartanIyam ... karoti. saMmUXakaH ca kAlam
   karoti. duṣprajñaś ca bhavati. yathoktaṃ nandikasūtre. pañcatriṃśad	karoti. duzprajQaH ca Bavati. yaToktam nandika-sUtre. paQcatriMSat-
   ādīnavāḥ surāmaireyamadyapramādasthāne yojayitavyāḥ. buddhe cāgauravo	AdInavAH surA-mEreya-madya-pramAda-sTAne yojayitavyAH. budDe ca-agOravaH-
   bhavati. dharme saṃghe cāgauravo bhavati. ataḥ śākyasūtraṃ yojayitavyam.	Bavati. Darme saMGe ca-agOravaH Bavati. atas SAkya-sUtram yojayitavyam.
   yadā ca bhagavān kapilavastum āgataḥ sa madyapānadoṣān na kadācid	yadA ca BagavAn kapilavastum AgataH sa madya-pAna-dozAt na kadAcid-
   bhagavantam upasaṃkrāntaḥ. caturbhiḥ sthavirair bhagavatā preṣitair gatvā	Bagavantam upasaMkrAntaH. caturBiH sTavirEH BagavatA prezitEH gatvA
   vinītaḥ kālagataś ca. śākyaḥ pṛcchati. bhagavan. tasya kā gatir iti.	vinItaH kAlagataH ca. SAkyaH pRcCati. Bagavan. tasya kA gatiH iti.
   bhagavān āha. ime 'pi ca me śākya bhāṣitasyārtham ājānīyur iti sūtraṃ (MKV	BagavAn Aha. ime api ca me SAkya BAzitasya-arTam AjAnIyuH iti sUtram (MKV
   43) yojayitavyam. yathā cūḍā panthako nāma bhikṣus tasya rājagṛhe	43) yojayitavyam. yaTA cUxA panTakaH nAma BikzuH tasya rAjagRhe
   prativasato bhagavatā gāthoddiṣṭā. sā ca varṣātyayena na śakitā grahītum.	prativasataH BagavatA gATA-uddizwA. sA ca varza-atyayena na SakitA grahItum-.
   bhikṣavo vismayaṃ prāptāḥ pṛcchanti. bhagavan kasyaiṣa karmaṇo vipākena	BikzavaH vismayam prAptAH pRcCanti. Bagavan kasya-eza karmaNaH vipAkena
   duṣprajñaḥ. bhagavān āha. kāśyape samyaksaṃbuddhe parinirvṛte eṣa āraṇyako	duzprajQaH. BagavAn Aha. kASyape samyaksaMbudDe parinirvRte ezaH AraNyakaH-
   bhikṣus tripiṭakas tatkālam abhūt. bhikṣūṇāṃ ca buddhapūjām akurvatāṃ	BikzuH tripiwakaH tad-kAlam aBUt. BikzUNAm ca budDa-pUjAm akurvatAm
   buddhavacanam antarhitam. te bhikṣavas tasya samīpaṃ gatāḥ asmākaṃ	budDa-vacanam antarhitam. te BikzavaH tasya samIpam gatAH asmAkam
   buddhavacanam antarhitam. asmākam apy upadeśaṃ kuruṣvety anena	budDa-vacanam antarhitam. asmAkam api upadeSam kuruzva-iti anena
   mātsaryadoṣāt teṣām upadeśo na kṛtaḥ. evaṃ tacchāsanam antarhitam. tasya	mAtsarya-dozAt tezAm upadeSaH na kRtaH. evam tad-SAsanam antarhitam. tasya
   karmaṇo vipākenaiṣa duṣprajñaḥ. idaṃ karma duṣprajñasaṃvartanīyam.	karmaNaH vipAkena-eza duzprajQaH. idam karma duzprajQa-saMvartanIyam.
   XIV. tatra katamat karma mahāprajñasaṃvartanīyam. ucyate. (MKV 44)	XIV. tatra katamat karma mahA-prajQa-saMvartanIyam. ucyate. (MKV 44)
   ihaikatyaḥ paripṛcchaka jātīyo bhavati paṇḍitāñ chramaṇān brāhmaṇān sevate	iha-ekatyaH paripRcCaka jAtIyaH Bavati paNxitAn CramaNAn brAhmaNAn sevate
   duṣprajñān parivarjayati. saddharmaṃ dīpayati. asaddharmaṃ vigarhati	duzprajQAn parivarjayati. sadDarmam dIpayati. asat-Darmam vigarhati
   dharmabhāṇakānāṃ vaiśāradyaṃ varṇayati. sahitabhāṣiṇāṃ sādhukāraṃ dadāti.	Darma-BANakAnAm vESAradyam varNayati. sahita-BAziNAm sADu-kAram dadAti.
   ahitabhāṣiṇaṃ pariharati. samyagdṛṣṭiṃ varṇayati. mithyādṛṣṭiṃ vigarhati.	ahita-BAziNam pariharati. samyak-dRzwim varNayati. miTyA-dRzwim vigarhati.
   masīpustakalekhanīpradānāni dadāti. na ca madyaṃ pibati. yathoktaṃ ca	masI-pustaka-leKanI-pradAnAni dadAti. na ca madyam pibati. yaTA-uktam ca
   nandikasūtre. pañcatriṃśad madyapānadoṣā akuśalapakṣeṇa yojayitavyāḥ. idaṃ	nandika-sUtre. paQcatriMSat madya-pAna-dozAH akuSala-pakzeNa yojayitavyAH. idam
   karma mahāprajñasaṃvartanīyam.	karma mahA-prajQa-saMvartanIyam.
   XV. tatra katamat karma narakopapattisaṃvartanīyam. ucyate. tīvraṃ	XV. tatra katamat karma naraka-upapatti-saMvartanIyam. ucyate. tIvram
   praduṣṭacittasya kāyavāṅmanoduścaritam. ucchedadṛṣṭiḥ. śāśvatadṛṣṭiḥ.	praduzwa-cittasya kAya-vAc-manaH-duScaritam. ucCeda-dRzwiH. SASvata-dRzwiH.
   nāstikadṛṣṭiḥ. akriyādṛṣṭiḥ. matsarivādaḥ. akṛtajñatā. ānantaryam. āryāṇāṃ	nAstika-dRzwiH. akriyA-dRzwiH. mad-sarivAdaH. akRtajQa-tA. Anantaryam. AryANAm
   śīlavatām abhūtābhyākhyānadānam. idaṃ karma narakopapattisaṃvartanīyam.	SIlavatAm aBUta-aByAKyAna-dAnam. idam karma naraka-upapatti-saMvartanIyam.
   XVI. tatra katamat karma tiryagyonyupapattisaṃvartanīyam. ucyate.	XVI. tatra katamat karma tiryagyoni-upapatti-saMvartanIyam. ucyate.
   madhyamaṃ kāyavāṅmanoduścaritaṃ vicitraṃ rāgasamutthitaṃ karma vicitraṃ	maDyamam kAya-vAc-manaH-duScaritam vicitram rAga-samutTitam karma vicitram
   dveṣasamutthitaṃ karma vicitraṃ mohasamutthitaṃ karma. mātāpitroḥ	dveza-samutTitam karma vicitram moha-samutTitam karma. mAtA-pitroH
   pravrajitānāṃ cākalpikapradānam. tiryagyonigatānāṃ satvānām avahasanam.	pravrajitAnAm ca-akalpika-pradAnam. tiryagyoni-gatAnAm satvAnAm avahasanam.
   tathā praṇidhānakarma yathā govratikakukkuravratikaprabhṛtīnāṃ praṇidhānam	taTA praNiDAna-karma yaTA govratika-kukkura-vratika-praBRtInAm praNiDAnam
   atropapadyeyam iti.	atra-upapadyeyam iti.
   a) yathā ca bodhisatvasya siṃha jātake 'vadānaṃ vaktavyam. yathā ca	a) yaTA ca boDisatvasya siMha jAtake avadAnam vaktavyam. yaTA ca
   varṣākārasya brāhmaṇasya markaṭopapattiḥ. tadyathā (MKV 45) varṣākāreṇa	varza-AkArasya brAhmaNasya markawa-upapattiH. tat-yaTA (MKV 45) varza-AkAreNa
   brāhmaṇena sthaviramahākāśyapo bhikṣū rājagṛhasyoparimeṇa gṛdhrakūṭāt	brAhmaNena sTavira-mahAkASyapaH BikzuH rAjagRhasya-uparimeNa gRDrakUwAt-
   parvatād ṛṣigiripārśvaṃ vihāyasā gacchan dṛṣṭaḥ. tena praduṣṭacittena	parvatAt Rzi-giri-pArSvam vihAyasA gacCan dRzwaH. tena praduzwa-cittena
   devadattājātaśatrusaṃsargād vāgduścaritaṃ kṛtam. eṣa śramaṇo vihāyasā	deva-dattA-jAta-Satru-saMsargAt vAc-duScaritam kRtam. eza SramaNaH vihAyasA
   gacchan parvatāt parvataṃ gacchati. tadyathā markaṭo vṛkṣād vṛkṣam eva.	gacCan parvatAt parvatam gacCati. tat-yaTA markawaH vRkzAt vRkzam eva.
   bhagavataḥ kathitam. varṣākāreṇa brāhmaṇena krodhajātena vāgduścaritaṃ	BagavataH kaTitam. varza-AkAreNa brAhmaNena kroDa-jAtena vAc-duScaritam
   kṛtam. tasya ko vipākaḥ. bhagavān āha. asya vāgduścaritasya vipākato	kRtam. tasya kaH vipAkaH. BagavAn Aha. asya vAc-duScaritasya vipAkataH-
   varṣākāro brāhmaṇaḥ pañca janmāntaraśatāni markaṭo bhaviṣyatīti. tatas	varza-AkAraH brAhmaNaH paQca janma-antara-SatAni markawaH Bavizyati-iti. tatas-
   tena varṣākāreṇa śrutaṃ bhagavatā nirdiṣṭatvaṃ kila pañca janmāntaraśatāni	tena varza-AkAreNa Srutam BagavatA nirdizwa-tvam kila paQca janma-antara-SatAni
   markaṭo bhaviṣyatīti. sa saṃvignacittaṃ prasāditavān. tena bhagavān	markawaH Bavizyati-iti. sa saMvigna-cittam prasAditavAn. tena BagavAn
   parinirvāṇakāle pṛṣṭaḥ. tasya karmaṇaḥ kadā parikṣaya iti. bhagavān āha.	parinirvANa-kAle pRzwaH. tasya karmaNaH kadA parikzayaH iti. BagavAn Aha.
   tāny eva pañca janmāntaraśatāni kiṃ tu rājagṛhe utpatsyase yathā jambvā	tAni eva paQca janma-antara-SatAni kim tu rAja-gRhe utpatsyase yaTA jambvA
   jambudvīpe jāyate. yatroṣṭrikāmātrāṇi phalāni. yathā kṣaudramadhv aneḍakam	jambudvIpe jAyate. yatra-uzwrikA-mAtrANi PalAni. yaTA kzOdra-maDu anexakam
   evamāsvādāni. (MKV 46) tatropapattir bhaviṣyati. tato vyutthitasya te	evam-AsvAdAni. (MKV 46) tatra-upapattiH Bavizyati. tatas vyutTitasya te
   sugatir bhaviṣyati. yathā cittapradūṣaṇena siṃheṣūpapannaḥ. tadarthaṃ ca	sugatiH Bavizyati. yaTA citta-pradUzaNena siMhezu-upapannaH. tad-arTam ca
   bhagavatā gāthā bhāṣitā.	BagavatA gATA BAzitA.
   dīrghā jāgarato rātrir dīrghaṃ śrāntasya yojanam	dIrGA jAgarataH rAtriH dIrGam SrAntasya yojanam
   dīrgho bālasya saṃsāraḥ saddharmam avijānataḥ.	dIrGaH bAlasya saMsAraH sadDarmam avijAnataH.
   idaṃ karma tiryagyonyupapattisaṃvartanīyam.	idam karma tiryagyoni-upapatti-saMvartanIyam.
   XVII. tatra katamat karma yamalokopapattisaṃvartanīyam. ucyate. kruddhasya	XVII. tatra katamat karma yama-loka-upapatti-saMvartanIyam. ucyate. krudDasya
   pratihatacittasya kāyavāṅmanoduścaritam. lobho viṣamalobho mithyājīvo	pratihata-cittasya kAya-vAc-manaH-duScaritam. loBaH vizama-loBaH miTyAjIvaH-
   jighāṃsitapipāsitasya kruddhasya kālakriyā. vastuṣv abhiṣaktacittasya	jiGAMsita-pipAsitasya krudDasya kAla-kriyA. vastuzu aBizakta-cittasya
   kālakriyā.	kAla-kriyA.
   a) yathā coktaṃ bhagavatā śatavarge āgame karmavibhaṅgasūtre. (MKV 47)	a) yaTA ca-uktam BagavatA Satavarge Agame karma-viBaFga-sUtre. (MKV 47)
   tasya khalu punar ānanda pudgalasyānyajātikṛtaṃ vā karma pratyupasthitaṃ	tasya Kalu punar Ananda pudgalasya-anya-jAti-kRtam vA karma pratyupasTitam
   bhavati. maraṇakāle vā mithyādṛṣṭiḥ. idaṃ karma	Bavati. maraNa-kAle vA miTyA-dRzwiH. idam karma
   yamalokopapattisaṃvartanīyam.	yama-loka-upapatti-saMvartanIyam.
   XVIII. tatra katamat karmāsuralokopapattisaṃvartanīyam. ucyate.	XVIII. tatra katamat karma-asura-loka-upapatti-saMvartanIyam. ucyate.
   sarvamṛdukāyavāṅmanoduścaritam. mānaḥ. abhimānaḥ adhimānaḥ. asmimānaḥ.	sarva-mRdu-kAya-vAc-manaH-duScaritam. mAnaH. aBimAnaH aDimAnaH. asmimAnaH.
   mithyāmānaḥ. sukṛta kuśalāmūlam asuralokopapattipariṇāmitam.	miTyAmAnaH. sukRta kuSalA-mUlam asura-loka-upapatti-pariNAmitam.
   sarvotkṛṣṭarāgasamutthitaṃ dauḥśīlyaṃ prajñāmukhena. idaṃ	sarva-utkRzwa-rAga-samutTitam dOHSIlyam prajQA-muKena. idam
   karmāsuralokopapattisaṃvartanīyam.	karma-asura-loka-upapatti-saMvartanIyam.
   XIX. tatra katamat karma manuṣyalokopapattisaṃvartanīyam. ucyate.	XIX. tatra katamat karma manuzya-loka-upapatti-saMvartanIyam. ucyate.
   subhāvitā mandabhāvitāś ca daśa kuśalāḥ karmapathāḥ. katame daśa.	su-BAvitAH manda-BAvitAH ca daSa kuSalAH karma-paTAH. katame daSa.
   trividhaṃ kāyakarma. caturvidhaṃ vākkarma. trividhaṃ manaḥkarma. idaṃ	triviDam kAya-karma. caturviDam vAkkarma. triviDam manaH-karma. idam
   karma manuṣyalokopapattisaṃvartanīyam.	karma manuzya-loka-upapatti-saMvartanIyam.
   XX. tatra katamat karma kāmāvacaradevopapattisaṃvartanīyam. ucyate.	XX. tatra katamat karma kAma-avacaradeva-upapatti-saMvartanIyam. ucyate.
   susamāptā daśa kuśalāḥ karmapathāḥ. idaṃ karma	su-samAptAH daSa kuSalAH karma-paTAH. idam karma
   kāmāvacaradevopapattisaṃvartanīyam.	kAma-avacaradeva-upapatti-saMvartanIyam.
   XXI. tatra katamat karma rūpāvacaradevopapattisaṃvartanīyam. ucyate.	XXI. tatra katamat karma rUpAvacara-deva-upapatti-saMvartanIyam. ucyate.
   susamāptāḥ susamāhitās tato viśiṣṭatarāḥ paripūrṇā daśa kuśalāḥ	su-samAptAH su-samAhitAH tatas viSizwatarAH paripUrNAH daSa kuSalAH
   karmapathāḥ. idaṃ karma rūpāvacaradevopapattisaṃvartanīyam.	karma-paTAH. idam karma rUpAvacara-deva-upapatti-saMvartanIyam.
   XXII. tatra katamat karmārūpyāvacaradevopapattisaṃvartanīyam. ucyate.	XXII. tatra katamat karmA-rUpya-avacara-deva-upapatti-saMvartanIyam. ucyate.
   catasra ārūpyasamāpattayaḥ. ākāśānantyāyatanam. vijñānānantyāyatanam.	catasraH ArUpya-samApattayaH. AkASa-Anantya-Ayatanam. vijQAna-Ananti-Ayatanam.
   ākiṃcanyānantyāyatanam. naivasaṃjñānāsaṃjñāyatanam. etāḥ samāpattayo	AkiMcanya-Ananti-Ayatanam. na-eva-saMjQAna-asaMjQAyatanam. etAH samApattayo
   bhāvitā bahulīkṛtāś ca bhavanti. idaṃ	BAvitAH bahulIkRtAH ca Bavanti. idam
   karmārūpyāvacaradevopapattisaṃvartanīyam.	karmA-rUpya-avacaradeva-upapatti-saMvartanIyam.
   XXIII. tatra katamat karma kṛtaṃ nopacitam. ucyate. yat kṛtvā karma	XXIII. tatra katamat karma kRtam na-upacitam. ucyate. yat kRtvA karma
   āstīryati jihreti vigarhati vijugupsati deśayati ācaṣṭe vyaktīkaroti. (MKV	AstIryati jihrA-iti vigarhati vijugupsati deSayati Acazwe vyaktIkaroti. (MKV
   48) āyatyāṃ saṃvaram āpadyate. na punaḥ karoti. idaṃ karma kṛtaṃ	48) AyatyAm saMvaram Apadyate. na punar karoti. idam karma kRtam
   nopacitam.	na-upacitam.
   XXIV. tatra katamat karmopacitaṃ na kṛtam. ucyate. yat karma kāyena	XXIV. tatra katamat karma-upacitam na kRtam. ucyate. yat karma kAyena
   paripūrayitavyam. tatra praduṣṭacitto vācaṃ bhāṣate evaṃ te kariṣyāmīti.	paripUrayitavyam. tatra praduzwa-cittaH vAcam BAzate evam te karizyAmi-iti.
   idaṃ karmopacitaṃ na kṛtam.	idam karma-upacitam na kRtam.
   XXV. tatra katamat karma kṛtaṃ copacitaṃ ca. ucyate. yat karma	XXV. tatra katamat karma kRtam ca-upacitam ca. ucyate. yat karma
   sāṃcetanikam.	sAMcetanikam.
   a) yathoktaṃ bhagavatā.	a) yaToktam BagavatA.
   manaḥpūrvaṅgamā dharmā manaḥśreṣṭhā manojavāḥ	manaH-pUrvaFgamAH DarmAH manaH-SrezWAH manojavAH
   manasā cet praduṣṭena bhāṣate vā karoti vā	manasA ced praduzwena BAzate vA karoti vA
   tatas taṃ duḥkham anveti cakraṃ vā vahataḥ padam	tatas tam duHKam anveti cakram vA vahataH padam
   manaḥpūrvaṅgamā dharmā manaḥśreṣṭhā manojavāḥ	manaH-pUrvaFgamAH DarmAH manaH-SrezWAH manojavAH
   manasā cet prasannena bhāṣate vā karoti vā	manasA ced prasannena BAzate vA karoti vA
   tatas taṃ sukham anveti chāyā vā anuyāyinī.	tatas tam suKam anveti CAyA vA anuyAyinI.
   idaṃ karma kṛtaṃ copacitaṃ ca.	idam karma kRtam ca-upacitam ca.
   XXVI. tatra katamat karma naiva kṛtaṃ naivopacitam. ucyate. yat karma	XXVI. tatra katamat karma na-eva kRtam na-eva-upacitam. ucyate. yat karma
   sāṃcetanikaṃ svapnāntare kṛtaṃ kāritaṃ vā. idaṃ karma naiva kṛtaṃ	sAMcetanikam svapna-antare kRtam kAritam vA. idam karma na-eva kRtam
   naivopacitam.	na-eva-upacitam.
   XXVII. tatra katamat karma yena samanvāgataḥ pudgalo narakeṣūpapannaḥ	XXVII. tatra katamat karma yena samanvAgataH pudgalaH narakezu-upapannaH
   paripūrṇaṃ nairayikam āyuḥ kṣapayitvā cyavati. ucyate. (MKV 49)	paripUrNam nErayikam AyuH kzapayitvA cyavati. ucyate. (MKV 49)
   ihaikatyena narakīyaṃ karma kṛtaṃ bhavaty upacitam. sa tat karma kṛtvā	iha-ekatyena narakI-iyam karma kRtam Bavati upacitam. sa tat karma kRtvA
   nāstīryati. na jihrīyati na vigarhati na jugupsati na deśayati nācaṣṭe na	na-AstIryati. na jihrIyati na vigarhati na jugupsati na deSayati na-Acazwe na
   vyaktīkaroti nāyatyāṃ saṃvaram āpadyate bhūyasyā mātrayā hṛṣyati. prītim	vyaktIkaroti na-AyatyAm saMvaram Apadyate BUyasyA mAtrayA hRzyati. prItim
   utpādayati. yathā devadattakokālikādayaḥ. idaṃ karma yena samanvāgataḥ	utpAdayati. yaTA devadatta-kokAlikA-AdayaH. idam karma yena samanvAgataH
   pudgalo narakeṣūpapannaḥ paripūrṇanairayikam āyuḥ kṣapayitvā cyavati.	pudgalaH narakezu-upapannaH paripUrNa-nErayikam AyuH kzapayitvA cyavati.
   XXVIII. tatra katamat karma yena samanvāgataḥ pudgalo narakeṣūpapanno	XXVIII. tatra katamat karma yena samanvAgataH pudgalaH narakezu-upapannaH-
   'rdhanairayikam āyuḥ kṣapayitvā cyavati. ucyate. ihaikatyena nārakīyaṃ	arDa-nErayikam AyuH kzapayitvA cyavati. ucyate. iha-ekatyena nArakIyam
   karma kṛtaṃ bhavaty upacitam. sa tat kṛtvā nāstīryati na jihrīyati na	karma kRtam Bavati upacitam. sa tat kRtvA na-Asti-Iryati na jihrIyati na
   vigarhati na jugupsate na deśayati nācaṣṭe na vyaktīkaroti. nāyatyāṃ	vigarhati na jugupsate na deSayati na-Acazwe na vyaktIkaroti. na-AyatyAm
   saṃvaram āpadyate. api tu na bhūyasyā mātrayā hṛṣyati. na pritim	saMvaram Apadyate. api tu na BUyasyA mAtrayA hRzyati. na pritim
   utpādayati. idaṃ karma yena samanvāgataḥ pudgalo narakeṣūpapanno	utpAdayati. idam karma yena samanvAgataH pudgalaH narakezu-upapannaH-
   'rdhanairayikam āyuḥ kṣapayitvā cyavati.	arDa-nErayikam AyuH kzapayitvA cyavati.
   XXIX. tatra katamat karma yena samanvāgataḥ pudgalo narakeṣūpapannamātra	XXI-X. tatra katamat karma yena samanvAgataH pudgalaH narakezu-upapanna-mAtra
   eva cyavati. ucyate. ihaikatyena nārakīyaṃ karma kṛtaṃ bhavaty upacitaṃ	eva cyavati. ucyate. iha-ekatyena nArakIyam karma kRtam Bavati upacitam
   ca. sa tat kṛtvāstīryati. jihrīyati. vigarhati vijugupsati ācaṣṭe.	ca. sa tat kRtvA-AstIryati. jihrIyati. vigarhati vijugupsati Acazwe.
   deśayati. vyaktīkaroti. āyatyāṃ saṃvaram āpadyate. na punaḥ kurute. sa cen	deSayati. vyaktIkaroti. AyatyAm saMvaram Apadyate. na punar kurute. sa ced-
   narakeṣūpapadyate upapannamātra eva cyavati.	narakezu-upapadyate upapanna-mAtre eva cyavati.
   a) yathā rājājātaśatruḥ. tena devadattasahāyenānantaryakarma kṛtam.	a) yaTA rAjA-ajAtaSatruH. tena deva-datta-sahAyena-anantarya-karma kRtam.
   pitṛvadhaḥ. saṃghabhedaḥ. dhanapālamokṣaṇam. śilāyantramokṣaṇaṃ	pitR-vaDaH. saMGa-BedaH. Dana-pAla-mokzaNam. SilAyantra-mokzaNam
   devadattasyādeśena. tasmād avīcinarakagamanaṃ śrutvā tena saṃvignena	devadattasya-AdeSena. tasmAt avIci-naraka-gamanam SrutvA tena saMvignena
   bhagavati cittaṃ prasāditam. śrāmaṇyaphalasūtre 'tyayadeśanaṃ kṛtam.	Bagavati cittam prasAditam. SrAmaNya-Pala-sUtre atyaya-deSanam kRtam.
   pratisaṃdadhāti kuśalamūlāni. tena maraṇakāle cittaṃ prasāditam. asthibhir	pratisaMdaDAti kuSala-mUlAni. tena maraNa-kAle cittam prasAditam. asTiBiH-
   api buddhaṃ bhagavantaṃ (MKV 50) śaraṇaṃ gacchāmi. sa upapannamātra eva	api budDam Bagavantam (MKV 50) SaraNam gacCAmi. saH upapanna-mAtre eva
   cyavati. idaṃ karma yena samanvāgataḥ pudgalo narakeṣūpapannamātra eva	cyavati. idam karma yena samanvAgataH pudgalaH narakezu-upapanna-mAtre eva
   cyavati.	cyavati.
   XXX. tatra katamat karma niyatopapattisaṃvartanīyam. ucyate. yat kṛtvā	XXX. tatra katamat karma niyata-upapatti-saMvartanIyam. ucyate. yat kRtvA
   kvacid upapattau pariṇāmayati amutropapadyeyam iti. sa tatropapadyate.	kvacid upapattO pariNAmayati amutra-upapadyeyam iti. sa tatra-upapadyate.
   yathā bhagavato jātake śyāmākajātakaprabhṛtiṣu praṇidhānavaśād upapattir	yaTA BagavataH jAtake SyAmAka-jAtaka-praBRtizu praNiDAna-vaSAt upapattiH-
   varṇyate. idaṃ karma niyatopapattisaṃvartanīyam.	varNyate. idam karma niyata-upapatti-saMvartanIyam.
   XXXI. tatra katamat karmāniyatopapattisaṃvartanīyam. ucyate. yat kṛtvā na	XXXI. tatra katamat karma-aniyata-upapatti-saMvartanIyam. ucyate. yat kRtvA na
   kvacid upapattau pariṇāmayati amutropapadyeyam iti. yathā satvāḥ	kvacid upapattO pariNAmayati amutra-upapadyeyam iti. yaTA satvAH
   karmavaśād upapadyante. idaṃ karmāniyatopapattisaṃvartanīyam.	karma-vaSAt upapadyante. idam karma-aniyata-upapatti-saMvartanIyam.
   XXXII. tatra katamat karma deśāntaravipākam ucyate. yat karma tasminn eva	XXXII. tatra katamat karma deSa-antara-vipAkam ucyate. yat karma tasmin eva
   janmāntare vā deśāntaragatasya vipacyate śubham aśubhaṃ vā. tat karma	janma-antare vA deSa-antara-gatasya vipacyate SuBam aSuBam vA. tat karma
   deśāntaravipākam. yathā bhagavān kathayati. bhūtapūrvaṃ bhikṣavo	deSa-antara-vipAkam. yaTA BagavAn kaTayati. BUta-pUrvam BikzavaH-
   jambudvīpe manuṣyāṇam aparimāṇam āyur bhavati. yathā rājño māndhātuḥ.	jambudvIpe manuzyANam aparimANam AyuH Bavati. yaTA rAjQaH mAnDAtuH.
   athānyatarasmin nagare maitrāyajño nāma (MKV 51) sārthavāhaputro babhūva.	aTa-anyatarasmin nagare mEtrAyajQaH nAma (MKV 51) sArTavAha-putraH baBUva.
   sa pañcaśatasahāyaparivṛta udyānaṃ gataḥ. taiś ca sahāyair uktaḥ. asmin	sa paQca-Sata-sahAya-parivRtaH udyAnam gataH. tEH ca sahAyEH uktaH. asmin
   nagare baṇijas tava pitaraṃ pūrvaṅgamaṃ kṛtvā mahāsamudram avatīrya	nagare baNijaH tava pitaram pUrvaFgamam kRtvA mahA-samudram avatIrya
   suvarṇabhūmiprabhṛtīni deśāntarāṇi gatvā dvīpāntarāṇi ca paśyanti.	suvarNa-BUmi-praBRtIni deSa-antarANi gatvA dvIpa-antarANi ca paSyanti.
   dravyopārjanaṃ ca kurvanti. vayam api tvāṃ pūrvaṅgamaṃ kṛtvā samudram	dravya-upArjanam ca kurvanti. vayam api tvAm pUrvaFgamam kRtvA samudram
   avatīrya dravyopārjanaṃ kariṣyāmo dvīpāntarāṇi ca drakṣyāmaḥ. tatas tena	avatIrya dravya-upArjanam karizyAmaH dvIpa-antarANi ca drakzyAmaH. tatas tena
   evam iti pratiśrutam. sa rātrau gatvā mātaram āpṛcchati. amba	evam iti pratiSrutam. sa rAtrO gatvA mAtaram ApRcCati. amba
   suvarṇabhūmiṃ gamiṣyāmaḥ. tasya mātāha. aparimāṇaṃ putra dravyaṃ gṛhe	suvarNa-BUmim gamizyAmaH. tasya mAtA-aha. aparimANam putra dravyam gRhe
   tiṣṭhati. na gantavyam iti. sa mātur vacanena nivṛttaḥ. sa bhūya udyānaṃ	tizWati. na gantavyam iti. sa mAtuH vacanena nivRttaH. sa BUyas udyAnam
   gataḥ sahāyair uktaḥ. tam arthaṃ vijñāpayāmaḥ. tena tathāstv iti	gataH sahAyEH uktaH. tam arTam vijQApayAmaH. tena taTA-astu iti
   pratiśrutam. sa bhūyo mātaraṃ gatvāpṛcchati. bhūyaś ca mātrā pādapatanān	pratiSrutam. sa BUyas mAtaram gatvA-ApRcCati. BUyas ca mAtrA pAda-patanAn
   nivartitaḥ. evaṃ tṛtīyam api. sa kālāntareṇa bhūya (MKV 52) udyānaṃ gatvā	nivartitaH. evam tRtIyam api. sa kAla-antareNa BUyas (MKV 52) udyAnam gatvA
   sahāyair uktaḥ. tava doṣād vayam api na gacchāmaḥ. pṛcchāmo vayam.	sahAyEH uktaH. tava dozAt vayam api na gacCAmaH. pRcCAmaH vayam.
   trayodaśyāṃ gamiṣyāma iti. tena mātur aviditam eva bahir bahu bhāṇḍaṃ	trayodaSyAm gamizyAmaH iti. tena mAtuH aviditam eva bahis bahu BANxam
   nirgamitam. tasya gamanakāle prasthitasya mātā dvāre pādapatanaṃ kṛtvā	nirgamitam. tasya gamana-kAle prasTitasya mAtA dvAre pAda-patanam kRtvA
   sthitvā. putra na gantavyam iti. sa kruddho mātuḥ pādaṃ mastake	sTitvA. putra na gantavyam iti. sa krudDaH mAtuH pAdam mastake
   dattvātikrāntaḥ samudrakūlaṃ ca gataḥ. tena sahāyā uktāḥ. samudram	dattvA-atikrAntaH samudrakUlam ca gataH. tena sahAyAH uktAH. samudram
   avataratāṃ na jñāyate jīvitaṃ maraṇaṃ ca. vayaṃ sarva	avataratAm na jQAyate jIvitam maraNam ca. vayam sarva
   evāṣṭāṅgasamanvāgataṃ poṣadhaṃ gṛhṇāmaḥ. tais tathāstv iti pratipannam.	eva-azwa-aFga-samanvAgatam pozaDam gRhNAmaH. tEH taTA-astu iti pratipannam.
   poṣadhaṃ ca gṛhītam. te samudram avatīrṇāḥ. samudramadhyagatānāṃ ca teṣāṃ	pozaDam ca gRhItam. te samudram avatIrNAH. samudra-maDya-gatAnAm ca tezAm
   viṣamavātādyāhataḥ poto vinaṣṭas tena sarve kālagatāḥ. maitrāyajñaś ca ma.	vizama-vAta-Adi-a-AhataH potaH vinazwaH tena sarve kAlagatAH. mEtrAyajQaH ca ma.
   praṭamukhyān avabaddhaṃ tāmraghataṃ ca gṛhya samudrakūla uttīrṇaḥ sa	prawamuKyAn avabadDam tAmra-Gatam ca gRhya samudra-kUle uttIrNaH sa
   paryaṭamānaḥ sauvarṇaprākāraṃ nagaraṃ paśyati. ārāmasaṃpannaṃ	paryawamAnaH sOvarNa-prAkAram nagaram paSyati. ArAma-saMpannam
   vanasaṃpannaṃ puṣkariṇīsaṃpannam. dhūpitadhūpanaṃ muktapuṣpāvakīrṇam	vana-saMpannam puzkariNI-saMpannam. DUpita-DUpanam mukta-puzpa-avakIrNam
   avasaktapaṭṭadāmakalāpam. tataś catasro 'psaraso nirgatāḥ. sa tābhir gṛhya	avasakta-pawwa-dAma-kalA-pam. tatas catasraH apsarasaH nirgatAH. sa tABiH gRhya
   nagaraṃ praveśitaḥ. sa tābhiḥ sārdhaṃ bahūni varṣāṇi krīḍitavān. bahūni	nagaram praveSitaH. sa tABiH sArDam bahUni varzANi krIxitavAn. bahUni
   varṣaśatāni. bahūni varṣasahasrāṇi bahūni varṣaśatasahasrāṇi krīḍitavān.	varza-SatAni. bahUni varza-sahasrANi bahUni varza-Sata-sahasrANi krIxitavAn-.
   sa tābhir uktaḥ. āryaputra tavāyaṃ pṛthivīpradeśo 'pūrvaḥ. asmākam	sa tABiH uktaH. Arya-putra tava-ayam pRTivI-pradeSaH apUrvaH. asmAkam
   aviditaṃ na nirgantavyam. yadi nirgacchasi sarvathottarābhimukhena na	aviditam na nirgantavyam. yadi nirgacCasi sarvaTA-uttara-aBimuKena na
   gantavyam. iti. sa tasmāt kālāntareṇa nirgataḥ. sa bhūyo gacchan nagaraṃ	gantavyam. iti. sa tasmAt kAla-antareNa nirgataH. sa BUyas gacCan nagaram
   paśyati. rūpyamayena prākāreṇa. ārāmasaṃpannaṃ vanasaṃpannam. pūrvavad	paSyati. rUpya-mayena prAkAreNa. ArAma-saMpannam vana-saMpannam. pUrvavat-
   yāvat. tasmād apy aṣṭāv apsaraso nirgatāḥ. tābhir apy asau gṛhya	yAvat. tasmAt api azwO apsarasaH nirgatAH. tABiH api asO gRhya
   praveśitaḥ. sa tābhiḥ sārdhaṃ bahūni varṣāṇi krīḍitavān. bahūni	praveSitaH. sa tABiH sArDam bahUni varzANi krIxitavAn. bahUni
   varṣaśatāni. bahūni varṣasahasrāṇi bahūni varṣaśatasahasrāṇi krīḍitavān.	varza-SatAni. bahUni varza-sahasrANi bahUni varza-Sata-sahasrANi krIxitavAn-.
   pūrvavat. tato 'pi kālāntareṇa nirgataḥ. bhūyaś ca paryaṭan nagaraṃ	pUrvavat. tatas api kAla-antareNa nirgataH. BUyas ca paryawan nagaram
   paśyati. vaidūryamayena prākāreṇa ārāmasaṃpannaṃ vanasaṃpannam.	paSyati. vEdUrya-mayena prAkAreNa ArAma-saMpannam vana-saMpannam.
   puṣkariṇīsaṃpannam. dhūpitadhūpanam. muktapuṣpāvakīrṇam	puzkariNI-saMpannam. DUpita-DUpanam. mukta-puzpa-avakIrNam
   avasaktapaṭṭadāmakalāpam. tasmād api ṣoḍaśāpsaraso nirgatāḥ. tābhir api	avasakta-pawwa-dAma-kalApam. tasmAt api zoxaSa-apsarasaH nirgatAH. tABiH api
   sārdhaṃ bahūni varṣāṇi krīḍitavān. pūrvavat. sa tābhir uktaḥ. āryaputra	sArDam bahUni varzANi krIxitavAn. pUrvavat. sa tABiH uktaH. Arya-putra
   tavāyaṃ pṛthivīpradeśo 'pūrvaḥ. asmād vihārāt tena na nirgantavyam. atha	tava-ayam pRTivI-pradeSaH apUrvaH. asmAt vihArAt tena na nirgantavyam. aTa
   nirgacchasi. sarvathottarāmukhena na gantavyam iti. sa tasmāt kālāntareṇa	nirgacCasi. sarvaTA-uttarA-muKena na gantavyam iti. sa tasmAt kAla-antareNa
   nirgataḥ. bhūyāḥ paryaṭamānaḥ (MKV 53) sphaṭikaprākāreṇa nagaram.	nirgataH. BUyAH paryawamAnaH (MKV 53) sPawika-prAkAreNa nagaram.
   tathaivārāmasaṃpannam. vanasaṃpannaṃ puṣkariṇīsaṃpannam. dhūpitadhūpanaṃ	taTA-eva-ArAma-saMpannam. vana-saMpannam puzkariNI-saMpannam. DUpita-DUpanam
   muktapuṣpāvakīrṇam avasaktapaṭṭadāmakalāpam. tasmād api dvātriṃśad	mukta-puzpa-avakIrNam avasakta-pawwa-dAma-kalApam. tasmAt api dvAtriMSat-
   apsaraso nirgatāḥ. tābhir api sārdhaṃ bahūni varṣāṇi bahūni varṣaśatāni	apsarasaH nirgatAH. tABiH api sArDam bahUni varzANi bahUni varza-SatAni
   bahūni varṣaśatasahasrāṇi krīḍitavān. sa tābhir apy uktaḥ. āryaputra	bahUni varza-Sata-sahasrANi krIxitavAn. sa tABiH api uktaH. Arya-putra
   tavāyaṃ pṛthivīpradeśo 'pūrvaḥ. asmād vihārāt tena na nirgantavyam. atha	tava-ayam pRTivI-pradeSaH apUrvaH. asmAt vihArAt tena na nirgantavyam. aTa
   nirgacchasi. uttarāmukhena na gantavyam iti. sa tāsāṃ pramādād ratikhinno	nirgacCasi. uttarAmuKena na gantavyam iti. sa tAsAm pramAdAt rati-KinnaH-
   nirgataḥ. uttarābhimukhena gacchan kaṇṭakāṭavīṃ prapannaḥ. atha	nirgataH. uttara-aBimuKena gacCan kaNwaka-awavIm prapannaH. aTa
   kṛṣṇāyasena prākāreṇa nagaraṃ paśyati. sa tatra praviṣṭaḥ.	kRzNAyasena prAkAreNa nagaram paSyati. sa tatra pravizwaH.
   praviṣṭamātrasya ca nagaradvāraṃ pihitam. ūrdhvaṃ paśyati. prākāro	pravizwa-mAtrasya ca nagara-dvAram pihitam. UrDvam paSyati. prAkAraH-
   vardhate bhairavaṃ ca śabdaṃ śṛṇoti. tatrasthaś ca cintayati. kim etad	varDate BEravam ca Sabdam SRNoti. tatrasTaH ca cintayati. kim etat-
   iti. sa tatra gataḥ. atha paśyati puruṣasyāsidharaṃ cakraṃ śiraś chinatti.	iti. sa tatra gataH. aTa paSyati puruzasya-asi-Daram cakram SiraH Cinatti.
   sa bhītaḥ pṛcchati. kim etad bho puruṣa. nairayikapuruṣaḥ prāha. eṣa	sa BItaH pRcCati. kim etat Bo puruza. nErayika-puruzaH prAha. eza
   pratyekanarakaḥ. maitrāyajña āha. kiṃ tvayā pāpakarma kṛtam iti. sa	pratyeka-narakaH. mEtrAyajQaH Aha. kim tvayA pApa-karma kRtam iti. sa
   kathayati. asmin jambudvīpe mahākośalī nāma nagaram. tatrāhaṃ	kaTayati. asmin jambudvIpe mahAkoSalI nAma nagaram. tatra-aham
   mahāsārthavāhaputro 'bhūvam. sa pañcabhiḥ sahāyaśataiḥ sahodyānaṃ gataḥ.	mahA-sArTavAha-putraH aBUvam. sa paQcaBiH sahAya-SatEH saha-udyAnam gataH.
   te kathayanti. tava pitā sārthavāho 'smākaṃ pūrvapuruṣo 'sti. pūrvaṅgamaṃ	te kaTayanti. tava pitA sArTavAhaH asmAkam pUrva-puruzaH asti. pUrvaFgamam
   kṛtvā deśāntarāṇi gatvā dravyopārjanāni kurvanti. suvarṇabhūmiṃ	kRtvA deSa-antarANi gatvA dravya-upArjanAni kurvanti. suvarNa-BUmim
   siṃhaladvīpaṃ ca prabhṛtīni ca dvīpāntarāṇi paśyanti. vayam api tvayā	siMhala-dvIpam ca praBRtIni ca dvIpa-antarANi paSyanti. vayam api tvayA
   pūrvaṅgamena deśāntaraṃ paśyāma iti. vayam api gacchāma iti pratiśrutam.	pUrvaFgamena deSa-antaram paSyAmaH iti. vayam api gacCAmaH iti pratiSrutam.
   so 'haṃ gṛhaṃ gatvā mātaram āpṛṣṭavān. aham evaṃ deśāntaraṃ gamiṣyāmīti.	saH aham gRham gatvA mAtaram ApRzwavAn. aham evam deSa-antaram gamizyAmi-iti.
   mātā ma āha. putra tava pitā samudram avatīrṇo deśāntaraṃ gata eva	mAtA me Aha. putra tava pitA samudram avatIrNaH deSa-antaram gataH eva
   kālagataḥ. tvam ekaputrakaḥ. prabhūtaṃ gṛhe dravyaṃ tiṣṭhati. na	kAlagataH. tvam eka-putrakaH. praBUtam gRhe dravyam tizWati. na
   gantavyam. iti. mayā na gacchāmīti pratiśrutam. evaṃ dvitīyaṃ tṛtīyaṃ	gantavyam. iti. mayA na gacCAmi-iti pratiSrutam. evam dvitIyam tRtIyam
   caturtham apy āpādapatanaṃ nivartitaḥ. kālāntareṇāhaṃ bhūyo 'py udyānaṃ	caturTam api ApAdapatanam nivartitaH. kAla-antareNa-aham BUyas api udyAnam
   gataḥ sahāyair uktaḥ. avaśyaṃ gantavyam iti. gamiṣyāmīti mayā pratiśrutam.	gataH sahAyEH uktaH. avaSyam gantavyam iti. gamizyAmi-iti mayA pratiSrutam.
   atha mama prasthitasya mātā dvāre pādapatanaṃ kṛtvā sthitā. putra nārhasi	aTa mama prasTitasya mAtA dvAre pAda-patanam kRtvA sTitA. putra na-arhasi
   māṃ parityaktum iti. tasyāhaṃ mastake pādaṃ dattvā prakrāntaḥ. so 'haṃ	mAm parityaktum iti. tasya-aham mastake pAdam dattvA prakrAntaH. saH aham
   pañcabhiḥ sahāyaśataiḥ sārdhaṃ samudrakūlaṃ gataḥ. aṣṭāṅgasamanvāgataṃ	paQcaBiH sahAya-SatEH sArDam samudrakUlam gataH. azwa-aFga-samanvAgatam
   poṣadhaṃ gṛhya samudram avatīrṇaḥ. suvarṇabhūmiprasthitānām asmākaṃ	pozaDam gRhya samudram avatIrNaH. suvarNa-BUmi-prasTitAnAm asmAkam
   viṣamavātādyāhataḥ poto vinaṣṭaḥ. te sarve kālagatāḥ. ahaṃ tu bahubhir	vizama-vAta-Adi-a-AhataH potaH vinazwaH. te sarve kAlagatAH. aham tu bahuBiH-
   divasaiḥ kathaṃcana samudrād uttīrṇo 'tha prapīḍyamānaḥ sauvarṇena	divasEH kaTaMcana samudrAt uttIrNaH aTa prapIxyamAnaH sOvarNena
   prākāreṇa nagaram. ārāmasaṃpannam. vanasaṃpannam. puṣkariṇīsaṃpannam.	prAkAreNa nagaram. ArAma-saMpannam. vana-saMpannam. puzkariNI-saMpannam.
   dhūpitadhūpanam. muktapuṣpāvakīrṇam. avasaktapaṭṭadāmakalāpam. tasmāc	DUpita-DUpanam. mukta-puzpa-avakIrNam. avasakta-pawwa-dAma-kalApam. tasmAt-
   catasro 'psaraso nirgatāḥ. tābhiḥ praveśito 'smi. yāvat. (MKV 54) tābhir	catasraH apsarasaH nirgatAH. tABiH praveSitaH asmi. yAvat. (MKV 54) tABiH-
   api sārdhaṃ bahūni varṣāṇi. bahūni varṣaśatāni. bahūni varṣaśatasahasrāṇi	api sArDam bahUni varzANi. bahUni varza-SatAni. bahUni varza-Sata-sahasrANi
   krīḍitam. tataḥ kālāntareṇa nirgacchan pa ... pūrvavat. tasmād apsaraso	krIxitam. tatas kAla-antareNa nirgacCan paH ... pUrvavat. tasmAt apsarasaH-
   nirgatāḥ. tābhiḥ praveśito 'smi. yāvat. tābhir api sārdhaṃ bahūni varṣāṇi	nirgatAH. tABiH praveSitaH asmi. yAvat. tABiH api sArDam bahUni varzANi
   bahūni varṣaśatāni bahūni varṣaśatasahasrāṇi krīḍitam. evaṃ vaidūryamayam.	bahUni varza-SatAni bahUni varza-Sata-sahasrANi krIxitam. evam vEdUrya-m-ayam.
   tasmād api ṣoḍaśāpsaraso nirgatāḥ .... tasmād api nirgatah. sphaṭikamayaṃ	tasmAt api zoxaSa-apsarasaH nirgatAH .... tasmAt api nirgata-h. sPawika-mayam
   nagaraṃ paśyāmi. pūrvavat. tasmād dvātriṃśad apsaraso nirgatāḥ. tābhir api	nagaram paSyAmi. pUrvavat. tasmAt dvAtriMSat apsarasaH nirgatAH. tABiH api
   saha tathaiva krīḍitam ...... kaṇṭakāṭavīṃ prapannaḥ. yāvad. āyasanagaraṃ	saha taTA-eva krIxitam ...... kaNwaka-awavIm prapannaH. yAvat-. Ayasa-na-garam
   paśyāmi. so 'ham atra praviṣṭaḥ. praviṣṭasya me dvāraṃ pihitam. atra ca	paSyAmi. saH aham atra pravizwaH. pravizwasya me dvAram pihitam. atra ca
   pūrvavat ....... asidharaṃ cakraṃ śirasi parivartamānaṃ paśyāmi. tatra ca	pUrvavat ....... asiDaram cakram Sirasi parivartamAnam paSyAmi. tatra ca
   mamāvasthitasya śirasi asidharaṃ cakraṃ saṃkrāntam. yad ahaṃ mātu ...	mama-avasTitasya Sirasi asiDaram cakram saMkrAntam. yat aham mAtu ...
   nivṛttaḥ. aṣṭāṅgasamanvāgataṃ ca poṣadhaṃ gṛhītam. tasya karmaṇo vipākena	nivRttaH. azwa-aFga-samanvAgatam ca pozaDam gRhItam. tasya karmaNaH vipAkena
   caturṣu mahānagareṣu pratyekasvargasva .... mātuḥ śirasi pādaṃ dattvā	caturzu mahA-nagarezu pratyeka-svargasva .... mAtuH Sirasi pAdam dattvA
   gataḥ. tasya karmaṇo vipākena mamāsidharaṃ cakraṃ śiraś chinatti.	gataH. tasya karmaNaH vipAkena mama-asiDaram cakram SiraH Cinatti.
   maitrāyajñaś cintayati. mayāpy etad eva karma kṛtam. upasthito mamāpi	mEtrAyajQaH cintayati. mayA-api etat eva karma kRtam. upasTitaH mama-api
   karmavipāka iti. nairayikapurusaḥ prāha. kutas tvam. maitrāyajñaḥ	karma-vipAkaH iti. nErayika-purusaH prAha. kutas tvam. mEtrAyajQaH
   kathayati. asti jambudvīpe tāmaliptaṃ nāma mahānagaram. tato 'ham. mayāpi	kaTayati. asti jambudvIpe tAm-aliptam nAma mahA-nagaram. tatas aham. mayA-api
   caitat sarvam anuṣṭheyam. nairayikapuruṣaḥ prāha. asti mayādyāntarikṣe	ca-etat sarvam anuzWeyam. nErayika-puruzaH prAha. asti mayA-adya-antarikze
   ghoṣaḥ śrutaḥ. kṣīṇas tava karmavipākaḥ. maitrāyajño nāma sārthavāhaputraḥ	GozaH SrutaH. kzINaH tava karma-vipAkaH. mEtrAyajQaH nAma sArTavAha-putraH
   adyāgamiṣyati. etad eva karma kṛtveti. maitrāyajña āha. kiṃ bhojanam. sa	adya-Agamizyati. etat eva karma kRtvA-iti. mEtrAyajQaH Aha. kim Bojanam. sa
   āha. ata eva mastakāc chidyamānād yat pūyaśoṇitaṃ sravati. evam uktvā sa	Aha. atas eva mastakAt CidyamAnAt yat pUya-SoNitam sravati. evam uktvA sa
   puruṣaḥ kālagataḥ patitaḥ. maitrāyajño bhītaḥ saṃvignaḥ. sarveṇa bhāvena	puruzaH kAlagataH patitaH. mEtrAyajQaH BItaH saMvignaH. sarveNa BAvena
   mātāpitroḥ praṇipātaṃ kṛtvāha.	mAtA-pitroH praNipAtam kRtvA-Aha.
   ūrdhvaṃ bhavāgravitatān adharād avīciṃ	UrDvam Bava-agra-vitatAn aDarAt avIcim
   tiryakprathān agaṇitān api lokadhātūn	tiryak-praTAn agaNitAn api lokaDAtUn
   ātmansva surāsuranaroragabhūtakāye	Atman-sva sura-asura-nara-uraga-BUta-kAye
   satvāni yāni upagatāni sukhino bhavantu	satvAni yAni upagatAni suKinaH Bavantu
   (MKV 55)	(MKV 55)
   evaṃ cintayitvā sarveṇa bhāvena mātāpitror namaskāraṃ kṛtvā praṇipātaṃ ca	evam cintayitvA sarveNa BAvena mAtA-pitroH namaskAram kRtvA praNipAtam ca
   praṇidhānaṃ ca kṛtavān. yatra yatropapadyāmi mātāpitroḥ śuśrūṣāṃ kuryām	praNiDAnam ca kRtavAn. yatra yatra-upapadyAmi mAtA-pitroH SuSrUzAm kuryAm
   aham iti. ye ca kecana satvā pratyekanarake upapadyante teṣāṃ sarveṣām	aham iti. ye ca kecana satvA pratyeka-narake upapadyante tezAm sarvezAm
   arthāyāham atrāvasthitaḥ. ye ca kecana loke yuktāś ca muktāś ca teṣāṃ	arTAya-aham atra-avasTitaH. ye ca kecana loke yuktAH ca muktAH ca tezAm
   namaḥ. te māṃ pālayantu. idam uktvā tasmin nairayikapuruṣaḥ kāle sthitaḥ.	namaH. te mAm pAlayantu. idam uktvA tasmin nErayika-puruzaH kAle sTitaH.
   punaś ca praṇidhānaṃ kṛtvā punar apy āha.	punar ca praNiDAnam kRtvA punar api Aha.
   kṛtvādau narakam avīcim ābhavāgrād	kRtvA-AdO narakam avIcim ABava-agrAd
   ye satvāś cyutigatibandhanāvabaddhāḥ	ye satvAH cyuti-gati-banDana-a=-abadDAH
   te sarve sukham atināpya dharmayuktaṃ	te sarve suKam atinApya Darma-yuktam
   nirvāṇaṃ yad ajaram acyutaṃ spṛśantu.	nirvANam yat ajaram acyutam spRSantu.
   atha tac cakram aspṛśamānaṃ śirasi nityakālam evopari vihāyasi sthitam.	aTa tat cakram aspRSamAnam Sirasi nityakAlam eva-upari vihAyasi sTitam.
   nityaṃ ca kila tasya mātāśiṣaṃ prayuṅkte. yady asti mama kiṃcit	nityam ca kila tasya mAtA-ASizam prayuFkte. yadi asti mama kiMcid-
   puṇyaphalaṃ pradānena vā śīlena vā brahmacaryeṇa vā pativratatvena vā tena	puNya-Palam pradAnena vA SIlena vA brahmacaryeNa vA pativrata-tvena vA tena
   puṇyaphalena mama putrasya yatra tatra sthitasya mā kiṃcit pāpaṃ bhavatu.	puNya-Palena mama putrasya yatra tatra sTitasya mA kiMcid pApam Bavatu.
   tena ca tasya śivam āsīt.	tena ca tasya Sivam AsIt-.
   b) yathā śyāmajātake saviṣeṇa śareṇa ... śyāmakumārasya mātāpitror	b) yaTA SyAma-jAtake sa-vizeNa SareNa ... SyAma-kumArasya mAtA-pitroH-
   āśīrvacanena śalyaś ca nirgato viṣaṃ ca naṣṭaṃ mṛtaś ca saṃjīvitas tadvat	ASIrvacanena SalyaH ca nirgataH vizam ca nazwam mRtaH ca saMjIvitaH tadvat-
   tasyāpi śivam āsīt. yathā vajrarājagṛhe dhanaṃjayasūtre	tasya-api Sivam AsIt. yaTA vajra-rAja-gRhe DanaMjaya-sUtre
   āryaśāradvatīputreṇoktam. tam enaṃ brāhmaṇaṃ mātāpitarau samaṃ mānitau	Arya-SAradvatI-putreNa-uktam. tam enam brAhmaNam mAtA-pitarO samam mAnitO
   samyak pūjitau kalyāṇena manasānukampete. (MKV 56) adhosī vatana putro	samyak pUjitO kalyANena manasA-anukampete. (MKV 56) aDosI vatana putraH-
   dhārmikeṇa karmaguṇena na ca kiṃcit pāpaṃ karma karoti. sarvaṃ sūtraṃ	DArmikeNa karma-guNena na ca kiMcid pApam karma karoti. sarvam sUtram
   yojyam. yathā ca śivālakasūtre bhagavatoktam. tam evaṃ gṛhapatiputra	yojyam. yaTA ca Siva-alaka-sUtre BagavatA-uktam. tam evam gRhapati-putra
   mātāpitarau pañcasu sthāneṣu pratyupasthitau pañcasu sthāneṣu	mAtA-pitarO paQcasu sTAnezu pratyupasTitO paQcasu sTAnezu
   pratiṣṭhāpayataḥ. tasya punar gṛhapatiputra mātāpitṛbhyām anukampitasya	pratizWApayataH. tasya punar gRhapati-putra mAtA-pitRByAm anukampitasya
   puruṣapudgalasya vṛddhir evaṃ pratyāśaṃsitavyā.	puruza-pudgalasya vRdDiH evam pratyASaMsitavyA.
   c) sa tatra prītyāhāraḥ sthitvā paripūrṇeṣu ṣaṣṭivarṣasahasreṣu kālagataḥ.	c) sa tatra prIti-AhAraH sTitvA paripUrNezu zazwi-varza-sahasrezu kAlagataH.
   d) yathā rājājātaśatrur aparipūrṇa eva nairayikāyuḥpramāṇe cyutaḥ.	d) yaTA rAja-ajAtaSatruH aparipUrNaH eva nErayika-AyuH-pramANe cyutaH.
   abandhyatvāt karmaṇāṃ kadācid atīva śirorujā bhavati.	abanDya-tvAt karmaNAm kadAcid atIva SiraH-rujA Bavati.
   e) atra kṛtapraṇidhānasya maitrāyajñasya mātāpitṛśuśrūṣā vaktavyā. yathā	e) atra kRta-praNiDAnasya mEtrAyajQasya mAtA-pitR-SuSrUzA vaktavyA. yaTA
   śyāmajātake 'ndhau mātāpitarau hastibhūtena paripālitau. anyeṣu	SyAma-jAtake anDO mAtA-pitarO hasti-BUtena paripAlitO. anyezu
   jātakaśateṣu ca.	jAtaka-Satezu ca.
   f) atha bhagavān prāptakālaṃ bhikṣūn āmantrayate. syād evaṃ bhikṣavo	f) aTa BagavAn prApta-kAlam BikzUn Amantrayate. syAt evam BikzavaH-
   yuṣmākam anyaḥ sa tena kālena tena samayena maitrāyajño nāma	yuzmAkam anyaH sa tena kAlena tena samayena mEtrAyajQaH nAma
   sārthavāhaputro babhūveti. naivaṃ draṣṭavyam. ahaṃ sa tena kālena tena	sArTavAha-putraH baBUva-iti. na-evam drazwavyam. aham sa tena kAlena tena
   samayena maitrāyajño nāma sārthavāhaputra āsīt. tasmāt tarhi bhikṣavo mama	samayena mEtrAyajQaH nAma sArTavAha-putraH AsIt. tasmAt tarhi BikzavaH mama
   vacanaṃ śraddadhānair buddhe sagauravair bhavitavyaṃ dharme saṃghe	vacanam SraddaDAnEH budDe sa-gOravEH Bavitavyam Darme saMGe
   sagauravair bhavitavyam. mātāpitṛṣu ācāryopādhyāyeṣu sagauravair	sa-gOravEH Bavitavyam. mAtA-pitRzu AcArya-upADyAyezu sa-gOravEH-
   bhavitavyam. evaṃ vo bhikṣavaḥ śikṣitavyam. ya evaṃ deśāntaragataḥ sukhaṃ	Bavitavyam. evam vaH BikzavaH Sikzitavyam. yaH evam deSa-antara-gataH suKam
   duḥkhaṃ pratyanubhavati. (MKV 57) yathā maitrāyajñena deśāntaragatena	duHKam pratyanuBavati. (MKV 57) yaTA mEtrAyajQena deSa-antara-gatena
   tasminn eva janmani pratyekasvargaṃ pratyekanarakaṃ cānubhūtam. ya evaṃ	tasmin eva janmani pratyeka-svargam pratyeka-narakam ca-anuBUtam. yaH evam
   deśāntaragataḥ sukhaṃ duḥkhaṃ pratyanubhavati. idaṃ karma	deSa-antara-gataH suKam duHKam pratyanuBavati. idam karma
   deśāntaravipākam.	deSa-antara-vipAkam.
   g) etad darśayati bhagavān. yathā mayi tathā mātāpitṛṣu. ācāryopādhyāyeṣu	g) etat darSayati BagavAn-. yaTA mayi taTA mAtA-pitRzu. AcArya-upADyAyezu
   vacanakāriṇāṃ samo vipākaḥ iha loke paraloke ca. katham iha loke samaḥ	vacana-kAriNAm samaH vipAkaH iha loke para-loke ca. kaTam iha loke samaH
   karmavipāko bhavati. yathā śrāvastyāṃ daridrapuruṣo bhagavantaṃ	karma-vipAkaH Bavati. yaTA SrAvastyAm daridra-puruzaH Bagavantam
   saśrāvakasaṃghaṃ bhuñjānaṃ dṛṣṭvā cittaṃ prasāditavān. tena	sa-SrAvaka-saMGam BuQjAnam dRzwvA cittam prasAditavAn. tena
   mahāpuṇyasaṃbhāra upārjitaḥ rājyasaṃvartanīyaṃ karma kṛtam. tad eva ca	mahA-puNya-saMBAraH upArjitaH rAjya-saMvartanIyam karma kRtam. tat eva ca
   mokṣabījam. tac ca jñātvā bhagavatā gāthā bhāṣitā.	mokza-bIjam. tat ca jQAtvA BagavatA gATA BAzitA.
   ye tatrābhyanumodante vaiyāvṛtyakarāś ca ye	ye tatra-aByanumodante vEyAvRtya-karAH ca ye
   anūnā dakṣiṇā teṣāṃ te 'pi puṇyasya bhāginaḥ.	anUnA dakziNA tezAm te api puNyasya BAginaH.
   etad eva gāthā samutthānam.	etat eva gATA samutTAnam-.
   manaḥpūrvaṅgamā dharmā manaḥśreṣṭhā manojavāḥ	manaH-pUrvaFgamAH DarmAH manaH-SrezWAH manojavAH
   manasā cet prasannena bhāṣate vākaroti vā	manasA ced prasannena BAzate vA-akaroti vA
   tatas taṃ sukham anveti chāyā vā anuyāyinī.	tatas tam suKam anveti CAyA vA anuyAyinI.
   tataś cyutaś ca deveṣūpapannaḥ. yathā ca tagaraśikhī nāma pratyekabuddhaḥ.	tatas cyutaH ca devezu-upapannaH. yaTA ca tagaraSiKI nAma pratyekabudDaH.
   durbhikṣe daridrapuruṣeṇa sūpaḥ pratipāditaḥ. sa ca tadahar eva tasmin	durBikze daridra-puruzeNa sUpaH pratipAditaH. sa ca tat-ahar eva tasmin
   nagare rājābhiṣiktaḥ. tataḥ kālāntareṇa pratyekabuddhaḥ saṃvṛttaḥ. ya eṣa	nagare rAjA-aBiziktaH. tatas kAla-antareNa pratyekabudDaH saMvRttaH. yaH eza
   sūtrantare paripaṭhitaḥ pratyekabuddhas (MKV 58) tagaraśikhī nāma. evaṃ	sUtR-antare paripaWitaH pratyekabudDaH (MKV 58) tagaraSiKI nAma. evam
   tāvad bhagavati sāṃdṛṣṭikaś cittaprasādasya phalavipākaḥ.	tAvat Bagavati sAMdRzwikaH citta-prasAdasya Pala-vipAkaH.
   h) kathaṃ mātāpitṛṣu. yathā maitrāyajñaḥ sārthavāhaputraḥ ācaturthaṃ	h) kaTam mAtA-pitRzu. yaTA mEtrAyajQaH sArTavAha-putraH AcaturTam
   pratinivṛtto mātur vacanena caturṣu mahānagareṣu pratyekasvargasukham	pratinivRttaH mAtuH vacanena caturzu mahA-nagarezu pratyeka-svarga-suKam
   anubhūtavān. tat tu tasya mokṣabījam. evaṃ mātāpitṛṣv api sāṃdṛṣṭikaḥ	anuBUtavAn. tat tu tasya mokza-bIjam. evam mAtA-pitRzu api sAMdRzwikaH
   phalavipākaḥ.	Pala-vipAkaH.
   i) kathaṃ bhagavati mātāpitṛṣu ca cittapradoṣeṇa narakagamanaṃ bhavati.	i) kaTam Bagavati mAtA-pitRzu ca citta-pradozeNa naraka-gamanam Bavati.
   ucyate. devadatto bhagavati cittaṃ pra ... to 'vīcau mahānarake patitaḥ.	ucyate. devadattaH Bagavati cittam pra ... taH avIcO mahAnarake patitaH.
   tathā sindhu viṣaye raurukaṃ nāma nagaram. tatra śikhaṇḍī rājaputraḥ	taTA sinDu vizaye rOrukam nAma nagaram. tatra SiKaNxI rAja-putraH
   pitaraṃ ghātayitvā narake patitaḥ. evaṃ bhagavati mātāpitṛṣu ca	pitaram GAtayitvA narake patitaH. evam Bagavati mAtA-pitRzu ca
   cittapradūṣaṇena narakagamanaṃ bhavati.	citta-pradUzaNena naraka-gamanam Bavati.
   j) tena kāraṇena kiṃ nāsti nānākaraṇam. ucyate. mahāntaṃ nānākaraṇam.	j) tena kAraNena kim na-asti nAnA-karaNam. ucyate. mahAntam nAnA-karaNam.
   bhagavān anekakalpaśatasahasropārjitakuśalamūlasaṃbhūtasaṃbhāraḥ	BagavAn aneka-kalpa-Sata-sahasra-upArjita-kuSala-mUla-saMBUta-saMBAraH
   anutpannasya mārgasyotpādayitā buddho bodhāya mārgaṃ deśayati. tasmin	anutpannasya mArgasya-utpAdayitA budDaH boDAya mArgam deSayati. tasmin
   kṛtaḥ prasādo 'prameyaphalavipākaḥ ante ca nirvāṇam. mātāpitror mokṣamārgo	kRtaH prasAdaH aprameya-Pala-vipAkaH ante ca nirvANam. mAtA-pitroH mokza-mArgaH-
   'viditaḥ. api ca na sarvaṃ mātāpitror vacanaṃ kāryam. santi kecin	aviditaH. api ca na sarvam mAtA-pitroH vacanam kAryam. santi kecid-
   mithyādarśanopahatacittāḥ putrān bruvanti. ehi mām avasanaṃ naya. tava ca	miTyA-darSana-upahata-cittAH putrAn bruvanti. ehi mAm avasanam naya. tava ca
   bhaviṣyati hitāya (MKV 59) sukhāya mama ca. [prapāte māṃ pā]tayāgnau vā	Bavizyati hitAya (MKV 59) suKAya mama ca. [prapAte mAm pA]tayA-agnO vA
   praveśayeti. tan naiva kartavyam. kiṃ kāraṇam. mātāpitarau	praveSaya-iti. tat na-eva kartavyam. kim kAraNam. mAtA-pitarO
   ghātayitvāvaśyaṃ narakagamanam. ata eva bhagavatā pratiṣiddho na	GAtayitvA-avaSyam naraka-gamanam. atas eva BagavatA pratizidDaH na
   mātāpitṛghātakaḥ pravrājayitavyaḥ nāsti tasya pravrajyā nopasaṃpadā. nāsti	mAtA-pitR-GAtakaH pravrAjayitavyaH na-asti tasya pravrajyA na-upasaMpadA. na-asti
   phalaprāptiḥ. evaṃvidhaṃ varjayitvānyathā samasamā mātāpitara	Pala-prAptiH. evaMviDam varjayitvA-anyaTA sama-samA mAtA-pitara
   ācāryopādhyāyāḥ. kathaṃ ca samasamā. nanu bhagavatoktam. mātāpitroḥ	AcArya-upADyAyAH. kaTam ca sama-samA. nanu BagavatA-uktam. mAtA-pitroH
   putrasneho yāvad asthimajjām āśritya tiṣṭhaty ata eva mātāpitṛbhyām	putra-snehaH yAvat asTi-majjAm ASritya tizWati atas eva mAtA-pitRByAm
   ananujñātasya nāsti pravrajyā. yathāryarāṣṭrapālaśoṇaprabhṛtayo bhagavatā	ananujQAtasya na-asti pravrajyA. yaTA-AryarAzwra-pAla-SoNa-praBRtayaH BagavatA
   mātāpitarāv ananujñāpya na pravrājitāḥ. adyāpi tān ananujñātān na	mAtA-pitarO ananujQApya na pravrAjitAH. adya-api tAn ananujQAtAn na
   pravrājayanti. yathā ca bhagavati pravrajite śuddhodanasya putraśokena	pravrAjayanti. yaTA ca Bagavati pravrajite SudDodanasya putra-Sokena
   cakṣuṣī antarhite. ucyate. mātāpitaraḥ pañca sthānāni pratyāśaṃsamānāḥ	cakzuzI antarhite. ucyate. mAtA-pitaraH paQca sTAnAni pratyASaMsamAnAH
   putram icchanti. śaṃvardhito no vṛddhībhūtān pālayiṣyati kāryaṃ ca	putram icCanti. SaMvarDitaH naH vRdDIBUtAn pAlayizyati kAryam ca
   kariṣyati dravyasvāmī ca bhaviṣyati. kālagatānāṃ ca pitṛpiṇḍaṃ dāsyati.	karizyati dravya-svAmI ca Bavizyati. kAla-gatAnAm ca pitR-piNxam dAsyati.
   kulavaṃśaś ca cirasthitiko bhaviṣyati. imāni pañca sthānāni	kula-vaMSaH ca cira-sTitikaH Bavizyati. imAni paQca sTAnAni
   pratyāśaṃsamānā mātāpitaraḥ putram icchanti. naivam ācāryopādhyāyāḥ.	pratyASaMsamAnAH mAtA-pitaraH putram icCanti. na-evam AcArya-upADyAyAH.
   kevalam eva kāruṇyaṃ puraskṛtya katham asyā nādikālapravṛttasya	kevalam eva kAruNyam puraskRtya kaTam asyAH na-Adi-kAla-pravRttasya
   saṃsāracakrasya paryantaṃ kuryād iti. yathā bhagavatā vinaya uktam.	saMsAra-cakrasya paryantam kuryAt iti. yaTA BagavatA vinaya uktam.
   upādhyāyasya śiṣye putrasaṃjñā bhavati. śiṣyasyāpy upādhyāye pitṛsaṃjñā	upADyAyasya Sizye putra-saMjQA Bavati. Sizyasya-api upADyAye pitR-saMjQA
   bhavati. evam anyonyaniśritāḥ sukhino bhaviṣyanti. evam ācāryopādhyāyāḥ	Bavati. evam anyonya-niSritAH suKinaH Bavizyanti. evam AcArya-upADyAyAH
   samasamā mātāpitṛbhiḥ. yathā cakravartisūtra (MKV 60) uktaṃ bhagavatā.	sama-samA mAtA-pitRBiH. yaTA cakravarti-sUtra (MKV 60) uktam BagavatA.
   kasya karmaṇo vipākena rājā cakravartī hastiratnāny aśvaratnāni ca	kasya karmaNaH vipAkena rAjA cakravartI hasti-ratnAni aSva-ratnAni ca
   pratilabhate. dīrgharātraṃ rājā cakravartī mātaraṃ pitaraṃ vā svayaṃ vā	pratilaBate. dIrGarAtram rAjA cakravartI mAtaram pitaram vA svayam vA
   skandhe vahati vā rathādibhir vāhayati vā. ācāryopādhyāyān svayaṃ vahati	skanDe vahati vA raTa-AdiBiH vAhayati vA. AcArya-upADyAyAn svayam vahati
   vāhayati vā. tasya karmaṇo vipākena rājā cakravartī hastyaśvaratnāni	vAhayati vA. tasya karmaNaH vipAkena rAjA cakravartI hasti-aSva-ratnAni
   pratilabhate. anenāpi kāraṇena samasamā mātāpitara ācāryopādhyāyāś ca. api	pratilaBate. anena-api kAraNena sama-samAH mAtA-pitaraH AcArya-upADyAyAH ca. api
   tv asty anyatra nānākaraṇam. gṛhasthānāṃ mātāpitṛ pravrajitāḥ pūjyāḥ.	tu asti anyatra nAnA-karaNam. gRhasTAnAm mAtA-pitR pravrajitAH pUjyAH.
   pravrajitānām ācāryopādhyāyā eva pūjanīyāḥ. yathā mahīśāsakā gotrāntarīyā	pravrajitAnAm AcArya-upADyAyAH eva pUjanIyAH. yaTA mahISAsakAH gotra-antarIyA
   vinaye 'rthotpattiṃ dhārayanti. yathāha bhagavān. na bhikṣavaḥ	vinaye arTa-utpattim DArayanti. yaTA-Aha BagavAn-. na BikzavaH
   ācāryopādhyāyān anāpṛṣṭvā deśāntaraṃ gantavyam. kasmād. bhavati bhikṣavo	AcArya-upADyAyAn anApRzwvA deSa-antaram gantavyam. kasmAt-. Bavati BikzavaH-
   jīvitāntarāyo bhavati brahmacaryāntarāyo bhavati pātracīvarāntarāyaḥ.	jIvita-antarAyaH Bavati brahmacarya-antarAyaH Bavati pAtra-cIvara-antarAyaH.
   bhūtapūrvaṃ bhikṣavo maitrāyajño nāma sārthavāhaputra āsīd iti. etad	BUta-pUrvam BikzavaH mEtrAyajQaH nAma sArTavAha-putraH AsIt iti. etat-
   evāvadānaṃ yathāvasthitaṃ vaktavyam. evam eva samasamā ācāryopādhyāyā	eva-avadAnam yaTA-avasTitam vaktavyam. evam eva sama-samA AcArya-upADyAyA
   mātāpitaraś ca. yathā coktaṃ bhagavatā. yo bhikṣavo mātāpitarau skandhena	mAtA-pitaraH ca. yaTA ca-uktam BagavatA. yaH BikzavaH mAtA-pitarO skanDena
   gṛhya jambudvīpaṃ paryaṭeta yogodvahanaṃ ca kuryāt caturṣu (MKV 61)	gRhya jambudvIpam paryaweta yoga-udvahanam ca kuryAt caturzu (MKV 61)
   dvīpeṣu hiraṇyasuvarṇaṃ ca dadyāt. evam api mātāpitroḥ pratyupakāro na	dvIpezu hiraNya-suvarNam ca dadyAt. evam api mAtA-pitroH pratyupakAraH na
   kṛto bhavati. yaś ca punar buddhe prasādayet. dharme. saṃghe. pañcasu	kRtaH Bavati. yaH ca punar budDe prasAdayet. Darme. saMGe. paQcasu
   śikṣāpadeṣu āryakānteṣu śīleṣu pratiṣṭhāpayet. evaṃ mātāpitṝṇāṃ putraiḥ	SikzA-padezu Arya-kAntezu SIlezu pratizWApayet. evam mAtA-pitLNAm putrEH
   pratyupakāraḥ kṛto bhavati. tac ca sarvam ācāryopādhyāyāḥ kurvanti.	pratyupakAraH kRtaH Bavati. tat ca sarvam AcArya-upADyAyAH kurvanti.
   yathāha bhagavān dakṣiṇāvibhaṅgasūtre. yathānanda pudgalaḥ pudgalam āgamya	yaTA-Aha BagavAn dakziNA-viBaFga-sUtre. yaTA-Ananda pudgalaH pudgalam Agamya
   buddhaṃ śaraṇaṃ gacchati dharmaṃ saṃghaṃ śaraṇaṃ gacchati yathoktāni ca	budDam SaraNam gacCati Darmam saMGam SaraNam gacCati yaTA-uktAni ca
   śikṣāpadāni vaktavyāni. tenānanda pudgalena tasya pudgalasya na śakyaṃ	SikzA-padAni vakta-vyAni. tena-Ananda pudgalena tasya pudgalasya na Sakyam
   pratikartum. yad idam abhivādanapratyutthānamātreṇaivam api	pratikartum. yat idam aBivAdana-pratyutTAna-mAtreNa-evam api
   prativiśiṣṭatarā ācāryopādhyāyā mātāpitṛbhyām. yathā ca	prativiSizwatarA AcArya-upADyAyA mAtA-pitRByAm. yaTA ca
   mahākātyāyanenāvantiprabhṛtayaḥ paścimajanapadā abhiprasāditāḥ. yathā	mahAkAtyAyanena-avanti-praBRtayaH paScima-janapadAH aBiprasAditAH. yaTA
   cāryamadhyandinena kāśmīrāyāṃ pañca nāgaśatani vinīya deśo 'bhiprasāditaḥ	cArya-maDyandinena kASmIrAyAm paQca nAga-Satani vinIya deSaH aBiprasAditaH
   (MKV 62) anavataptasarasaś ca kuṅkumam ānīya kaśmīrāyāṃ pratiṣṭhāpitam.	(MKV 62) anavatapta-sarasaH ca kuFkumam AnIya kaSmIrAyAm pratizWApitam.
   tac cādyāpi lokopabhuktam. vihāraś ca kārito 'dyāpi ca tatraiva	tat ca-adya-api loka-upaBuktam. vihAraH ca kAritaH adya-api ca tatra-eva
   prativasanti. yathā āryagavāṃpatinā suvarṇabhūmyāṃ yojanaśataṃ janapado	prativasanti. yaTA Arya-gavAMpatinA suvarNa-BUmyAm yojana-Satam janapadaH-
   'bhiprasāditaḥ. yathā ca pūrvavidehā āryapiṇḍolabhāradvājenābhiprasāditā	aBiprasAditaH. yaTA ca pUrva-videhA Arya-piNxola-BAradvAjena-aBiprasAditA
   vihārāś ca kāritā adyāpi tatraiva (MKV 63) prativasanti. yathā	vihArAH ca kAritA adya-api tatra-eva (MKV 63) prativasanti. yaTA
   cāryamahendreṇa siṃhaladvīpe vibhīṣaṇaprabhṛtayo rākṣasāḥ samaye sthāpitā	cArya-mahA-indreNa siMhala-dvIpe viBIzaNa-praBRtayaH rAkzasAH samaye sTApitA
   deśaś cābhiprasāditaḥ. yathā cādhyardhaśatake sūtra āryapūrṇena śūrpārake	deSaH ca-aBiprasAditaH. yaTA ca-aDyarDa-Satake sUtra Arya-pUrNena SUrpArake
   nagare pañcopāsakaśatāni (MKV 64) abhiprasāditāni. candanamālaś ca vihāraḥ	nagare paQca-upAsaka-SatAni (MKV 64) aBiprasAditAni. candanamAlaH ca vihAraH
   kāritaḥ. yathā ca bhagavān pañcabhir bhikṣuśataiḥ sārdhaṃ vihāyasā tatra	kAritaH. yaTA ca BagavAn paQcaBiH Bikzu-SatEH sArDam vihAyasA tatra
   gato janakāyaś cābhiprasāditaḥ. api ca kim ekaikasya bhikṣor nāmagrahaṇena	gataH jana-kAyaH ca-aBiprasAditaH. api ca kim ekEkasya BikzoH nAma-grahaNena
   kṛtena yato bhagavān parinirva ... ntar yaḥ kaścid vinīto bhikṣur vā	kRtena yatas BagavAn parinirva ... ntar yaH kaScid vinItaH BikzuH vA
   bhikṣuṇī vopāsako vopāsikā vā sarve te bhikṣubhir eva vinītāḥ. yaś ca	BikzuNI vA-upAsakaH vA-upAsikAH vA sarve te BikzuBiH eva vinItAH. yaH ca
   yenābhiprasāditaḥ sa tasyācāryopādhyāyāś ca eta .... ta bhagavān	yena-aBiprasAditaH sa tasya-AcArya-upADyAyAH ca ete .... te BagavAn
   mātāpitaraḥ pañca sthānāni pratyanuśaṃsamānāḥ putram icchanti.	mAtA-pitaraH paQca sTAnAni pratyanuSaMsamAnAH putram icCanti.
   ācāryopādhyāyās tu kāruṇyān nirvāṇaṃ dharmaṃ deśayanti. anenāpi kāraṇena	AcArya-upADyAyAH tu kAruNyAt nirvANam Darmam deSayanti. anena-api kAraNena
   mātāpitṛbhya ācāryopādhyāyāḥ prativiśiṣṭatarā iti. ata evam āha bhagavān.	mAtA-pitRByaH AcArya-upADyAyAH prativiSizwatarA iti. atas evam Aha BagavAn-.
   mama bhikṣavo vacanaṃ śraddadhānair bhagavati paraḥ prasādaḥ kāryaḥ dharme	mama BikzavaH vacanam SraddaDAnEH Bagavati paraH prasAdaH kAryaH Darme
   saṃghe mātāpitṛṣv ācāryopādhyāyeṣu paraḥ prasādaḥ kāryaḥ. tad vo	saMGe mAtA-pitRzu AcArya-upADyAyezu paraH prasAdaH kAryaH. tat vaH-
   bhaviṣyati dīrgharātraṃ hitāya sukhāyeti. idaṃ karma deśāntaravipākam.	Bavizyati dIrGarAtram hitAya suKAya-iti. idam karma deSa-antara-vipAkam.
   (MKV 65)	(MKV 65)
   XXXIII. katamat karma yena samanvāgataḥ pudgalaḥ pūrvaṃ sukhito bhūtvā	XXXIII. katamat karma yena samanvAgataH pudgalaH pUrvam suKitaH BUtvA
   paścād duḥkhito bhavati. ucyate. ihaikatyo dānaṃ yācitaḥ samānaḥ pūrvaṃ	paScAt duHKitaH Bavati. ucyate. iha-ekatyaH dAnam yAcitaH samAnaH pUrvam
   prahṛṣṭaḥ pratijānīte pramudito dadāti. dattvā ca khalu pratisārī bhavati.	prahRzwaH pratijAnIte pramuditaH dadAti. dattvA ca Kalu pratisArI Bavati.
   sa yadā manuṣyeṣūpapadyate. āḍhyeṣu mahādhaneṣu mahābhogeṣu	sa yadA manuzyezu-upapadyate. AXyezu mahADanezu mahA-Bogezu
   kuleṣūpapadyate. paścāt tasya te bhogāḥ parikṣayaṃ paryādānaṃ gacchanti.	kulezu-upapadyate. paScAt tasya te BogAH parikzayam paryAdAnam gacCanti.
   sa paścād daridro bhavati. yathāryagopakaḥ. tena kila kakucchande	sa paScAt daridraH Bavati. yaTA-AryagopakaH. tena kila kakucCande
   samyaksaṃbuddhe bhikṣusaṃghasya godhenur dattā. sa paścāt parair garhito	samyaksaMbudDe Bikzu-saMGasya goDenuH dattA. sa paScAt parEH garhitaH-
   na sādhukṛteyaṃ datteti. tena cittaṃ pradūṣitam. sa yatra yatropapadyate	na sADu-kRtA-iyam dattA-iti. tena cittam pradUzitam. sa yatra yatra-upapadyate
   tatra tatra mahādhano bhavati. paścāt tena cittapradoṣeṇa daridro bhavati.	tatra tatra mahADanaH Bavati. paScAt tena citta-pradozeNa daridraH Bavati.
   paścime bhave 'pi rājagṛhe nagare (MKV 66) 'nyatarasmin gṛhe pratyājātaḥ.	paScime Bave api rAja-gRhe nagare (MKV 66) anyatarasmin gRhe pratyAjAtaH.
   tasya jāyamānasya mātā kālagatā. anena mātā māritā jāyamānena mūlanakṣatre	tasya jAyamAnasya mAtA kAlagatA. anena mAtA mAritA jAyamAnena mUla-nakzatre
   jāto 'yaṃ mā nirmūlaṃ kulaṃ kariṣyaty amaṅgalo 'yam iti mātrā sārdhaṃ	jAtaH ayam mA nirmUlam kulam karizyati amaFgalaH ayam iti mAtrA sArDam
   śmaśāne utsṛṣṭaḥ. tatrāpi ca mātur ekastanāt kṣīraṃ pragharati tenaiva	SmaSAne utsRzwaH. tatra-api ca mAtuH eka-stanAt kzIram praGarati tena-eva
   puṇyānubhāvena. vivṛddhaś ca bhagavatāgatya pravrājitaḥ. etac ca sarvam	puNya-anuBAvena. vivRdDaH ca BagavatA-Agatya pravrAjitaH. etat ca sarvam
   anupūrveṇa bhagavatā bhikṣūṇāṃ kathitam. evam anena pūrvaṃ kṣīradhenuḥ	anupUrveNa BagavatA BikzUNAm kaTitam. evam anena pUrvam kzIraDenuH
   prasādajātena dattā paścād vipratisārī saṃvṛttaḥ. tasyedaṃ karmaphahm. yas	prasAda-jAtena dattA paScAt vipratisArI saMvRttaH. tasya-idam karma-Pahm. yaH-
   tv asau pūrvakaś cittaprasādas tad evāsya mokṣabījam. yathā ca campāyāṃ	tu asO pUrvakaH citta-prasAdaH tat eva-asya mokza-bIjam. yaTA ca campAyAm
   mahānagaryām īśvaro gṛhapatiputraḥ. tena bhṛtyānāṃ haste sarvaṃ dhanaṃ	mahA-nagaryAm ISvaraH gRhapati-putraH. tena BRtyAnAm haste sarvam Danam
   caturdiśaṃ bāṇijyāya preṣitam. tac ca sarvaṃ deśāntaragataṃ vinaṣṭam. sa	caturdiSam bANijyAya prezitam. tat ca sarvam deSa-antara-gatam vinazwam. sa
   ca parakarmakaraḥ saṃvṛttaḥ. idaṃ karma yena samanvāgataḥ pudgalaḥ pūrvaṃ	ca para-karma-karaH saMvRttaH. idam karma yena samanvAgataH pudgalaH pUrvam
   sukhito bhūtvā paścād duḥkhito bhavati.	suKitaH BUtvA paScAt duHKitaH Bavati.
   XXXIV. katamat karma yena samanvāgataḥ pudgalaḥ pūrvaṃ duḥkhito bhūtvā	XXXIV. katamat karma yena samanvAgataH pudgalaH pUrvam duHKitaH BUtvA
   paścāt sukhito bhavati. ucyate. ihaikatyo dānaṃ samādāya yācitaḥ samānaḥ	paScAt suKitaH Bavati. ucyate. iha-ekatyaH dAnam samAdAya yAcitaH samAnaH
   pratijānīte. kṛcchreṇa dadāti. dattvā tu dānaṃ paścāt prītim utpādayati.	pratijAnIte. kRcCreNa dadAti. dattvA tu dAnam paScAt prItim utpAdayati.
   sa yadā manuṣyeṣūtpadyate daridreṣu kuleṣūtpadyate. tasya paścāt te bhogā	sa yadA manuzyezu-utpadyate daridrezu kulezu-utpadyate. tasya paScAt te BogA
   abhivṛddhiṃ gacchanti. atra cāniruddhasyāvadānaṃ vaktavyam. tena kila	aBivRdDim gacCanti. atra ca-anirudDasya-avadAnam vaktavyam. tena kila
   rājagṛhe (MKV 67) śyāmākataṇḍulabhaktam upariṣṭhasya pratyekabuddhasya	rAja-gRhe (MKV 67) SyAmAka-taNxula-Baktam uparizWasya pratyekabudDasya
   piṇḍapāto dattaḥ. taddivasam eva rājñā tuṣṭenāṣṭau mahāgrāmā dattāḥ. tac	piNxapAtaH dattaH. tad-divasam eva rAjQA tuzwena-azwO mahA-grAmAH dattAH. tat-
   ca paścimakaṃ dāridryam. yathā tasyaiva vyākaraṇaṃ pūrvāparāntake sūtre.	ca paScimakam dAridryam. yaTA tasya-eva vyAkaraNam pUrva-aparAntake sUtre.
   yathā ca śrāvastyāṃ daridrapuruṣeṇa svajanaphalāni yācitvā kṣetraṃ nītāni	yaTA ca SrAvastyAm daridra-puruzeNa sva-jana-PalAni yAcitvA kzetram nItAni
   karṣaṇārthe. tasya patnyā paragṛhe bhājanam ādhāya vrīhim ānīya bhaktaṃ	karzaNa-arTe. tasya patnyA para-gRhe BAjanam ADAya vrIhim AnIya Baktam
   siddham. atha bhagavatā	sidDam. aTa BagavatA
   śāriputramaudgalyāyanamahākāśyapasubhūtiprabhṛtayaḥ ete uktāḥ. amukasya	SAriputra-mOdgalyAyana-mahA-kASyapa-su-BUti-praBRtayaH ete uktAH. amukasya
   gṛhapater gṛhe prathamaṃ bhaikṣyaṃ grahītavyam iti. te ca sarve	gRhapateH gRhe praTamam BEkzyam grahItavyam iti. te ca sarve
   yathānupūrvaṃ tatra gatāḥ. sarvaiś ca tasmād bhaikṣyaṃ labdham. atha	yaTA-anupUrvam tatra gatAH. sarvEH ca tasmAt BEkzyam labDam. aTa
   paścād bhagavān api gataḥ. tayā striyā jātaprasādayā pariśiṣṭaṃ bhaktaṃ	paScAt BagavAn api gataH. tayA striyAH jAta-prasAdayA pariSizwam Baktam
   sarvaṃ bhagavato dattaṃ praṇidhānaṃ ca karoti. anena bhagavan kuśalamūlena	sarvam BagavataH dattam praNiDAnam ca karoti. anena Bagavan kuSala-mUlena
   mā me bhūyaḥ kadācid dāridryaṃ syād iti. tathāstv iti bhagavatā	mA me BUyas kadAcid dAridryam syAt iti. taTA-astu iti BagavatA
   pratiśrutam. tadahar eva tasya mahānidhānaṃ prādurbhūtam. tac chrutvā	pratiSrutam. tat-ahar eva tasya mahA-niDAnam prAdurBUtam. tat SrutvA
   rājāprasenajit tasmin gṛhe gataḥ. tenoktam. asmākaṃ pūrvarājabhis te	rAjA-prasenajit tasmin gRhe gataH. tena-uktam. asmAkam pUrva-rAjaBiH te
   dīnārāḥ sthāpitā iti. gṛhapatinā tasya tato gṛhyāñjalipūro dattaḥ. aṅgāraḥ	dInArAH sTApitA iti. gRhapatinA tasya tatas gRhya-aQjali-pUraH dattaH. aFgAraH
   saṃvṛttaḥ. rājñā bhūyo gṛhapater dattāḥ. suvarṇaṃ saṃvṛttam. athā rājā	saMvRttaH. rAjQA BUyas gRhapateH dattAH. suvarNam saMvRttam. aTA rAjA
   prasenajid vismayajātaḥ. gatvā bhagavato nivedayati. bhagavān āha.	prasenajit vismaya-jAtaH. gatvA BagavataH nivedayati. BagavAn Aha.
   puṇyanirjātā gṛhapater na grāhyā. sarvaṃ ca tadānupūrveṇa kathitam. evam	puNya-nirjAtAH gRhapateH na grAhyA. sarvam ca tad-AnupUrveNa kaTitam. evam
   eṣa yadā dātā bhavati duḥkhena yācitaḥ samānaḥ pratijānīte. duḥkhena (MKV	eza yadA dAtA Bavati duHKena yAcitaH samAnaH pratijAnIte. duHKena (MKV
   68) dadāti dattvā ca cittaṃ prasādayati. tena hetunā pūrvaṃ daridro bhūtvā	68) dadAti dattvA ca cittam prasAdayati. tena hetunA pUrvam daridraH BUtvA
   paścān mahādhano bhavati. idaṃ karma yena samanvāgataḥ pudgalaḥ pūrvaṃ	paScAt mahADanaH Bavati. idam karma yena samanvAgataH pudgalaH pUrvam
   duḥkhito bhūtvā paścāt sukhito bhavati.	duHKitaH BUtvA paScAt suKitaH Bavati.
   XXXV. katamat karma yena samanvāgataḥ pudgalaḥ pūrvaṃ ca paścāc ca sukhito	XXXV. katamat karma yena samanvAgataH pudgalaH pUrvam ca paScAt ca suKitaH-
   bhavati. ucyate. ihaikatyo dānaṃ yācitaḥ sa prahṛṣṭaḥ pratijānīte prahṛṣṭo	Bavati. ucyate. iha-ekatyaH dAnam yAcitaH sa prahRzwaH pratijAnIte prahRzwaH-
   dadāti. dattvāpi ca prītimān bhavati. sa yadā manuṣyeṣūpapadyate. āḍhyeṣu	dadAti. dattvA-api ca prItimAn Bavati. sa yadA manuzyezu-upapadyate. AXyezu
   kuleṣūpapadyate mahādhaneṣu mahābhogeṣu. atra bhadrike nagare	kulezu-upapadyate mahADanezu mahA-Boga-izu. atra Badrike nagare
   miṇḍhakaprabhṛtīnāṃ caturṇāṃ dānapatīnāṃ vipāko vaktavyaḥ. taiḥ kila	miNXaka-praBRtInAm caturNAm dAnapatInAm vipAkaH vaktavyaH. tEH kila
   tagaraśikhī pratyekabuddhaḥ piṇḍapātena pratipādilaḥ. atra vinayāvadānaṃ	tagaraSiKI pratyekabudDaH piNxa-pAtena pratipAdilaH. atra vinaya-avadAnam
   vaktavyam. idaṃ karma yena samanvāgataḥ pudgalaḥ pūrvaṃ ca paścāc ca	vaktavyam. idam karma yena samanvAgataH pudgalaH pUrvam ca paScAt ca
   sukhito bhavati.	suKitaH Bavati.
   XXXVI. katamat karma yena samanvāgataḥ pudgalaḥ pūrvaṃ ca paścāc ca	XXXVI. katamat karma yena samanvAgataH pudgalaH pUrvam ca paScAt ca
   duḥkhito bhavati. ucyate. ihaikatyaḥ kalyāṇamitra virahito bhavati. sa	duHKitaH Bavati. ucyate. iha-ekatyaH kalyANa-mitra virahitaH Bavati. sa
   dānaṃ na dadāti. na ca tena kiṃcit pāpakaṃ karma kṛtaṃ bhavati. sa yadā	dAnam na dadAti. na ca tena kiMcid pApakam karma kRtam Bavati. sa yadA
   manuṣyeṣūpapadyate daridreṣu kuleṣūpapadyate. alpānnapānabhojaneṣu. yathā	manuzyezu-upapadyate daridrezu kulezu-upapadyate. alpa-anna-pAna-Bojana-izu. yaTA
   śrāvastyāṃ daridradārakasyāvadānaṃ varṇayanti. śrāvastyāṃ kila bhagavān	SrAvastyAm daridra-dArakasya-avadAnam varNayanti. SrAvastyAm kila BagavAn
   piṇḍapātaṃ paryaṭati. tadā ca śrāvastyām ikṣudvādaśī nāma bhavati.	piNxa-pAtam paryawati. tadA ca SrAvastyAm ikzudvAdaSI nAma Bavati.
   bhagavatā cekṣūṇi labdhāni. anyatarasmin gṛhadvāre daridradārakas	BagavatA ca-ikzUNi labDa-ani. anyatarasmin gRha-dvAre daridradAraka-s
   tiṣṭhati. sa bhagavantam ikṣūṇi yācati. bhagavataikaṃ dattam. sa (MKV 69)	tizWati. sa Bagavantam ikzUNi yAcati. BagavatA-ekam dattam. sa (MKV 69)
   bhūyo yācatiḥ bhagavān āha. vatsa. ucyatām. necchāmīti te bhūyo dāsyāmīti.	BUyas yAcatiH BagavAn Aha. vatsa. ucyatAm. na-icCAmi-iti te BUyas dAsyAmi-iti.
   sa prāha. mayā bhagavan na kadācin necchāmīty uktaṃ pūrvam. bhagavān āha.	sa prAha. mayA Bagavat na kadAcid na-icCAmi-iti uktam pUrvam. BagavAn Aha.
   vatsa. ucyatāṃ necchāmi bhagavan sarvāṇi dāsyāmīti. tenekṣulobhān	vatsa. ucyatAm na-icCAmi Bagavan sarvANi dAsyAmi-iti. tena-ikzu-loBAn
   necchāmīty uktam. bhagavatā sarvāṇi dattāni. athāryānandaḥ pṛcchati.	na-icCAmi-iti uktam. BagavatA sarvANi dattAni. aTa-AryAnandaH pRcCati.
   bhagavan kim idam. bhagavān āha. na kadācid eṣa ānanda	Bagavan kim idam. BagavAn Aha. na kadAcid ezaH Ananda
   rūparasagandhasparśādīnāṃ tṛptapūrvo 'bhavat necchāmīti vā na kadācid	rUpa-rasa-ganDa-sparSa-AdInAm tRpta-pUrvaH aBavat na-icCAmi-iti vA na kadAcid-
   uktapūrvam. tad etasya vacanaṃ tasya necchāmīti hetubhūtaṃ bhaviṣyati. āha	ukta-pUrvam. tat etasya vacanam tasya na-icCAmi-iti hetu-BUtam Bavizyati. Aha
   ca.	ca.
   necchāmīty eṣa vyāhāro na kadācid udīritaḥ	na-icCAmi-iti eza vyAhAraH na kadAcid udIritaH
   kuto rūpāṇi śabdāś ca gandhāḥ sparśāś ca vai kutah.	kutas rUpANi SabdAH ca ganDAH sparSAH ca vE kutah.
   ity evaṃ prārthayann eṣa nityaṃ bhramati bāliśaḥ	iti evam prArTayan eza nityam Bramati bAliSaH
   necchāmīti praharṣeṇa yaiṣā vāk samudīritā	na-icCAmi-iti praharzeNa yA-ezA vAc samudIritA
   hetur alpecchatā yaiṣā sa evāsya bhaviṣyati.	hetuH alpa-icCatA yA-ezA saH eva-asya Bavizyati.
   idaṃ karma yena samanvāgataḥ pūrvaṃ ca paścāc ca duḥkhito bhavati.	idam karma yena samanvAgataH pUrvam ca paScAt ca duHKitaH Bavati.
   XXXVII. katamat karma yena samanvāgataḥ pudgala āḍhyo bhavati matsarī.	XXXVII. katamat karma yena samanvAgataH pudgalaH AXyaH Bavati matsarI.
   ucyate. ihaikatyenālpamātraṃ dānaṃ dattaṃ bhavati śīlavati pātrabhūte na	ucyate. iha-ekatyena-alpa-mAtram dAnam dattam Bavati SIlavati pAtra-BUte na
   tu punas tyāgacittam abhyastaṃ bhavati. yadā manuṣyeṣūpapadyate. āḍhyeṣu	tu punar tyAga-cittam aByastam Bavati. yadA manuzyezu-upapadyate. AXyezu
   kuleṣūpapadyate mahādhaneṣu mahābhogeṣu. tena dānaviśeṣeṇa yat tena punas	kulezu-upapadyate mahADanezu mahA-Boga-izu. tena dAna-viSezeNa yat tena punar-
   tyāgacittam abhyastaṃ na bhavati sa tena karmaṇā matsarī bhavati. yathā	tyAga-cittam aByastam na Bavati sa tena karmaNA matsarI Bavati. yaTA
   śrāvastyāṃ (MKV 70) hilliśālagṛhapater avadānam. sa kila pūrvajanmani	SrAvastyAm (MKV 70) hilli-SAla-gRhapateH avadAnam. sa kila pUrva-janmani
   matsarī bhavati. atha tasya gṛhadvāre tagaraśikhī nāma pratyekabuddha	matsarI Bavati. aTa tasya gRha-dvAre tagaraSiKI nAma pratyekabudDa
   āgataḥ. tasya bhikṣā dattā. tena dṛṣṭvādīyamānā tena kṣavaṇaye na ca	AgataH. tasya BikzA dattA. tena dRzwvA-AdIyamAnA tena kzavaNaye na ca
   bhikṣā dattā. sa ca pravrājitaḥ paribhraṣṭaḥ. sa tena karmaṇā	BikzA dattA. sa ca pravrAjitaH pariBrazwaH. sa tena karmaNA
   divyamānuṣyakāḥ saṃpattayo 'nubhūya śrāvastyām agrakulikaputraḥ pratyājāto	divya-mAnuzyakAH saMpattayaH anuBUya SrAvastyAm agra-kulika-putraH pratyAjAtaH-
   matsarī kālagataḥ. tasya dravyaṃ rājñā prasenajitāputrakaṃ gṛhītvā	matsarI kAlagataH. tasya dravyam rAjQA prasenajitAputrakam gRhItvA
   śatavarge āgame prasenajitsaṃyukteṣu rājopakīrṇakaṃ nāma sūtram.	Satavarge Agame prasenajit-saMyuktezu rAja-upakIrNakam nAma sUtram.
   prasenajid bhagavataḥ kathayati. iha bhagavann agrakulikaḥ kālagataḥ.	prasenajit BagavataH kaTayati. iha Bagavan agra-kulikaH kAlagataH.
   tasya mayāputrakaṃ svāpateyaṃ gṛhītam. bhagavān āha. katīyaṃ mahārāja	tasya mayA-putrakam svApateyam gRhItam. BagavAn Aha. katIyam mahA-rAja
   gṛhapater dravyaṃ gṛhītam. sa āha. śataṃ bhagavan śatasahasrāṇāṃ yad	gRhapateH dravyam gRhItam. saH Aha. Satam Bagavan Sata-sahasrANAm yat-
   āhataṃ pariśiṣṭaṃ dravyam aparimitam anāhatam. bhagavān āha. idaṃ tasya	Ahatam pariSizwam dravyam aparimitam anAhatam. BagavAn Aha. idam tasya
   mahārāja saptamam aputrakaṃ dravyagrahaṇam. yat tena tagaraśikhī nāma	mahA-rAja saptamam aputrakam dravya-grahaNam. yat tena tagaraSiKI nAma
   pratyekabuddhaḥ piṇḍapātena pratipāditaḥ. tad asya karma parikṣīṇam. anyac	pratyekabudDaH piNxa-pAtena pratipAditaH. tat asya karma parikzINam. anya-t-
   ca kuśalamūlaṃ na kṛtam. tenādya prathamāyāṃ rātryāṃ mahāraurave narake	ca kuSala-mUlam na kRtam. tena-adya praTamAyAm rAtryAm mahArOrave narake
   pacyate. tatra bhagavān gāthā bhāṣate.	pacyate. tatra BagavAn gATAH BAzate.
   dhanaṃ dhānyaṃ jātarūpaṃ gavāśvamaṇikuṇḍalam	Danam DAnyam jAtarUpam gavA-Sva-maNi-kuNxalam
   dāsakarmakarā bhṛtyā ye cānye anujīvinaḥ	dAsa-karma-karAH BRtyAH ye ca-anye anujIvinaH
   mriyamāṇasya nānveti nāpi ādāya gacchati.	mriyamANasya na-anveti na-api AdAya gacCati.
   yat tena kṛtaṃ bhavati kalyāṇam atha pāpakam	yat tena kRtam Bavati kalyANam aTa pApakam
   tad dhi tasya svakaṃ bhavati tac ca ādāya gacchati.	tat Di tasya svakam Bavati tat ca AdAya gacCati.
   tasmāt kuruta puṇyānāṃ nicayaṃ sāmparāyikam	tasmAt kuruta puNyAnAm nicayam sAmparAyikam
   (MKV 71)	(MKV 71)
   puṇyāni paraloke 'smin pratiṣṭhā prāṇināṃ smṛtā	puNyAni para-loke asmin pratizWA prANinAm smRtA
   gṛhe tiṣṭhati kāyo 'yaṃ śmaśāne priyabāndhavāḥ	gRhe tizWati kAyaH ayam SmaSAne priya-bAnDavAH
   sukṛtaṃ duṣkṛtaṃ caiva gacchantam anugacchati.	sukRtam duzkRtam ca-eva gacCantam anugacCati.
   ayaṃ pudgala āḍhyo bhavati matsarī.	ayam pudgalaH AXyaH Bavati matsarI.
   XXXVIII. katamat karma yena samanvāgataḥ pudgalo daridro bhavati tyāgavān.	XXXVIII. katamat karma yena samanvAgataH pudgalaH daridraH Bavati tyAgavAn-.
   ucyate. ihaikatyena pudgalena bahu dānaṃ dattaṃ bhavati. tiryaggateṣu	ucyate. iha-ekatyena pudgalena bahu dAnam dattam Bavati. tiryak-gatezu
   manuṣyeṣu ca duḥśīleṣv abrahmacāriṣu. punaḥ punas tyāgacittam abhyastam.	manuzyezu ca duHSIlezu abrahmacArizu. punar punar tyAga-cittam aByastam.
   sa yadā manuṣyeṣūpapadyate daridro bhavati tyāgavān tena dānābhyāsena. yat	sa yadA manuzyezu-upapadyate daridraH Bavati tyAgavAn tena dAna-aByAsena. yat-
   tu tenāpātrabhūteṣu dānaṃ dattaṃ tena daridraḥ. yathā śrāvastyāṃ tatra	tu tena-apAtra-BUtezu dAnam dattam tena daridraH. yaTA SrAvastyAm tatra
   vinaye tantravāyasya nidānaṃ varṇayanti. sa tyāgavān daridraś ca. punaḥ	vinaye tantravAyasya nidAnam varNayanti. sa tyAgavAn daridraH ca. punar-
   punas tyāgacittam abhyastam. idaṃ karma yena samanvāgataḥ pudgalo daridro	punar tyAga-cittam aByastam. idam karma yena samanvAgataH pudgalaH daridraH-
   bhavati tyāgavān.	Bavati tyAgavAn-.
   XXXIX. katamat karma yena samanvāgataḥ pudgala āḍhyo bhavati tyāgavān.	XXhI-X. katamat karma yena samanvAgataH pudgalaH AXyaH Bavati tyAgavAn-.
   ucyate. ihaikatyena pudgalena bahu dānaṃ dattaṃ bhavati śīlavatsu	ucyate. iha-ekatyena pudgalena bahu dAnam dattam Bavati SIlavatsu
   pātrabhūteṣu. punaḥ punas tyāgacittam abhyastaṃ bhavati. sa tena karmaṇā	pAtra-BUta-izu. punar punar tyAga-cittam aByastam Bavati. sa tena karmaNA
   yadā manuṣyeṣūpapadyate. āḍhyeṣu kuleṣūpapadyate mahādhaneṣu mahābhogeṣu.	yadA manuzyezu-upapadyate. AXyezu kulezu-upapadyate mahADanezu mahA-Boga-izu.
   yat tu tena punaḥ punas tyāgacittam abhyastaṃ tena tyāgavān bhavati.	yat tu tena punar punar tyAga-cittam aByastam tena tyAgavAn Bavati.
   yathānāthapiṇḍadena kila krakucchande samyaksaṃbuddhe jetavanaṃ	yaTA-anATapiNxadena kila krakucCande samyaksaMbudDe jetavanam
   niryātitam. vihāraś ca kāritaḥ. evaṃ kanakamunau samyaksaṃbuddhe kāśyape	niryAtitam. vihAraH ca kAritaH. evam kanaka-munO samyaksaMbudDe kASyape
   sarvārthasiddhe ca. bhūyaś ca maitreyasya suvarṇāstīrṇaṃ niryātayiṣyati.	sarva-arTa-sidDe ca. BUyas ca mEtreyasya suvarNa-AstIrNam niryAtayizyati.
   idaṃ karma yena samanvāgataḥ pudgala āḍhyo bhavati tyāgavān.	idam karma yena samanvAgataH pudgalaH AXyaH Bavati tyAgavAn-.
   XL. katamasya pudgalasyāyuḥ kṣīṇaṃ na karma. ucyate. yaḥ pudgalo narakāc	XL. katamasya pudgalasya-AyuH kzINam na karma. ucyate. yaH pudgalaH narakAt-
   cyuto narakeṣūpapadyate. tiryagbhyaś cyutas (MKV 72) tiryakṣūpapadyate.	cyutaH narakezu-upapadyate. tiryagByaH cyutaH (MKV 72) tiryakzu-upapadyate.
   yamalokāc cyuto yamaloke upapadyate. devebhyaś cyuto deveṣūpapadyate.	yama-lokAt cyutaH yama-loke upapadyate. deveByaH cyutaH devezu-upapadyate.
   yathā varṣākārasya brāhmaṇasya punaḥ punaḥ kālagatasya markaṭopapattiḥ.	yaTA varza-AkArasya brAhmaNasya punar punar kAlagatasya markawa-upapattiH.
   yathā kāśmīrāyāṃ pūrvoktasya gṛhapateḥ punaḥ punaḥ paśūpapattiḥ. yathā ca	yaTA kASmIrAyAm pUrva-uktasya gRhapateH punar punar paSu-upapattiH. yaTA ca
   śrāvastyāṃ kaścid daridraḥ kuṭumbī kālagataḥ. tasya gṛhadvāre balīvardo	SrAvastyAm kaScid daridraH kuwumbI kAlagataH. tasya gRha-dvAre balIvardaH-
   vraṇībhūtena skandhena tiṣṭhati. sa gṛha āsaktacittaḥ kuṭumbī tasya	vraNI-BUtena skanDena tizWati. sa gRha Asakta-cittaH kuwumbI tasya
   balīvardasya skandhe kṛmiḥ pratyājātaḥ. upapannamātraś ca kākena	balIvardasya skanDe kRmiH pratyAjAtaH. upapanna-mAtraH ca kAkena
   bhakṣitaḥ. punas tatraiva kṛmiḥ pratyājātaḥ. sa evaṃ saptakṛtva	BakzitaH. punar tatra-eva kRmiH pratyAjAtaH. saH evam sapta-kRtva
   ekadivasena kālagataḥ. upapannamātraś ca kākena bhakṣitaḥ. yathā	eka-divasena kAlagataH. upapanna-mAtraH ca kAkena BakzitaH. yaTA
   cāryamahāmaudgalyāyano magadheṣu bhaikṣyaṃ paryaṭamāno 'nyatamagṛhadvāram	cArya-mahAmOdgalyAyanaH magaDezu BEkzyam paryawamAnaH anyatama-gRha-dvAram
   anuprāptaḥ. tasmiṃś ca gṛhe gṛhapatiḥ patnīsahito matsyamāṃsaprakāreṇa	anuprAptaH. tasmin ca gRhe gRhapatiH patnI-sahitaH matsya-mAMsa-prakAreNa
   bhojanaṃ bhuṅkte. putreṇa paryaṅkagatena kṛṣṇā cāsya kukkurī puraḥ sthitā.	Bojanam BuFkte. putreNa paryaFka-gatena kRzNA ca-asya kukkurI puras sTitA.
   sa tasya matsyā sthīni kṣipati. atḥa sa gṛhapatir mahāmaudgalyāyanaṃ	sa tasya matsyA sTIni kzipati. atHa sa gRhapatiH mahAmOdgalyAyanam
   dṛṣṭvāha. gamyatām ārya nāsti kāścid atra yo bhikṣāṃ dāsyati. sa khalu	dRzwvA-aha. gamyatAm Arya na-asti kAScid atra yaH BikzAm dAsyati. sa Kalu
   saṃprasthitaḥ. taśmiṃś ca gṛhadvāre deśāntarābhyāgatāḥ puruṣā vidvāṃsaḥ	saMprasTitaH. taSmin ca gRha-dvAre deSa-antara-aByAgatAH puruzAH vidvAMsaH
   pūrvasthitāḥ te taṃ dṛṣṭvā vismayaṃ prāptāḥ. aho āścaryam ayaṃ nāma	pUrva-sTitAH te tam dRzwvA vismayam prAptAH. aho AScaryam ayam nAma
   ṛddhimatām agryaḥ yena nandopanandau nāgarājānau vinītau vaijayantaś ca	RdDimatAm agryaH yena nanda-upanandO nAga-rAjAnO vinItO vEjayantaH ca
   prāsādo vāmapādāṅguṣṭhena kampitaḥ śakro vismāpitaḥ trisāhasraṃ lokadhātuṃ	prAsAdaH vAma-pAda-aFguzWena kampitaH SakraH vismApitaH tri-sAhasram lokaDAtum
   nimeṣāntaracārī sa nāma bhikṣām adattvā visarjitaḥ. atha sthaviras teṣāṃ	nimeza-antara-cArI sa nAma BikzAm adattvA visarjitaH. aTa sTaviraH tezAm
   saṃvejanārtham āha. vatsa. naitad āścaryam. puruṣā ūcuḥ. atha kim anyad	saMvejana-arTam Aha. vatsa. na-etat AScaryam. puruzAH UcuH. aTa kim anyat-
   āścaryaṃ vismayakāraṇam. sa uvāca. ya eṣa gṛhapatir matsyamāṃsaprakārair	AScaryam vismaya-kAraNam. saH uvAca. yaH eza gRhapatiH matsya-mAMsa-prakArEH-
   bhojanaṃ (MKV 73) bhuṅkte eṣa matsyaḥ asya gṛhapateḥ pitā. tena yā eṣāsya	Bojanam (MKV 73) BuFkte eza matsyaH asya gRhapateH pitA. tena yAH eza-asya
   gṛhasya pṛṣṭhataḥ puṣkariṇī ataḥ prabhūtamatsyān uddhṛtyoddhṛtya	gRhasya pRzWatas puzkariNI atas praBUta-matsyAn udDRtya-udDRtya
   bhakṣitāḥ. sa kālagato 'traiva matsyaḥ pratyājātaḥ. sa eṣo 'nekaśa	BakzitAH. sa kAlagataH atra-eva matsyaH pratyAjAtaH. saH ezaH anekaSa
   uddhṛtyoddhṛtya bhakṣyate. atraiva ca bhūyo bhūya upapadyate. yāpy eṣā	udDRtya-udDRtya Bakzyate. atra-eva ca BUyas BUyas upapadyate. yA-api ezA
   kukkurī asyaiva gṛhapater mātā. etayā lobhadoṣeṇa na kiṃcid dānaṃ dattam.	kukkurI asya-eva gRhapateH mAtA. etayA loBa-dozeNa na kiMcid dAnam dattam.
   na ca śīlaṃ sevitam. kevalaṃ kulavaṃśārthaṃ dravyaṃ paripālitam. sātraiva	na ca SIlam sevitam. kevalam kula-vaMSa-arTam dravyam paripAlitam. sA-atra-eva
   gṛhe āsaktacittā kālagatā kukkurīṣu pratyājātā. kālagatā bhūyo bhūyo	gRhe Asakta-cittA kAlagatA kukkurIzu pratyAjAtA. kAlagatAH BUyas BUyo
   'traivopapadyate. sarvāṃ ca rātrīṃ gṛhaṃ samantāt paryaṭati. mātra kaścit	atra-eva-upapadyate. sarvAm ca rAtrIm gRham samantAt paryawati. mA-atra kaScid-
   praviśed iti. atha yas tv eṣa putraḥ paryaṅke kṛtaḥ eṣo 'syā eva striyāḥ	praviSet iti. aTa yaH tu eza putraH paryaFke kRtaH ezaH asyAH eva striyAH
   pracchannabhartā anena ca gṛhapatinā śrutam. eṣā te patnī	pracCanna-BartA anena ca gRhapatinA Srutam. ezA te patnI
   parapuruṣavyāsaktā jāteti. sa eṣa gṛhapatir grāmāntara gamanavyapadeśena	para-puruza-vyAsaktA jAtA-iti. saH eza gRhapatiH grAma-antara gamana-vyapadeSena
   gṛhān niṣkrāntaḥ. eṣāpi strī parapuruṣeṇa saha śayitā. anena gṛhapatinā	gRhAt nizkrAntaH. ezA-api strI para-puruzeNa saha SayitA. anena gRhapatinA
   rātrāv āgamya puruṣo ghātitaḥ. so 'syām eva striyām āraktacittas tenaiva	rAtrO Agamya puruzaH GAtitaH. saH asyAm eva striyAm Arakta-cittaH tena-eva
   snehānubandhena kukṣav upapannaḥ. paśya vatsa yaḥ pitā caiva tasya sa	sneha-anubanDena kukzau upapannaH. paSya vatsa yaH pitA ca-eva tasya sa
   maṃsāni bhakṣayati. yā mātā janitrī tasyā matsyakaṇtakāsthikāni dadāti.	maMsAni Bakzayati. yA mAtA janitrI tasyAH matsya-kaNtaka-asTikAni dadAti.
   yaś ca śatruḥ kruddhena māritaḥ pāradārikaḥ taṃ paryaṅkena dhārayati. eṣa	yaH ca SatruH krudDena mAritaH pAradArikaH tam paryaFkena DArayati. eza
   saṃsāradoṣo nirvedaḥ kāryaḥ. idam atrāścaryakāraṇam. atha sa bhikṣur	saMsAra-dozaH nirvedaH kAryaH. idam atra-AScarya-kAraNam. aTa sa BikzuH-
   mahāmaudgalyāyana etad evārthaṃ sarvaṃ paścimajanatāsaṃvejanārthaṃ ślokena	mahAmOdgalyAyanaH etat eva-arTam sarvam paScima-janatA-saMvejana-arTam Slokena
   saṃgṛhītavān. yathāha.	saMgRhItavAn. yaTA-Aha.
   pitur maṃsāni khādate mātuḥ kṣipati kaṇṭakān	pituH maMsAni KAdate mAtuH kzipati kaNwakAn
   bhāryā jāraṃ ca poṣeti loko mohatamovṛtaḥ.	BAryA jAram ca poza-iti lokaH moha-tamaH-vRtaH.
   ayaṃ pudgalo yasyāyuḥ kṣīṇaṃ na karma.	ayam pudgalaH yasya-AyuH kzINam na karma.
   (MKV 74)	(MKV 74)
   XLI. katamasya pudgalasya karma kṣīṇaṃ nāyuḥ. ucyate. yaḥ pūrvaṃ sukhito	XLI. katamasya pudgalasya karma kzINam na-AyuH. ucyate. yaH pUrvam suKitaH-
   bhūtvā paścād duḥkhito bhavati. pūrvaṃ yo duḥkhito bhūtvā paścāt sukhito	BUtvA paScAt duHKitaH Bavati. pUrvam yaH duHKitaH BUtvA paScAt suKitaH-
   bhavati. asya pudgalasya karma kṣīṇaṃ nāyuḥ.	Bavati. asya pudgalasya karma kzINam na-AyuH.
   XLII. katamasya pudgalasya karma kṣīṇam āyuś ca. ucyate. yaḥ pudgalo	XLII. katamasya pudgalasya karma kzINam AyuH ca. ucyate. yaH pudgalaH-
   narakāc cyutas tiryakṣūpapadyate. tiryagbhyaś cyuto yamaloke upapadyate.	narakAt cyutaH tiryakzu-upapadyate. tiryagByaH cyutaH yama-loke upapadyate.
   yamalokāc cyuto manuṣyeṣūpapadyate. tataś cyuto deveṣūpapadyate. yathā	yama-lokAt cyutaH manuzyezu-upapadyate. tatas cyutaH devezu-upapadyate. yaTA
   śrāvastyāṃ vaṇikputra udyānaṃ gataḥ puṣpahetoḥ patnīvacanenāśokavṛkṣam	SrAvastyAm vaNij-putraH udyAnam gataH puzpa-hetoH patnI-vacanena-aSoka-vRkzam
   ārūḍhaḥ. sā ca vṛkṣaśākhā viśīrṇā. sa pāṣāṇaśilāyāṃ patitaḥ kālagataḥ.	ArUXaH. sA ca vRkza-SAKAH viSIrNA. sa pAzANa-SilAyAm patitaH kAlagataH.
   tatra mahājanakāyo rudati. atha bhikṣavo divāvihāraṃ gatāḥ. taṃ dṛṣṭvā	tatra mahA-jana-kAyaH rudati. aTa BikzavaH divAvihAram gatAH. tam dRzwvA
   saṃvignā bhagavato nivedayanti. bhagavann aho anityatā. atrodyāne	saMvignAH BagavataH nivedayanti. Bagavan aho anitya-tA. atra-udyAne
   gṛhapatiputro bālo 'bhuktabhogo 'śokavṛkṣāt patitaḥ kālagatah. tatra	gRhapati-putraH bAlaH aBukta-BogaH aSoka-vRkzAt patitaH kAlagata-h. tatra
   mahājanakāyaḥ saṃnipatitaḥ rauravasadṛśaś ca śabdaḥ śrūyate. bhagavān āha.	mahA-jana-kAyaH saMnipatitaH rOrava-sadRSaH ca SabdaH SrUyate. BagavAn Aha.
   eṣa eva bhikṣavaḥ gṛhapatiputraḥ pūrvaṃ mahāsamudre 'nyatarasmiṃ nāgakule	ezaH eva BikzavaH gRhapati-putraH pUrvam mahA-samudre anyatarasmim nAga-kule
   upapannaḥ. sa tatra jātamātra eva strīsahitaḥ krīḍamāno garuḍenoddhṛtya	upapannaH. sa tatra jAta-mAtre eva strI-sahitaH krIxamAnaH garuxena-udDRtya
   bhakṣitaḥ. tatra nāgakanyā rudanti iha striyo rudanti. sa ca yasyāḥ striyā	BakzitaH. tatra nAga-kanyAH rudanti iha striyaH rudanti. sa ca yasyAH striyA
   vacanenāśokavṛkṣam ārūḍhas tasyopary āghātaṃ kṛtavān. asyā doṣeṇāhaṃ	vacanena-aSoka-vRkzam ArUXaH tasya-upari AGAtam kRtavAn. asyAH dozeNa-aham
   vṛkṣam ārūḍhaḥ. kruddhaḥ kālagato narakeṣūpapannaḥ. asya pudgalasya karma	vRkzam ArUXaH. krudDaH kAlagataH narakezu-upapannaH. asya pudgalasya karma
   kṣīṇam āyuś ca.	kzINam AyuH ca.
   XLIII. katamasya pudgalasya puṇyāni ca kṣīṇāni āyuś ca. (MKV 75) ucyate.	XLIII. katamasya pudgalasya puNyAni ca kzINAni AyuH ca. (MKV 75) ucyate.
   yathā sa eva hilliśālī gṛhapatiḥ. yathā bhagavan āha. tasya punar mahārāja	yaTA saH eva hilli-SAlI gRhapatiH. yaTA Bagavan Aha. tasya punar mahA-rAja
   gṛhapates tac ca kuśalaṃ karma parikṣīṇam anyac ca na kṛtam. so 'dya	gRhapateH tat ca kuSalam karma parikzINam anyat ca na kRtam. saH adya
   prathamarātrīṃ raurave pacyate. yathā rājā prasenajid rājyād bhraṣṭo	praTamarAtrIm rOrave pacyate. yaTA rAjA prasenajit rAjyAt BrazwaH-
   rājagṛham anuprāptaḥ. sa tatra purāṇamūlakapattrāṇi mukhe prakṣipya khādan	rAja-gRham anuprAptaH. sa tatra purANa-mUlaka-pattrANi muKe prakzipya KAdan
   puruṣeṇākṣiptaḥ. śyāsupūrṇena mnkhenātha maraṇaṃ mṛtaḥ.	puruzeNa-AkziptaH. SyAsu-pUrNena mnKena-aTa maraNam mRtaH.
   pratyekabuddhapūrvas tasya [pūrvasya?] piṇḍapātasya vipākena. ayaṃ pudgalo	pratyekabudDa-pUrvaH tasya [pUrvasya?] piNxa-pAtasya vipAkena. ayam pudgalaH-
   yasyāyuś ca kṣīṇaṃ puṇyāni ca.	yasya-AyuH ca kzINam puNyAni ca.
   XLIIIbis. katamasya pudgalasya nāyuḥ kṣīṇaṃ [na] karma. api tu kleśāḥ	XLIIIbis. katamasya pudgalasya na-AyuH kzINam [na] karma. api tu kleSAH
   kṣīṇāḥ. ucyate. śrotaāpannasya. sakṛdāgāminaḥ. anāgāminaḥ.	kzINAH. ucyate. SrotaApannasya. sakRdAgAminaH. anAgAminaH.
   pratyekabuddhasya. ayaṃ pudgalo yasya nāyuḥ kṣīṇaṃ [na] karma. api tu	pratyekabudDasya. ayam pudgalaH yasya na-AyuH kzINam [na] karma. api tu
   kleśāḥ kṣīṇāḥ.	kleSAH kzINAH.
   XLIV. katamaḥ pudgalaḥ kāyena sukhī na cittena. ucyate. kṛtapuṇyaḥ	XLIV. katamaH pudgalaH kAyena suKI na cittena. ucyate. kRta-puNyaH
   pṛthagjanaḥ kāyena sukhī na cittena. yathā mahādhanabrāhmaṇagṛhapatayo	pRTagjanaH kAyena suKI na cittena. yaTA mahADana-brAhmaNa-gRhapatayaH-
   rājā ca māndhātā. ayaṃ pudgalaḥ kāyena sukhī na cittena.	rAjA ca mAnDAtA. ayam pudgalaH kAyena suKI na cittena.
   XLV. katamaḥ pudgalaś cittena sukhī na kāyena. ucyate. yathārhann apuṇyaḥ	XLV. katamaH pudgalaH cittena suKI na kAyena. ucyate. yaTA-arhan apuNyaH
   cittena sukhī na kāyena. yathārya śoṇottaras tena kila pūrvajanmani	cittena suKI na kAyena. yaTA-Arya SoNa-uttaraH tena kila pUrva-janmani
   pratyekabuddhasya snāyato gomayapiṇḍakaḥ kapikacchumiśraḥ snānārthaṃ	pratyekabudDasya snAyataH gomaya-piNxakaH kapikacCu-miSraH snAna-arTam
   dattaḥ. tena karma vipākena kuṣṭhena śarīraṃ viśīryati. tathā hi gāthā	dattaH. tena karma vipAkena kuzWena SarIram viSIryati. taTA hi gATA
   bhāṣitā.	BAzitA.
   (MKV 76)	(MKV 76)
   karmāṇi nūnaṃ balavattarāṇi karmabhyo vajrakalpebhyaḥ	karmANi nUnam balavattarANi karmaByaH vajra-kalpeByaH
   yatra vaśībhūto 'ham anubhavāmi duḥkhāni karmāṇi.	yatra vaSIBUtaH aham anuBavAmi duHKAni karma-aNi.
   yathā ca jaṅghākāśyapaḥ. tena kila vārāṇasyāṃ pratyekabuddhasya	yaTA ca jaFGA-kASyapaH. tena kila vArANasyAm pratyekabudDasya
   pratiśrutam. bhaktaṃ dāśyāmīti. sa tasya mahatā pariśrameṇa kālātikramaṇe	pratiSrutam. Baktam dASyAmi-iti. sa tasya mahatA pariSrameNa kAla-atikramaNe
   āsanne bhaktaṃ dattavān. sa tena karmaṇā paścime janmani vītarāgo 'pi	Asanne Baktam dattavAn. sa tena karmaNA paScime janmani vIta-rAgaH api
   bhūtvā pūrvāhṇe piṇḍapātaṃ paryaṭati. kālātikramaṇe āsanne kathaṃcid	BUtvA pUrvAhNe piNxa-pAtam paryawati. kAla-atikramaNe Asanne kaTaMcid-
   bhaktaṃ labhate. tathāsya jaṅghākāśyapa eva nāma. ayaṃ pudgalaś cittena	Baktam laBate. taTA-asya jaFGA-kASyapaH eva nAma. ayam pudgalaH cittena
   sukhī na kāyena.	suKI na kAyena.
   XLVI. katamaḥ pudgalaḥ kāyena sukhī cittena ca. ucyate. arhan kṣīṇāsravaḥ	XLVI. katamaH pudgalaH kAyena suKI cittena ca. ucyate. arhan kzINa-AsravaH
   kṛtapuṇyaḥ. yathā kaśmīrarājā dharmayaśaḥputro bakulaḥ. tathā hy asya	kRta-puNyaH. yaTA kaSmIra-rAjA Darma-yaSaH-putraH bakulaH. taTA hi asya
   siṃhanādaḥ. aśītir me āyuṣmanto varṣāṇi pravrajitasya na kadācid vyādhir	siMhanAdaH. aSItiH me AyuzmantaH varzANi pravrajitasya na kadAcid vyADiH-
   bhūtapūrvaḥ. antataḥ śiro'rtimātram api. tena kila vārāṇasyāṃ	BUta-pUrvaH. antatas SiraH-arti-mAtram api. tena kila vArANasyAm
   gāndhikabaṇijā bhūtvā kakucchandaḥ samyaksaṃbuddhaḥ saśrāvakasaṃgho	gAnDika-baNijAH BUtvA kakucCandaH samyaksaMbudDaH sa-SrAvaka-saMGaH-
   glānabhaiṣajyenopanimantrito bhikṣuṇā cārhatā ekā harītakī gṛhītā. sa	glAna-BEzajyena-upanimantritaH BikzuNA ca-arhatA ekA harItakI gRhItA. sa
   tasya karmaṇo vipākena nirābādhaḥ. ārogyaparamā lābhā uktā bhagavatā.	tasya karmaNaH vipAkena nirAbADaH. Arogya-paramA lABAH uktAH BagavatA.
   yathā cāryāniruddhaḥ kathayati. tasya khalv āyuṣmantaḥ piṇḍapātasya	yaTA ca-Arya-anirudDaH kaTayati. tasya Kalu AyuzmantaH piNxa-pAtasya
   vipākena saptakṛtvaḥ praṇīte trayastriṃśadevanikāye upapannaḥ saptakṛtvo	vipAkena sapta-kRtvas praNIte trayastriMSat-eva-nikAye upapannaH sapta-kRtvA-u
   manuṣyeṣu rājyaṃ kāritam. tasyaiva ca piṇḍapātasya (MKV 77)	manuzyezu rAjyam kAritam. tasya-eva ca piNxa-pAtasya (MKV 77)
   vipākenārhatvaphalalābhī	vipAkena-arha-tva-Pala-lABI
   cīvarapiṇḍapātaśayanāsanaglānapratyayabhaiṣajyapariṣkārāṇāṃ lābhī. tathā	cIvara-piNxapAta-Sayana-Asana-glAna-pratyaya-BEzajya-parizkArANAm lABI. taTA
   hi tasya bhagavatā durbhikṣe pañca bhikṣuśatāni dattāni. tasya	hi tasya BagavatA durBikze paQca Bikzu-SatAni dattAni. tasya
   puṇyānubhāvena sarveṣāṃ divyam anantabhaktaṃ prādurbhavati. ayaṃ pudgalaḥ	puNya-anuBAvena sarvezAm divyam ananta-Baktam prAdurBavati. ayam pudgalaH
   kāyena sukhī cittena ca.	kAyena suKI cittena ca.
   XLVII. katamaḥ pudgalo na kāyena sukhī na cittena ca. akṛtapuṇyāḥ	XLVII. katamaH pudgalaH na kAyena suKI na cittena ca. akRta-puNyAH
   pṛthagjanā utsannakulavaṃśā vastrānnapānavirahitāḥ paragṛheṣu hiṇḍanti.	pRTagjanAH utsanna-kula-vaMSAH vastra-anna-pAna-virahitAH para-gRhezu hiNxanti.
   tathā vyādhibhiḥ kuṣṭhakṣayakāsajvarapāṇḍurogadadrupāmādibhiḥ parigatā	taTA vyADiBiH kuzWa-kzaya-kAsa-jvara-pANxu-roga-dadru-pAma-AdiBiH parigatA
   hastapādavikalāś cakṣurvihīnāś ca. ayaṃ pudgalo na kāyena sukhī na	hasta-pAda-vikalAH cakzuH-vihInAH ca. ayam pudgalaH na kAyena suKI na
   cittena.	cittena.
   XLVIII. katamat karma yena samanvāgataḥ pudgalo 'pāyeṣūpapanno 'bhirūpo	XLVIII. katamat karma yena samanvAgataH pudgalaH apAyezu-upapannaH aBirUpaH-
   bhavati prāsādikaḥ snigdhakāyaḥ snigdhacchavir nayanābhirāmo darśanīyaḥ.	Bavati prAsAdikaH snigDa-kAyaH snigDa=-CaviH nayana-aBirAmaH darSanIyaH.
   ucyate. yaḥ pudgalo rāgasamutthitena dauḥśīlyena samanvāgataḥ	ucyate. yaH pudgalaH rAga-samutTitena dOHSIlyena samanvAgataH
   apāyeṣūpapadyate. yathā mayūraśukasārikākāraṇḍavacakravākaprabhṛtayaḥ.	apAyezu-upapadyate. yaTA mayUra-Suka-sArikA-kAraNxava-cakravAka-praBRtayaH.
   idaṃ karma yena samanvāgataḥ pudgalo 'pāyeṣūpapanno 'bhirūpo bhavati	idam karma yena samanvAgataH pudgalaH apAyezu-upapannaH aBirUpaH Bavati
   prāsādikaḥ snigdhakāyaḥ snigdhacchavir nayanābhirāmo darśanīyaḥ.	prAsAdikaH snigDa-kAyaH snigDa=-CaviH nayana-aBirAmaH darSanIyaH.
   XLIX. tatra katamat karma yena samanvāgataḥ pudgalo 'pāyeṣūpapanno	XLIX. tatra katamat karma yena samanvAgataH pudgalaH apAyezu-upapannaH-
   durvarṇo bhavati rūkṣakāyo ghoradarśanaḥ. ucyate. yaḥ pudgalo	durvarNaH Bavati rUkza-kAyaH Gora-darSanaH. ucyate. yaH pudgalaH-
   dveṣasamutthitena dauḥśīlyena samanvāgato 'pāyeṣūpapadyate. yathā	dveza-samutTitena dOHSIlyena samanvAgataH apAyezu-upapadyate. yaTA
   siṃhavyāghrakākaśṛgālakṛṣṇasarpapretapiśācādayaḥ. idaṃ karma yena	siMha-vyAGra-kAka-SRgAla-kRzNa-sarpa-preta-piSAca-AdayaH. idam karma yena
   apāyeṣūpapanno durvarṇo bhavati rūkṣakāyo ghoradarśanaḥ.	apAyezu-upapannaH durvarNaH Bavati rUkza-kAyaH Gora-darSanaH.
   L. tatra katamat karma yena samanvāgataḥ pudgalo 'pāyeṣūpapanno durgandho	L. tatra katamat karma yena samanvAgataH pudgalaH apAyezu-upapannaH durganDaH-
   bhavati jihmendriyo 'vyaktendriyaḥ. ucyate. yaḥ pudgalo mohasamutthitena	Bavati jihma-indriyaH avyakta-indriyaH. ucyate. yaH pudgalaH moha-samutTitena
   dauḥśīlyena samanvāgataḥ apāyeṣūpapadyate. (MKV 78) yathā	dOHSIlyena samanvAgataH apAyezu-upapadyate. (MKV 78) yaTA
   chuchundarīkṛmyajagarayūkāmakṣikādayo yathā śarīre viṃśatikṛmijātayaḥ.	CuCundarI-kRmI-ajagara-yUkA-makzika-AdayaH yaTA SarIre viMSati-kRmi-jAtayaH.
   idaṃ karma yena samanvāgataḥ pudgalo 'pāyeṣūpapanno durgandho bhavati	idam karma yena samanvAgataH pudgalaH apAyezu-upapannaH durganDaH Bavati
   jihmendriyo 'vyaktendriyaḥ.	jihma-indriyaH avyakta-indriyaH.
   LI. daśākuśalāḥ karmapathāḥ. katame daśa. trividhaṃ kāyakarma. caturvidhaṃ	LI. daSa-akuSalAH karma-paTAH. katame daSa. triviDam kAya-karma. caturviDam
   vākkarma. trividhaṃ manaskarma. eṣāṃ daśānām akuśalānāṃ karmapathānāṃ	vAkkarma. triviDam manaskarma. ezAm daSAnAm akuSalAnAm karma-paTAnAm
   vipākena daśānāṃ bāhyānāṃ bhāvānām abhivṛddhir bhavati.	vipAkena daSAnAm bAhyAnAm BAvAnAm aBivRdDiH Bavati.
   LII. prāṇātipātasyākuśalakarmapathasya vipākena pṛthivyā ojaś ca tejaś	LII. prANa-atipAtasya-akuSala-karma-paTasya vipAkena pRTivyAH ojaH ca tejaH-
   cāntardhīyate. tasyaiva ca karmaṇo vipākenālpāyur bhavati.	ca-antarDIyate. tasya-eva ca karmaNaH vipAkena-alpa-AyuH Bavati.
   LIII. adattādānasyākuśalasya karmapathasya vipākena pṛthivyām	LIII. adatta-AdAnasya-akuSalasya karma-paTasya vipAkena pRTivyAm
   aśaniśukaśalabhamūṣikakīṭaprabhṛtayaḥ sasyaghāsakā utpadyante. tasyaiva	aSani-Suka-SalaBa-mUzika-kIwa-praBRtayaH sasya-GAsakAH utpadyante. tasya-eva
   karmaṇo vipākena bhogavyasanam adhigacchati.	karmaNaH vipAkena Boga-vyasanam aDigacCati.
   LIV. kāmamithyācārasyākuśalasya karmapathasya vipākena pṛthivyāṃ	LIV. kAma-miTyA-AcArasya-akuSalasya karma-paTasya vipAkena pRTivyAm
   tṛṇadarbhādīni durgandhīni prādurbhavanti. tasyaiva karmaṇo vipākena	tRNa-darBa-AdIni durganDIni prAdurBavanti. tasya-eva karmaNaH vipAkena
   saṃpannagṛhāvāsaṃ praviśanti. atrāvadānaṃ śvabhrapadasya susudhī dārikā	saMpanna-gRha-AvAsam praviSanti. atra-avadAnam SvaBra-padasya susuDI dArikA
   kāsirājñaḥ patnī devāvataraṇe kālodayinaḥ pūrvajanmany avadānaṃ vaktavyam.	kA-asi-rAjQaH patnI deva-avataraNe kAla-udayinaH pUrva-janmani avadAnam vaktavyam.
   LV. mṛṣāvādasyākuśalasya karmapathasya vipākena	LV. mRzAvAdasya-akuSalasya karma-paTasya vipAkena
   mukharogadantarogagalarogamukhadaurgandhyādīni (MKV 79) prādurbhavanti.	muKa-roga-danta-roga-gala-roga-muKa-dOrganDya-AdIni (MKV 79) prAdurBavanti.
   tasyaiva karmaṇo vipākenābhūtākhyānaṃ pratilabhate.	tasya-eva karmaNaH vipAkena-aBUta-AKyAnam pratilaBate.
   LVI. piśunavacanasyākuśalasya karmapathasya vipākena pṛthivyāṃ	LVI. piSuna-vacanasya-akuSalasya karma-paTasya vipAkena pRTivyAm
   śarkarakaṭhallyādīni duḥkhasaṃsparśādīni prādurbhavanti. tasyaiva karmaṇo	Sarkara-kaWallI-AdIni duHKa-saMsparSa-AdIni prAdurBavanti. tasya-eva karmaNaH-
   vipākena jātivyasanā mitravyasanā bhavanti bhedyaḥ parivāraś ca bhavati.	vipAkena jAti-vyasanAH mitra-vyasanAH Bavanti BedyaH parivAraH ca Bavati.
   LVIl. paruṣavacaso 'kuśalakarmapathasya vipākena	LVIl. paruza-vacasaH akuSala-karma-paTasya vipAkena
   pāṃśurajodhūlivātavṛṣṭyādīni prādurbhavanti. tasyaiva karmaṇo	pAMSu-rajaH-DUli-vAta-vRzwi-AdIni prAdurBavanti. tasya-eva karmaNaH-
   vipākenāmanojñaśabdaśravaṇadarśanāny anubhavanti.	vipAkena-amanojQa-Sabda-SravaNa-darSanAni anuBavanti.
   LVIII. saṃbhinnapralāpasyākuśalasya karmapathasya vipākena ...	LVIII. saMBinna-pralApasya-akuSalasya karma-paTasya vipAkena ...
   kandaraśvabhrādīni prādurbhavanti. tasyaiva karmaṇo vipākenānādeyavacanā	kandara-SvaBra-AdIni prAdurBavanti. tasya-eva karmaNaH vipAkena-anAdeya-vacanA
   bhavanti.	Bavanti.
   LIX. abhidhyāyā akuśalasya karmapathasya vipākena vrīhiyavagodhūmādīnāṃ	LIX. aBiDyAyAH akuSalasya karma-paTasya vipAkena vrIhi-yava-goDUma-AdInAm
   sasyānāṃ tuṣapalālādīni prādurbhavanti. tasyaiva karmaṇo vipākena	sasyAnAm tuza-palAla-AdIni prAdurBavanti. tasya-eva karmaNaH vipAkena
   paraprārthanīyabhogā bhavanti.	para-prArTanIya-BogAH Bavanti.
   LX. vyāpādasyākuśalakarmapathasya vipākena prabhūte upte niṣphalaṃ sasyaṃ	LX. vyApAdasya-akuSala-karma-paTasya vipAkena praBUte upte nizPalam sasyam
   bhavati. tasyaiva karmaṇo vipākena pratikūladarśano bhavati.	Bavati. tasya-eva karmaNaH vipAkena pratikUla-darSanaH Bavati.
   LXI. mithyādṛṣṭer akuśalasya karmapathasya vipākena tiktakaṭukabhāvāny	LXI. miTyA-dRzweH akuSalasya karma-paTasya vipAkena tikta-kawuka-BAvAni-
   (MKV 80) api picumandakoṣātakīviṣatiktālābuprabhṛtīni phalāni	(MKV 80) api picumanda-kozAtakI-viza-tikta-alAbu-praBRtIni PalAni
   prādurbhavanti. mithyādṛṣṭer akuśalasya karmapathasya vipākena	prAdurBavanti. miTyA-dRzweH akuSalasya karma-paTasya vipAkena
   nāstikyavādī bhavati. ucchedadṛṣṭiḥ lokāyatādiṣu ca śāstreṣu prasādo	nAstikya-vAdI Bavati. ucCeda-dRzwiH lokAyata-Adizu ca SAstrezu prasAdaH-
   bhavati. yathā padāśvasya rājaputrasya yaḥ kumārakāśyapena śvetikāyāṃ	Bavati. yaTA padASvasya rAja-putrasya yaH kumArakASyapena SvetikAyAm
   vinīto lokāyatikaḥ. yathā yathā sattvā imān daśākuśalān karmapathān	vinItaH lokAyatikaH. yaTA yaTA sattvAH imAn daSa-akuSalAn karma-paTAn
   bhāvayanti tathaiṣāṃ daśānāṃ bāhyānāṃ bhāvānām atīva prādurbhāvo bhavati.	BAvayanti taTA-ezAm daSAnAm bAhyAnAm BAvAnAm atIva prAdurBAvaH Bavati.
   anenaiva ca kāraṇena mahāsaṃvartakalpe bhaviṣyati samayo 'nāgate 'dhvani	anena-eva ca kAraNena mahA-saMvarta-kalpe Bavizyati samayaH anAgate aDvani
   yat tilā bhaviṣyanti tilapiṣṭaṃ bhaviṣyati tailaṃ na bhaviṣyati ikṣur	yat tilAH Bavizyanti tila-pizwam Bavizyati tElam na Bavizyati ikzuH-
   bhaviṣyati ikṣuraso na bhaviṣyati guḍo na bhaviṣyati. na khaṇḍaṃ	Bavizyati ikzu-rasaH na Bavizyati guxaH na Bavizyati. na KaNxam
   bhaviṣyati na śarkarā bhaviṣyanti. gāvo bhaviṣyanti kṣīraṃ bhaviṣyati	Bavizyati na SarkarA Bavizyanti. gAvaH Bavizyanti kzIram Bavizyati
   dadhi bhaviṣyati navanītaṃ na bhaviṣyati na ghṛtaṃ na gḥrtamaṇḍo	daDi Bavizyati navanItam na Bavizyati na GRtam na gHrtamaNxo
   bhaviṣyati. evam anupūrveṇa sarveṇa sarve rasā antardhāsyanti.	Bavizyati. evam anupUrveNa sarveNa sarve rasAH antarDAsyanti.
   (MKV 81) [notes only]	(MKV 81) [noteH only]
   (MKV 82)	(MKV 82)
   LXII. katame daśānuśaṃsā madhyadeśe	LXII. katame daSa-anuSaMsAH maDyadeSe
   caturmahācaityalumbinīmahābodhiprabhṛtiṣu	catur-mahA-cEtya-lumbinI-mahA-boDi-praBRtizu
   tathāgatacaityāñjalikarmapraṇipāte. ucyate. madhyadeśe janma pratilabhate.	taTAgata-cEtya-aQjali-karma-praNipAte. ucyate. maDya-deSe janma pratilaBate.
   udārāṇi ca vastrāṇi pratilabhate. udāraṃ kulaṃ pratilabhate. udāraṃ vayaḥ	udArANi ca vastrANi pratilaBate. udAram kulam pratilaBate. udAram vayaH
   pratilabhate. udāraṃ svaraṃ pratilabhate. udārāṃ pratibhānatāṃ	pratilaBate. udAram svaram pratilaBate. udArAm pratiBAnatAm
   pratilabhate. udārāṃ śraddhāṃ pratilabhate. udāraṃ śīlaṃ pratilabhate.	pratilaBate. udArAm SradDAm pratilaBate. udAram SIlam pratilaBate.
   udāraṃ śrutaṃ pratilabhate. udāraṃ tyāgaṃ pratilabhate. udārāṃ smṛtiṃ	udAram Srutam pratilaBate. udAram tyAgam pratilaBate. udArAm smRtim
   pratilabhate. udārāṃ prajñāṃ pratilabhate. asyoddānam.	pratilaBate. udArAm prajQAm pratilaBate. asya-uddAnam.
   deśavastrakularūpasvarapratibhānatāśraddhāśīlaśrutatyāgān smṛtimān bhavati	deSa-vastra-kula-rUpa-svara-pratiBAnatA-SradDA-SIla-Sruta-tyAgAn smRtimAn Bavati
   prajñāvān tathāgatasya buddhaprasādaṃ kṛtvāñjaliṃ labhate dhīraḥ (MKV 83)	prajQAvAn taTAgatasya budDa-prasAdam kRtvA-aQjalim laBate DIraH (MKV 83)
   saprajña udāram āśravakṣayam. uktaṃ ca sūtre. ye kecid ānanda caityacaryāṃ	sa-prajQaH udAram ASrava-kzayam. uktam ca sUtre. ye kecid Ananda cEtya-caryAm
   caramāṇāḥ prasannacittāḥ kālaṃ kariṣyanti. yathā bhallo nikṣiptaḥ	caramANAH prasanna-cittAH kAlam karizyanti. yaTA BallaH nikziptaH
   pṛthivyāṃ tiṣṭhate evaṃ kāyasya bhedāt svargeṣūpapatsyanti.	pRTivyAm tizWate evam kAyasya BedAt svargezu-upapatsyanti.
   (MKV 84)	(MKV 84)
   LXIII. katame daśānuśaṃsās tathāgatacaityavandanāyām. ucyate. abhirūpo	LXIII. katame daSa-anuSaMsAH taTAgata-cEtya-vandana-AyAm. ucyate. aBirUpaH-
   bhavati. susvaraḥ. ādeyavākyaḥ. pariṣadam upasaṃkrāntaḥ pariṣadam	Bavati. su-svaraH. Adeya-vAkyaH. parizadam upasaMkrAntaH parizadam
   āvarjayati priyo bhavati devamanuṣyāṇām. maheśākhyo bhavati. maheśākhyaiḥ	Avarjayati priyaH Bavati deva-manuzyANAm. maheSa-AKyaH Bavati. maheSa-AKyEH
   samāgamo sattvaiḥ bhavati. buddhair buddhaśrāvakaiś ca samāgamo bhavati.	samAgamaH sattvEH Bavati. budDEH budDa-SrAvakEH ca samAgamaH Bavati.
   mahābhogo bhavati. svargeṣūpapadyate. kṣipraṃ ca parinirvāti. ime	mahA-BogaH Bavati. svargezu-upapadyate. kzipram ca parinirvAti. ime
   daśānuśāṃsās tathāgatacaityavandanāyāḥ.	daSa-anuSAMsAH taTAgata-cEtya-vandanAyAH.
   (MKV 85)	(MKV 85)
   LXIV. katame daśānuśaṃsāś chattrapradānasya. ucyate. chattrabhūto bhavati	LXIV. katame daSa-anuSaMsAH Cattra-pradAnasya. ucyate. Cattra-BUtaH Bavati
   lokasya. anavatapto bhavati kāyena anavatapto bhavati cittena.	lokasya. anavataptaH Bavati kAyena anavataptaH Bavati cittena.
   ādhipatyasaṃvartanīyaṃ cānena karma kṛtaṃ bhavaty upacitam. punaḥ punaś ca	ADipatya-saMvartanIyam ca-anena karma kRtam Bavati upacitam. punar punar ca
   rājā bhavati cakravartī. maheśākhyo bhavati. maheśākhyaiḥ sattvaiḥ	rAjA Bavati cakravartI. maheSa-AKyaH Bavati. maheSa-AKyEH sattvEH
   samāgamo bhavati buddhair buddhaśrāvakaiś ca samāgamo bhavati. mahābhogo	samAgamaH Bavati budDEH budDa-SrAvakEH ca samAgamaH Bavati. mahA-BogaH-
   bhavati. svargeṣūpapadyate. kṣipraṃ ca parinirvāti.	Bavati. svargezu-upapadyate. kzipram ca parinirvAti.
   a) atra gaṅgāsaṃtāre bhagavataḥ pratyekabuddhasya stūpe dattasya	a) atra gaFgA-saMtAre BagavataH pratyekabudDasya stUpe dattasya
   chattrasya vipāko varṇyate. yathā cāryasundaranando vyākaroti.	Cattrasya vipAkaH varNyate. yaTA ca-Aryasundara-nandaH vyAkaroti.
   jentākasya ca snānena tālasyālepanena ca	jentAkasya ca snAnena tAlasya-Alepanena ca
   ekacchattrapradānāc ca prāptā me suvarṇavarṇatā.	eka=-Cattra-pradAnAt ca prAptA me suvarNa-varNa-tA.
   evamādi chattrapradānasya vipāko vaktavyaḥ. āha ca.	evamAdi Cattra-pradAnasya vipAkaH vaktavyaH. Aha ca.
   (MKV 86) [notes only]	(MKV 86) [noteH only]
   (MKV 87)	(MKV 87)
   yad dhāryate pravaradaṇḍam udārarūpaṃ	yat DAryate pravara-daNxam udAra-rUpam
   kodaṇḍadāmaparimaṇḍitavastikośam	kodaNxa-dAma-parimaNxita-vasti-koSam
   chattraṃ viśālam amalaṃ śaśimaṇḍalābham	Cattram viSAlam amalam SaSi-maNxala-ABam
   chattrapradānajanitena jagaddharasya.	Cattra-pradAna-janitena jagadharasya.
   śrīcihnabhūtaṃ maṇihemadaṇḍam	SrI-cihna-BUtam maNi-hema-daNxam
   paṭojjvalaṃ kāñcanam ātapatram	pawa-ujjvalam kAQcanam Atapatram
   yad dhāryate mūrdhni narādhipasya	yat DAryate mUrDni narADipasya
   chattrapradānena jagaddharasya	Cattra-pradAnena jagat-harasya
   ime daśānuśaṃsaś chattrapradānasya.	ime daSa-anuSaMsaH Cattra-pradAnasya.
   LXV. katame daśānuśaṃsā ghaṇṭāpradānasya. ucyate. abhirūpo bhavati.	LXV. katame daSa-anuSaMsA GaNwA-pradAnasya. ucyate. aBirUpaH Bavati.
   susvaro bhavati. manojñabhāṣī bhavati. kalaviṅkarutabhāṣī bhavati.	susvaraH Bavati. manojQa-BAzI Bavati. kalaviFka-ruta-BAzI Bavati.
   ādeyavākyo bhavati. nityaṃ saṃprahāryajāto bhavati. punaḥ punar ānandaṃ	Adeya-vAkyaH Bavati. nityam saMprahArya-jAtaH Bavati. punar punar Anandam
   śabdaṃ śṛṇoti. svargeṣūpapadyate. mahābhogaś ca bhavati. kṣipraṃ ca	Sabdam SRNoti. svargezu-upapadyate. mahA-BogaH ca Bavati. kzipram ca
   parinirvāti.	parinirvAti.
   a) yathā viśākhayā mṛgāramātrā bhagavān pṛṣṭaḥ. kathaṃ mama prāsāde nityaṃ	a) yaTA viSAKayA mRgAra-mAtrA BagavAn pRzwaH. kaTam mama prAsAde nityam
   kālaṃ pañcāṅgikaṃ tūryaṃ sadaiva vadet. bhagavān (MKV 88) āha.	kAlam paQca-AFgikam tUryam sadA-eva vadet. BagavAn (MKV 88) Aha.
   sarvasvaropetāṃ ghaṇṭām āropaya. evaṃ te nityaṃ kālaṃ prāsāde	sarva-svara-upetAm GaNwAm Aropaya. evam te nityam kAlam prAsAde
   pañcāṅgikatūryaśabdo bhaviṣyati. anavadyaś ca. ime daśa guṇā	paQcAFgika-tUrya-SabdaH Bavizyati. anavadyaH ca. ime daSa guNA
   ghaṇṭāpradānasya.	GaNwA-pradAnasya.
   (MKV 89)	(MKV 89)
   LXVI. katame daśa guṇā vastrapradānasya. ucyate. ślakṣṇachavir bhavati.	LXVI. katame daSa guNAH vastra-pradAnasya. ucyate. SlakzNa-CaviH Bavati.
   snigdhacchavir bhavati. na carajaś cailaṃ kāye śliṣyati.	snigDa=-CaviH Bavati. na carajaH cElam kAye Slizyati.
   hrīrapatrāpyasaṃpanno bhavati priyadarśano bhavati prabhūtavastro bhavati	hrIH-apatra-api-asaMpannaH Bavati priya-darSanaH Bavati praBUta-vastraH Bavati
   lābhī ca bhavati sūkṣmāṇāṃ vastrāṇām āstaraṇānām. mahābhogo bhavati.	lABI ca Bavati sUkzmANAm vastrANAm AstaraNAnAm. mahA-BogaH Bavati.
   svargeṣūpapadyate kṣipraṃ ca parinirvāti. yathoktaṃ bhagavatā devatāsūtre.	svargezu-upapadyate kzipram ca parinirvAti. yaToktam BagavatA devatA-sUtre.
   vastraprado bhavati varṇavān. ime daśa guṇānuśaṃsā vastrapradānasya.	vastra-pradaH Bavati varNavAn. ime daSa guNa-anuSaMsAH vastra-pradAnasya.
   (MKV 90)	(MKV 90)
   LXVII. katame daśānuśaṃsā āsanapradānasya. ucyate. gurusthānīyo bhavati	LXVII. katame daSa-anuSaMsAH Asana-pradAnasya. ucyate. guru-sTAnIyaH Bavati
   lokasya. priyadarśano bhavati. prāsādiko bhavati. paṇḍitajanābhigamyo	lokasya. priya-darSanaH Bavati. prAsAdikaH Bavati. paNxita-jana-aBigamyaH-
   bhavati. yaśaḥ kīrtiś cāsya loke prathitā bhavati. sukhasaumanasyabahulo	Bavati. yaSaH kIrtiH ca-asya loke praTitA Bavati. suKa-sOmanasya-bahulaH-
   bhavati. svadeśe 'bhiramati. āsanair avaikalyaṃ bhavati. upasthāyakair	Bavati. sva-deSe aBiramati. AsanEH avEkalyam Bavati. upasTAyakEH-
   avaikalyaṃ bhavati. mahābhogaś ca bhavati. svargeṣūpapadyate. kṣipraṃ ca	avEkalyam Bavati. mahA-BogaH ca Bavati. svargezu-upapadyate. kzipram ca
   parinirvāti. ime daśa guṇā āsanapradānasya.	parinirvAti. ime daSa guNAH Asana-pradAnasya.
   (MKV 91)	(MKV 91)
   LXVIII. katame daśānuśaṃsā bhājanapradānasya. ucyate. bhājanabhūto bhavati	LXVIII. katame daSa-anuSaMsAH BAjana-pradAnasya. ucyate. BAjana-BUtaH Bavati
   guṇānāṃ snigdhasaṃtatir bhavati. na ca tṛṣābahulo bhavati. tṛṣārtasya	guNAnAm snigDa-saMtatiH Bavati. na ca tRzA-bahulaH Bavati. tRzA-Artasya
   pānīyaṃ prādurbhavati. na ca preteṣūpapadyate. bhājanair avaikalyaṃ	pAnIyam prAdurBavati. na ca pretezu-upapadyate. BAjanEH avEkalyam
   bhavati. mahābhogaś ca bhavati. svargeṣūpapadyate. kṣipraṃ ca parinirvāti.	Bavati. mahA-BogaH ca Bavati. svargezu-upapadyate. kzipram ca parinirvAti.
   ime daśānuśaṃsā bhājanapradānasya.	ime daSa-anuSaMsAH BAjana-pradAnasya.
   (MKV 92)	(MKV 92)
   LXIX. katame daśānuśaṃsā bhojanapradānasya. ucyate. balavān bhavati.	LXIX. katame daSa-anuSaMsAH Bojana-pradAnasya. ucyate. balavAn Bavati.
   varṇavān bhavati. sukhito bhavati. pratibhānavān bhavati. dīrghāyur	varNavAn Bavati. suKitaH Bavati. pratiBAnavAn Bavati. dIrGa-AyuH-
   bhavati. mahājanābhigamyo bhavati. priyadarśano bhavati. mahābhogaś ca	Bavati. mahA-jana-aBigamyaH Bavati. priya-darSanaH Bavati. mahA-BogaH ca
   bhavati. svargeṣūpapadyate. kṣipraṃ ca parinirvāti.	Bavati. svargezu-upapadyate. kzipram ca parinirvAti.
   a) yathoktaṃ bhagavatā vaiśālyāṃ siṃhasya rājaputrasya. dadan siṃha priyo	a) yaToktam BagavatA vESAlyAm siMhasya rAja-putrasya. dadan siMha priyaH-
   bhavati. santo janā bhajanti. kalyāṇaśabdo bhavati. viśāradaḥ parṣadam	Bavati. santaH janAH Bajanti. kalyANa-SabdaH Bavati. viSAradaH parzadam
   avagāhati. kālagato deveṣūpapadyate.	avagAhati. kAlagataH devezu-upapadyate.
   gāthā coktā.	gATA ca-uktA.
   (MKV 93)	(MKV 93)
   te tatra nandanti ramanti ca modayanti	te tatra nandanti ramanti ca modayanti
   samarpitāḥ kāmaguṇeṣu pañcasu	samarpitAH kAma-guNezu paQcasu
   kṛtvā hi vākyam amitasya tāyino	kRtvA hi vAkyam amitasya tAyinaH-
   modanti te sugatavarasya śrāvakāḥ.	modanti te sugata-varasya SrAvakAH.
   etad dānasya phalaṃ bhagavatoktam.	etat dAnasya Palam BagavatA-uktam.
   svargeṣūpapadyate kṣipraṃ ca parinirvāti. āha ca.	svargezu-upapadyate kzipram ca parinirvAti. Aha ca.
   nānārasavyañjanasupraṇītaṃ	nAnA-rasa-vyaQjana-su-praNItam
   kāle śubhaṃ gandharasopapannam	kAle SuBam ganDa-rasa-upapannam
   dadāti yaḥ pātram avekṣya dānaṃ	dadAti yaH pAtram avekzya dAnam
   sadāryasaṃghasya guṇān vicintya	sa-dA-Arya-saMGasya guNAn vicintya
   āyuś ca varṇaṃ ca yaśo balaṃ ca	AyuH ca varNam ca yaSaH balam ca
   saṃprāpya bhogān pratibhāṃ sukhaṃ ca	saMprApya BogAn pratiBAm suKam ca
   divīha caiva prathitottamaśrīḥ	divi-iha ca-eva praTita-uttama-SrIH
   sukhāt sukhaṃ yāti vimokṣam ante.	suKAt suKam yAti vimokzam ante.
   ime daśa guṇā bhojanapradānasya.	ime daSa guNAH Bojana-pradAnasya.
   (MKV 94)	(MKV 94)
   LXX. katame daśa guṇā yānapradānasya. ucyate. sukumāracaraṇo bhavati.	LXX. katame daSa guNAH yAna-pradAnasya. ucyate. sukumAra-caraNaH Bavati.
   snpratiṣṭhitacaraṇo bhavati. mārgaklamatho na bhavati. na ca bahvamitro	sn-pratizWita-caraNaH Bavati. mArga-klamaTaH na Bavati. na ca bahu-amitraH-
   bhavati. punaḥ punaḥ ṛddhipādān pratilabhate. hastyaśvādibhir yānair	Bavati. punar punar RdDi-pAdAn pratilaBate. hasti-aSva-AdiBiH yAnEH-
   avaikalyaṃ bhavati. mahābhogaś ca bhavati. svargeṣūpapadyate. kṣipraṃ ca	avEkalyam Bavati. mahA-BogaH ca Bavati. svargezu-upapadyate. kzipram ca
   parinirvāti.	parinirvAti.
   a) yathā coktaṃ devatāsūtre. yānadaḥ sukhito bhavati. yo dadāty upānahau.	a) yaTA ca-uktam devatA-sUtre. yAna-daH suKitaH Bavati. yaH dadAti upAnahO.
   yathā coktam abhidharme cakravartisūtre. katamasya karmaṇo vipākena rājā	yaTA ca-uktam aBiDarme cakravarti-sUtre. katamasya karmaNaH vipAkena rAjA
   cakravartī hastyaśvādīni vāhanāni pratilabhate. dīrgharātraṃ rājā	cakravartI hasti-aSva-AdIni vAhanAni pratilaBate. dIrGarAtram rAjA
   cakravartī mātaraṃ vā pitaraṃ vopādhyāyaṃ vā skandhena vahati vā vāhayati	cakravartI mAtaram vA pitaram vA-upADyAyam vA skanDena vahati vA vAhayati
   vā. hastyaśvādibhiḥ śivikāyānair vā vahati vā. durgasaṃkramaṃ vā karoti.	vA. hasti-aSva-AdiBiH SivikA-yAnEH vA vahati vA. durga-saMkramam vA karoti.
   setubandhaṃ karoti. upānahapradānāni vā dadāti. kāruṇyena mahāṭavyāṃ	setu-banDam karoti. upAnaha-pradAnAni vA dadAti. kAruNyena mahA-awavyAm
   sārtham atikrāmayati. tasya karmaṇo vipākena rājā cakravartī hastyaśvādīni	sArTam atikrAmayati. tasya karmaNaH vipAkena rAjA cakravartI hasti-aSva-AdIni
   pratilabhate. tatrārūḍhaḥ samudraparyantāṃ pṛthivīṃ divasacaturbhāgena	pratilaBate. tatra-ArUXaH samudra-paryantAm pRTivIm divasa-catur-BAgena
   paryaṭati. ime daśa guṇā yānapradānasya.	paryawati. ime daSa guNAH yAna-pradAnasya.
   (MKV 95) [notes only]	(MKV 95) [noteH only]
   (MKV 96)	(MKV 96)
   LXXI. katame daśa guṇāḥ pratiśrayapradānasya. ucyate. rājā bhavati	LXXI. katame daSa guNAH pratiSraya-pradAnasya. ucyate. rAjA Bavati
   prādeśikaḥ. rājā bhavati māṇḍalikaḥ. rājā bhavati jambudvīpādhipatiḥ. rājā	prAdeSikaH. rAjA Bavati mANxalikaH. rAjA Bavati jambudvIpa-aDipatiH. rAjA
   bhavati dvīpadvayādhipatiḥ. rājā bhavati dvīpatrayādhipatiḥ. rājā bhavati	Bavati dvIpa-dvaya-aDipatiH. rAjA Bavati dvIpa-traya-aDipatiH. rAjA Bavati
   caturdvīpādhipatiś cakravartī. mahābhogaś ca bhavati. svargeṣūpapadyate.	catur-dvIpa-aDipatiH cakravartI. mahA-BogaH ca Bavati. svargezu-upapadyate.
   kṣipraṃ ca parinirvāti.	kzipram ca parinirvAti.
   yathā sumedhāyā bhikṣuṇyā gāthā.	yaTA sumeDAyAH BikzuNyA gATA.
   (MKV 97)	(MKV 97)
   bhagavati konāgamunau saṃghārāme ca niveśe	Bagavati kona-AgamunO saMGAra-Ame ca niveSe
   sakhyas trayo vayaṃ sa vihāraṃ dadau pūrvam.	saKyaH trayaH vayam sa vihAram dadO pUrvam.
   etā gāthā sumedhāyāḥ. dharmadinnā ca bhikṣuṇī viśākhyā ca mṛgāramātā.	etA gATA sumeDAyAH. DarmadinnA ca BikzuNI viSA-AKyA ca mRgAra-mAtA.
   tābhiḥ pūrvaṃ daridrastrībhiś catvāri kāṣṭhāni nikhanya kāśakaṭakam upari	tABiH pUrvam daridra-strIBiH catvAri kAzWAni niKanya kASa-kawakam upari
   dattvā bhagavān konāgamunir buddho nimantritaḥ. sa tatra bhikṣubhiḥ	dattvA BagavAn konAga-muniH budDaH nimantritaH. sa tatra BikzuBiH
   sārdhaṃ muhūrtaṃ viśrāntaḥ. tābhiś cittāni prasāditāni. tena karmaṇā	sArDam muhUrtam viSrAntaH. tABiH cittAni prasAditAni. tena karmaNA
   śatasahasraṃ vārān deveṣūpapannāḥ. aparimitāni cakravartirāṣṭrāny	Sata-sahasram vArAn devezu-upapannAH. aparimitAni cakravarti-rAzwrAni-
   anubhūtāni. sumedhāgāthāś cāsminn arthe sarvā vistareṇa pratyekam	anuBUtAni. sumeDA-gATAH ca-asmin arTe sarvAH vistareNa pratyekam
   avagantavyāḥ. ime daśa guṇāḥ pratiśrayapradānasya.	avagantavyAH. ime daSa guNAH pratiSraya-pradAnasya.
   LXXII. katame daśa guṇāḥ pānakapradānasya. ucyate. sarvendriyasaṃpanno	LXXII. katame daSa guNAH pAnaka-pradAnasya. ucyate. sarva-indriya-saMpannaH-
   bhavati. prasannavadano. viśuddhalalāṭaḥ. snigdhacchaviḥ. saṃgatabhāṣī	Bavati. prasanna-vadano. viSudDa-lalAwaH. snigDa=-CaviH. saMgata-BAzI
   bhavati. na ca tṛṣābahulo bhavati. tṛṣitasya (MKV 98) pānīyaṃ	Bavati. na ca tRzA-bahulaH Bavati. tRzitasya (MKV 98) pAnIyam
   prādurbhavati. na ca preteṣūpapadyate. mahābhogaś ca bhavati.	prAdurBavati. na ca pretezu-upapadyate. mahA-BogaH ca Bavati.
   svargeṣūpapadyate. kṣipraṃ ca parinirvāti. yathā cāha.	svargezu-upapadyate. kzipram ca parinirvAti. yaTA ca-Aha.
   manojñavarṇaṃ rasagandhayuktaṃ	manojQa-varNam rasa-ganDa-yuktam
   sarvendriyaprītivivardhanaṃ ca	sarva-indriya-prIti-vivarDanam ca
   akālikaṃ satpuruṣapraśastaṃ	akAlikam sat-puruza-praSastam
   dadāti saṃghāya tu pānakaṃ yaḥ	dadAti saMGAya tu pAnakam yaH
   sakṛtpipāsāvigato viśoko	sakRt-pipAsA-vigataH viSokaH-
   rasān pradhānāñ caturo 'nubhūya	rasAn praDAnAn caturaH anuBUya
   jagac ca saddharmarasena tarpya	jagat ca sadDarma-rasena tarpya
   tṛṣākṣayaṃ yāti sukhaṃ sukhena.	tRzA-akzayam yAti suKam suKena.
   ime daśa guṇāḥ pānakapradānasya.	ime daSa guNAH pAnaka-pradAnasya.
   LXXIII. katame daśa guṇā mālāpradānasya. ucyate. mālābhūto bhavati	LXXIII. katame daSa guNAH mAlA-pradAnasya. ucyate. mAlA-BUtaH Bavati
   lokasya. kāyād daurgandhyam apaiti saugandhyaṃ prādurbhavati.	lokasya. kAyAt dOrganDyam apEti sOganDyam prAdurBavati.
   nityasugandho nityālaṃkṛto bhavati. abhedyaparivāro bhavati.	nitya-suganDaH nitya-alaMkRtaH Bavati. aBedya-parivAraH Bavati.
   sarvajanapriyo bhavati. mahābhogaś ca bhavati. svargeṣūpapadyate. kṣipraṃ	sarva-jana-priyaH Bavati. mahA-BogaH ca Bavati. svargezu-upapadyate. kzipram
   ca parinirvāti.	ca parinirvAti.
   (MKV 99)	(MKV 99)
   a) aha ca.	a) aha ca.
   mālyaṃ vicitraṃ pravaraṃ sugandhaṃ	mAlyam vicitram pravaram suganDam
   praharṣaṇaṃ prītikaraṃ narāṇām	praharzaNam prIti-karam narANAm
   prasannacitto munidhātugarbhe	prasanna-cittaH muni-DAtu-garBe
   tathāgatebhyaś ca dadāti yo vai	taTAgateByaH ca dadAti yaH vE
   sa divyamālyābharaṇojjvalāṅgaḥ	sa divya-mAlya-ABaraNa-ujjvala-aFgaH
   śrīmat sukhaṃ prāpya divīha caiva	SrImat suKam prApya divi-iha ca-eva
   bodhyaṅgadāmapratibhūṣitātmā	boDi-aFga-dAma-pratiBUzita-AtmA
   mokṣaṃ paraṃ yāti guṇāgragandhaḥ.	mokzam param yAti guNa-agra-ganDaH.
   b) tathānyatarasya daridragṛhapater duhitā. sā khalu dvāre sthitā	b) taTA-anyatarasya daridra-gRhapateH duhitA. sA Kalu dvAre sTitA
   janapadaṃ sarvālaṃkārabhūṣitaṃ paśyati. utsave ramamāṇam. sā pitaram āha.	janapadam sarva-alaMkAra-BUzitam paSyati. utsave ramamANam. sA pitaram Aha.
   mām apy alaṃkuruṣveti. pitāha. kuto 'smākaṃ daridrāṇām alaṃkāraḥ. eṣa	mAm api alaMkuruzva-iti. pitA-aha. kutas asmAkam daridrANAm alaMkAraH. eza
   janapadaḥ kṛtapuṇyo 'nekaśo buddhe bhagavati kṛtādhikāraḥ. tena ca karmaṇā	janapadaH kRta-puNyaH anekaSas budDe Bagavati kRta-aDikAraH. tena ca karmaNA
   karṇesumanasya sthavirasyāvadānaṃ vistaraśas tasyoktam. evam alpo 'pi	karNesumanasya sTavirasya-avadAnam vistaraSaH tasya-uktam. evam alpaH api
   bhagavati kṛtaḥ prasādo mahāphalo bhavati. tayā pitātīvoparodhitaḥ	Bagavati kRtaH prasAdaH mahAPalaH Bavati. tayA pitA-atIva-uparoDitaH
   prayaccha mama kiṃcid eṣo 'grato vihāraḥ atra bhagavataḥ pūjām	prayacCa mama kiMcid ezaH agratas vihAraH atra BagavataH pUjAm
   upariṣyāmīti. tena duḥkhārtena vibhave 'vidyamāne palālamayīṃ mālāṃ kṛtvā	uparizyAmi-iti. tena duHKa-Artena viBave avidyamAne palAla-mayIm mAlAm kRtvA
   dattā. sā tāṃ palālamayīṃ mālāṃ gṛhya buddhapratimāyāḥ śirasi dattvā	dattA. sA tAm palAla-mayIm mAlAm gRhya budDa-pratimAyAH Sirasi dattvA
   pādayoḥ praṇipatya āha. bhagavann anena kuśalamūlena saṃsāre saṃsaratyā mā	pAdayoH praNipatya Aha. Bagavan anena kuSala-mUlena saMsAre saMsaratyA mA
   bhūyaḥ dāridryaṃ syād iti. tasyāḥ prasādajātāyās tad ahar eva mānuṣyaṃ	BUyas dAridryam syAt iti. tasyAH prasAda-jAtAyAH tat ahar eva mAnuzyam
   strībhāvam atikrāntaṃ divyaṃ rūpaṃ prādurbhūtam. tadviṣayaprativāsinā ca	strI-BAvam atikrAntam divyam rUpam prAdurBUtam. tad-vizaya-prativAsinA ca
   rājñāgradevī sthāpitā. kālagatā deveṣūpapannā. paścime 'pi ca bhave	rAjQA-agra-devI sTApitA. kAlagatAH devezu-upapannA. paScime api ca Bave
   campāyām agrakulikasya (MKV 100) duhitā pratyājātā paramakalyāṇī sauvarṇā	campAyAm agra-kulikasya (MKV 100) duhitA pratyAjAtA parama-kalyANI sOvarNA
   cāsyā mālā sarvaratnamaṇḍitā śirasi sahasaiva prādurbhūtā. mātāpitṛbhyāṃ	ca-asyAH mAlA sarva-ratna-maNxitA Sirasi sahasA-eva prAdurBUtA. mAtA-pitRByAm
   vismayajātābhyāṃ mālinīty evāsyā nāma kṛtam. yadā ca bhagavān	vismaya-jAtAByAm mAlinI-iti eva-asyAH nAma kRtam. yadA ca BagavAn
   abhisaṃbuddho rājagṛhāc campām anuprāptaḥ. sā copasaṃkrāntā. tasyāś ca	aBisaMbudDaH rAjagRhAt campAm anuprAptaH. sA ca-upasaMkrAntA. tasyAH ca
   bhagavatā dharmadeśanā kṛtā pravrajitā cārhantī saṃvṛttā. sāha cittotpādād	BagavatA Darma-deSanA kRtA pravrajitA ca-arhantI saMvRttA. sA-Aha citta-utpAdAt-
   evāsyā mā me bhūyo mālā bhavatv ity antarhitā. tāṃ ca dṛṣṭvā vismayaprāptā	eva-asyAH mA me BUyas mAlA Bavatu iti antarhitA. tAm ca dRzwvA vismaya-prAptA
   devatā gāthām anugāyate yathāha.	devatA gATAm anugAyate yaTA-Aha.
   dattvā tu palālamayīṃ mālāṃ sā mālinī sugatasya caitye	dattvA tu palAla-mayIm mAlAm sA mAlinI sugatasya cEtye
   varakanakaratnamālāṃ lebhe bodhyaṅgamālāṃ ca.	vara-kanaka-ratna-mAlAm leBe boDi-aFga-mAlAm ca.
   ime daśa guṇā mālāpradānasya.	ime daSa guNAH mAlA-pradAnasya.
   LXXIV. katame daśa guṇā muktapuṣpapradānasya. ucyate. puṣpabhūto bhavati	LXXIV. katame daSa guNAH mukta-puzpa-pradAnasya. ucyate. puzpa-BUtaH Bavati
   lokasya. ghrāṇendriyaṃ viśudhyati. kāyadaurgandhyaṃ samapaiti. saugandhyaṃ	lokasya. GrANa-indriyam viSuDyati. kAya-dOrganDyam sama-pEti. sOganDyam
   prādurbhavati. daśa diśaḥ śīlagandhaḥ khyātiṃ gacchati. abhigamanīyaś ca	prAdurBavati. daSa diSaH SIlaganDaH KyAtim gacCati. aBigamanIyaH ca
   bhavati. lābhī ca bhavati (MKV 101) iṣṭānāṃ dharmāṇām. mahābhogaś ca	Bavati. lABI ca Bavati (MKV 101) izwAnAm DarmANAm. mahA-BogaH ca
   bhavati. svargeṣūpapadyate kṣipraṃ ca parinirvāti.	Bavati. svargezu-upapadyate kzipram ca parinirvAti.
   a) atra karṇesumanasya pūrvajanmani prasāde jāte ekaikapuṣpapradānasya	a) atra karNesumanasya pUrva-janmani prasAde jAte eka-eka-puzpa-pradAnasya
   vipāko vaktavyaḥ. yathā sa eva āha.	vipAkaH vaktavyaH. yaTA saH eva Aha.
   ekapuṣpapradānena aśītikalpakoṭayaḥ	eka-puzpa-pradAnena aSIti-kalpa-kowayaH
   durgatiṃ nābhijānāmi buddhapūjāya tat phalam.	durgatim na-aBijAnAmi budDa-pUjAya tat Palam.
   ime daśa guṇā muktapuṣpapradānasya.	ime daSa guNAH mukta-puzpa-pradAnasya.
   LXXV. katame daśa guṇā dīpapradānasya. ucyate. pradīpabhūto bhavati	LXXV. katame daSa guNAH dIpa-pradAnasya. ucyate. pradIpa-BUtaH Bavati
   lokasya. māṃsacakṣur naśyati. divyacakṣuḥ prādurbhavati. avidyāndhakāraṃ	lokasya. mAMsa-cakzuH naSyati. divya-cakzuH prAdurBavati. avidyA-anDakAram
   vidhamati. jñānāloka utpadyate. kuśalākuśalān dharmān kṣipraṃ prajñayā	viDamati. jQAna-Aloke utpadyate. kuSala-akuSalAn DarmAn kzipram prajQayA
   pratividhyati. saṃsāre saṃsarato 'vidyāndhakāro na bhavati. mahābhogaś ca	prativiDyati. saMsAre saMsarataH avidyA-anDakAraH na Bavati. mahA-BogaH ca
   bhavati. svargeṣūpapadyate. kṣipraṃ ca parinirvāti.	Bavati. svargezu-upapadyate. kzipram ca parinirvAti.
   (MKV 102)	(MKV 102)
   a) yathā coktam abhidharme cakravartisūtravibhaṅge. kasya karmaṇo vipākena	a) yaTA ca-uktam aBiDarme cakravarti-sUtra-viBaFge. kasya karmaNaH vipAkena
   rājā cakravartī maṇiratnaṃ pratilabhate. dīrgharātraṃ rājñā cakravartinā	rAjA cakravartI maNi-ratnam pratilaBate. dIrGarAtram rAjQA cakravartinA
   dīpapradānāni pradattāni. pradīpaikadānāni ca. andhakāre ratnapradīpā	dIpa-pradAnAni pradattAni. pradIpa-eka-dAnAni ca. anDakAre ratna-pradIpA
   dhāritā. ye cakṣuṣmantas te samaviṣamāṇi rūpāṇi paśyantu. āha ca.	DAritA. ye cakzuzmantaH te sama-vizamANi rUpANi paSyantu. Aha ca.
   buddhapraśastaṃ labhate ca cakṣuś	budDa-praSastam laBate ca cakzuH-
   cakṣus tu yasyottamahetubhūtam	cakzuH tu yasya-uttama-hetu-BUtam
   lokāvabhāsaṃ bhavatīha rūpam	loka-avaBAsam Bavati-iha rUpam
   pradīpadānena jagaddharasya.	pradIpa-dAnena jagadharasya.
   tejo'dhiko nārtham udīkṣaṇīyaḥ	tejaH-aDikaH na-arTam udIkzaNIyaH
   atīva tuṣṭaḥ śubhakarmadarśī	atIva tuzwaH SuBa-karma-darSI
   saṃprāpya saukhyaṃ divi ceha caiva	saMprApya sOKyam divi ca-iha ca-eva
   viśuddhacakṣuḥ praśamaṃ paraiti.	viSudDa-cakzuH praSamam parEti.
   atrāryāniruddhasya dīpe divyacakṣur ṛṣīṇāṃ ca cakṣūtpāṭanamokṣāyaṇe	atra-Arya-anirudDasya dIpe divya-cakzuH RzINAm ca cakzu-utpAwana-mokzAyaNe
   vaktavyam. yathā dīpamālāpradānena dīpaṅkareṇa buddhatvaṃ prāptam. yā ca	vaktavyam. yaTA dIpa-mAlA-pradAnena dIpaFkareNa budDa-tvam prAptam. yA ca
   śrāvastyāṃ cakṣuvikalena pradīpamālā kāritā. saprasādo jātaḥ. praṇidhānaṃ	SrAvastyAm cakzu-vikalena pradIpa-mAlA kAritA. sa-prasAdaH jAtaH. praNiDAnam
   kṛtavān. utthitasya cāsya yathā paurāṇaṃ cakṣuḥ saṃvṛttam. ime daśa guṇā	kRtavAn. utTitasya ca-asya yaTA pOrANam cakzuH saMvRttam. ime daSa guNA
   dīpapradānasya.	dIpa-pradAnasya.
   (MKV 103)	(MKV 103)
   LXXVI. katame daśa guṇā gandhapradānasya. ucyate. gandhabhūto bhavati	LXXVI. katame daSa guNAH ganDa-pradAnasya. ucyate. ganDa-BUtaH Bavati
   lokasya. ghrāṇendriyaṃ viśudhyati. kāyadaurgandhyam apaiti. saugandhyaṃ	lokasya. GrANa-indriyam viSuDyati. kAya-dOrganDyam apEti. sOganDyam
   prādurbhavati. daśa diśaḥ śīlagandhaḥ pravāti. abhigamanīyo bhavati. lābhī	prAdurBavati. daSa diSaH SIlaganDaH pravAti. aBigamanIyaH Bavati. lABI
   ca bhavati iṣṭānāṃ dharmāṇām. mahābhogaś ca bhavati. svargeṣūpapadyate.	ca Bavati izwAnAm DarmANAm. mahA-BogaH ca Bavati. svargezu-upapadyate.
   kṣipraṃ ca parinirvāti.	kzipram ca parinirvAti.
   a) yathoktam abhidharme cakravartisūtre. kasya karmaṇo vipākena rājñaś	a) yaTA-uktam aBiDarme cakravarti-sUtre. kasya karmaNaH vipAkena rAjQaH-
   cakravartinaḥ strīratnasya romakūpebhyaḥ śarīrād gandho nirgacchati.	cakravartinaH strI-ratnasya romakUpeByaH SarIrAt ganDaH nirgacCati.
   tadyathā gandhasamudgakasya. dīrgharātraṃ tayā striyā caityagarbhagṛheṣu	tat-yaTA ganDa-samudgakasya. dIrGarAtram tayA striyA cEtya-garBa-gRhezu
   gandhopalepanāni dattāni. surabhīṇi ca puṣpāṇi dhūpaś ca dattāḥ. stūpeṣu	ganDa-upalepanAni dattAni. suraBINi ca puzpANi DUpaH ca dattAH. stu-upezu
   ca gandhasnāpanāni kṛtāni. tasya karmaṇo vipākena rājñaś cakravartinaḥ	ca ganDa-snApanAni kRtAni. tasya karmaNaH vipAkena rAjQaH cakravartinaH
   strīratnasya śarīrād evaṃrūpo gandho nirgacchati. tadyathā	strI-ratnasya SarIrAt evaMrUpaH ganDaH nirgacCati. tat-yaTA
   gandhakaraṇḍasya. ime daśa guṇā gandhapradānasya.	ganDakaraNxasya. ime daSa guNAH ganDa-pradAnasya.
   (MKV 104)	(MKV 104)
   LXXVII. katame daśa guṇāḥ pravrajyāyāḥ. ucyate.	LXXVII. katame daSa guNAH pravrajyAyAH. ucyate.
   putrabhāryaduhitṛdhanatṛṣṇāsya na bhavati. kāmasya parigraho na bhavati.	putra-BArya-duhitR-Dana-tRzNA-asya na Bavati. kAmasya parigrahaH na Bavati.
   araṇyavāse prītiṃ pratilabhate. buddhagocaraṃ sevate. bālagocaraṃ	araNya-vAse prItim pratilaBate. budDa-gocaram sevate. bAla-gocaram
   vivarjayati. durgatigamanīyān dharmān vivarjayati. sugatigamanīyān dharmān	vivarjayati. durgati-gamanIyAn DarmAn vivarjayati. sugati-gamanIyAn DarmAn
   sevate. devā asya spṛhayanti. nityaṃ sugatavacane pravrajyāṃ pratilabhate.	sevate. devAH asya spRhayanti. nityam sugata-vacane pravrajyAm pratilaBate.
   ime daśa guṇāḥ pravrajyāyā bhavanti.	ime daSa guNAH pravrajyAyAH Bavanti.
   LXXVIII. katame daśa guṇā araṇyavāsasya. ucyate. saṃgaṇikā vivarjayati.	LXXVIII. katame daSa guNAH araNya-vAsasya. ucyate. saMgaNikA vivarjayati.
   pravivekaṃ sevate. dhyānālambanaṃ cittaṃ bhavati. na ca bahukarmakṛtyatāṃ	pravivekam sevate. DyAna-Alambanam cittam Bavati. na ca bahu-karma-kRtyatAm
   prāpnoti. buddhānāṃ smṛtiṃ yāti. prītisukhasaumanasyaṃ kāyo na jahāti.	prApnoti. budDAnAm smRtim yAti. prIti-suKa-sOmanasyam kAyaH na jahAti.
   antarāyāś ca na bhavanti. brahmacaryasya alpāyāsena samādhim adhigacchati.	antarAyAH ca na Bavanti. brahmacaryasya alpa-AyAsena samADim aDigacCati.
   uddiṣṭaṃ cāsya padavyañjanaṃ na naśyati. yathāśrutānāṃ dharmāṇāṃ	uddizwam ca-asya pada-vyaQjanam na naSyati. yaTA-SrutAnAm DarmANAm
   vistareṇārtham ājānati. ime daśa guṇā araṇyavāsasya.	vistareNa-arTam AjAnati. ime daSa guNAH araNya-vAsasya.
   LXXIX. katame daśa guṇāḥ paiṇḍapātikatve. ucyate. caṅkramo 'sya upārjito	LXXIX. katame daSa guNAH pENxapAtika-tve. ucyate. caFkramaH asya upArjitaH-
   bhavati. gocaro 'sya prahato bhavati. māno 'sya nihato (MKV 105) bhavati.	Bavati. gocaraH asya prahataH Bavati. mAnaH asya nihataH (MKV 105) Bavati.
   ātmānaṃ lābhena yojayati. parān puṇye pratiṣṭhāpayati. śāstuḥ śāsanaṃ	AtmAnam lABena yojayati. parAn puNye pratizWApayati. SAstuH SAsanam
   dīpayati. paścimāyā janatāyā ālokaḥ kṛto bhavati. sabrahmacāriṇām	dIpayati. paScimAyAH janatAyAH AlokaH kRtaH Bavati. sabrahmacAriNAm
   upaghātaḥ kṛto na bhavati. nīcacittam upasthāpitaṃ bhavati.	upaGAtaH kRtaH na Bavati. nIca-cittam upasTApitam Bavati.
   piṇḍapātaparacittasya bhikṣoḥ sarvā diśo 'pratikūlā bhavanti gamanāya. ime	piNxa-pAta-para-cittasya BikzoH sarvAH diSaH apratikUlAH Bavanti gamana-aya. ime
   daśa guṇāḥ piṇḍapātikatve.	daSa guNAH piNxa-pAtika-tve.
   LXXX. daśa vaiśāradyāni. katamāni daśa. ucyate. viśārado grāmaṃ praviśati.	LXXX. daSa vESAradyAni. katamAni daSa. ucyate. viSAradaH grAmam praviSati.
   viśārado grāmān niṣkrāmati. viśāradaḥ piṇḍapātaṃ paribhuṅkte. viśāradaḥ	viSAradaH grAmAt nizkrAmati. viSAradaH piNxa-pAtam pariBuFkte. viSAradaH
   pariṣadi dharmaṃ deśayati. viśāradaḥ saṃghamadhyam avatarati. viśārada	parizadi Darmam deSayati. viSAradaH saMGa-maDyam avatarati. viSArada
   ācāryopādhyāyān upasaṃkrāmati. viśārado maitracittaḥ śiṣyān anuśāsti.	AcArya-upADyAyAn upasaMkrAmati. viSAradaH mEtra-cittaH SizyAn anuSAsti.
   viśāradaś cīvarapiiiḍapātaśayanāsanaglānapratyayabhaiṣajyapariṣkārān	viSAradaH cIvara-piiixa-pAta-Sayana-Asana-glAna-pratyaya-BEzajya-parizkArAn
   paribhuṅkte. grāhyaṃ cāsya vaco bhavati. imāni daśa vaiśāradyāni.	pariBuFkte. grAhyam ca-asya vacaH Bavati. imAni daSa vESAradyAni.
   karmavibhaṅgasūtraṃ samāptam	karma-viBaFga-sUtram samAptam
