   Mahāsāhasrapramardanī	MahAsAhasra-pramardanI
   namo bhagavatyai āryamahāsāhasrapramardanyai //	namaH BagavatyE Arya-mahA-sAhasra-pramardanyE //
   evaṃ mayā śrutam ekasmin samaye bhagavān rājagṛhe viharati sma /	evam mayA Srutam ekasmin samaye BagavAn rAjagRhe viharati sma /
   gṛdhrakūṭe parvate dakṣiṇe pārśve buddhagocare ratnavṛkṣe prabhāse	gRDrakUwe parvate dakziNe pArSve budDa-gocare ratna-vRkze praBAse
   vanaṣaṇḍe mahatā bhikṣusaṃghena sārdham ardhatrayodaśabhir bhikṣuśataiḥ //	vana-zaNxe mahatA Bikzu-saMGena sArDam arDa-trayodaSaBiH Bikzu-SatEH //
   tadyathā / āyuṣmatā ca śāriputreṇa / āyuṣmatā ca mahāmaudgalyāyanena /	tat-yaTA / AyuzmatA ca SAriputreNa / AyuzmatA ca mahAmOdgalyAyanena /
   āyuṣmatā ca mahākāśyapena / ayuṣmatā ca gayākāśyapena / āyuṣmatā ca	AyuzmatA ca mahAkASyapena / ayuzmatA ca gayAkASyapena / AyuzmatA ca
   nadīkāśyapena / āyuṣmatā coruvilvākāśyapena / āyuṣmatā cājñātakauṇḍinyena	nadIkASyapena / AyuzmatA ca-Uru-vilvAkASyapena / AyuzmatA ca-ajQAta-kONxinyena
   / āyuṣmatā ca mahākātyāyanena / āyuṣmatā ca vakulena / āyuṣmatā ca vāṣpeṇa	/ AyuzmatA ca mahAkAtyAyanena / AyuzmatA ca vakulena / AyuzmatA ca vAzpeNa
   / āyuṣmatā ca koṣṭhilena / āyuṣmatā ca vāgīśena / āyuṣmatā cāśvajitā /	/ AyuzmatA ca kozWilena / AyuzmatA ca vAgISena / AyuzmatA ca-aSva-jitA /
   āyuṣmatā ca subhūtinā / āyuṣmatā ca suvāhunā / āyuṣmatā cāniruddhena /	AyuzmatA ca suBUtinA / AyuzmatA ca suvAhunA / AyuzmatA ca-anirudDena /
   āyuṣmatā ca revatena / āyuṣmatā ca nandikena / āyuṣmatā cānandena / evaṃ	AyuzmatA ca revatena / AyuzmatA ca nandikena / AyuzmatA ca-Anandena / evam
   pramukhair ardhatrayodaśabhir bhikṣuśatais tasmiṃś ca samaye bhagavān	pramuKEH arDa-trayodaSaBiH Bikzu-SatEH tasmin ca samaye BagavAn
   sabhikṣusaṃgho māgadhena rājñājātaśatruṇā vaidehīputreṇa satkṛto gurukṛto	sa-Bikzu-saMGaH mAgaDena rAjQA-ajAtaSatruNA vEdehI-putreNa satkRtaH gurukRtaH-
   mānitaḥ pūjito 'rcito yācayitaś	mAnitaH pUjitaH arcitaH yAcayitaS
   cīvarapiṇḍapātaśayanāsanaglānapratyayabhaiṣajyapariṣkāraiḥ //	cIvara-piNxapAta-Sayana-Asana-glAna-pratyaya-BEzajya-parizkArEH //
   tena khalu samayena vaiśālyāṃ mahānagaryāṃ mahān bhūmicālo 'bhūd	tena Kalu samayena vESAlyAm mahA-nagaryAm mahAn BUmicAlaH aBUt-
   abhrakūṭaṃ ca prādurbhūtam / mahati cākālavātāśanir mahāmeghaś ca	aBra-kUwam ca prAdurBUtam / mahati ca-akAla-vAta-aSaniH mahA-meGaH ca
   samutthito devo garjati guḍaguḍāyati vidyutaś ca niścaranti / daśadiśaś	samutTitaH devaH garjati guxa-guxAyati vidyutaH ca niScaranti / daSa-diSaH-
   cākulībhūtāś tamo 'ndhakāraṃ ca prādurbhūtam / nakṣatrāṇi ca na bhāṣante /	ca-AkulIBUtAH tamaH anDakAram ca prAdurBUtam / nakzatrANi ca na BAzante /
   candrasūryau na prabhavato na tapato na virocato na ca prabhāsvarau	candra-sUryO na praBavataH na tapataH na virocataH na ca praBAsvarO
   bhavataḥ //	BavataH //
   atha bhagavān adrākṣīd divyena cakṣuṣā viśuddhenātikrāntamānuṣyakena	aTa BagavAn adrAkzIt divyena cakzuzA viSudDena-atikrAnta-mAnuzyakena
   vaiśālyāṃ mahānagaryāṃ tāni bhayāni prādurbhūtani / (Mps_2) apy ekatyānāṃ	vESAlyAm mahA-nagaryAm tAni BayAni prAdurBUtani / (MpH-_2) api ekatyAnAm
   vaiśālakānāṃ licchavīnāṃ yā grāmāntaḥ purīṣābhūtair adhiṣṭhitā	vESAlakAnAm licCavInAm yA grAma-antaH purIzABUtEH aDizWitA
   abhisaṃsṛṣṭā / apy ekatyānāṃ ca grāmakumārakānāṃ	aBisaMsRzwAH / api ekatyAnAm ca grAma-kumArakAnAm
   gaṇakamahāmātyāmātyāpārṣadyādāsīdāsakarmakarapreṣyaparicārakāḥ bhūtair	gaNaka-mahAmAtya-amAtya-apArzadyAt-AsI-dAsa-karmakara-prezya-paricArakAH BUtEH-
   abhibhūtāḥ samantataś ca vaiśālījanapade yā bhikṣubhikṣuṇyupāsakopāsikā	aBiBUtAH samantataH ca vESAlI-janapade yA BikzuBikzuNI-upAsa-kopAsikA
   bhītās trastāḥ saṃvignāḥ saṃdṛṣṭaromakūpajātā ūrdhvamukhāḥ prakrandanto	BItAH trastAH saMvignAH saMdRzwa-romakUpa-jAtAH UrDva-muKAH prakrandantaH-
   buddhadharmasaṃghān namasyanti //	budDa-Darma-saMGAn namasyanti //
   ye ca brāhmaṇagṛhapatayo buddhaśāsane nābhipannās te cāpy ekatyā	ye ca brAhmaNa-gRhapatayaH budDa-SAsane nABi-pannAH te ca-api ekatyA
   brāhmaṇagṛhapatayo brāhmaṇaṃ namasyanti / kecit punaḥ śakraṃ kecil	brAhmaNa-gRhapatayaH brAhmaNam namasyanti / kecid punar Sakram kecid-
   lokapālān namasyanti / kecit punar	lokapAlAn namasyanti / kecid punar-
   maheśvaramāṇibhadrapūrṇabhadrahārītīcandrasūryagrahanakṣatraparvatavanaṣaṇḍauṣadhivṛkṣanadyutsasarohradakūpataḍāgacaityasthānāny	maheSvara-mANi-Badra-pUrNa-Badra-hArItI-candra-sUrya-graha-nakzatra-parvata-vana-zaNxa-ozaDi-vRkza-nadI-utsasaraH-hrada-kUpa-taxAga-cEtya-sTAnAni-
   api namasyanti /	api namasyanti /
   kathaṃ nāmaitad syād vayam evaṃrūpād upadravato bhayasthānāt parimucyema	kaTam nAma-etat syAt vayam evaMrUpAt upadravataH Baya-sTAnAt parimucya-ima
   iti //	iti //
   atha bhagavāṃs tathā rūpam ṛddhyabhisaṃskāram akāśīd yathā rūpeṇa	aTa BagavAn taTA rUpam RdDi-aBisaMskAram akASIt yaTA rUpeNa
   ṛddhyabhisaṃskāreṇābhisaṃskṛtena trisāhasramahāsāhasraṃ lokadhātuṃ svareṇa	RdDi-aBisaMskAreNa-aBisaMskRtena tri-sAhasra-mahA-sAhasram lokaDAtum svareNa
   vijñāpya sadevamānuṣāsuraṃ lokaṃ prasādya sa sannipātayām āsa / atha	vijQApya sa-deva-mAnuza-asuram lokam prasAdya sa sannipAtayAm Asa / aTa
   brahmā sahāpatir brahmakāyikāś ca devāḥ śakraś ca devānām indro devāś ca	brahmA sahApatiH brahmakAyikAH ca devAH SakraH ca devAnAm indraH devAH ca
   trayastriṃśāś catvāraś ca mahārājānaś caturmahārājakāyikāś ca devā	trayastriMSAH catvAraH ca mahA-rAjAnaH catur-mahA-rAja-kAyikAH ca devAH-
   aṣṭāviṃśatiś ca mahāyakṣasenāpatayo dvātriṃśac ca mahāyakṣanagnā hārītī ca	azwAviMSatiH ca mahA-yakza-senApatayaH dvAtriMSat ca mahAyakza-nagnA hArItI ca
   saputrikā saparivārā atikrāntavarṇā atikrāntāyāṃ rātrau kevalaṃ kalyaṃ	sa-putrikA sa-parivArAH atikrAnta-varNAH atikrAntAyAm rAtrO kevalam kalyam
   gṛdhrakūṭaṃ parvataṃ svakena varṇānubhāvenodāreṇāvabhāsenāvabhāsya yena	gRDrakUwam parvatam svakena varNa-anuBAvena-udAreNa-avaBAsena-avaBAsya yena
   bhagavāṃs tenopasaṃkrāntāḥ / upasaṃkramya bhagavataḥ pādau śirasā vanditvā	BagavAn tena-upasaMkrAntAH / upasaMkramya BagavataH pAdO SirasA vanditvA
   ekānte sthitā ekavāgekasvaraikapadena bhagavantaṃ gāthābhir abhituṣṭuvuḥ	ekAnte sTitAH eka-vAc-eka-svara-eka-padena Bagavantam gATABiH aBituzwuvuH
   dīptakāñcananirbhāsaḥ pūrṇacandraprabhāsvaraḥ /	dIpta-kAQcana-nirBAsaH pUrNa-candra-praBAsvaraH /
   śrīvaiśramaṇavad vīraratnānām ākāro dṛśi //	SrI-vESramaNa-vat vIra-ratnAnAm AkAraH dRSi //
   siṃhavāraṇavikrāntamattanāgaparākramaḥ /	siMha-vAraNa-vikrAnta-matta-nAga-parAkramaH /
   (Mps_3)	(MpH-_3)
   parvato vā suvarṇasya niṣkaṃ jambūnadasya vā //	parvataH vA suvarNasya nizkam jambUnadasya vA //
   candro vā vimale vyomni nakṣatrebhiḥ puraskṛtaḥ //	candraH vA vimale vyomni nakzatreBiH puraskRtaH //
   madhye śrāvakasaṃghasya lakṣaṇaiḥ samalaṃkṛtaḥ //	maDye SrAvaka-saMGasya lakzaNEH samalaMkRtaH //
   lokaḥ sadevako hy eṣa muniṃ śaraṇam āgataḥ /	lokaH sa-devakaH hi eza munim SaraNam AgataH /
   manuṣyāṇāṃ hitārthāya rakṣākāla upasthitaḥ //	manuzyANAm hita-arTAya rakzA-kAle upasTitaH //
   sāhasrapramardanaṃ sūtraṃ sarvabuddhaiḥ prakāśitam /	sAhasra-pramardanam sUtram sarva-budDEH prakASitam /
   ācakravāṭaparyantaṃ sīmābandhanam uttamam //	AcakravAwa-paryantam sImAbanDanam uttamam //
   namas te puruṣavīra namas te puruṣottamam /	namaH te puruza-vIra namaH te puruzottamam /
   kṛtāñjalir namasyāmo dharmarājaṃ mahāmunim //	kRtAQjaliH namasyAmaH DarmarAjam mahA-munim //
   atha bhagavān muhūrtaṃ tūṣṇībhavenādhivāsya caturo mahārājān āmantrayāmāsa	aTa BagavAn muhUrtam tUzNIBavena-aDivAsya caturaH mahA-rAjAn AmantrayAmAsa
   naitaṃ te mahārājānaḥ pratirūpaṃ bhaved yad yuṣmat pariṣado 'smat	na-etam te mahA-rAjAnaH pratirUpam Bavet yat yuzmat parizadaH asmat-
   pariṣadaṃ viheṭhayitavyaṃ manyate / tat kasya hetoḥ / ito hi mānuṣe loke	parizadam viheWayitavyam manyate / tat kasya hetoH / itas hi mAnuze loke
   buddhotpādo dharmasvākhyātatā ca saṃghasupratipannatā ca / idam asmin	budDa-utpAdaH Darmasu-a-AKyAta-tA ca saMGa-su-pratipanna-tA ca / idam asmin
   bījam avaropya buddhā bhagavanto loka utpadyante / pratyekabuddhāś	bIjam avaropya budDAH BagavantaH loke utpadyante / pratyekabudDa-AH-
   cārhantaḥ śrāvakāś cāsminn ime lokāḥ kuśalamūlāny avaropya sa daśato	ca-arhantaH SrAvakAH ca-asmin ime lokAH kuSala-mUlAni avaropya sa daSato
   dvātriṃśatāṃ devanikāyānām anyatarānyatare devanikāye utpadyante / rājāno	dvAtriMSatAm deva-nikAyAnAm anyatara-anyatare deva-nikAye utpadyante / rAjAnaH-
   'pi bhavanti caturaṅginaś caturdvīpeśvarāś cakravartinaḥ / samudraparyante	api Bavanti caturaFginaH catur-dvIpa-ISvarAH cakravartinaH / samudra-paryante
   mahāpṛthivīmaṇḍale dharmeṇa rājaṃ kārayanti / teṣāṃ ca putrasahasraṃ	mahA-pRTivI-maNxale DarmeNa rAjam kArayanti / tezAm ca putra-sahasram
   bhavati śūrāṇāṃ vīrāṇāṃ varāṅgarūpiṇāṃ mahānagnabalavegadhārināṃ	Bavati SUrANAm vIrANAm vara-aFga-rUpiNAm mahA-nagna-bala-vega-DArinAm
   parasainyapramardakānāṃ saptaratnasamanvāgatānām / tad yuṣmākam	para-sEnya-pramardakAnAm sapta-ratna-samanvAgatAnAm / tat yuzmAkam
   alpotsukavihāreṇa viharatām evaṃrūpāṇām asmin loke notpattir bhaviṣyati //	alpa-utsuka-vihAreNa viharatAm evaMrUpANAm asmin loke na-utpattiH Bavizyati //
   atha vaiśramaṇo mahārājo 'bhyudgamyāsanād ekāṃsam uttarāsaṅgaṃ kṛtvā	aTa vESramaNaH mahA-rAjaH aByudgamya-AsanAt eka-aMsam uttarAsaFgam kRtvA
   dakṣiṇaṃ jānumaṇḍalaṃ pṛthivyāṃ pratiṣṭhāpya yena bhagavāṃs tenāñjaliṃ	dakziNam jAnu-maNxalam pRTivyAm pratizWApya yena BagavAn tena-aQjalim
   kṛtvā bhagavantam eva namasyamāno bhagavantam etad avocat // santi	kRtvA Bagavantam eva namasyamAnaH Bagavantam etat avocat // santi
   bhadanta bhagavann asmākam udārāṇi gṛhasthānabhavanāni	Badanta Bagavan asmAkam udArANi gRhasTAna-BavanAni
   nagarodyānavimānakūṭāgāraharmyaniryūhatoraṇagavākṣaśubharucitavividhavicitrapaṭṭadāmaghaṇṭācāmaramuktājālaparikṣiptāni	nagara-udyAna-vimAna-kUwa-AgAra-harmya-niryUha-toraNa-gavAkza-SuBa-rucita-viviDa-vicitra-pawwa-dAma-GaNwA-cAmara-muktA-jAla-parikziptAni
   (Mps_4) dhūpaghaṭikāni dhūpitāni puṣpāvakīrṇāni yeṣu vayaṃ	(MpH-_4) DUpa-GawikAni DUpitAni puzpa-avakIrNAni yezu vayam
   nārīśatasahasraparivṛtāḥ saṃpūrṇaiḥ pañcabhiḥ kāmaguṇaiḥ samarpitāḥ	nArI-Sata-sahasra-parivRtAH saMpUrNEH paQcaBiH kAma-guNEH samarpitAH
   samanvaṅgībhūtā viharāmaḥ / teṣām asmākaṃ bhadanta bhagavan pramattānāṃ	samanvaFgIBUtAH viharAmaH / tezAm asmAkam Badanta Bagavan pramattAnAm
   pramādavihāravihāriṇāṃ viharatāṃ pariṣadaḥ samantād daśadiśo	pramAda-vihAra-vihAriNAm viharatAm parizadaH samantAt daSa-diSo
   'nnapānabhojanāni mārgayanti / prapalāyamānāḥ strīpuruṣadārakadārikāṇāṃ	anna-pAna-BojanAni mArgayanti / prapalAyamAnAH strI-puruza-dAraka-dArikANAm
   tiryagjātagarbhānāṃ tiryagyonigatānām api ca prāṇinām ojo haranti	tiryak-jAta-garBAnAm tiryagyoni-gatAnAm api ca prANinAm ojaH haranti
   viheṭhayanti vighnayanti mārayanti / jīvitād vyaparopayanti / te vayaṃ	viheWayanti viGnayanti mArayanti / jIvitAt vyaparopayanti / te vayam
   bhadanta bhagavato 'ntike caturvarṇāṃ pariṣadāṃ purataḥ svakasvakānāṃ	Badanta BagavataH antike catur-varNAm parizadAm puratas sva-ka-svakAnAm
   pariṣadāṃ rūpalakṣaṇaṃ darśayiṣyāmaḥ / yasya pariṣado yo graho bhaviṣyati	parizadAm rUpa-lakzaNam darSayizyAmaH / yasya parizadaH yaH grahaH Bavizyati
   / tatas tasya mahārājasyodāracaityapratimā kartavyā / āturasya ca hastena	/ tatas tasya mahA-rAjasya-udAra-cEtya-pratimA kartavyA / Aturasya ca hastena
   tasya mahārājasya nāmnā nānāgandhadhūpā dhūpayitavyāḥ / puṣpāvakīrṇāṃ	tasya mahA-rAjasya nAmnA nAnA-ganDa-DUpAH DUpayitavyAH / puzpa-avakIrNAm
   dhāraṇīṃ kṛtvā dīpāṃś cādīpya tatra caitye pūjā kartavyā / madīyāyāḥ	DAraNIm kRtvA dIpAn ca-AdIpya tatra cEtye pUjA kartavyA / madIyAyAH
   pariṣado bhadanta bhagavan yakṣagrahagṛhītasya īdṛśaṃ rūpalakṣaṇam /	parizadaH Badanta Bagavan yakza-graha-gRhItasya IdRSam rUpa-lakzaNam /
   hasati trasate 'bhīkṣṇaṃ pralapaṃś ca vikūpyati /	hasati trasate aBIkzNam pralapan ca vikUpyati /
   nidrā cāviśate tasya śūlo vāpy upajāyate //	nidrA ca-AviSate tasya SUlaH vA-api upajAyate //
   ūrdhvaṃ saṃprekṣate nityaṃ nakṣatrāṇy anudhāvati /	UrDvam saMprekzate nityam nakzatrANi anuDAvati /
   rātrau praharṣam āyāti vepate stanate sadā //	rAtrO praharzam AyAti vepate stanate sadA //
   tatra mantrapadāny asti lokanātha śṛṇohi me //	tatra mantra-padAni asti lokanATa SRNohi me //
   syād yathedam //	syAt yaTA-idam //
   siddhe / susiddhe / satve are / araṇe / bale / mahābale / jambhe stambhe	sidDe / su-sidDe / satve are / araNe / bale / mahA-bale / jamBe stamBe
   jaṭile / akhane / makhame / khakhane / kharaṭṭe / kharaṅge / haripiṅgale	jawile / aKane / maKame / Ka-Kane / Karawwe / KaraFge / hari-piFgale
   timiṅgile svāhā //	timiFgile svAhA //
   sidhyantu me mantrapadāḥ svasty astu mama sarvasatvānāṃ ca vaiśramaṇasya	siDyantu me mantra-padAH svasti astu mama sarva-satvAnAm ca vESramaNasya
   mahārājasya nāmnā balenaiśvaryādhipatyena ca svāhā //	mahA-rAjasya nAmnA balena-ESvarya-ADipatyena ca svAhA //
   atha dhṛtarāṣṭro mahārājo 'bhyudgamyāsanād ekāṃsam uttarāsaṅgaṃ kṛtvā	aTa DRtarAzwraH mahA-rAjaH aByudgamya-AsanAt eka-aMsam uttarAsaFgam kRtvA
   dakṣiṇaṃ jānumaṇḍalaṃ pṛthivyāṃ pratiṣṭhāpya yena bhagavāṃs tenāñjaliṃ	dakziNam jAnu-maNxalam pRTivyAm pratizWApya yena BagavAn tena-aQjalim
   kṛtvā bhagavantam eva namasyamāno bhagavantam (Mps_5) etad avocat / asmat	kRtvA Bagavantam eva namasyamAnaH Bagavantam (MpH-_5) etat avocat / asmat-
   pariṣado bhadanta bhagavan gandharvagrahagṛhītasya īdṛśaṃ rūpalakṣaṇam /	parizadaH Badanta Bagavan ganDarva-graha-gRhItasya IdRSam rUpa-lakzaNam /
   nṛtyate gāyate cāpi bhūṣaṇāni priyāyate /	nRtyate gAyate ca-api BUzaNAni priyAyate /
   alubdhaḥ satyavādi ca hasate kupyate punaḥ //	alubDaH satya-vAdi ca hasate kupyate punar //
   tṛṣṇāyate raktanetro jvaro 'syāviśate sadā /	tRzNAyate rakta-netraH jvaraH asya-AviSate sadA /
   unmiṣati na cakṣuś ca śayate ca parāṅmukhaḥ //	unmizati na cakzuH ca Sayate ca parAFmuKaH //
   tatra mantrapadāny asti lokanātha śṛṇohi me //	tatra mantra-padAni asti lokanATa SRNohi me //
   syād yathedam /	syAt yaTA-idam /
   akhe / nakhe / vinakhe / bandhe / varāṇe / capale / vakhe / vakhane /	aKe / naKe / vinaKe / banDe / varANe / capale / vaKe / vaKane /
   vakhiṇe / akhine / nakhine / vahale / bhage / bhagandare / vaśe	vaKiNe / aKine / naKine / vahale / Bage / Bagandare / vaSe
   vaśavartini / svāhā //	vaSa-vartini / svAhA //
   mucyantu sarvasatvāḥ sarvagrahebhyo dhṛtarāṣṭrasya mahārājasya nāmnā	mucyantu sarva-satvAH sarva-graheByaH DRtarAzwrasya mahA-rAjasya nAmnA
   balenaiśvaryādhipatyena ca svāhā //	balena-ESvarya-ADipatyena ca svAhA //
   atha virūḍhako mahārājo 'bhyudgamyāsanād ekāṃsam uttarāsaṅgaṃ kṛtvā	aTa virUXakaH mahA-rAjaH aByudgamya-AsanAt eka-aMsam uttarAsaFgam kRtvA
   dakṣiṇaṃ jānumaṇḍalaṃ pṛthivyāṃ pratiṣṭhāpya yena bhagavāṃs tenāñjaliṃ	dakziNam jAnu-maNxalam pRTivyAm pratizWApya yena BagavAn tena-aQjalim
   kṛtvā bhagavantam eva namasyamāno bhagavantam etad avocat / asmat pariṣado	kRtvA Bagavantam eva namasyamAnaH Bagavantam etat avocat / asmat parizadaH-
   bhadanta bhagavan kumbhāṇḍagrahagṛhītasya īdṛśaṃ rūpalakṣaṇam /	Badanta Bagavan kumBANxa-graha-gRhItasya IdRSam rUpa-lakzaNam /
   balavatī tṛṣā bhonti vibhrāntaś cāpi prekṣate /	balavatI tRzA Bonti viBrAntaH ca-api prekzate /
   mukhaṃ lohitam ābhāti bhūmau svapiti kuñcitaḥ //	muKam lohitam ABAti BUmO svapiti kuQcitaH //
   durvarṇaḥ kṛśagātraś ca dīrghakeśanakhas tathā /	durvarNaH kRSa-gAtraH ca dIrGa-keSa-naKaH taTA /
   durgandho malinaś cāpi mṛśā sambhinnā bhāṣante //	durganDaH malinaH ca-api mRSA samBinnAH BAzante //
   tatra mantrapadāny asti lokanātha śṛṇohi me //	tatra mantra-padAni asti lokanATa SRNohi me //
   syād yathedam /	syAt yaTA-idam /
   khakhakhame / khalane / khalane / khalome / kharalikhe / kharakhe /	Ka-Ka-Kame / Kalane / Kalane / Kalome / Kara-liKe / KaraKe /
   khaṭine / kharali / karakhi / kaśane / karaṭe / kāle kāmini / vidhali /	Kawine / Karali / karaKi / kaSane / karawe / kAle kAmini / viDali /
   vidhiye / vidheye / śayane / samavate / śami śamini svāhā //	viDiye / viDeye / Sayane / samavate / Sami Samini svAhA //
   śāmyantu mama sarvasatvānāṃ ca sarvagrahāḥ sarvabhayopadravā virūḍhakasya	SAmyantu mama sarva-satvAnAm ca sarva-grahAH sarva-Baya-upadravAH virUXakasya
   mahārājasya nāmnā balenaiśvaryādhipatyena ca svāhā //	mahA-rAjasya nAmnA balena-ESvarya-ADipatyena ca svAhA //
   (Msp 6)	(Msp 6)
   atha virūpākṣo mahārājo 'bhyudgamyāsanād ekāṃsam uttarāsaṅgaṃ kṛtvā	aTa virUpAkzaH mahA-rAjaH aByudgamya-AsanAt eka-aMsam uttarAsaFgam kRtvA
   dakṣiṇaṃ jānumaṇḍalaṃ pṛthivyāṃ pratiṣṭhāpya yena bhagavāṃs tenāñjaliṃ	dakziNam jAnu-maNxalam pRTivyAm pratizWApya yena BagavAn tena-aQjalim
   kṛtvā bhagavantam eva namasyamāno bhagavantam etad avocat / asmat pariṣado	kRtvA Bagavantam eva namasyamAnaH Bagavantam etat avocat / asmat parizadaH-
   bhadanta bhagavan nāgasuparṇīgrahagṛhītasya īdṛśaṃ rūpalakṣaṇam /	Badanta Bagavat nAga-suparNI-graha-gRhItasya IdRSam rUpa-lakzaNam /
   hikkate śvasate cāpi śītalaṃ gātram eva ca /	hikkate Svasate ca-api SItalam gAtram eva ca /
   svidyate phenalālāsya svapate ca punaḥ punaḥ //	svidyate Pena-lAlA-asya svapate ca punar punar //
   varṇavān bhavate śūro vepate dhāvate tathā /	varNavAn Bavate SUraH vepate DAvate taTA /
   punar nakhān vidarśayati mahīṃ viśati roditi //	punar naKAn vidarSayati mahIm viSati roditi //
   tatra mantrapadāny asti lokanātha śṛṇohi me //	tatra mantra-padAni asti lokanATa SRNohi me //
   syād yathedam /	syAt yaTA-idam /
   kragame / krakamaṇi / krakase / krakaśase / kruśume / krukeke / krukhume	kragame / krakamaNi / krakase / krakaSase / kruSume / krukeke / kruKume
   krume / agale / nagale / samaṅgale / kuhume / hume / aluke / kalamake /	krume / agale / nagale / sa-maFgale / kuhume / hume / aluke / kalamake /
   kalale / ire mire / dhire dhire agaruvati svāhā //	kalale / ire mire / Dire Dire agaruvati svAhA //
   svasty astu mama sarvasatvānāṃ ca virūpākṣasya mahārājasya nāmnā	svasti astu mama sarva-satvAnAm ca virUpAkzasya mahA-rAjasya nAmnA
   balenaiśvaryādhipatyena ca svāhā //	balena-ESvarya-ADipatyena ca svAhA //
   atha bhagavāṃs tāvad eva sarvāvatyāḥ pariṣadaḥ purataḥ siṃhanādaṃ nadati /	aTa BagavAn tAvat eva sarvAvatyAH parizadaH puratas siMhanAdam nadati /
   daśabalasamanvāgato 'haṃ caturvaiśāradyaviśāradaḥ pariṣady udāram ārṣabhaṃ	daSa-bala-samanvAgataH aham catur-vESAradya-viSAradaH parizadi udAram ArzaBam
   samyaksiṃhanādaṃ nadāmi / brahmacakraṃ pravartayāmi / māro nirjita ekena	samyak-siMhanAdam nadAmi / brahma-cakram pravartayAmi / mAraH nirjitaH ekena
   sasainyabalavāhanaḥ / rakṣāyai sarvasatvānāṃ sarve vidyāṃ śṛṇātha me //	sa-sEnya-bala-vAhanaH / rakzAyE sarva-satvAnAm sarve vidyAm SRNATa me //
   syād yathedam /	syAt yaTA-idam /
   asaṅge / khaṅgavate / balavate / balanirghoṣe / śūre śūravate / vajraṃgame	asaFge / KaFgavate / balavate / bala-nirGoze / SUre SUravate / vajraMgame
   / vajradhare / stambhe jambhe / dṛḍhasāre / viraje / vighase /	/ vajraDare / stamBe jamBe / dRXasAre / viraje / viGase /
   varāgraprāpte / araṇe dharmayukte diśi vighuṣṭe svāhā //	vara-agra-prApte / araNe Darma-yukte diSi viGuzwe svAhA //
   svasty astu mama sarvasatvānāṃ ca tathāgatasya nāmnā	svasti astu mama sarva-satvAnAm ca taTAgatasya nAmnA
   balenaiśvaryādhipatyena ca svāhā //	balena-ESvarya-ADipatyena ca svAhA //
   buddhasya vacanaṃ śrutvā lokapālāś caturdiśam /	budDasya vacanam SrutvA lokapAlAH caturdiSam /
   uttrastā bhītasaṃvighnā asthāsuḥ prāñjalīkṛtāḥ //	uttrastAH BIta-saMviGnAH asTAsuH prAQjalIkRtAH //
   (Msp 7)	(Msp 7)
   śiṣṭā bhūtagaṇās trastā vikṣiptā viralīkṛtāḥ /	SizwAH BUta-gaNAH trastAH vikziptAH viralIkRtAH /
   palāyante daśadiśo mahānādam udīrayan //	palAyante daSa-diSaH mahA-nAdam udIrayan //
   tad viditvā mahārājās triguptiṃ samudāharat /	tat viditvA mahA-rAjAH tri-guptim samudAharat /
   aho vidyā mahāvidyā mahāsāhasrapramardanī //	aho vidyA mahAvidyA mahA-sAhasra-pramardanI //
   yasyāṃ trasanti bhūtāni śrutvā buddhasya bhāṣitam /	yasyAm trasanti BUtAni SrutvA budDasya BAzitam /
   yathā prajvalito vahniraśmir vātair apāyitaḥ //	yaTA prajvalitaH vahni-H-aSmiH vAtEH apAyitaH //
   kṣuradhārāsamā vidyā gautamena prakāśitā /	kzura-DArA-samA vidyA gOtamena prakASitA /
   yo hy etan nābhimanyeta ṛṣivākyaṃ subhāṣitam //	yaH hi etat na-aBimanyeta Rzi-vAkyam su-BAzitam //
   tasyātra brahmaśāpena jyeṣṭhaputro na bheṣyati /	tasya-atra brahma-SApena jyezWa-putraH na Bezyati /
   agniṃ prajvālayitvā tu gṛhītvāsitasarṣapān //	agnim prajvAlayitvA tu gRhItvA-asita-sarzapAn //
   ghṛtamaṇḍena saṃyuktāḥ prakṣeptavyāhutāśane /	GRta-maNxena saMyuktAH prakzepta-vyAhuta-aSane /
   heṣṭham ūrdhvaṃ caturdikṣu kṣiptvā ca varuṇodakam //	hezWam UrDvam catur-dikzu kziptvA ca varuNa-udakam //
   yadi kṣipraṃ na muñceyuḥ śrutvā buddhasya bhāṣitam /	yadi kzipram na muQceyuH SrutvA budDasya BAzitam /
   bhavantu jvalitāḥ sarve yathāgnau ghṛtasarṣapāḥ //	Bavantu jvalitAH sarve yaTA-agnO GRta-sarzapAH //
   kṣemaṃ ca tena lapsyanti yakṣadaṇḍena tarjitāḥ /	kzemam ca tena lapsyanti yakza-daNxena tarjitAH /
   teṣāṃ dakṣiṇapārśveṣu mahāgaṇḍo bhaviṣyati //	tezAm dakziNa-pArSvezu mahA-gaNxaH Bavizyati //
   citrabhūtā bhaviṣyanti yakṣarogena pīḍitāḥ /	citra-BUtAH Bavizyanti yakza-rogena pIxitAH /
   aḍakavatīṃ rājadhānīṃ na gacchanti kadā cana //	axakavatIm rAjaDAnIm na gacCanti kadA canaH //
   niveśanaṃ na paśyanti kuberasya yaśasvinaḥ /	niveSanam na paSyanti kuberasya yaSasvinaH /
   āsanaṃ ca na lapsyanti bhūtasaṃghāḥ samāgame //	Asanam ca na lapsyanti BUta-saMGAH samAgame //
   annapānena rahitā jāyante yakṣamaṇḍale /	anna-pAnena rahitAH jAyante yakza-maNxale /
   mahāsāhasrapramardanaṃ sūtraṃ yo yakṣo nānuvartate //	mahA-sAhasra-pramardanam sUtram yaH yakzaH na-anuvartate //
   tasya vajradharaḥ kruddho mūrdhānaṃ sphoṭayiṣyati /	tasya vajraDaraH krudDaH mUrDAnam sPowayizyati /
   karkaśakṣuradhāreṇa jihvān tasyeha cchetsyati //	karkaSa-kzura-DAreNa jihvAn tasya-iha cCetsyati //
   tīkṣṇeṇa cāsya śastreṇa karṇau nāsāṃ ca cchetsyati /	tIkzNeNa ca-asya SastreNa karNO nAsAm ca cCetsyati /
   prapātayati cakreṇa kṣuradhāreṇa mastakam //	prapAtayati cakreNa kzura-DAreNa mastakam //
   lohamudgarakīlena hṛdayaṃ cāsya pīḍayet /	loha-mudgara-kIlena hRdayam ca-asya pIxayet /
   mukhataḥ sravate cāsya pūyam uṣṇaṃ ca śoṇitam //	muKataH sravate ca-asya pUyam uzNam ca SoNitam //
   vidyāpāśena daṇḍena sadā saṃsāragāminaḥ /	vidyA-pASena daNxena sadA saMsAra-gAminaH /
   tatraiva saṃsariṣyanti saṃsāre cakramaṇḍale //	tatra-eva saMsarizyanti saMsAre cakra-maNxale //
   (Msp 8)	(Msp 8)
   śriyāviṣṭā mahārājāḥ samāgamya caturdiśam /	SriyA-AvizwAH mahA-rAjAH samAgamya caturdiSam /
   dharmasaṃnāhasaṃnaddhā niṣaṇṇā bhadrapīṭhake //	Darma-saMnAha-saMnadDAH nizaNNA BadrapIWake //
   dhṛtarāṣṭraś ca pūrvāyāṃ dakṣiṇena virūḍhakaḥ /	DRtarAzwraH ca pUrvAyAm dakziNena virUXakaH /
   paścimena virūpākṣaḥ kuberaś cottarāṃ diśam //	paScimena virUpAkzaH kuberaH ca-uttarAm diSam //
   rājñāṃ samāgatānāṃ hi jvalatāṃ tejasā śriyā /	rAjQAm samAgatAnAm hi jvalatAm tejasA SriyA /
   antarīkṣaṃ tadā śāśtā sarvajño hi samudgataḥ //	antarIkzam tadA SAStA sarvajQaH hi samudgataH //
   vajrāsane niṣadyeha vimāne brahmanirmite /	vajrAsane nizadya-iha vimAne brahma-nirmite /
   tato brahmā mahābrahmā prāñjalistho namasyati //	tatas brahmA mahA-brahmA prAQjali-sTaH namasyati //
   suvarṇaparvataḥ śrīmāṃś taptakāñcanasaṃnibhaḥ /	suvarNaparvataH SrImAn tapta-kAQcana-saMniBaH /
   padmapuṣpavad utphullaḥ śālarājeva puṣpitaḥ //	padma-puzpa-vat utPullaH SAlarAjA-iva puzpitaH //
   pūrṇacandro ravir vāpi nakṣatraiḥ parivāritaḥ /	pUrNa-candraH raviH vA-api nakzatrEH parivAritaH /
   suvarṇavarṇakāyena lakṣaṇair munir āvṛtaḥ //	suvarNa-varNa-kAyena lakzaNEH muniH AvRtaH //
   saṃstutvā lokapradyotaṃ brahmā lokapitāmahaḥ /	saMstutvA loka-pradyotam brahmA lokapitAmahaH /
   purato lokanāthasya lokapālān athābravīt //	puratas loka-nATasya lokapAlAn aTa-abravIt //
   na prāptaṃ lokapālānāṃ parṣado nānuśāsanam /	na prAptam lokapAlAnAm parzadaH na-anuSAsanam /
   ito buddhā hi jāyante buddhāḥ pratyekajā api //	itas budDAH hi jAyante budDAH pratyeka-jAH api //
   itaś ca śrāvakotpattir devāś cāpi samutsthitāḥ /	itas ca SrAvaka-utpattiH devAH ca-api samutsTitAH /
   jāyante brāhmaṇāś cetaḥ ṣaḍaṅgāvedapāragāḥ //	jAyante brAhmaNAH cetaH zaxaFga-Aveda-pAragAH //
   ṛṣayaś ca mahābhāgā itaḥ śramaṇabrāhmaṇāḥ /	RzayaH ca mahABAgAH itas SramaNa-brAhmaNAH /
   alpotsukānāṃ yuṣmākaṃ badhyate mānuṣīprajā //	alpa-utsukAnAm yuzmAkam baDyate mAnuzI-prajAH //
   brahmaṇo vacanaṃ śrutvā lokapālā vaco 'bruvan /	brahmaNaH vacanam SrutvA lokapAlAH vacaH abruvan /
   evam etan mahābrahmann evam etat mahāmune //	evam etat mahA-brahman evam etat mahA-mune //
   ete viśodhayiṣyāmaḥ samantāt sāgaraṃ vayam /	ete viSoDayizyAmaH samantAt sAgaram vayam /
   sumeruṃ kaṃpayitvā tu dhāraṇīṃ parivartya ca //	sumerum kaMpayitvA tu DAraNIm parivartya ca //
   bandhayiṣyāmaḥ pāśena candrasūryau tathānilam /	banDayizyAmaH pASena candra-sUryO taTA-anilam /
   nakṣatrāṇi ca sarvāṇi gāḍhenābhyāhatena //	nakzatrANi ca sarvANi gAXena-aByAhatena //
   diśaś cādarśanā bhāgās teṣāṃ neṣyāma sarvadā /	diSaH ca-adarSanAH BAgAH tezAm nezyAma sarvadA /
   ye praduṣṭā bhaviṣyanti na ca lokahitodyataḥ //	ye praduzwAH Bavizyanti na ca loka-hita-udyataH //
   lokaḥ sadevako hy eṣa garhate bhūtakāraṇāt /	lokaH sa-devakaH hi eza garhate BUta-kAraNAt /
   parābhavanti bhūtāni hiṃsante mānuṣīṃ prajām //	parABavanti BUtAni hiMsante mAnuzIm prajAm //
   (Msp 9)	(Msp 9)
   atra mantradharāḥ kāmaṃ darśayanti parākramam /	atra mantra-DarAH kAmam darSayanti parAkramam /
   atikrāmanti ye vidyāṃ mantrān auṣadham eva vā //	atikrAmanti ye vidyAm mantrAn OzaDam eva vA //
   vidyātikrāntāḥ pariṣadaḥ samantād daṇḍatarjitāḥ /	vidyA-atikrAntAH parizadaH samantAt daNxa-tarjitAH /
   kṛtvā samānayiṣyāmo lokanāthasya cāgrataḥ //	kRtvA samAnayizyAmaH loka-nATasya ca-agratas //
   teṣāṃ daṇḍaṃ praṇeṣyāmaḥ sūtraṃ brahmaṇā nirmitam /	tezAm daNxam praNezyAmaH sUtram brahmaNA nirmitam /
   yasyedaṃ bhāṣato viśvaṃ tarjate bhūtamaṇḍalam //	yasya-idam BAzataH viSvam tarjate BUta-maNxalam //
   buddhasya pādau vanditvā ālokya ca parasparam /	budDasya pAdO vanditvA Alokya ca parasparam /
   suvarṇarūpyavaiḍūryamuktāyāḥ sphaṭikasya ca //	suvarNa-rUpya-vExUrya-muktAyAH sPawikasya ca //
   samusārāśmagarbhasya saptaratnasamākulān /	samusAra-aSma-garBasya sapta-ratna-samAkulAn /
   sahasrārān suvarṇāṃś caturaḥ saṃskṛtān rathān //	sahasrArAn suvarNAn caturaH saMskRtAn raTAn //
   viśvakarmasu saṃyuktān ṛddhya vaihāyasaṃgamān /	viSvakarmasu saMyuktAn RdDya vEhAya-saMgamAn /
   tatrābhiruhya rājānaḥ prakrāntā bhūtamaṇḍalam //	tatra-aBiruhya rAjAnaH prakrAntA BUta-maNxalam //
   puṣpapūrṇāṃ mahīṃ kṛtvā cūrṇaiś cāpi hiraṇmayaiḥ /	puzpa-pUrNAm mahIm kRtvA cUrNEH ca-api hiraNmayEH /
   yaṣṭīr ābadhya hi gale sūtrapāśāṃs tathāpi ca //	yazwIH AbaDya hi gale sUtra-pASAn taTA-api ca //
   yakṣasenāpatīn sarvān preṣayitvā caturdiśam /	yakza-senApatIn sarvAn prezayitvA caturdiSam /
   ānetha sarvabhūtāni yāvanto 'smadgatā diśi //	AneTa sarva-BUtAni yAvantaH asmad-gatAH diSi //
   sāhasrapramardanaṃ hy etet saṃśrautuṃ sūtram uttamam /	sAhasra-pramardanam hi etet saMSrOtum sUtram uttamam /
   brahmalokān samuditaṃ sarvalokair vicintitam //	brahma-lokAn samuditam sarva-lokEH vicintitam //
   mahāsāhasrakāyena marditā yakṣarākṣasāḥ /	mahA-sAhasra-kAyena marditAH yakza-rAkzasAH /
   śrutvā vākyaṃ kuberasya yakṣasenāpatir gataḥ //	SrutvA vAkyam kuberasya yakza-senApatiH gataH //
   vikramantaś caturdikṣu ghoṣaṃ ghoṣanti guhyakāḥ /	vikramantaH catur-dikzu Gozam Gozanti guhyakAH /
   aṣṭāviṃśac ca bhūtāni grahā gandharvajā mune //	azwAviMSat ca BUtAni grahAH ganDarva-jAH mune //
   pūrve 'smin diśobhāge bhūtasaṃghāḥ śṛṇontu me /	pUrve asmin diSaH-BAge BUta-saMGAH SRNontu me /
   sarve te sūtrapāśena pañcabandhanapīḍitāḥ //	sarve te sUtra-pASena paQca-banDana-pIxitAH //
   aṣṭāviṃśac ca bhūtāni grahāḥ kumbhāṇḍajā mune /	azwAviMSat ca BUtAni grahAH kumBANxa-jAH mune /
   dakṣiṇe 'smin diśobhāge bhūtasaṃghāḥ śṛṇontu me //	dakziNe asmin diSaH-BAge BUta-saMGAH SRNontu me //
   sarve te sūtrapāśena pañcabandhanapīḍitāḥ /	sarve te sUtra-pASena paQca-banDana-pIxitAH /
   aṣṭāviṃśac ca bhūtāni bhonti nāgagrahā mune /	azwAviMSat ca BUtAni Bonti nAga-grahAH mune /
   paścime 'smin diśobhāge bhūtasaṃghāḥ śṛṇontu me //	paScime asmin diSaH-BAge BUta-saMGAH SRNontu me //
   sarve te sūtrapāśena pañcabandhanapīḍitāḥ /	sarve te sUtra-pASena paQca-banDana-pIxitAH /
   (Msp 10)	(Msp 10)
   aṣṭāviṃśac ca bhūtāni bhonti yakṣagrahā mune /	azwAviMSat ca BUtAni Bonti yakza-grahAH mune /
   digbhāge uttare cāpi bhūtasaṃghāḥ śṛṇontu me //	digBAge uttare ca-api BUta-saMGAH SRNontu me //
   sarve te sūtrapāśena pañcabandhanapīḍitāḥ /	sarve te sUtra-pASena paQca-banDana-pIxitAH /
   jyeṣṭhaputraḥ kuberasya sañjayo naravāhanaḥ //	jyezWa-putraH kuberasya saQjayaH naravAhanaH //
   pādamūle tu tasyaiva yakṣāṇāṃ ṣaṣṭhikoṭayaḥ /	pAda-mUle tu tasya-eva yakzANAm zazWi-kowayaH /
   ākṛṣṭāḥ sūtrapāśena pañcabandhanapīḍitāḥ //	AkRzwAH sUtra-pASena paQca-banDana-pIxitAH //
   putro dvitīyas tasyaiva janako nāma viśrutaḥ /	putraH dvitIyaH tasya-eva janakaH nAma viSrutaH /
   pādamūle tu tasyaiva yakṣāṇāṃ ṣaṣṭhikoṭayaḥ //	pAda-mUle tu tasya-eva yakzANAm zazWi-kowayaH //
   ākṛṣṭāḥ sūtrapāśena pañcabandhanapīḍitāḥ /	AkRzwAH sUtra-pASena paQca-banDana-pIxitAH /
   putras tritīyas tasyaiva nāmnā cāsau mahāgrahaḥ //	putraH tritIyaH tasya-eva nAmnA ca-asO mahA-grahaH //
   pādamūle tu tasyaiva yakṣāṇāṃ ṣaṣṭhikoṭayaḥ /	pAda-mUle tu tasya-eva yakzANAm zazWi-kowayaH /
   ākṛṣṭāḥ sūtrapāśena pañcabandhanapīḍitāḥ //	AkRzwAH sUtra-pASena paQca-banDana-pIxitAH //
   putraś caturthas tasyaiva nāmnāsau kalaśodaraḥ /	putraH caturTaH tasya-eva nAmnA-asO kalaSa-udaraH /
   pādamūle tu tasyaiva yakṣāṇāṃ ṣaṣṭhikoṭayaḥ //	pAda-mUle tu tasya-eva yakzANAm zazWi-kowayaH //
   ākṛṣṭāḥ sūtrapāśena pañcabandhanapīḍitāḥ /	AkRzwAH sUtra-pASena paQca-banDana-pIxitAH /
   maheśvaro mahādevaś caturbāhur mahābalaḥ //	maheSvaraH mahAdevaH catur-bAhuH mahA-balaH //
   pādamūle tu tasyaiva yakṣāṇāṃ ṣaṣṭhikoṭayaḥ /	pAda-mUle tu tasya-eva yakzANAm zazWi-kowayaH /
   ākṛṣṭāḥ sūtrapāśena pañcabandhanapīḍitāḥ //	AkRzwAH sUtra-pASena paQca-banDana-pIxitAH //
   āgatya sarvabhūtāni parvate bhūtamardane /	Agatya sarva-BUtAni parvate BUta-mardane /
   eṣā udbhāvitā vidyā sarvavidyā śarmakarā //	ezA udBAvitA vidyA sarva-vidyA Sarma-karAH //
   niṣṭhuraṃ puruṣaṃ daṇḍaṃ sarvabuddhair hi bhāṣitam /	nizWuram puruzam daNxam sarva-budDEH hi BAzitam /
   eṣa gacchāmaḥ śaraṇaṃ sarve gautamam ādarāt //	eza gacCAmaH SaraNam sarve gOtamam AdarAt //
   aśāṭhyenānuvartetha mā ca sarveṇa bheṣyetha /	aSAWyena-anuvarteTa mA ca sarveNa BezyeTa /
   tato muhūrtamātreṇa bhūtasaṃghāḥ samāgatāḥ //	tatas muhUrta-mAtreNa BUta-saMGAH samAgatAH //
   parvateṣu prapāteṣu samudreṣu saraḥsu ca /	parvatezu prapAtezu samudrezu saraHsu ca /
   nadīprasravaṇotseṣu āvarteṣu ca ye sthitāḥ //	nadI-prasravaNa-utsezu Avartezu ca ye sTitAH //
   udyāneṣu vimāneṣu ārāmeṣu vaneṣu ca /	udyAnezu vimAnezu ArAmezu vanezu ca /
   caityasthāneṣu grāmeṣu vṛkṣamūleṣu ye sthitāḥ //	cEtya-sTAnezu grAmezu vRkza-mUlezu ye sTitAH //
   nagarasya praveśeṣu nigamajanapadeṣu ca /	nagarasya praveSezu nigama-janapadezu ca /
   rājakuleṣu dvāreṣu vimāneṣu ca ye sthitāḥ //	rAja-kulezu dvArezu vimAnezu ca ye sTitAH //
   (Msp 11)	(Msp 11)
   maṇḍapeṣu śmaśāneṣu tathā devakuleṣu ca /	maNxapezu SmaSAnezu taTA devakulezu ca /
   sīmāsu śulkaśālāyāṃ śūnyāgāre 'tha jāṅgale //	sImAsu Sulka-SAlAyAm SUnya-AgAre aTa jAFgale //
   ūrdhvaṃ heṣṭhaṃ ca ye yakṣāś caturdikṣu vidikṣu ca /	UrDvam hezWam ca ye yakzAH catur-dikzu vidikzu ca /
   yakṣakoṭīsahasrāṇi vidyāpāśena karṣitāḥ //	yakza-kowI-sahasrANi vidyA-pASena karzitAH //
   mṛdaṅgavāditaṃ kṛtvā kecid gargaravāditam /	mRdaFga-vAditam kRtvA kecid gargara-vAditam /
   vīṇāpaṇavaveṇūś ca vādayanto mahābalāḥ //	vINA-paNava-veNUH ca vAdayantaH mahA-balAH //
   kṛtvā ca vāditaṃ citraṃ gāndharvaṃ nāṭyam eva ca /	kRtvA ca vAditam citram gAnDarvam nAwyam eva ca /
   indraḥ somaś ca varuṇo bharadvājaḥ prajāpatiḥ //	indraH somaH ca varuNaH BaradvAjaH prajApatiH //
   mātalir lohitākṣaś ca himavantaḥ supūrṇakaḥ /	mAtaliH lohitAkzaH ca himavantaH su-pUrNakaH /
   candanaḥ kāmaśreṣṭhī ca maṇikaṇṭho nikaṇṭhakaḥ //	candanaH kAmaSrezWI ca maNikaNWaH nikaNWakaH //
   prajāgurur yatīśaś ca devasūtaś ca mātaliḥ /	prajA-aguruH yati-ISaH ca devasUtaH ca mAtaliH /
   citrasenaś ca gandharvo nararājo jinarṣabhaḥ //	citrasenaH ca ganDarvaH nara-rAjaH jina-RzaBaH //
   tathā pañcaśikho nāma tumburuḥ sūryavarcasaḥ /	taTA paQcaSiKaH nAma tumburuH sUrya-varcasaH /
   śailaś caivāsiputraś ca viśvāmitro yaśodharaḥ //	SElaH ca-eva-asi-putraH ca viSvAmitraH yaSoDaraH //
   āḍavakaḥ sumanaś ca śūcīkarṇo darīmukhaḥ /	AxavakaH sumanaH ca SUcIkarNaH darImuKaH /
   pañcālagaṇḍaḥ sumukhaḥ sasainyabalavāhanaḥ //	paQcAlagaNxaH su-muKaH sa-sEnya-bala-vAhanaH //
   devā nāgāś ca gandharvā asurā yakṣarākṣasāḥ /	devAH nAgAH ca ganDarvAH asurAH yakza-rAkzasAH /
   traitīyakaś ca unmādās tathā cāturthako jvarāḥ //	trEtIyakaH ca unmAdAH taTA cAturTakaH jvarAH //
   ye ca lokaṃ viheṭhanti praduṣṭā yakṣarākṣasāḥ /	ye ca lokam viheWanti praduzwAH yakza-rAkzasAH /
   caturdikṣu samānīya pañcabandhanapīḍitāḥ //	catur-dikzu samAnIya paQca-banDana-pIxitAH //
   prāñjalīkāḥ puraḥ sthitvā lokanātham athābruvan /	prAQjalIkAH puras sTitvA lokanATam aTa-abruvan /
   namas te puruṣavīra namas te puruṣottama //	namaH te puruza-vIra namaH te puruzottamaH //
   prāñjalīkā namasyāmo dharmarāja namo 'stu te /	prAQjalIkA namasyAmaH DarmarAja namaH astu te /
   dhāvanti puratas teṣāṃ bhūtā yakṣā mahābhayāḥ //	DAvanti puratas tezAm BUtAH yakzAH mahA-BayAH //
   caturbhujā mahāghorā bahupādekapādaḥ /	catur-BujA mahA-GorAH bahupAd-eka-pAdaH /
   catuṣpādā dvipādāś ca ūrdhvapādā adhomukhaḥ //	catuzpAdAH dvi-pAdAH ca UrDva-pAdAH aDomuKaH //
   bahukāyaikaśīrṣāś ca ekakāyāś catuḥśirāḥ /	bahu-kAya-ekaSIrzAH ca eka-kAyAH catur-SirAH /
   bahunetrā mahākāyāś ca ekākṣā dvādaśodarāḥ //	bahu-netrAH mahA-kAyAH ca eka-akzAH dvAdaSa-udarAH //
   kharoṣṭhahastiśīrṣāś ca ūrdhvahastā adhaḥśirāḥ /	Kara-uzWa-hasti-SIrzAH ca UrDva-hastAH aDaHSirAH /
   śastradantāḥ śastrabāhū śastrapādāś ca rākṣasāḥ //	Sastra-dantAH Sastra-bAhU Sastra-pAdAH ca rAkzasAH //
   (Msp 12)	(Msp 12)
   tāmrakeśās tāmrahastās tāmrākṣās tāmrapāṇayaḥ /	tAmra-keSAH tAmra-hastAH tAmra-akzAH tAmra-pANayaH /
   tāmramudgarapādāś ca tāmranāsā ayomukhāḥ //	tAmra-mudgara-pAdAH ca tAmra-nAsAH ayaH-muKAH //
   ādīptahastapādāś ca manuṣyatanunā sthitāḥ /	AdIpta-hasta-pAdAH ca manuzya-tanunA sTitAH /
   kāṇāḥ kubjās tu garuḍā vikṛtākṣā vijṛmbhakāḥ //	kANAH kubjAH tu garuxAH vikRta-akzAH vijRmBakAH //
   makaravyāḍarūpāś ca virūpāś sakalonmukhāḥ /	makara-vyAxa-rUpAH ca virUpAH sakala-unmuKAH /
   lamvoṣṭhā vakradantāś ca praduṣṭā bhṛkuṭīmukhāḥ //	lamu-a-uzWAH vakra-dantAH ca praduzwAH BRkuwI-muKAH //
   sthūlodarāḥ kumbhakarṇā laṃvakarṇā akarṇakāḥ /	sTUla-udarAH kumBakarNAH laMva-karNAH akarNakAH /
   dīrghakarṇā dīrghabāhū dīrghakeśāgrapāṇayaḥ //	dIrGakarNAH dIrGa-bAhU dIrGa-keSa-agra-pANayaH //
   śuṣkakāyā dīrghakāyā dīrghakeśāḥ svalaṃkṛtāḥ /	Suzka-kAyAH dIrGa-kAyAH dIrGa-keSAH su-alaMkRtAH /
   pādabhārāḥ kṛṣagrīvā durgandhāḥ karaśodarāḥ //	pAda-BArAH kRza-grIvAH durganDAH karaSodarAH //
   makarasya yathā aṃśo muṣalamudgarodarāḥ /	makarasya yaTA aMSaH muzala-mudgara-udarAH /
   ūrdhvanetrā mahākarṇā ūrdhvakeśāḥ sulohitāḥ //	UrDva-netrAH mahA-karNAH UrDva-keSAH su-lohitAH //
   sthūlaśīrṣā dhanugrīvāḥ kubjakuṃbhodarāḥ kṛṣāḥ /	sTUla-SIrzAH Danu-grIvAH kubja-kuMBa-udarAH kRzAH /
   vavṛṣur vahnivarṣāṇi merumūrdhaṃ vicārya vai //	vavRzuH vahni-varzANi meru-mUrDam vicArya vE //
   vṛkṣaparvatapāṣāṇām agrakūṭaṃ samadyutim /	vRkza-parvata-pAzANAm agrakUwam sama-dyutim /
   śaṃkhabherīmṛdaṅgānāṃ kuṃbhāṇḍā dundubhisvarāḥ //	SaMKa-BerI-mRdaFgAnAm kuMBANxAH dunduBi-svarAH //
   pramuñcanti ravaṃ bhīmaṃ mahākaṇṭhāḥ kharasvarāḥ /	pramuQcanti ravam BImam mahA-kaNWAH Kara-svarAH /
   kālanīlakapītāś ca haritpiṅgalapiṅgalāḥ //	kAlanIlaka-pItAH ca harit-piFgala-piFgalAH //
   guhyakāḥ sarvaduṣṭānām ālaye puraḥ sthitāḥ /	guhyakAH sarva-duzwAnAm Alaye puras sTitAH /
   grasante mānuṣaṃ lokaṃ naranāryas tathetarān //	grasante mAnuzam lokam nara-nAryaH taTA-itarAn //
   hatakṛtyamāṃśarudhiraṃ medamajjān tathāpare /	hata-kRtyama-aMSa-ruDiram meda-majjAn taTA-apare /
   sūcīlomāsikeśāś ca raktalohitamrakṣitāḥ //	sUcIlomAsi-keSAH ca rakta-lohitamrakzitAH //
   bhakṣamāṇā vidhāvanti kuṇapaṃ saṃpragṛhya vai /	BakzamANAH viDAvanti kuNapam saMpragRhya vE /
   tīkṣudantā raktahastā oṣṭhamrakṣitalohitāḥ //	tIkzu-dantAH rakta-hastAH ozWamrakzita-lohitAH //
   ardhakhāditagātraiś ca kṛtvā hastau prapūritau /	arDa-KAdita-gAtrEH ca kRtvA hastO prapUritO /
   vṛkkāhṛdayajatrunijaghaṇaṃ bhakṣamāṇakāḥ //	vRkkA-hRdaya-jatru-nija-GaNam BakzamANakAH //
   karālā hastapādebhyo harante prāṇināṃ balam /	karAlAH hasta-pAdeByaH harante prANinAm balam /
   asthisaṃkarakāyena trāsayanti janān bahūn //	asTi-saMkara-kAyena trAsayanti janAn bahUn //
   gṛhītvā mānuṣaṃ carma lohitena prapūritam /	gRhItvA mAnuzam carma lohitena prapUritam /
   viṣeṇogreṇa saṃsṛṣṭaṃ vikṣipanti diśodaśam //	vizeNa-ugreNa saMsRzwam vikzipanti diSodaSam //
   (Msp 13)	(Msp 13)
   nagarāṇāṃ praveśeṣu vikṣipanti kulākulam /	nagarANAm praveSezu vikzipanti kula-Akulam /
   vātaṃ pittaṃ ca śleṣmāṇaṃ kṣobhayanti caturdiśam //	vAtam pittam ca SlezmANam kzoBayanti caturdiSam //
   iti saṃtiṣṭhante tatra rājapīḍā mahābhayāḥ /	iti saMtizWante tatra rAja-pIxAH mahA-BayAH /
   sarve samāgatās te 'pi vidyāpāśena karṣitāḥ //	sarve samAgatAH te api vidyA-pASena karzitAH //
   namas te puruṣavīra namo 'stu puruṣottama /	namaH te puruza-vIra namaH astu puruzottamaH /
   namasyāmo 'ñjalikarā dharmarāja namo 'stu te //	namasyAmaH aQjali-karAH DarmarAja namaH astu te //
   caranti nagaraṃ grāmaṃ rāṣṭrarājakuleṣu ca /	caranti nagaram grAmam rAzwra-rAja-kulezu ca /
   yakṣā ojoharā ghorā nṛmāṃsarudhirāsinaḥ //	yakzAH ojaH-harA GorAH nR-mAMsa-ruDira-asinaH //
   mahākāyā mahābhīmā mahābalā maheśvarāḥ /	mahA-kAyAH mahA-BImAH mahA-balAH maheSvarAH /
   daśagrīvāḥ sahasrākṣā mahāgrāsā mahāmukhāḥ //	daSagrIvAH sahasrAkzAH mahA-grAsAH mahAmuKAH //
   mahatā parivāreṇa śastrahastāḥ subhairavāḥ /	mahatA parivAreNa Sastra-hastAH su-BEravAH /
   ahicarmagṛhītāś ca ulkāhastāś caturbhujāḥ //	ahi-carma-gRhItAH ca ulkA-hastAH catur-BujAH //
   daṇḍahastāḥ śastrahastāḥ śūlino vajrapāṇinaḥ /	daNxa-hastAH Sastra-hastAH SUlinaH vajrapANinaH /
   uttrāsenti diśaḥ sarvāyudhvaṃ kṛtvā sudāruṇam //	uttrAsenti diSaH sarva-AyuDvam kRtvA su-dAruNam //
   prasannā guhyakāḥ sarve duṣṭānām ālaye sthitāḥ /	prasannAH guhyakAH sarve duzwAnAm Alaye sTitAH /
   grasante mānuṣe loke naranāryas tathetarān //	grasante mAnuze loke nara-nAryaH taTA-itarAn //
   uṣṇair māṃsaiś ca rudhirair bhāntāṅgāḥ kāmarūpiṇaḥ /	uzNEH mAMsEH ca ruDirEH BAnta-aFgAH kAmarUpiNaH /
   siṃhavyāghrāś ca mahiṣīgokharoṣṭrebharūpiṇaḥ //	siMha-vyAGrAH ca mahizI-go-Kara-uzwra-iBa-rUpiNaH //
   ṛkṣadvīpivṛkanyaṅkuśṛgālaiḍaviḍālakaiḥ /	Rkza-dvIpi-vRkanI-aFku-SRgAla-exa-vixAlakEH /
   rūpair ākhukapiprakhyaiḥ khaṅgīśūkaranākulaiḥ //	rUpEH AKu-kapi-praKyEH KaFgI-SUkara-nAkulEH //
   matsakacchaparūpaiś ca aparaiḥ kākakokilaiḥ /	mad-sakacCapa-rUpEH ca aparEH kAka-kokilEH /
   ulūkagṛdhrasenyādi tathā timitimiṅgilaiḥ //	ulUka-gRDrasenya-Adi taTA timi-timiFgilEH //
   māyūrair haṃsakāpotai rūpaiḥ krauñcavihaṅgamaiḥ /	mAyUrEH haMsa-kApotEH rUpEH krOQca-vihaFgamEH /
   kecit kukkuṭarūpeṇa yakṣāḥ paśyanti mānuṣān //	kecid kukkuwa-rUpeNa yakzAH paSyanti mAnuzAn //
   suparṇīpakṣiveṣeṇa saṃtrāsenti janān bahūn /	suparNI-pakzi-vezeNa saMtrAsenti janAn bahUn /
   keṣāṃcid mānuṣaṃ śīrṣaṃ śarīraṃ kharakotkaṭam /	kezAMcid mAnuzam SIrzam SarIram Karaka-utkawam /
   anyāny abhidravanto 'nye dṛśyante vikalāśayāḥ /	anyAni aBidravantaH anye dRSyante vikala-ASayAH /
   vinagnāḥ kāmaparamā antramālāvaguṇṭhitāḥ //	vinagnAH kAma-paramAH antra-mAla-avaguNWitAH //
   praharanti triśūlena pīḍāṃ kurvanti prāṇinām /	praharanti triSUlena pIxAm kurvanti prANinAm /
   muñcanti dāruṇaṃ śvāsaṃ saṃtāpenti imāḥ prajāḥ //	muQcanti dAruNam SvAsam saMtApenti imAH prajAH //
   (Msp 14)	(Msp 14)
   vicitrarūpā dṛśyante yāvatī prāṇasaṃtatiḥ /	vicitra-rUpAH dRSyante yAvatI prANa-saMtatiH /
   gṛhītaparvataś cānye asicakradharāpare //	gRhIta-parvataH ca-anye asi-cakra-Dara-apare //
   saṃkhyāśatasahasrāṇi musaladaṇḍatarjitāḥ /	saMKyA-Sata-sahasrANi musala-daNxa-tarjitAH /
   utpāṭitākṣā vimukhāḥ khaṇḍadantāś ca rākṣasāḥ //	utpAwita-akzAH vimuKAH KaNxa-dantAH ca rAkzasAH //
   chinnanāsāś chinnakarṇāś chinnajihvā valīmukhaḥ /	Cinna-nAsAH Cinna-karNAH Cinna-jihvA valImuKaH /
   saṃchinnahastapādāś ca chinnaśīrṣāś ca rākṣasāḥ //	saMCinna-hasta-pAdAH ca Cinna-SIrzAH ca rAkzasAH //
   prekṣanti cāvatāraṃ hi ojo hiṃsanti kilbiṣāḥ /	prekzanti ca-avatAram hi ojaH hiMsanti kilbizAH /
   mānuṣāṇāṃ śarīreṣu suśūkṣmo dṛśyate grahaḥ //	mAnuzANAm SarIrezu su-SUkzmaH dRSyate grahaH //
   romāntareṣu marmeṣu tathā vraṇamukheṣu ca /	roma-antarezu marmezu taTA vraNa-muKezu ca /
   sarve samāgatās te 'pi vidyāpāśena karṣitāḥ //	sarve samAgatAH te api vidyA-pASena karzitAH //
   namas te puruṣavīra namas te puruṣottama /	namaH te puruza-vIra namaH te puruzottamaH /
   namasyāmo 'ñjalikarā dharmarāja namo 'stu te //	namasyAmaH aQjali-karAH DarmarAja namaH astu te //
   sumerau girirāje ca cakravāḍe tathaiva ca /	sumerO giri-rAje ca cakravAxe taTA-eva ca /
   gṛdhrakūṭe iśādhāre himavadgandhamādane //	gRDrakUwe iSa-ADAre himavat-ganDamAdane //
   pāṇḍave citrakūṭe ca nārade parvatadvaye /	pANxave citrakUwe ca nArade parvata-dvaye /
   śrīparvatasya mūrdhasthāḥ śṛṅgā ye bhṛśam udgatāḥ //	SrIparvatasya mUrDa-sTAH SRFgAH ye BRSam udgatAH //
   yās tatra devatādhastā ṛṣayaś ca tathādhikāḥ /	yAH tatra devatA-aDastAH RzayaH ca taTA-aDikAH /
   babhūvus te 'pi codvignā āyuś cottrastamānasāḥ //	baBUvuH te api ca-udvignAH AyuH ca-uttrasta-mAnasAH //
   devakoṭīsahasrāṇi devakoṭīśatāni ca /	deva-kowI-sahasrANi deva-kowI-SatAni ca /
   devakanyā mahābhāgā añjaliṃ saṃpragṛhya vai //	deva-kanyA mahABAgAH aQjalim saMpragRhya vE //
   vemacitrī rāhulaś ca prahlādaś ca samāgatāḥ /	vema-citrI rAhulaH ca prahlAdaH ca samAgatAH /
   bhṛtyakoṭīsahasraiś ca bhṛtyakoṭīśatair api //	BRtya-kowI-sahasrEH ca BRtya-kowI-SatEH api //
   kanyās teṣām ṛddhimatyo baddhā daśanakhāñjalim /	kanyAH tezAm RdDimatyaH badDAH daSa-naKa-aQjalim /
   sāgaraḥ supratiṣṭhaś ca nāgarājo manasvy api //	sAgaraH su-pratizWaH ca nAga-rAjaH manasvi api //
   nagendro 'navataptaś ca ubhau nandopanandakau /	naga-indraH anavataptaH ca uBO nanda-upanandakO /
   vakṣunando vajramatir gaṅgā sindhuś ca sāgaraḥ //	vakzunandaH vajra-matiH gaFgA sinDuH ca sAgaraH //
   suparṇī pakṣirājānaḥ sāgaraṃ kṣobhayanti ye /	suparNI pakzirAjAnaH sAgaram kzoBayanti ye /
   nāgakoṭīsahasrabhir nāgakoṭīśatais tathā //	nAga-kowI-sahasraBiH nAga-kowI-SatEH taTA //
   kanyās teṣāṃ mahābhāgā añjaliṃ saṃpragṛhya vai /	kanyAH tezAm mahABAgAH aQjalim saMpragRhya vE /
   ravicandrāv ubhau vāpi nakṣatraparivāritau //	ravi-candrO uBO vA-api nakzatra-parivAritO //
   (Msp 15)	(Msp 15)
   suvarṇavarṇaḥ puṣpeṣu magadheṣu rabheyakaḥ /	suvarNa-varNaH puzpezu magaDezu raBeyakaH /
   kāpilir bharukaccheṣu kośaleṣu prapuṇḍakaḥ //	kApiliH BarukacCezu koSalezu prapuNxakaH //
   śūcīlomā ca madreṣu malleṣu ca yaśodharaḥ /	SUcI-lomA ca madrezu mallezu ca yaSoDaraH /
   vibhīṣaṇaś ca pāñcāle lohitākṣaś ca aśvaje //	viBIzaNaH ca pAQcAle lohitAkzaH ca aSva-je //
   piṅgalaś ca avanteṣu kapilākṣaś ca vaidiśe /	piFgalaH ca avantezu kapilAkzaH ca vEdiSe /
   kumbhodaraś ca matseṣu sūrateṣu ca dīrghilaḥ //	kumBodaraH ca matsezu sUratezu ca dIrGilaH //
   pramardanas tu gāndhāre sūryamitraś ca kambuṣu /	pramardanaH tu gAnDAre sUrya-mitraH ca kambuzu /
   mahājanapadeṣv ete uktā yakṣāś caturdaśa //	mahA-janapadezu ete uktAH yakzAH caturdaSa //
   vajrapāṇir mahāyakṣo dharmapālaḥ prapuṇḍaraḥ /	vajrapANiH mahA-yakzaH DarmapAlaH prapuNxaraH /
   kapilaḥ sudarśano viṣṇuḥ piṇḍāraḥ karaśodaraḥ //	kapilaH sudarSanaH vizNuH piNxAraH karaSodaraH //
   kumbhīraḥ sātyakiś cāpi pāñcikaś ca jinarṣabhaḥ /	kumBIraH sAtyakiH ca-api pAQcikaH ca jina-RzaBaH /
   maheśvaro mahāyakṣaś caturbāhur mahābalaḥ //	maheSvaraH mahA-yakzaH catur-bAhuH mahA-balaH //
   pramardanaḥ śūraseno mahānagno mahābalaḥ /	pramardanaH SUrasenaH mahA-nagnaH mahA-balaH /
   yamaś ca yamadūtaś ca māraś cāpi sasainyakaḥ //	yamaH ca yamadUtaH ca mAraH ca-api sa-sEnyakaH //
   harir nāmnā tv asau yakṣo yakṣakoṭīparigrahaḥ /	hariH nAmnA tu asO yakzaH yakza-kowI-parigrahaH /
   hārītī ca sasainyā tu giridāri ca yakṣiṇī //	hArItI ca sa-sEnyA tu giridAri ca yakziNI //
   bhīmarūpā mahātejā hārītī nāma viśrutā /	BIma-rUpA mahA-tejAH hArItI nAma viSrutA /
   caṇḍā caṇḍālikā caiva pañcaputraśatair vṛtā //	caNxA caNxAlikA ca-eva paQca-putra-SatEH vRtAH //
   ākoṭā karkaṭī kālī padumā padumāvatī /	AkowA karkawI kAlI padumA padumAvatI /
   puṣpadantī viśālā ca kharakarṇā ca rākṣasī //	puzpadantI viSAlA ca KarakarNA ca rAkzasI //
   candano viṣṇulaś cāpi haripiṅgalapiṅgalaḥ /	candanaH vizNulaH ca-api hari-piFgala-piFgalaH /
   kuñjaro nāgadantaś ca girimitro 'gradaṃṣṭrakaḥ //	kuQjaraH nAgadantaH ca giri-mitraH agradaMzwrakaH //
   rākṣasī bhadradantā ca brahmilā viṣṇulā tathā /	rAkzasI BadradantA ca brahmilA vizNulA taTA /
   yakṣo hālāhalaś caiva rākṣasaś ca vituṇḍakaḥ //	yakzaH hAlAhalaH ca-eva rAkzasaH ca vituNxakaH //
   śūleṣu te gṛhītvātha gavāś ca mṛgamānuṣān /	SUlezu te gRhItvA-aTa gavAH ca mRga-mAnuzAn /
   bhakṣayantaś ca jīvanto dhāvantaś ca diśodiśaḥ //	BakzayantaH ca jIvantaH DAvantaH ca diSaH-diSaH //
   prakampamānā dhāraṇīṃ śoṣayanto vanaspatīn /	prakampamAnAH DAraNIm SozayantaH vanaspatIn /
   saṃkocayantaḥ śikharān mardayanta imāḥ prajāḥ //	saMkocayantaH SiKarAn mardayantaH imAH prajAH //
   parasparaṃ saṃharṣento vidyākṛṣṭāḥ samāgatāḥ /	parasparam saMharzentaH vidyA-AkRzwAH samAgatAH /
   teṣāṃ samāgatānāṃ hi lokanāthasya cāgrataḥ //	tezAm samAgatAnAm hi loka-nATasya ca-agratas //
   (Msp 16)	(Msp 16)
   tato vaiśramaṇo rājā lokanātham athābravīt /	tatas vESramaNaH rAjA lokanATam aTa-abravIt /
   mamāsty uttaradigbhāge rājadhāni sunirmitā //	mama-asti uttara-diS-BAge rAjaDAni su-nirmitA //
   manoramāḍakavatī tenāham aḍakādhipaḥ /	manoramAxakavatI tena-aham axaka-aDipaH /
   cintitā sarvadeve hi rājadhāny aḍakāhvayā //	cintitA sarva-deve hi rAjaDAnI axaka-AhvayA //
   samucchritā tu prākārā saptaratnasamākulā /	samucCritA tu prAkArA sapta-ratna-samAkulAH /
   kṣomakair yojane dvedhaiḥ saṃskṛtā kāñcanāmayaiḥ //	kzomakEH yojane dveDEH saMskRtA kAQcana-AmayEH //
   kṣomake caikamekasmin samantād dikcatuṣṭaye /	kzomake ca-ekam-ekasmin samantAt diS-catuzwaye /
   sthitā vajradharā yakṣāḥ śastrahastāḥ suvarmitāḥ //	sTitAH vajraDarAH yakzAH Sastra-hastAH su-varmitAH //
   rājadhānyās tu tasyaiva kṛtaṃ dvāracatuṣṭayam /	rAjaDAnyAH tu tasya-eva kRtam dvAra-catuzwayam /
   ekaṃ suvarṇamayaṃ dvāraṃ dvitīyaṃ rūpyasaṃskṛtam //	ekam suvarNa-mayam dvAram dvitIyam rUpya-saMskRtam //
   tṛtīyaṃ sphāṭikaṃ dvāraṃ caturthaṃ maṇivicitritam /	tRtIyam sPAwikam dvAram caturTam maNi-vicitritam /
   asty antare tu nagare udyāne vanapuṣpite //	asti antare tu nagare udyAne vana-puzpite //
   vimānāni vicitrāṇi saptaratnamayāni vai /	vimAnAni vicitrANi sapta-ratna-mayAni vE /
   nānāratnamayā vṛkṣā nānāpakṣiṇikūjitāḥ //	nAnA-ratna-mayAH vRkzAH nAnA-pakziNi-kUjitAH //
   nānāpuṣpasaṃchannā nānāgandhānulepanāḥ /	nAnA-puzpa-saMCannAH nAnA-ganDa-anulepanAH /
   pakṣiṇīnāṃ vilāsaiś ca gītavādyair alaṃkṛtāḥ //	pakziNInAm vilAsEH ca gIta-vAdyEH alaMkRtAH //
   anubhomi śriyaṃ tv agryāṃ bhūtānāṃ tatra maṇḍale /	anuBomi Sriyam tu agryAm BUtAnAm tatra maNxale /
   sarvākāravaropetās tatra me paricārakāḥ //	sarva-AkAra-vara-upetAH tatra me paricArakAH //
   dharmacārī dharmakāmā na vihiṃsanti prāṇinām /	Darma-cArI Darma-kAmAH na vihiMsanti prANinAm /
   annapānais tu vikalā dāruṇās tv itarāḥ prajāḥ //	anna-pAnEH tu vikalAH dAruNAH tu itarAH prajAH //
   adharmacāry adharmakāmās te vihiṃsanti prāṇinām /	aDarma-cArI aDarma-kAmAH te vihiMsanti prANinAm /
   udāraṃ parimārganto viprekṣanti caturdiśaṃ //	udAram parimArgantaH viprekzanti caturdiSam //
   nagaradvārasaṃsthā ye udyāneṣu vaneṣu ca /	nagara-dvAra-saMsTAH ye udyAnezu vanezu ca /
   yakṣarākṣasabhūtānāṃ koṭīsahasrakān gaṇān //	yakza-rAkzasa-BUtAnAm kowI-sahasrakAn gaNAn //
   sarvāṃs tān ānayiṣyāmi sūtrapāśena karṣitān /	sarvAn tAn AnayizyAmi sUtra-pASena karzitAn /
   candanānāṃ vanaiś cchannaṃ śītapuṣkariṇīcitam //	candanAnAm vanEH cCannam SIta-puzkariNI-citam //
   madhye tadrājadhānyās tu dharmarājaniveśanaṃ /	maDye tad-rAjaDAnyAH tu DarmarAja-niveSanam /
   samantād yojanaṃ yāvat kūṭāgārās tu nirmitāḥ /	samantAt yojanam yAvat kUwAgArAH tu nirmitAH /
   suvarnasya bhaved eko dvitīyo rūpyam eva ca /	suvarnasya Bavet ekaH dvitIyaH rUpyam eva ca /
   vaiḍūryasya tṛtīyas tu caturthaḥ sphāṭikaḥ śuciḥ //	vExUryasya tRtIyaH tu caturTaH sPAwikaH SuciH //
   (Msp 17)	(Msp 17)
   pañcamo raktamuktāyāḥ ṣaṣṭhaś caivāśmagarbhaḥ /	paQcamaH rakta-muktAyAH zazWaH ca-eva-aSmagarBaH /
   saptamas tu musārasya saptaratnamayo 'ṣṭamaḥ //	saptamaH tu musArasya sapta-ratna-mayaH azwamaH //
   nāriśatasahasrāṇi ekaikasmin samāgatāḥ /	nAri-Sata-sahasrANi ekEkasmin samAgatAH /
   citrair ābharaṇair agraiś citrair veśair alaṃkṛtāḥ //	citrEH ABaraNEH agrEH citrEH veSEH alaMkRtAH //
   vicitragītavādyeṣu śilpasthāneṣu śikṣitāḥ /	vicitra-gIta-vAdyezu Silpa-sTAnezu SikzitAH /
   īdṛśena pramodena udagras tuṣṭamānasaḥ //	IdRSena pramodena udagraH tuzwa-mAnasaH //
   tatrāhaṃ madhupānena kāmaiś cātyartham ucchritaḥ /	tatra-aham maDu-pAnena kAmEH ca-atyarTam ucCritaH /
   parṣat me prapalāyanti saṃtrāsenti diśodaśaḥ //	parzad me prapalAyanti saMtrAsenti diSodaSaH //
   striyaś ca puruṣāś caiva tathā dārakadārikāḥ /	striyaH ca puruzAH ca-eva taTA dAraka-dArikAH /
   garbhasthā api naśyanti tiryagyonigatā api //	garBa-sTAH api naSyanti tiryagyoni-gatAH api //
   nakṣatracandrasūryāś ca grahāḥ pīḍanti dāruṇāḥ /	nakzatra-candra-sUryAH ca grahAH pIxanti dAruNAH /
   sasyaṃ bījaṃ phalaṃ puṣpam oṣadhaṃ pānabhojanam //	sasyam bIjam Palam puzpam ozaDam pAna-Bojanam //
   harante mānuṣīṃ lakṣmīm uccānīcīṃ karonti ca /	harante mAnuzIm lakzmIm uccAnIcIm karonti ca /
   ye kecid duṣkṛtā loke vairāḥ kalahavigrahāḥ //	ye kecid duzkRtAH loke vErAH kalaha-vigrahAH //
   dagdhaṃ naṣṭaṃ hataṃ bhinnaṃ tat sarvaṃ bhūtajaṃ smṛtam /	dagDam nazwam hatam Binnam tat sarvam BUta-jam smRtam /
   oguṇṭhanti niguṇṭhanti paryasyanti sthitanti //	oguNWanti niguNWanti paryasyanti sTitanti //
   uttrāsenti ca satvānāṃ viprekṣanti dviṣanti ca /	uttrAsenti ca satvAnAm viprekzanti dvizanti ca /
   darśenti pāpakān svapnān prasuptān pīḍayanti ca //	darSenti pApakAn svapnAn prasuptAn pIxayanti ca //
   dvārasthāś cācchaṭāṃ kṛtvā prakrośanti grasanti ca /	dvAra-sTAH ca-acCawAm kRtvA prakroSanti grasanti ca /
   mitrajñātisarūpāś ca dṛśyante ālapanti ca //	mitra-jQAti-sarUpAH ca dRSyante Alapanti ca //
   vicitrakanyārūpeṇa dṛśyante kāmarūpiṇaḥ /	vicitra-kanyA-rUpeNa dRSyante kAmarUpiNaH /
   candrarūpeṇa dṛśyante sūryanakṣatrarūpiṇaḥ //	candra-rUpeNa dRSyante sUrya-nakzatra-rUpiNaH //
   vātolkāśanirūpeṇa dṛśyante vāyupīḍakāḥ /	vAta-ulka-aSani-rUpeNa dRSyante vAyu-pIxakAH /
   ulkākalāpasadṛśāḥ śṛgālasvarabhairavāḥ //	ulkA-kalApa-sadRSAH SRgAla-svaraBEravAH //
   vikramantaś ca dṛśyante vṛkṣacaityālayeṣu ca /	vikramantaH ca dRSyante vRkza-cEtya-Alayezu ca /
   kumārarūpeṇa jvalantaḥ śakaṭasvarāḥ //	kumAra-rUpeNa jvalantaH Sakawa-svarAH //
   sadā citrāṇi darśenti ālayeṣu patheṣu ca /	sadA citrANi darSenti Alayezu paTezu ca /
   gṛhāṇāṃ nagarāṇāṃ ca dvāre muñcanti te grahāḥ /	gRhANAm nagarANAm ca dvAre muQcanti te grahAH /
   gṛhītvā jīvitaṃ kāyaṃ kupathe grāmayanti ca /	gRhItvA jIvitam kAyam kupaTe grAmayanti ca /
   vicitrāṇi ca rūpāṇi vicitrāṇi svarāṇi ca //	vicitrANi ca rUpANi vicitrANi svarANi ca //
   (Msp 18)	(Msp 18)
   rogān vicitrān darśenti vyādhīn vai kāyasaṃsthitān /	rogAn vicitrAn darSenti vyADIn vE kAya-saMsTitAn /
   viparītaṃ ca darśenti sarvarogeṣu ca lakṣaṇam //	viparItam ca darSenti sarva-rogezu ca lakzaNam //
   yāvatī prakṛti loke sarvān darśenti te 'nyathā /	yAvatI prakRti loke sarvAn darSenti te anyaTA /
   sarve samāgatās te 'pi vidyāpāśena karṣitāḥ //	sarve samAgatAH te api vidyA-pASena karzitAH //
   namas te puruṣavīra namas te puruṣottama /	namaH te puruza-vIra namaH te puruzottamaH /
   namasyāmo 'ñjalikarā dharmarāja namo 'stu te //	namasyAmaH aQjali-karAH DarmarAja namaH astu te //
   tato vaiśramaṇo rājā utthito 'tha kṛtāñjaliḥ /	tatas vESramaNaH rAjA utTitaH aTa kRtAQjaliH /
   cakrāṅkacitracaraṇayaṣṭikāñcanasannibhaḥ //	cakra-aFka-citra-caraNa-yazwi-kAQcana-sanniBaH //
   lokapradyotakiraṇa agnikalpamahāmune /	loka-pradyota-kiraNa agni-kalpa-mahA-mune /
   catuḥṣaṣṭhisahasrāṇi yakṣāṇām atra dāruṇāḥ //	catuHzazWi-sahasrANi yakzANAm atra dAruNAH //
   niśritā hy uttarabhāgaṃ pīḍayanti tadudbhavān /	niSritAH hi uttara-BAgam pIxayanti tad-udBavAn /
   teṣāṃ daṇḍaṃ praṇeṣyāmi lokanāthasya saṃmukham //	tezAm daNxam praNezyAmi lokanATasya saMmuKam //
   syād yathedam /	syAt yaTA-idam /
   khaṅge / khaṅgagarbhe / vicakṣaṇe / cakragagane / candre capale /	KaFge / KaFga-garBe / vicakzaNe / cakra-gagane / candre capale /
   bhīmaparvate / kharāgre / kuṭilakarāgre / ekākṣivargavati / sāraṅgavati	BIma-parvate / Kara-agre / kuwila-kara-agre / eka-akzi-vargavati / sAraFgavati
   vicitrakānti svasty astu mama sarvasatvānāṃ ca uttarasyāṃ diśi svāhā //	vicitra-kAnti svasti astu mama sarva-satvAnAm ca uttarasyAm diSi svAhA //
   brahmā cāpy atha śakraś ca lokapālā maheśvarāḥ /	brahmA ca-api aTa SakraH ca lokapAlAH maheSvarAH /
   yakṣasenāpatayaḥ sarve hārītī ca saputrikā //	yakza-senApatayaH sarve hArItI ca sa-putrikA //
   idaṃ puṣpaṃ ca gandhaṃ ca pratigṛhṇantu mamāhutiṃ /	idam puzpam ca ganDam ca pratigRhNantu mama-Ahutim /
   vīryeṇa tejasā teṣām aiśvaryeṇa balena ca //	vIryeNa tejasA tezAm ESvaryeNa balena ca //
   nihatāḥ sarvarogāś ca svasty astu mama sarvasatvānāṃ ca	nihatAH sarva-rogAH ca svasti astu mama sarva-satvAnAm ca
   sarvabhayopadravebhyaḥ svāhā //	sarva-Baya-upadraveByaH svAhA //
   namas te puruṣavīra namas te puruṣottama /	namaH te puruza-vIra namaH te puruzottamaH /
   namasyāmo 'ñjalikarā dharmarājā namo 'stu te //	namasyAmaH aQjali-karAH DarmarAjA namaH astu te //
   dhṛtarāṣṭraś ca rājo 'pi sa kṛtāñjalir utthitaḥ /	DRtarAzwraH ca rAjaH api sa kRtAQjaliH utTitaH /
   pūrṇarāśir ivotphullaḥ kalaviṅkarutasvaraḥ //	pUrNa-rASiH iva-utPullaH kalaviFka-ruta-svaraH //
   morakokilanirghoṣameghadundubhigarjitaḥ /	mora-kokila-nirGoza-meGa-dunduBi-garjitaH /
   catuḥṣaṣṭhisahasrāṇi gandharvā rākṣasā mune //	catuHzazWi-sahasrANi ganDarvAH rAkzasAH mune //
   niśritā pūrvadigbhāgaṃ pīḍayanti tadudbhavān /	niSritA pUrva-diS-BAgam pIxayanti tad-udBavAn /
   (Msp 19)	(Msp 19)
   teṣāṃ daṇḍaṃ praṇeṣyāmi lokanāthasya saṃmukham //	tezAm daNxam praNezyAmi lokanATasya saMmuKam //
   syād yathedam /	syAt yaTA-idam /
   dharaṇi dhāraṇi / pradhvaṃsani / bhañjani / prabhañjani / vidhamaṇi /	DaraNi DAraNi / praDvaMsani / BaQjani / praBaQjani / viDamaNi /
   kiṃpuruṣe / sakale / sārathe / sāravati / śūradhare / śūradhāriṇi /	kiMpuruze / sakale / sAraTe / sAravati / SUra-Dare / SUra-DAriNi /
   śuddhacaraṇe / ghoṣavati / sarāgre / śānti svasty astu mama sarvasatvānāṃ	SudDa-caraNe / Gozavati / sara-agre / SAnti svasti astu mama sarva-satvAnAm
   ca pūrvasyāṃ diśi svāhā //	ca pUrvasyAm diSi svAhA //
   brahmā cāpy atha śakraś ca lokapālā maheśvarāḥ /	brahmA ca-api aTa SakraH ca lokapAlAH maheSvarAH /
   yakṣasenāpatayaḥ sarve hārītī ca saputrikā //	yakza-senApatayaH sarve hArItI ca sa-putrikA //
   idaṃ puṣpaṃ ca gandhaṃ ca pratigṛhṇantu mamāhutiṃ /	idam puzpam ca ganDam ca pratigRhNantu mama-Ahutim /
   vīryeṇa tejasā teṣām aiśvaryeṇa balena ca //	vIryeNa tejasA tezAm ESvaryeNa balena ca //
   nihatāḥ sarvarogāś ca svasty astu mama sarvasatvānāṃ ca	nihatAH sarva-rogAH ca svasti astu mama sarva-satvAnAm ca
   sarvabhayopadravebhyaḥ svāhā //	sarva-Baya-upadraveByaH svAhA //
   namas te puruṣavīra namas te puruṣottama /	namaH te puruza-vIra namaH te puruzottamaH /
   namasyāmo 'ñjalikarā dharmarāja namo 'stu te //	namasyAmaH aQjali-karAH DarmarAja namaH astu te //
   rājā virūḍhakaś cāpi prāñjalīkas tato utthitaḥ /	rAjA virUXakaH ca-api prAQjalIkaH tatas utTitaH /
   sarvajñaḥ sarvadarśī ca sarvavādī pramardanaḥ /	sarvajQaH sarva-darSI ca sarva-vAdI pramardanaH /
   sarvasaṃśayacchetā ca sarvalokavināyakaḥ /	sarva-saMSaya=-CetA ca sarva-loka-vinAyakaH /
   catuḥṣaṣṭhisahasrāṇi kumbhāṇḍāḥ pretapūtanāḥ //	catuHzazWi-sahasrANi kumBANxAH preta-pUtanAH //
   niśrāya dakṣiṇaṃ deśaṃ pīḍayanti tadudbhavān /	niSrAya dakziNam deSam pIxayanti tad-udBavAn /
   teṣāṃ daṇḍaṃ praṇeṣyāmi lokanāthasya saṃmukham //	tezAm daNxam praNezyAmi lokanATasya saMmuKam //
   syād yathedam /	syAt yaTA-idam /
   śānti śāravati / kānti kāravati / kiṃkarasi / kiraṇḍi / kiṃvaḍi / dharaṇi	SAnti SAravati / kAnti kAravati / kiMkarasi / kiraNxi / kiMvaxi / DaraNi
   / vardhani / bhūmidhāriṇi / vibhūmidhāriṇi / himavati / jyotiścaraṇe /	/ varDani / BUmi-DAriNi / viBUmi-DAriNi / himavati / jyotiScaraNe /
   mālāgri / svasty astu mama sarvasatvānāṃ ca dakṣiṇāyāṃ diśi svāhā //	mAlA-agri / svasti astu mama sarva-satvAnAm ca dakziNAyAm diSi svAhA //
   brahmā cāpy atha śakraś ca lokapālā maheśvarāḥ /	brahmA ca-api aTa SakraH ca lokapAlAH maheSvarAH /
   yakṣādhipatayaḥ sarve hārītī ca saputrikā //	yakza-aDipatayaH sarve hArItI ca sa-putrikA //
   idaṃ puṣpaṃ ca gandhaṃ ca pratigṛhṇantu mamāhutiṃ /	idam puzpam ca ganDam ca pratigRhNantu mama-Ahutim /
   vīryeṇa tejasā teṣām aiśvaryeṇa balena ca //	vIryeNa tejasA tezAm ESvaryeNa balena ca //
   nihatāḥ sarvarogāś ca svasty astu mama sarvasatvānāṃ ca (Msp 20)	nihatAH sarva-rogAH ca svasti astu mama sarva-satvAnAm ca (MsB 20)
   sarvabhayopadravopasargebhyaḥ svāhā //	sarva-Baya-upadrava-upasargeByaH svAhA //
   namas te puruṣavīra namas te puruṣottama /	namaH te puruza-vIra namaH te puruzottamaH /
   namasyāmo 'ñjalikarā dharmarāja namo 'stu te //	namasyAmaH aQjali-karAH DarmarAja namaH astu te //
   virūpākṣo mahārājā gṛhītāñjalir utthitaḥ /	virUpAkzaH mahA-rAjAH gRhIta-aQjaliH utTitaH /
   mahāmeghamahāsiṃhaḥ mahāmahamahodadhiḥ /	mahA-meGa-mahA-siMhaH mahA-maha-mahA-udaDiH /
   mahāvādī mahāśūro mahāsaṃgrāmamardakaḥ /	mahA-vAdI mahASUraH mahA-saMgrAma-mardakaH /
   catuḥṣaṣṭhisahasrāṇi nāgasauparṇiguhyakāḥ /	catuHzazWi-sahasrANi nAgasOparNi-guhyakAH /
   niśrāya paścimaṃ deśaṃ pīḍayanti tadudbhavān /	niSrAya paScimam deSam pIxayanti tad-udBavAn /
   teṣāṃ daṇḍaṃ praṇeṣyāmi lokanāthasya saṃmukham //	tezAm daNxam praNezyAmi lokanATasya saMmuKam //
   syād yathedam /	syAt yaTA-idam /
   dharmadharāgre / balavati / balini viśāṅge / vivasi sāgare / khari kapile	Darma-Dara-agre / balavati / balini viSAFge / vivasi sAgare / Kari kapile
   / caṇḍāli / tiriṇi / virājane / vidhāriṇi / varṇavati / acare / svasty	/ caNxAli / tiriNi / virAjane / viDAriNi / varNavati / acare / svasti-
   astu mama sarvasatvānāṃ ca paścimāyāṃ diśi svāhā //	astu mama sarva-satvAnAm ca paScimAyAm diSi svAhA //
   brahmā cāpy atha śakraś ca lokapālā maheśvarāḥ /	brahmA ca-api aTa SakraH ca lokapAlAH maheSvarAH /
   yakṣādhipatayaḥ sarve hārītī ca saputrikā //	yakza-aDipatayaH sarve hArItI ca sa-putrikA //
   idaṃ puṣpaṃ ca gandhaṃ ca pratigṛhṇantu mamāhutiṃ /	idam puzpam ca ganDam ca pratigRhNantu mama-Ahutim /
   vīryeṇa tejasā teṣām aiśvaryeṇa balena ca //	vIryeNa tejasA tezAm ESvaryeNa balena ca //
   nihatāḥ sarvarogāś ca svasty astu mama sarvasatvānāṃ ca	nihatAH sarva-rogAH ca svasti astu mama sarva-satvAnAm ca
   sarvabhayopadravopasargebhyaḥ svāhā //	sarva-Baya-upadrava-upasargeByaH svAhA //
   namas te puruṣavīra namas te puruṣottama /	namaH te puruza-vIra namaH te puruzottamaH /
   namasyāmo 'ñjalikarā dharmarāja namo 'stu te //	namasyAmaH aQjali-karAH DarmarAja namaH astu te //
   atha brahmā mahābrahmā prāñjalīkaḥ samutthitaḥ /	aTa brahmA mahA-brahmA prAQjalIkaH samutTitaH /
   brāhmaṇaḥ snātakaḥ śuddhaḥ sarvavedeṣu pāragaḥ /	brAhmaNaH snAtakaH SudDaH sarva-vedezu pAragaH /
   vaidyarājo janānandaḥ sarvarogacikitsakaḥ /	vEdya-rAjaH janAnandaH sarva-roga-cikitsakaH /
   ye yakṣarākṣasāś caiva digvidikṣu vyavasthitāḥ /	ye yakza-rAkzasAH ca-eva diS-vidikzu vyavasTitAH /
   pātāle heṣṭham ūrdhvaṃ ca ākāśe niśritā grahāḥ /	pAtAle hezWam UrDvam ca AkASe niSritAH grahAH /
   teṣāṃ daṇḍaṃ praṇeṣyāmi lokanāthasya saṃmukham //	tezAm daNxam praNezyAmi lokanATasya saMmuKam //
   syād yathedam /	syAt yaTA-idam /
   brahma brahmaghoṣe / brahmasvare / vajradhare / sthire / sāre / acale /	brahma brahma-Goze / brahma-svare / vajraDare / sTire / sAre / acale /
   araṇe / iṣaṇe / araṇi deraṇi / śūre / varāgraprāpte / sāravate / (Msp 21)	araNe / izaNe / araNi deraNi / SUre / vara-agra-prApte / sAravate / (MsB 21)
   svasty astu mama sarvasatvānāṃ ca sarvadigvidigbhyaḥ svāhā //	svasti astu mama sarva-satvAnAm ca sarva-diS-vidigByaH svAhA //
   brahmā cāpy atha śakraś ca lokapālā maheśvarāḥ /	brahmA ca-api aTa SakraH ca lokapAlAH maheSvarAH /
   yakṣasenāpatayaḥ sarve hārītī ca saputrikā //	yakza-senApatayaH sarve hArItI ca sa-putrikA //
   idaṃ puṣpaṃ ca gandhaṃ ca pratigṛhṇantu mamāhutiṃ /	idam puzpam ca ganDam ca pratigRhNantu mama-Ahutim /
   vīryeṇa tejasā teṣām aiśvaryeṇa balena ca //	vIryeNa tejasA tezAm ESvaryeNa balena ca //
   nihatāḥ sarvarogāś ca svasty astu mama sarvasatvānāṃ ca	nihatAH sarva-rogAH ca svasti astu mama sarva-satvAnAm ca
   sarvabhayopadravopasargebhyaḥ svāhā //	sarva-Baya-upadrava-upasargeByaH svAhA //
   namas te puruṣavīra namas te puruṣottama /	namaH te puruza-vIra namaH te puruzottamaH /
   namasyāmo 'ñjalikarā dharmarāja namo 'stu te //	namasyAmaH aQjali-karAH DarmarAja namaH astu te //
   vātajāḥ pittajā rogāḥ śleṣmajāḥ sannipātajāḥ / nihatāḥ sarvarogāś ca	vAta-jAH pitta-jAH rogAH Slezma-jAH sannipAta-jAH / nihatAH sarva-rogAH ca
   svasty astu mama sarvasatvānāṃ ca sarvabhayopadravopasargopāyāsebhyaḥ	svasti astu mama sarva-satvAnAm ca sarva-Baya-upadrava-upasarga-upAyAseByaH
   svāhā //	svAhA //
   atha bhagavān etad avocat /	aTa BagavAn etat avocat /
   naikarājasyārthāya buddhā bhagavanto loka utpadyante /	na-eka-rAjasya-arTAya budDAH BagavantaH loke utpadyante /
   naikanagaranigamajanapadagrāmakulānāṃ yāvan naikasatvasyārthāya buddhā	na-eka-nagara-nigama-janapada-grAma-kulAnAm yAvat na-eka-satvasya-arTAya budDA
   bhagavanto loka utpadyante / api tu sadevakasya lokasyārthāya samārakasya	BagavantaH loke utpadyante / api tu sa-devakasya lokasya-arTAya samArakasya
   saśramaṇabrāhmaṇikāyāḥ prajāyāḥ sadevamānuṣāsurāyā buddhā bhagavanto loka	sa-SramaNa-brAhmaNikAyAH prajAyAH sa-deva-mAnuza-asurAyAH budDAH BagavantaH loka
   utpadyante / tadyathā / syād vaidyaś cikitsakaḥ paramācāryaḥ kuśalo	utpadyante / tat-yaTA / syAt vEdyaH cikitsakaH parama-AcAryaH kuSalaH-
   bhiṣajjñāneṣu śikṣito naikarājasyārthāya naikasatvasyārthāya loka	Bizat-jQAnezu SikzitaH na-eka-rAjasya-arTAya na-eka-satvasya-arTAya loka
   utpadyante / evam eva buddhā bhagavanto loka utpadyante / tat kasya hetoḥ	utpadyante / evam eva budDAH BagavantaH loke utpadyante / tat kasya hetoH
   / yasyāṃ diśi buddhā bhagavanto viharanti / na tatra manuṣyāmanuṣyān	/ yasyAm diSi budDAH BagavantaH viharanti / na tatra manuzya-amanuzyAn
   viheṭhayitavyān manyate / pañcāhaṃ yena vaiśālī mahānagarī	viheWayitavyAn manyate / paQca-aham yena vESAlI mahA-nagarI
   tenopasaṃkrāmeyam / evaṃ mayā vaiśālyāṃ mahānagaryāṃ mahājanakāyasyārthāya	tena-upasaMkrAmeyam / evam mayA vESAlyAm mahA-nagaryAm mahA-jana-kAyasya-arTAya
   kṛto bhaviṣyati buddhakāryaṃ ca //	kRtaH Bavizyati budDa-kAryam ca //
   atha khalu bhagavān pūrvāhṇakālasamaye nivāsya pātracīvaram	aTa Kalu BagavAn pUrvAhNa-kAla-samaye nivAsya pAtra-cIvaram
   ādāyārdhatrayodaśabhir bhikṣuśataiḥ sārdhaṃ gṛdhrakūṭāt parvatād avatīrṇaḥ	AdAya-arDa-trayodaSaBiH Bikzu-SatEH sArDam gRDra-kUwAt parvatAt avatIrNaH
   atha brahmā sahāpatiḥ pañcamātrāṇi divyāni chatraśatāny ādāya bhagavato	aTa brahmA sahApatiH paQca-mAtrANi divyAni Catra-SatAni AdAya BagavataH-
   dakṣiṇeṇopanāmitavān / upanāmya bhagavantam (Msp 22) eva vijayamānaḥ	dakziNeNa-upanAmitavAn / upanAmya Bagavantam (Msc 22) eva vijayamAnaH
   sthito 'bhūt //	sTitaH aBUt //
   śakro 'pi devānām indraḥ pañcamātrāṇi chatraśatāny ādāya bhagavato	SakraH api devAnAm indraH paQca-mAtrANi Catra-SatAni AdAya BagavataH-
   vāmenopanāmitavān / upanāmya bhagavantam eva vijayamānaḥ sthitaḥ //	vAmena-upanAmitavAn / upanAmya Bagavantam eva vijayamAnaH sTitaH //
   catvāro 'pi mahārājānaḥ ekaiko 'pi divyāni pañcamātrāṇi chatraśatāny ādāya	catvAraH api mahA-rAjAnaH ekEkaH api divyAni paQca-mAtrANi Catra-SatAni AdAya
   bhagavataḥ pṛṣṭhata upanāmitavanta upanāmya bhagavantam eva vijayamānaḥ	BagavataH pRzWatas upanAmitavantaH upanAmya Bagavantam eva vijayamAnaH
   sthitaḥ //	sTitaH //
   maheśvaro 'pi devaputro 'ṣṭāviṃśatiś ca mahāyakṣasenāpatayo dvātriṃśac ca	maheSvaraH api deva-putraH azwAviMSatiH ca mahA-yakza-senApatayaH dvAtriMSat ca
   mahāyakṣanagnā hārītī ca saputrikā saparivārā śrāvakānāṃ pratyekaṃ divyaṃ	mahAyakza-nagnA hArItI ca sa-putrikA sa-parivArA SrAvakAnAm pratyekam divyam
   chatram upanāmitavatī vijayantī ca sthitā //	Catram upanAmitavatI vijayantI ca sTitAH //
   evaṃrūpayośolābhasatkārāgraprāpto bhagavān sabhikṣusaṃgho gṛdhrakūṭāt	evaMrUpayoSaH-lABa-satkAra-agra-prAptaH BagavAn sa-Bikzu-saMGaH gRDrakUwAt-
   parvatād avatīrya yena vaiśālī mahānagarī tenopasaṃkrāntaḥ / adrakṣuḥ	parvatAt avatIrya yena vESAlI mahA-nagarI tena-upasaMkrAntaH / adrakzuH
   khalu punar vaiśālikā licchavayo bhagavantaṃ dūrata evāgacchantaṃ	Kalu punar vESAlikAH licCavayaH Bagavantam dUratas eva-AgacCantam
   prāsādikaṃ prāsādanīyaṃ śāntendriyaṃ śāntamānasaṃ dāntendriyaṃ	prAsAdikam prAsAdanIyam SAnta-indriyam SAnta-mAnasam dAnta-indriyam
   dāntamānasaṃ paramottamadamaśamathaprāptaṃ jitendriyaṃ nāgam iva sudāntaṃ	dAnta-mAnasam parama-uttama-dama-SamaTa-prAptam jita-indriyam nAgam iva su-dAntam
   hradam ivācchaṃ viprasannam anāvilaṃ dvātriṃśadbhir mahāpuruṣalakṣaṇaiḥ	hradam iva-acCam viprasannam anAvilam dvAtriMSadBiH mahApuruza-lakzaNEH
   samalaṃkṛtagātram aśītibhiś cānuvyañjanaiḥ saṃkusumitaṃ vicitritaṃ gātraṃ	samalaMkRta-gAtram aSItiBiH ca-anuvyaQjanEH saMkusumitam vicitritam gAtram
   tathāgatasya śarīraṃ śālarājeva supuṣpitaḥ sūryo vā divā	taTAgatasya SarIram SAlarAjA-iva su-puzpitaH sUryaH vA divA
   pramuktaraśmijālaḥ / rātrau cāndhakāratamiśrāyāṃ giriśikharagataḥ /	pramukta-raSmi-jAlaH / rAtrO ca-anDakArata-miSrAyAm giri-SiKara-gataH /
   prajvālan mahān agniskandhaḥ / mahān iva cāmīkarācaladharaḥ / evam eva	prajvAlan mahAn agni-skanDaH / mahAn iva cAmIkara-acala-DaraH / evam eva
   bhagavān bhāṣate tapati virocate sahadarśanād eva vaiśālikā licchavayo	BagavAn BAzate tapati virocate saha-darSanAt eva vESAlikAH licCavayaH-
   bhagavato 'ntike cetāṃsi prasādayāmāsuḥ //	BagavataH antike cetAMsi prasAdayAmAsuH //
   te prasannacittā yena mārgeṇa bhagavān vaiśālīṃ mahānagarīṃ praviśati taṃ	te prasanna-cittAH yena mArgeNa BagavAn vESAlIm mahA-nagarIm praviSati tam
   mārgaṃ śodhayanti sma / saṃmārjayanti sma / puṣpāvakīrṇaṃ ca vareṇyaṃ	mArgam SoDayanti sma / saMmArjayanti sma / puzpa-avakIrNam ca vareNyam
   kurvanti sma /	kurvanti sma /
   ucchritavicitrapaṭṭadāmaghaṇṭāchatradhvajapatākānānāgandhāni dhūpitaṃ	ucCrita-vicitra-pawwa-dAma-GaNwA-Catra-Dvaja-patAkA-nAnAganDAni DUpitam
   kṛtvā yena bhagavāṃs tenopasaṃkrāmanti sma / upasaṃkramya bhagavataḥ	kRtvA yena BagavAn tena-upasaMkrAmanti sma / upasaMkramya BagavataH
   pādayoḥ śirāṃsi nipātayanti //	pAdayoH SirAMsi nipAtayanti //
   (Msp 23)	(Msp 23)
   atha bhagavān sahasrāracakraruciracaraṇavilikhitatalena	aTa BagavAn sahasrAra-cakra-rucira-caraNa-viliKita-talena
   padmabimbagarbhasūkumāreṇa pūrvasucaritalakṣaṇopacitena	padma-bimba-garBa-sUkumAreNa pUrva-su-carita-lakzaNa-upacitena
   taruṇadivākarakiraṇātirekaprabheṇa / prasṛtabahuraśmiśatasahasranirmalena	taruNa-divAkara-kiraNa-atireka-praBeNa / prasRta-bahu-raSmi-Sata-sahasra-nirmalena
   kareṇa teṣāṃ licchavīnāṃ śirāṃśi parimārjyotthāpya samanuśāsayati sma //	kareNa tezAm licCavInAm SirAMSi parimArjya-utTApya samanuSAsayati sma //
   mā bhaiṣṭha mā bhaiṣṭha āryā ethāham abhyāgato yuṣmākam evānukaṃpām	mA BEzWa mA BEzWaH AryAH eTa-aham aByAgataH yuzmAkam eva-anukaMpAm
   upādāya anuttaraṃ jñānam abhisaṃbuddho 'smi / sarvasatvānāṃ ca hitāya	upAdAya anuttaram jQAnam aBisaMbudDaH asmi / sarva-satvAnAm ca hitAya
   sukhāya //	suKAya //
   atha bhagavān vaiśālīm mahānagarīṃ praviśya madhyame yāme indrakīlam	aTa BagavAn vESAlIm mahA-nagarIm praviSya maDyame yAme indrakIlam
   avaṣṭabhya caturdiśam avalokya suvarṇavarṇabāhuṃ prasāryottarāsaṅgaṃ	avazwaBya caturdiSam avalokya suvarNa-varNa-bAhum prasArya-uttarAsaFgam
   vicaritvovāca / ye kecit paścime kāle paścime samaye sarṣapaphalamātraṃ	vicaritvA-uvAca / ye kecid paScime kAle paScime samaye sarzapa-Pala-mAtram
   tathāgatasya śarīradhātuṃ pūjayiṣyanti / imāṃ ca mahāsāhasrapramardanīṃ	taTAgatasya SarIra-DAtum pUjayizyanti / imAm ca mahA-sAhasra-pramardanIm
   vidyārājñīṃ sarvagrahaparimocanīyaṃ dharmaparyāyaṃ gaṅgāsikatāprakhyānāṃ	vidyA-rAjQIm sarva-graha-parimocanIyam Darma-paryAyam gaFgA-sikatA-praKyAnAm
   tathāgatānām arhatāṃ samyaksaṃbuddhānāṃ buddhamudrāṃ	taTAgatAnAm arhatAm samyaksaMbudDAnAm budDa-mudrAm
   bhikṣubhikṣuṇyupāsakopāsikā udgṛhīṣyanti dhārayiṣyanti vācayiṣyanti	Bikzu-BikzuNI-upAsa-ka-upAsikAH udgRhIzyanti DArayizyanti vAcayizyanti
   deśayiṣyanti paryavāpsyanti / teṣāṃ sarvatra iti	deSayizyanti paryavApsyanti / tezAm sarvatra iti
   bhayopadravopasargopāyāsāvairakalikalahabandhanavigrahavivādā antaśaḥ	Baya-upadrava-upasarga-upAyAsA-vEra-kalika-laha-banDana-vigraha-vivAdAH antaSas-
   paiśūnyapāpakā akuśalā duḥkhadharmā na kramiṣyanti / ajayāś ca bhaviṣyanti	pESUnya-pApakAH akuSalAH duHKa-DarmAH na kramizyanti / ajayAH ca Bavizyanti
   sarvaviheṭhakebhyaḥ //	sarva-viheWakeByaH //
   evam ukte brahmā sahāpatir bhagavantam etad avocat /	evam ukte brahmA sahApatiH Bagavantam etat avocat /
   katamā ca sā bhadanta bhagavan mahāsāhasrapramardanī nāma vidyārājñī	katamA ca sA Badanta Bagavat mahAsAhasrapramardanI nAma vidyA-rAjQI
   sarvagrahaparimocanīyaṃ dharmaparyāyaṃ gaṅgāsikatāprakhyānāṃ tathāgatānāṃ	sarva-graha-parimocanIyam Darma-paryAyam gaFgA-sikatA-praKyAnAm taTAgatAnAm
   arhatāṃ samyaksaṃbuddhānāṃ buddhamudrā //	arhatAm samyaksaMbudDAnAm budDa-mudrA //
   evam ukte bhagavān brahmāṇaṃ sahāpatim etad avocat /	evam ukte BagavAn brahmANam sahApatim etat avocat /
   tena hi tvaṃ brahman śṛṇu sādhu ca suṣṭhu ca manasi kuru bhāṣiṣya hanta /	tena hi tvam brahman SRNu sADu ca suzWu ca manasi kuru BAzizya hanta /
   eva bhadanteti brahmā sahāpatir bhagavataḥ pratyaśrauṣīd bhagavāṃs	eva Badanta-iti brahmA sahApatiH BagavataH pratyaSrOzIt BagavAn=-
   tasyaitad avocat /	tasya-etat avocat /
   syād yathedaṃ /	syAt yaTA-idam /
   (Msp 24)	(Msp 24)
   acale macale / sāramacale / prakṛtivarṇa / prakṛtinirghoṣe / samantamukhe	acale macale / sAram-acale / prakRti-varNaH / prakRti-nirGoze / samanta-muKe
   / sthire sthāvare / vighuṣṭaśabde / pragalane / pāraṅgame / sāravarṇe /	/ sTire sTAvare / viGuzwa-Sabde / pragalane / pAraFgame / sAra-varNe /
   sāraṅgavate / bale / mahābale / mahānirbhāse svāhā //	sAraFgavate / bale / mahA-bale / mahAnirBAse svAhA //
   tatredam ucyate kāyagatānusmṛtiḥ śamathavipaśyane / trayaḥ samādhayaḥ /	tatra-idam ucyate kAya-gata-anusmRtiH SamaTa-vipaSyane / trayaH samADayaH /
   catvāro ṛddhipādāḥ / catvāri samyakprahāṇāni / catvāri smṛtyupasthānāni /	catvAraH RdDi-pAdAH / catvAri samyak-prahANAni / catvAri smRti-upasTAnAni /
   catvāri dhyānāni / catvāry āryasatyāni / pañcendriyāṇi / pañcabalāni /	catvAri DyAnAni / catvAri Arya-satyAni / paQca-indriyANi / paQca-balAni /
   ṣaḍanusmṛtayaḥ / saptabodhyaṅgāni / āryāṣṭāṅgā mārgāḥ /	zaz-anusmRtayaH / sapta-boDi-aFgAni / Arya-azwa-aFgAH mArgAH /
   navānupūrvavihārasamāpattayaḥ / daśatathāgatabalāni /	nava-anupUrva-vihAra-samApattayaH / daSa-taTAgata-balAni /
   ekādaśavimuktāyatanāni / dvādaśāṅgapratītyasamutpādaḥ /	ekAdaSa-vimukta-AyatanAni / dvAdaSa-aFga-pratItyasamutpAdaH /
   dvādaśakāradharmacakram / ṣoḍaśākāra anāyānānusmṛtiḥ /	dvAdaSa-kAra-Darma-cakram / zoxaSa-AkAra anAyAna-anusmRtiH /
   aṣṭādaśāveṇikābuddhadharmāḥ / dvācatvāriṃśadakṣarāṇi / iyaṃ sā brahman	azwAdaSa-aveNikA-budDa-DarmAH / dvAcatvAriMSat-akzarANi / iyam sA brahman
   mahāsāhasrapramardanī nāma mahāvidyārājñī sarvagrahaparimocanīyaṃ sūtraṃ	mahAsAhasrapramardanI nAma mahAvidyA-rAjQI sarva-graha-parimocanIyam sUtram
   gaṅgāsikatāprakhyānāṃ tathāgatānāṃ arhatāṃ samyaksaṃbuddhānāṃ buddhamudrā	gaFgA-sikatA-praKyAnAm taTAgatAnAm arhatAm samyaksaMbudDAnAm budDamudrA
   / buddhanirhāraḥ / dharmanirhāraḥ / saṃghanirhāraḥ / brahmanirhāraḥ /	/ budDa-nirhAraH / Darma-nirhAraH / saMGa-nirhAraH / brahma-nirhAraH /
   indranirhāraḥ / lokapālanirhāraḥ / īśvaranirhāraḥ / satyanirhāraḥ /	indra-nirhAraH / lokapAla-nirhAraH / ISvara-nirhAraH / satya-nirhAraH /
   mārganirhāraḥ / pratītyasamutpādanirhāraḥ / candranirhāraḥ / sūryanirhāraḥ	mArga-nirhAraH / pratItyasamutpAda-nirhAraH / candra-nirhAraH / sUrya-nirhAraH
   / grahanakṣatranirhāraḥ //	/ graha-nakzatra-nirhAraH //
   syād yathedam /	syAt yaTA-idam /
   śāle kasine / vidharaṇi / varāgrasāre / amarṣaṇi / amoghavate / secane	SAle kasine / viDaraNi / vara-agra-sAre / amarzaNi / amoGavate / secane
   nakāli / kāsivare / bharaṇe / karakasakhe / samantaprāpte / sāraprāpte /	na-kAli / kAsi-vare / BaraNe / karaka-saKe / samanta-prApte / sAra-prApte /
   stambhaprāpte / vajradhare svāhā //	stamBa-prApte / vajraDare svAhA //
   atha bhagavāṃs tasyāṃ velāyām imāṃ gāthām abhāṣata /	aTa BagavAn tasyAm velAyAm imAm gATAm aBAzata /
   imasmin lokeṣv imasmin vā punaḥ svargeṣu vā ratnavarāṇi santi /	imasmin lokezu imasmin vA punar svargezu vA ratna-varANi santi /
   samo 'sti naiveha tathāgatena devātidevena narottamena //	samaH asti na-eva-iha taTAgatena deva-atidevena nara-uttamena //
   tasmād idaṃ ratnavaraṃ praṇītam etena satyena ihāstu svasti /	tasmAt idam ratna-varam praNItam etena satyena iha-astu svasti /
   kṣayo virāgo hy amṛtaṃ tv asaṃskṛtam ājñāya sauśākyamuniprabhāvitaḥ //	kzayaH virAgaH hi amRtam tu asaMskRtam AjQAya sOSAkya-muni-praBAvitaH //
   dharmeṇa tena na samo 'sti kaścid amṛtena śāntena asaṃśkṛtena /	DarmeNa tena na samaH asti kaScid amRtena SAntena asanSkRtena /
   (Msp 25)	(Msp 25)
   tasmād idaṃ ratnavaraṃ praṇītam etena satyena ihāstu svasti //	tasmAt idam ratna-varam praNItam etena satyena iha-astu svasti //
   yac chreṣṭham iṣṭaṃ vidhivatprakāśitaṃ śāstā sadānuttarayogavāhakam /	yat SrezWam izwam viDivat-prakASitam SAstA sadA-anuttara-yogavAhakam /
   samādhinā tena samo na vidyate vajropamenādvayamārgadarśinā //	samADinA tena samaH na vidyate vajra-upamena-advaya-mArga-darSinA //
   tasmād idaṃ ratnavaraṃ praṇītam etena satyena ihāstu svasti /	tasmAt idam ratna-varam praNItam etena satyena iha-astu svasti /
   aṣṭau mahāpudgalaye praśastāḥ khyātāni catvāri yugāni caiva //	azwO mahA-pudgalaye praSastAH KyAtAni catvAri yugAni ca-eva //
   te dakṣiṇīyā sugatena gītā maharṣiṇā hy apratipudgalena /	te dakziNIyA sugatena gItAH mahA-RziNA hi apratipudgalena /
   ebhyaḥ pradānaṃ bhavate mahāphalaṃ bījāni nyastāni yathā sukṣetre //	eByaH pradAnam Bavate mahA-Palam bIjAni nyastAni yaTA su-kzetre //
   idaṃ praṇītaṃ varasaṃgharatnam etena satyena ihāstu svasti /	idam praNItam vara-saMGa-ratnam etena satyena iha-astu svasti /
   ye suprasannāmanasā dṛḍhena upasaṃkramī gautamaśāsanaṃ hi //	ye su-prasanna-AmanasA dRXena upasaMkramI gOtama-SAsanam hi //
   te prāptiprāptā amṛtaṃ vigāhya tamonudā nirvṛtim āpnuvanti /	te prApti-prAptAH amRtam vigAhya tamonudAH nirvRtim Apnuvanti /
   idaṃ praṇītaṃ varasaṃgharatnam etena satyena ihāstu svasti //	idam praNItam vara-saMGa-ratnam etena satyena iha-astu svasti //
   sahasrayogād iha darśanasya trayaḥ prahīṇā yugapat kileśāḥ /	sahasra-yogAt iha darSanasya trayaH prahINAH yugapad kila-ISAH /
   satkāyadṛṣṭir vicikitsā ca śīlaṃ vrataṃ darśanam āryatā ca //	satkAya-dRzwiH vicikitsA ca SIlam vratam darSanam Arya-tA ca //
   idaṃ praṇītaṃ varasaṃgharatnam etena satyena ihāstu svasti /	idam praNItam vara-saMGa-ratnam etena satyena iha-astu svasti /
   na jātu kuryāt trividhaṃ hi pādaṃ kāyena vācā manasātha vāpi //	na jAtu kuryAt triviDam hi pAdam kAyena vAcA manasA-aTa vA-api //
   prachādanīyaṃ sahasā na kṛtvā yathā na dṛṣṭir grahaṇena teṣām /	praCAdanIyam sahasA na kRtvA yaTA na dRzwiH grahaNena tezAm /
   idaṃ praṇītaṃ varasaṃgharatnam etena satyena ihāstu svasti //	idam praNItam vara-saMGa-ratnam etena satyena iha-astu svasti //
   yathendrakīlapṛthivīpratiṣṭhitā caturdiśaṃ vāyubhir apy akampya /	yaTA-indrakIla-pRTivI-pratizWitA caturdiSam vAyuBiH api akampya /
   tathopamā pudgalāḥ santi saṃghe yā āryamārgasya darśinaḥ //	taTA-upamA pudgalAH santi saMGe yAH Arya-mArgasya darSinaH //
   idaṃ praṇītaṃ varasaṃgharatnam etena satyena ihāstu svasti /	idam praNItam vara-saMGa-ratnam etena satyena iha-astu svasti /
   ya āryasatyāni vibhāvayanti gambhīraprajñena sudeśitāni //	yaH Arya-satyAni viBAvayanti gamBIra-prajQena su-deSitAni //
   kāyapradānaṃ ca manasy akṛtvā na te bhayaṃ kaṣṭam avāpnuvanti /	kAya-pradAnam ca manasi akRtvA na te Bayam kazwam avApnuvanti /
   (Msp 26)	(Msp 26)
   idaṃ praṇītaṃ varasaṃgharatnam etena satyena ihāstu svasti //	idam praNItam vara-saMGa-ratnam etena satyena iha-astu svasti //
   arcir yathā vāyuvaśād vinaṣṭā astaṃgatā naiva upeti saṃkṣā /	arciH yaTA vAyu-vaSAt vinazwAH astaMgatA na-eva upa-iti saMkzAH /
   tathaiva samyojanaviprayuktā adarśanaṃ yānti hi buddhaputrā //	taTA-eva samyojana-viprayuktAH adarSanam yAnti hi budDa-putrAH //
   idaṃ praṇītaṃ varasaṃgharatnam etena satyena ihāstu svasti /	idam praNItam vara-saMGa-ratnam etena satyena iha-astu svasti /
   ye jaṅgamāś cātra tathaiva sthāvarās te sarvasatvāḥ sukhino bhavantu //	ye jaFgamAH ca-atra taTA-eva sTAvarAH te sarva-satvAH suKinaH Bavantu //
   śāstāram agryaṃ naradevapūjyaṃ buddhaṃ namasyetha ihāstu svasti /	SAstAram agryam naradeva-pUjyam budDam namasyeTa iha-astu svasti /
   ye jaṅgamāś cātra tathaiva sthāvarās te sarvasatvāḥ sukhino bhavantu //	ye jaFgamAH ca-atra taTA-eva sTAvarAH te sarva-satvAH suKinaH Bavantu //
   śāntaṃ virāgaṃ naradevapūjyaṃ dharmaṃ namasyetha ihāstu svasti /	SAntam virAgam naradeva-pUjyam Darmam namasyeTa iha-astu svasti /
   ye jaṅgamāś cātra tathaiva sthāvarās te sarvasatvāḥ sukhino bhavantu //	ye jaFgamAH ca-atra taTA-eva sTAvarAH te sarva-satvAH suKinaH Bavantu //
   gaṇānam agryaṃ naradevapūjyaṃ saṃghaṃ namasyetha ihāstu svasti /	gaNAnam agryam naradeva-pUjyam saMGam namasyeTa iha-astu svasti /
   yānīha bhūtāni samāgatāni sthitāni bhūmāv atha vāntarīkṣe //	yAni-iha BUtAni samAgatAni sTitAni BUmO aTa vA-antarIkze //
   kurvantu maitrī satataṃ prajāsu divā ca rātrau ca carantu dharmam /	kurvantu mEtrI satatam prajAsu divA ca rAtrO ca carantu Darmam /
   yenaiva satyena jino jitāriḥ sa satyavādī ripus tasya nāsti //	yena-eva satyena jinaH jita-ariH sa satya-vAdI ripuH tasya na-asti //
   tenaiva satyena ihāstu svasti mucyantu sarve 'dya mahābhayebhyaḥ svāhā //	tena-eva satyena iha-astu svasti mucyantu sarve adya mahA-BayeByaH svAhA //
   syād yathedam //	syAt yaTA-idam //
   dhire dhidhire / balanirghoṣe / balasāre / sāravate / stute /	Dire DiDire / bala-nirGoze / balasAre / sAravate / stute /
   prabhūtaprāpte / āradhe / āraghoṣe / sāravati / acyute / balavate /	praBUta-prApte / AraDe / Ara-Goze / sAravati / acyute / balavate /
   śūraprāpte / sāraṃgame / sūryagame / sūryanirghoṣe svāhā //	SUra-prApte / sAraMgame / sUrya-game / sUrya-nirGoze svAhA //
   iyaṃ sā mahābrahman mahāsāhasrapramardanī nāma vidyārājñī	iyam sA mahA-brahman mahAsAhasrapramardanI nAma vidyA-rAjQI
   sarvagrahaparimocanīyaṃ sūtraṃ gaṅgāsikatāprakhyānāṃ tathāgatānām arhatāṃ	sarva-graha-parimocanIyam sUtram gaFgA-sikatA-praKyAnAm taTAgatAnAm arhatAm
   samyaksaṃbuddhānāṃ buddhamudrā / buddhapadā / dharmapadā / saṃghapadā /	samyaksaMbudDAnAm budDa-mudrA / budDa-padA / Darma-padA / saMGapadA /
   brahmapadā / indrapadā / lokapālapadā / (Msp 27) īśvarapadā / mahārṣipadā	brahma-padAH / indra-padAH / lokapAla-padA / (Msp 27) ISvara-padA / mahA-rzipadA
   / paryarthipadā / āyatipadā / akṣipadā / hetupadā / pradeśapadā /	/ paryarTi-padA / Ayati-padAH / akzipadA / hetu-padA / pradeSa-padAH /
   nirdeśapadā / abhisaṃbuddhapadā / samyaksaṃbuddhaiś ca pratyekabuddhaiś ca	nirdeSa-padA / aBisaMbudDa-padA / samyaksaMbudDEH ca pratyekabudDEH ca
   sparśitā / śrāvakair adhiṣṭhitā / brahmabhiḥ praśaṃsitā / indreṇa pūjitā /	sparSitA / SrAvakEH aDizWitA / brahmaBiH praSaMsitA / indreNa pUjitAH /
   lokapālair namaskṛtā / īśvareṇa pūjitā / sarvadevair varṇitā / yogācārair	lokapAlEH namaskRtA / ISvareNa pUjitA / sarva-devEH varNitA / yoga-AcArEH-
   abhinanditā / ṛṣibhir alaṃkṛtā / brahmabhir abistutā / devatābhiś cintitā	aBinanditA / RziBiH alaMkRtA / brahmaBiH abistutA / devatABiH cintitA
   / snātakaiḥ praśaṃsitā / cāturvarṇena lokena / gocaraḥ sarvabuddhānām /	/ snAtakEH praSaMsitA / cAturvarNena lokena / gocaraH sarva-budDAnAm /
   udyānaṃ pratyekabuddhānām / niryāṇaṃ śrāvakānām / āśrayo yogācārāṇām /	udyAnam pratyekabudDAnAm / niryANam SrAvakAnAm / ASrayaH yoga-AcArANAm /
   ākaro bodhipakṣāṇāṃ dharmāṇām / pravāhanaṃ saṃkleśānām / utpāṭanam	AkaraH boDi-pakzANAm DarmANAm / pravAhanam saMkleSAnAm / utpAwanam
   anuśayaśalyānām / saṃdarśanaṃ mokṣadvārāṇām / bhedanaṃ satkāyadṛṣṭīnām /	anuSaya-SalyAnAm / saMdarSanam mokza-dvArANAm / Bedanam sat-kAya-dRzwInAm /
   prapātanaṃ mānaparvatasya / vivaraṇam āryamārgasya / pithanaṃ	prapAtanam mAna-parvatasya / vivaraNam Arya-mArgasya / piTanam
   mokṣadvārāṇām / saṃśoṣaṇaṃ saṃsārasamudrasya / uccālanaṃ	mokza-dvArANAm / saMSozaNam saMsAra-samudrasya / uccAlanam
   sarvasaṃsārapatitānām asthiparvatānām / cchedanī mārapāśasya / uttrāsanī	sarva-saMsAra-patitAnAm asTi-parvatAnAm / cCedanI mAra-pASasya / uttrAsanI
   māraparṣadaḥ / udgilanī mārabaḍiśasya / uttrāsanī kleśasaṃgrāmāt /	mAra-parzadaH / udgilanI mAra-baxiSasya / uttrAsanI kleSa-saMgrAmAt /
   praveśanī nirvāṇanagare / niṣkrāmaṇī saṃsāragṛhād iti //	praveSanI nirvANa-nagare / nizkrAmaNI saMsAra-gRhAt iti //
   syād yathedam /	syAt yaTA-idam /
   khaṅge / khaṅgaghoṣe / uṣodhane / sārathiprabhede / vipulaprabhe /	KaFge / KaFga-Goze / uzoDane / sAraTi-praBede / vipula-praBe /
   saṃkarṣaṇi / vikarṣaṇi / viṣāgravati / śuddhasādhane / varuṇavate / vāśane	saMkarzaNi / vikarzaNi / viza-agravati / SudDa-sADane / varuNavate / vA-aSane
   / vibhūṣaṇi / viṣaṃgame / paśupati / puṣpagarbhe / svasty astu mama	/ viBUzaNi / vizaMgame / paSupati / puzpa-garBe / svasti astu mama
   sarvasatvānāṃ ca sarvabhayopadravopasargopāyāsebhyaḥ svāhā //	sarva-satvAnAm ca sarva-Baya-upadrava-upasarga-upAyAseByaH svAhA //
   iyaṃ sā mahābrahman mahāsāhasrapramardanī nāma vidyārājñī	iyam sA mahA-brahman mahAsAhasrapramardanI nAma vidyA-rAjQI
   sarvagrahapramocanīyaṃ sūtraṃ gaṅgāsikatāprakhyānāṃ tathāgatānām arhatāṃ	sarva-graha-pramocanIyam sUtram gaFgA-sikatA-praKyAnAm taTAgatAnAm arhatAm
   samyaksaṃbuddhānāṃ buddhamudrā / yayā mudrayā mudritaḥ sadevamānuṣāsuro	samyaksaMbudDAnAm budDa-mudrA / yayA mudrayA mudritaH sa-deva-mAnuza-asuraH-
   loko 'nuttaranirvāṇapuraṃ praviṣṭaḥ / yasya cārthāya gaṅgāsikatāprakhyaiḥ	lokaH anuttara-nirvANa-puram pravizwaH / yasya ca-arTAya gaFgA-sikatA-praKyEH
   samyaksaṃbuddaiḥ pratyekabuddhaiḥ śrāvakaiś ca pūrvābhisaṃbuddhaiḥ	samyaksaMbuddEH pratyekabudDEH SrAvakEH ca pUrva-aBisaMbudDEH
   samyaksaṃbuddhāḥ pratyekabuddhāḥ śrāvakāś ca mātāpitṛdakṣiṇīyā	samyaksaMbudDAH pratyekabudDAH SrAvakAH ca mAtA-pitR-dakziNIyA
   gurusthānīyāḥ paryupāsitā brahmacaryaṃ cīrṇaṃ śīlaṃ rakṣitaṃ (Msp 28)	guru-sTAnIyAH paryupAsitAH brahmacaryam cIrNam SIlam rakzitam (MsB 28)
   dānaṃ dattaṃ kṛpā pāramitā paripūriḥ / sādhitā bodhisatvacaryā sādhitā	dAnam dattam kRpA pAramitA paripUriH / sADitA boDisatva-caryA sADitA
   bodhiprāptiprāptā sarvajñatā parājito māraḥ //	boDi-prApti-prAptA sarvajQa-tA parAjitaH mAraH //
   atha brahmā sahāpatiḥ śakraś ca devānām indraś catvāraś ca mahārājāna	aTa brahmA sahApatiH SakraH ca devAnAm indraH catvAraH ca mahA-rAjAna
   ekavāgekamataikasvarā bhagavantaṃ namasyamānā ūcuḥ //	eka-vAc-eka-mata-eka-svarAH Bagavantam namasyamAnAH UcuH //
   aho vidyā mahāvidyā mahāsāhasrapramardanī //	aho vidyA mahAvidyA mahA-sAhasra-pramardanI //
   ārakṣā sarvasatvānāṃ buddhamudrāś caturdiśam /	ArakzA sarva-satvAnAm budDa-mudrAH caturdiSam /
   mudrāṃ vayaṃ pradāsyāmaḥ sūtre sāhasrapramardane //	mudrAm vayam pradAsyAmaH sUtre sAhasra-pramardane //
   trāsenti sarvabhūtāni mudrayā mudritāyayā /	trAsenti sarva-BUtAni mudrayA mudritAyayA /
   ye manuṣyā praduṣṭāś ca trasannāś cātra śāsane //	ye manuzyAH praduzwAH ca trasannAH ca-atra SAsane //
   teṣāṃ daṇḍaṃ praṇeṣyāmi vidyāṃ brahmeṇa nirmitām /	tezAm daNxam praNezyAmi vidyAm brahmeNa nirmitAm /
   śakreṇa dhāritā mudrā lokapālaiś ca mudritāḥ //	SakreNa DAritAH mudrAH lokapAlEH ca mudritAH //
   syād yathedam /	syAt yaTA-idam /
   kaliṅge / bhārade / jūdagre / jāmale / siṃhamade / sārāgraprāpte /	kaliFge / BArade / jUdagre / jAmale / siMha-made / sAra-agra-prApte /
   haṃsagāmini / mālini / hule mihule / pihule 2 pihulame haham haham haham	haMsa-gAmini / mAlini / hule mihule / pihule 2 pihulame haham haham haham
   haham / sūdani varāgravati / hastine / necaramati / caṇḍāli / carame /	haham / sUdani vara-agravati / hastine / necaram-ati / caNxAli / carame /
   carācare svāhā //	carAcare svAhA //
   asyāṃ khalu punar mahāsāhasrapramardanyāṃ vidyārājñyāṃ bhāṣyamānāyām ayaṃ	asyAm Kalu punar mahA-sAhasra-pramardanyAm vidyA-rAjQyAm BAzyamAnAyAm ayam
   trisāhasramahāsahasro lokadhātuḥ ṣaḍadhikāram akampat / dikṣu vidikṣu	tri-sAhasra-mahA-sahasraH lokaDAtuH zaz-aDikAram akampat / dikzu vidikzu
   bhūtāśatair yakṣarākṣasair nirnādaḥ prakruṣṭaghoṣaṃ codghoṣayanti sma //	BUtASatEH yakza-rAkzasEH nirnAdaH prakruzwa-Gozam ca-udGozayanti sma //
   aho duḥkhamaho kaṣṭaṃ naṣṭā bhūtagaṇā vayam /	aho duHKam-aho kazwam nazwA BUta-gaNAH vayam /
   vinaṣṭā bhūtasaṃghās tā vaśanītāś ca sarvathā //	vinazwAH BUta-saMGAH tAH vaSanItAH ca sarvaTA //
   avaśāḥ prāṇibhūtānāṃ sarveṣām adya saṃvarāḥ /	avaSAH prANi-BUtAnAm sarvezAm adya saMvarAH /
   te ca bhūmau nipīḍanti saṃprapadyanti duḥkhitāḥ //	te ca BUmO nipIxanti saMprapadyanti duHKitAH //
   atha bhagavāṃs tāṃ bhūmīṃ vajramayīm abhinirmimīte /	aTa BagavAn tAm BUmIm vajra-mayIm aBinirmimIte /
   te caturdiśaṃ prapalāyanti atha catvāro mahārājānaḥ //	te caturdiSam prapalAyanti aTa catvAraH mahA-rAjAnaH //
   caturdiśaṃ mahān agnijvālāskandham abhinirmitavantaḥ /	caturdiSam mahAn agni-jvAlA-skanDam aBinirmitavantaH /
   te cākāśe paridhāvanti //	te ca-AkASe pariDAvanti //
   atha brahmā sahāpatir ayomayam ākāśam abhinirmimīte / te (Msp 29) ca	aTa brahmA sahApatiH ayaH-mayam AkASam aBinirmimIte / te (MsB 29) ca
   saptatālamātraṃ vaihāyasaṃ paridhāvanti / atha śakro devānām indro	sapta-tAla-mAtram vEhAyasam pariDAvanti / aTa SakraH devAnAm indraH-
   'siśaraśaktikuntatomaravṛkṣaparvatavṛṣṭīr abhipravarṣati / tena ca	asi-Sara-Sakti-kunta-tomara-vRkza-parvata-vRzwIH aBipravarzati / tena ca
   samayena samantataḥ sahāyāṃ lokadhātau pañcayakṣaśatasahasrāṇi	samayena samantataH sahAyAm lokaDAtO paQca-yakza-Sata-sahasrANi
   sannipatitāni vidyāśāpahatāni jvarāveśonmattāni vipīḍanti / bhagavataḥ	sannipatitAni vidyA-Sa-apa-hatAni jvara-AveSa-unmattAni vipIxanti / BagavataH
   pādayoḥ śirāṃsi nipatyābruvan //	pAdayoH SirAMsi nipatya-abruvan //
   sarvasatvahitānukampī śramaṇo gautama /	sarva-satva-hita-anukampI SramaNaH gOtamaH /
   trāyatu naḥ śramaṇo gautama //	trAyatu naH SramaNaH gOtamaH //
   atha bhagavāṃs tān guhyakān maitryā spharanti sma / śikṣāgrahaṇaṃ ca	aTa BagavAn tAn guhyakAn mEtryA sParanti sma / SikzA-grahaNam ca
   kārayāmāsa /	kArayAmAsa /
   yā gatir mātṛghāṭīnāṃ pitṛghāṭīnāṃ ca yā gatiḥ /	yA gatiH mAtR-GAwInAm pitR-GAwInAm ca yA gatiH /
   arhatāṃ ghāṭakasyāpi saṃghabhedī ca yā gatiḥ //	arhatAm GAwakasya-api saMGa-BedI ca yA gatiH //
   saṃbuddhaduṣṭacittasya lohitotpādakasya ca /	saMbudDa-duzwa-cittasya lohita-utpAdakasya ca /
   tāṃ gatiṃ pratipadyema yadi mudrāṃ kṣipemahi //	tAm gatim pratipadyema yadi mudrAm kzipemahi //
   saptadhāsya sphuṭo mūrdhā arjakasyeva mañjarī /	saptaDA-asya sPuwaH mUrDA arjakasya-iva maQjarI /
   saṃmṛṣṭā yakṣarogeṇa citragātrā bhavemahi //	saMmRzwA yakza-rogeNa citra-gAtrA Bavemahi //
   sāhasrapramardanīsūtraṃ yad idaṃ jinabhāṣitam /	sAhasra-pramardanI-sUtram yat idam jina-BAzitam /
   vidyārājñīm abhikramya vartema svecchayā vayam //	vidyA-rAjQIm aBikramya vartema sva-icCayA vayam //
   tena ca samayena vaiśālyāṃ mahānagaryāṃ sarve iti	tena ca samayena vESAlyAm mahA-nagaryAm sarve iti
   bhayopadravopasargopāyāsāḥ pratiprasrabdhāḥ / yakṣarākṣasamanuṣyāmanuṣyāḥ	Baya-upadrava-upasarga-upAyAsAH pratiprasrabDAH / yakza-rAkzasa-manuzya-amanuzyAH
   svakasvakaṃ gocaram atikrāntāḥ / vaiśālakā licchavayaś ca	svaka-svakam gocaram atikrAntAH / vESAlakAH licCavayaH ca
   sarvarogavyādhibhyo vinirmuktāḥ sarvasukhasamarpitā buddhe 'vetya	sarva-roga-vyADiByaH vinirmuktAH sarva-suKa-samarpitAH budDe avetya
   prasādena samanvāgatā babhūvuḥ / dharme 'vetya prasādena samanvāgatā	prasAdena samanvAgatAH baBUvuH / Darme avetya prasAdena samanvAgatA
   babhūvuḥ / satatasamitaṃ ratnatrayapūjābhiratā mahotsavena viharantaḥ /	baBUvuH / satata-samitam ratnatraya-pUjA-aBiratAH mahA-utsavena viharantaH /
   haṃsaśukaśārikākokilamayūracakravākakunārajīvañjīvakapakṣigaṇā madhuraṃ	haMsa-Suka-SArikA-kokila-mayUra-cakravAka-kunAra-jIvaQjIvaka-pakzi-gaNAH maDuram
   nikūjanti sma / vigatakāyapīḍāḥ sāṃsara iva kinnarāḥ / aghāṭitāni	nikUjanti sma / vigata-kAya-pIxAH sAMsaraH iva kinnarAH / aGAwitAni
   ratnabhājanāni raṇanti sma / bherīśaṅkhamṛdaṅgapaṇavavīṇāveṇavaś ca yathā	ratna-BAjanAni raNanti sma / BerI-SaFKa-mRdaFga-paNava-vINO=-eNavaH ca yaTA
   sthāne sthāpitā eva pravādyanti sma /	sTAne sTApitAH eva pravAdyanti sma /
   dāḍimabilvāmalanyagrodhāśvatthaprakṣakapitthodumbaraśālatālatamālatilakacampakavṛkṣā	dAxima-bilva-amala-nyagroDa-aSvatTa-prakza-kapitTa-udumbara-SAla-tAla-tamAla-tilaka-campaka-vRkzA
   nānāgandhān pramuñcanti sma / devatāsahasraiś ca hīhīkārapramuktaḥ /	nAnA-ganDAn pramuQcanti sma / devatA-sahasrEH ca hi-ihIkAra-pramuktaH /
   antarīkṣāc ca (Msp 30) puṣpavarṣam abhipraviṣṭam / amānuṣaś ca gandho loke	antarIkzAt ca (MsB 30) puzpa-varzam aBipravizwam / amAnuzaH ca ganDaH loke
   prādurbhūtaḥ //	prAdurBUtaH //
   atha catvāro mahārājānaḥ prāñjalayo bhagavantam etad avocat /	aTa catvAraH mahA-rAjAnaH prAQjalayaH Bagavantam etat avocat /
   idaṃ bhadanta bhagavan mahāsāhasrapramardanī sūtrarājaṃ	idam Badanta Bagavat mahA-sAhasra-pramardanI sUtrarAjam
   sarvagrahapramocanīyaṃ buddhamudrā dharmaparyāyam / yaḥ kaścic chikṣāpadaṃ	sarva-graha-pramocanIyam budDamudrA Darma-paryAyam / yaH kaScid SikzA-padam
   parigṛhītvā kāśāyadhārī udgṛhya dhārayitvā vācayitvā deśayitvā paryavāpya	parigRhItvA kASAya-DArI udgRhya DArayitvA vAcayitvA deSayitvA paryavApya
   likhitvā granthayitvā dhārayiṣyati / tasya sarve iti	liKitvA granTayitvA DArayizyati / tasya sarve iti
   bhayopadravopasargopāyāsāvairakalikalahabhaṇḍanavivādā yāvat paiśūnyakā	Baya-upadrava-upasarga-upAyAsA-vEra-kalika-laha-BaNxana-vivAdA yAvat pESUnyakA
   akuśalā dharmā nābhikramiṣyanti / ajayaś ca bhaviṣyanti	akuSalAH DarmAH na-aBikramizyanti / ajayaH ca Bavizyanti
   sarvaviheṭhakebhyaḥ / tena rāṣṭrasya sīmābandhayitukāmena susnātena	sarva-viheWakeByaH / tena rAzwrasya sImAbanDayitu-kAmena su-snAtena
   triśuklabhuktena pañcāmiṣaparivarjitena sarvamānuṣaśiṣyāpadaparigṛhītena	triSukla-Buktena paQca-Amiza-parivarjitena sarva-mAnuza-Sizya-Apada-parigRhItena
   sarvasatvasamācittena vastrābharaṇayuktena	sarva-satva-samAcittena vastra-ABaraNa-yuktena
   grāmanagaranigamaśṛṅgāṭakakulāny apagatasaṃkārakūṭāni kṛtvā madhyamāyāṃ	grAma-nagara-nigama-SRFgAwaka-kulAni apagata-saMkAra-kUwAni kRtvA maDyamAyAm
   rājadhānyāṃ puṣpāvakīrṇāṃ dharaṇīṃ kṛtvā nānāgandhā dhūpayitavyā /	rAjaDAnyAm puzpa-avakIrNAm DaraNIm kRtvA nAnA-ganDA DUpayitavyA /
   caturdiśaṃ catasraḥ kanyakāḥ susnātavibhūṣitāḥ śastrahastāḥ sthāpayitavyāḥ	caturdiSam catasraH kanyakAH su-snAta-viBUzitAH Sastra-hastAH sTApayitavyAH
   / catvāro ghaṇṭāś catvāri ratnabhājanāni gandhodakapuṣpaphalaparipūrṇāni	/ catvAraH GaNwAH catvAri ratna-BAjanAni ganDa-udaka-puzpa-Pala-paripUrNAni
   sthāpayitavyāni / pūrvāhṇakālasamaye udgate sahasrakiraṇavidyā	sTApayitavyAni / pUrvAhNa-kAla-samaye udgate sahasrakiraNa-vidyA
   āvartayitavyā / palaṣaṣṭhikayā sūtraṃ kartayitavyaṃ likhitvā cīrikāyāṃ	AvartayitavyA / pala-zazWikayA sUtram kartayitavyam liKitvA cIrikAyAm
   mūrdhni mahācaityeṣu mahāvṛkṣeṣu mahādhvajeṣu cocchrāpayitavyā /	mUrDni mahA-cEtyezu mahA-vRkzezu mahA-Dvajezu ca-ucCrApayitavyA /
   nānāpuṣpair nānāgandhaiś ca pakṣamātraṃ pūjā kartavyā / divase divase	nAnA-puzpEH nAnA-ganDEH ca pakza-mAtram pUjA kartavyA / divase divase
   caikavāraṃ vidyā āvartayitavyā / evaṃ rāṣṭraḥ parimocito bhaviṣyati / evaṃ	ca-eka-vAram vidyA AvartayitavyA / evam rAzwraH parimocitaH Bavizyati / evam
   janapadarājadhānīsthānavihāradevakulakṣatraśālāvṛkṣaphalaharitārāmagośālapaśuśālā	janapada-rAja-DAnI-sTAna-vihAra-deva-kula-kzatra-SAlA-vRkza-Pala-harita-ArAma-goSAla-paSu-SAlA
   apagatasaṃkārāḥ kṛtvā khadirabadarāgniṃ prajvālya puṣpāvakīrṇāṃ dharaṇīṃ	apagata-saMkArAH kRtvA Kadira-badara-agnim prajvAlya puzpa-avakIrNAm DaraNIm
   kṛtvā dvāraśālaśobhanāṃ nānāgandhapradhūpitāṃ kṛtvā sarvabījāni sarpiṣāṃ	kRtvA dvAra-SAla-SoBanAm nAnA-ganDa-praDUpitAm kRtvA sarva-bIjAni sarpizAm
   mrakṣayitvā caturdiśaṃ prakṣeptavyāni / agnau ca prakṣeptavyāni	mrakzayitvA caturdiSam prakzeptavyAni / agnO ca prakzeptavyAni
   nānāraṅgāni ca sūtrāṇi dvāre bandhanīyāni tiryagyonigatāni niṣkāsya punaḥ	nAnA-raFgAni ca sUtrANi dvAre banDanIyAni tiryagyoni-gatAni nizkAsya punar-
   praveśayitavyāni / vidyā cāvartayitavyāni / likhitvā granthayitvā cordhvam	praveSayitavyAni / vidyA ca-AvartayitavyAni / liKitvA granTayitvA ca-UrDvam
   utthāpya pūjanīyā / glānasya purato buddhapratibimbaṃ vā (Msp 31)	utTApya pUjanIyAH / glAnasya puratas budDa-pratibimbam vA (MsB 31)
   buddhaśarīraṃ vā / samudgatemaṃ cevāpīṭhe vāvaropya brahmapratibimbaṃ vā	budDa-SarIram vA / samudgata-imam ca-iva-apIWe vA-avaropya brahma-pratibimbam vA
   śakrapratibimbaṃ vā caturmahārājapratibimbaṃ vā catasro mudrāḥ kṛtvā	Sakra-pratibimbam vA catur-mahA-rAja-pratibimbam vA catasraH mudrAH kRtvA
   sthāpayitavyāḥ / nānāpuṣpair nānādhūpair nānāgandhair	sTApayitavyAH / nAnA-puzpEH nAnA-DUpEH nAnA-ganDEH-
   brahmaśakracaturmahārājamaheśvarayakṣasenāpatir yakṣamahānagnā hārītī ca	brahma-Sakra-catur-mahA-rAja-maheSvara-yakza-senApatiH yakza-mahA-nagnA hArItI ca
   namnā trayāṇāṃ ratnānāṃ pūjā kartavyā / teṣāṃ balenaiśvaryādhipatena ca	namnA trayANAm ratnAnAm pUjA kartavyA / tezAm balena-ESvarya-aDipatena ca
   svasty astu mama sarvasatvānāṃ ca muñcantu sarvaglānāḥ sarvavyādhibhyaḥ /	svasti astu mama sarva-satvAnAm ca muQcantu sarva-glAnAH sarva-vyADiByaH /
   glānasya cānnapānabhaiṣajyam //	glAnasya ca-anna-pAna-BEzajyam //
   upanāmayatā iyaṃ vidyā āvartayitavyā /	upanAmayatA iyam vidyA AvartayitavyA /
   vibuddhabodhau saṃbuddhe lokapālāś caturdiśam //	vibudDa-boDO saMbudDe lokapAlAH caturdiSam //
   bhājanāni samānīya catvāri sugatāya vai /	BAjanAni samAnIya catvAri sugatAya vE /
   dattāni nirmitaś caiko muninā bhājanottamam //	dattAni nirmitaH ca-ekaH muninA BAjana-uttamam //
   gṛhītaṃ pāṇinā śāstā bhaiṣajyam amṛtopamam /	gRhItam pANinA SAstA BEzajyam amRta-upamam /
   etena satyavākyena amṛtaṃ bhavantu auṣadham //	etena satya-vAkyena amRtam Bavantu OzaDam //
   hārītī ca tathā devī gṛhya paśyāṃ tathā śubham /	hArItI ca taTA devI gRhya paSyAm taTA SuBam /
   śāstre dattavatī divyaṃ bhaiṣajyam amṛtopamam //	SAstre dattavatI divyam BEzajyam amRta-upamam //
   etena satyavākyena āturasya rūjāpaham /	etena satya-vAkyena Aturasya rUja-apaham /
   sarvam upahāraṃ cāpi bhavatv amṛtam auṣadham //	sarvam upahAram ca-api Bavatu amRtam OzaDam //
   vipaśyibuddhatejena śikhinaś ca balena ca /	vipaSyi-budDa-tejena SiKinaH ca balena ca /
   viśvabhūsatyavākyena krakucchandasamādhinā //	viSva-BU-satya-vAkyena krakucCanda-samADinA //
   kanakāhvasya jñānena ṛddhyā vai kāśyapasya ca /	kanakAhvasya jQAnena RdDyA vE kASyapasya ca /
   śākyasiṃhasya vīryeṇa bhavatv amṛtam auṣadham //	SAkya-siMhasya vIryeNa Bavatu amRtam OzaDam //
   kṛtvā pūrvāmukhaṃ glānabhaiṣajyam upanāmayet /	kRtvA pUrvAmuKam glAna-BEzajyam upanAmayet /
   imāṃ pāṇitale vidyāṃ tasmin kāle udāharet //	imAm pANi-tale vidyAm tasmin kAle udAharet //
   syād yathedam //	syAt yaTA-idam //
   khaṭe / khaṭavikhaṭe / vimale / vilambe / bale balavate / candre / caraṇe	Kawe / Kawa-viKawe / vimale / vilambe / bale balavate / candre / caraNe
   / amṛtanirghoṣe svāhā //	/ amRta-nirGoze svAhA //
   vātajāḥ pittajā rogāḥ śleṣmajāḥ sannipātajāḥ / nihatāḥ sarvarogāś ca	vAta-jAH pitta-jAH rogAH Slezma-jAH sannipAta-jAH / nihatAH sarva-rogAH ca
   svasty astu mama sarvasatvānāṃ ca sarvadā sarvabhayebhyaḥ svāhā //	svasti astu mama sarva-satvAnAm ca sarvadA sarva-BayeByaH svAhA //
   (Msp 32)	(Msp 32)
   sarvakākhordavetāḍasaṃprayukteṣu karmasu tena puruṣeṇa striyā vā 'horātro	sarva-kAKoH-davetAxa-saMprayuktezu karmasu tena puruzeNa striyAH vA ahorAtraH-
   vapuṣṭena susnātena subhūṣitena puṣpāvakīrṇāṃ nānāgandhapradhūpitāṃ ca	vapuzwena su-snAtena su-BUzitena puzpa-avakIrNAm nAnA-ganDa-praDUpitAm ca
   dharaṇīṃ kṛtvā khadiravadarāgniṃ prajvālya sarvabījāni caturdiśaṃ	DaraNIm kRtvA Kadira-vadara-agnim prajvAlya sarva-bIjAni caturdiSam
   prakṣeptavyāni / nānāraṅgāni ca sūtrāṇi śastreṣu vā śūleṣu vā kunteṣu vā	prakzeptavyAni / nAnA-raFgAni ca sUtrANi Sastrezu vA SUlezu vA kuntezu vA
   kāṇḍeṣu vā granthayitvā bandhanīyāni sarvamūlāni sarvapuṣpāṇi	kANxezu vA granTayitvA banDanIyAni sarva-mUlAni sarva-puzpANi
   nānāgandhodakaṃ kṛtvā mahati kuṇḍe prakṣeptavyāni / yasya kākhordakṛtaṃ	nAnA-ganDa-udakam kRtvA mahati kuNxe prakzeptavyAni / yasya kAKoH-da-kRtam
   bhaviṣyati / tasya taṃ sūtrakam ābandhya kuṇḍe 'dhiṣṭhāpanīyaḥ śastreṇa	Bavizyati / tasya tam sUtrakam AbanDya kuNxe aDizWApanIyaH SastreNa
   taṃ sūtrakaṃ cchitvā agnau prakṣeptavyam / idaṃ ca	tam sUtrakam cCitvA agnO prakzeptavyam / idam ca
   mahāsāhasrapramardanīsūtram udāhartavyam /	mahA-sAhasra-pramardanI-sUtram udAhartavyam /
   buddhāḥ pratyekabuddhāś ca buddhānāṃ śrāvakāś ca ye /	budDAH pratyekabudDAH ca budDAnAm SrAvakAH ca ye /
   brahmendro lokapālāś ca yakṣasenāpatīśvarāḥ //	brahma-indraH lokapAlAH ca yakza-senApati-ISvarAH //
   tathā yakṣanagnā hārītī ca saputrikā /	taTA yakza-nagnA hArItI ca sa-putrikA /
   vīryeṇa tejasā teṣāṃ vetāḍaṃkarma cchidyatu //	vIryeNa tejasA tezAm vetAxaMkarma cCidyatu //
   bhinnanti vajraratnāni vahnir indhanadāhakaḥ /	Binnanti vajra-ratnAni vahniH inDana-dAhakaH /
   vātena śoṣitā meghā bhāskareṇa vanaspatī //	vAtena SozitA meGAH BAskareNa vanaspatI //
   etena satyavākyena kākhordakarma dahatām /	etena satya-vAkyena kAKoH-da-karma dahatAm /
   nānāgandhais tathā puṣpair nirdhūtāḥ sarvapāpakāḥ //	nAnA-ganDEH taTA puzpEH nirDUtAH sarva-pApakAH //
   tadyathā /	tat-yaTA /
   hume 2 kakhali / kharali / jukvini / javale / garage / hariṇi / śāvari	hume 2 kaKali / Karali / jukvini / javale / gara-ge / hariNi / SAvari
   śānti / prasānti svāhā //	SAnti / prasAnti svAhA //
   dhāvani svāhā / pradhāvani svāhā / gāndharve svāhā / palaṅgani svāhā /	DAvani svAhA / praDAvani svAhA / gAnDarve svAhA / palaFgani svAhA /
   sarvakākhordakṛtavetāḍacchedani svāhā //	sarva-kAKorda-kRta-vetAxa=-Cedani svAhA //
   imair mantrapadair mama sarvasatvānāṃ ca	imEH mantra-padEH mama sarva-satvAnAm ca
   sarvakākhordavetāḍauṣadhimantraviṣayogāḥ sarvadevaiś ccheditāḥ parājitāḥ	sarva-kAKoH-davetAxA-ozaDi-mantra-viza-yogAH sarva-devEH cCeditAH parAjitAH
   svāhā //	svAhA //
   galagaṇḍavaisarpātisāronmādagaṇḍapiṭakabhagandaraviṣapītakāt	galagaNxa-vEsarpa-atisAra-unmAda-gaNxa-piwaka-Bagandara-viza-pItakAt
   parimocayitukāmena susnātena subhūṣitena bhadrapīṭhāsananiṣaṇṇena iyaṃ	parimocayitu-kAmena su-snAtena su-BUzitena BadrapIWa-Asana-nizaNNena iyam
   vidyā udāhartavyā /	vidyA udAhartavyA /
   tejasā sarvabuddhānāṃ pratyekajinatejasā /	tejasA sarva-budDAnAm pratyeka-jina-tejasA /
   arhatāṃ caiva vīryeṇa sarveṣāṃ mantradhāriṇām //	arhatAm ca-eva vIryeNa sarvezAm mantra-DAriNAm //
   (Msp 33)	(Msp 33)
   prajñayā śāriputrasya maudgalyasya ca ṛddhiyā /	prajQayA SAriputrasya mOdgalyasya ca RdDiyA /
   cakṣuṣā cāniruddhasya kāśyapasya dhūtair guṇaiḥ //	cakzuzA ca-anirudDasya kASyapasya DUtEH guNEH //
   kauṇḍinyapūrvaprāptyā ca ānandasya śrutena ca /	kONxinya-pUrva-prAptyA ca Anandasya Srutena ca /
   maitryā vai brahmaṇā caiva aiśvaryeṇa śatakratoḥ //	mEtryA vE brahmaNA ca-eva ESvaryeNa SatakratoH //
   viṣayair lokapālānāṃ maheśvarabalena ca /	vizayEH lokapAlAnAm maheSvara-balena ca /
   senāpatīnāṃ sauryeṇa hārītyāś ca samṛddhyā //	senApatInAm sOryeNa hArItyAH ca samRdDyA //
   vīryeṇa tejasā teṣāṃ viṣam astv aviṣaṃ sadā /	vIryeNa tejasA tezAm vizam astu avizam sadA /
   tatra mantrapadā bhonti nirviṣā viṣadūṣaṇāḥ //	tatra mantra-padAH Bonti nirvizAH viza-dUzaNAH //
   syād yathedam /	syAt yaTA-idam /
   harikeśi / nakile / rehile / amare aṇḍare paṇḍare / kaṭake / keyūre / hase	harikeSi / nakile / rehile / amare aNxare paNxare / kawake / keyUre / hase
   hase hase / khase khase khase / kharaṅge / marugahaṇe svāhā // mumukṣa	hase hase / Kase Kase Kase / KaraFge / maru-gahaNe svAhA // mumukza
   svāhā / hile svāhā / mile svāhā //	svAhA / hile svAhA / mile svAhA //
   hatā gaṇḍāḥ kilāsāś ca vaisarpāś ca vicarcikāḥ /	hatAH gaNxAH kilAsAH ca vEsarpAH ca vicarcikAH /
   piṭṭakā lohaliṅgāś ca kacchūr bhavati saptamī //	piwwakAH loha-liFgAH ca kacCUH Bavati saptamI //
   rāgo dveṣaś ca mohaś ca ete loke trayo viṣāḥ /	rAgaH dvezaH ca mohaH ca ete loke trayaH vizAH /
   nirviṣo bhagavān buddho buddhatejohataṃ viṣam //	nirvizaH BagavAn budDaH budDa-tejaH-hatam vizam //
   rāgo dveṣaś ca mohaś ca ete loke trayo viṣāḥ /	rAgaH dvezaH ca mohaH ca ete loke trayaH vizAH /
   nirviṣo bhagavān dharmo dharmatejohataṃ viṣam //	nirvizaH BagavAn DarmaH Darma-tejaH-hatam vizam //
   rāgo dveṣaś ca mohaś ca ete loke trayo viṣāḥ /	rAgaH dvezaH ca mohaH ca ete loke trayaH vizAH /
   nirviṣo bhagavān saṃghaṃ saṃghatejohataṃ viṣam //	nirvizaH BagavAn saMGam saMGa-tejaH-hatam vizam //
   viṣasya pṛthivī mātā viṣasya pṛthivī pitā /	vizasya pRTivI mAtA vizasya pRTivI pitA /
   etena satyavākyena viṣāḥ sarve syur nirviṣāḥ //	etena satya-vAkyena vizAH sarve syuH nirvizAH //
   bhūmiṃ saṃkrāmantu viṣaṃ pūrṇapātre vā saṃkrāmantu viṣaṃ svāhā //	BUmim saMkrAmantu vizam pUrNa-pAtre vA saMkrAmantu vizam svAhA //
   athātaḥ kalikalahavigrahavivādaparacakraśatrūṇy aparājayitukāmena pūrvaṃ	aTa-atas kali-kalaha-vigraha-vivAda-para-cakra-SatrUNi aparAjayitu-kAmena pUrvam
   mahācaitye pūjā kartavyā / iyaṃ ca mahāsāhasrapramardanī vidyārājñī	mahA-cEtye pUjA kartavyA / iyam ca mahA-sAhasra-pramardanI vidyA-rAjQI
   pravartayitavyā //	pravartayitavyA //
   buddhena nirjitā mārā dharmeṇa ca adharmatā /	budDena nirjitA mArAH DarmeNa ca aDarma-tA /
   saṃghena nirjitā tīrthyā indreṇa asurā jitāḥ /	saMGena nirjitA tIrTyAH indreNa asurAH jitAH /
   asurais tu jitaḥ somo vainateyena sāgaraḥ //	asurEH tu jitaH somaH vEnateyena sAgaraH //
   (Msp 34)	(Msp 34)
   agninā ca jitāḥ kāṣṭhā udakenāgniḥ parājitāḥ /	agninA ca jitAH kAzWA udakena-agniH parAjitAH /
   vātena nirjitā meghā ratnavajreṇa mathyate //	vAtena nirjitA meGAH ratna-vajreNa maTyate //
   satyena devās tiṣṭhanti satyena pṛthivī sthitā /	satyena devAH tizWanti satyena pRTivI sTitA /
   satyaṃ buddhaś ca dharmaś ca satyaṃ jayatu mā mṛṣāḥ //	satyam budDaH ca DarmaH ca satyam jayatu mA mRzAH //
   syād yathedam /	syAt yaTA-idam /
   amṛte agrapuṣpe / bahuphale / nivāriṇi sarvārthasādhani / aparājite /	amRte agra-puzpe / bahu-Pale / nivAriNi sarva-arTa-sADani / aparAjite /
   dharadharaṇi / guhyāvarte / gautame / guptamati / jambhani svāhā //	Dara-DaraNi / guhya-Avarte / gOtame / guptam-ati / jamBani svAhA //
   balaprabhañjani svāhā // jaye svāhā // vijaye svāhā / jaye vijaye svāhā //	bala-praBaQjani svAhA // jaye svAhA // vijaye svAhA / jaye vijaye svAhA //
   jitāḥ pratyarthikāś caiva sarvapāpāḥ parājitāḥ /	jitAH pratyarTikAH ca-eva sarva-pApAH parAjitAH /
   tato 'tha śāstā sarvajña imāṃ gāthām abhāṣata //	tatas aTa SAstA sarvajQaH imAm gATAm aBAzata //
   akṣobhyarājo avalokiteśvaro 'mitābhanemīratanārcimeruḥ /	akzoBya-rAjaH avalokita-ISvaraH amita-ABanemI-ratana-arcimeruH /
   vajrasya co nāma gṛhītvā sarvadā naivaṃ bhayaṃ bhonti na chambitatvam //	vajrasya caH nAma gRhItvA sarvadA na-evam Bayam Bonti na Cambita-tvam //
   ya eṣān aṣṭān mahādyutīnāṃ nāmāni kīrteya anugrahārtham /	yaH ezAn azwAn mahA-dyutInAm nAmAni kIrteya anugraha-arTam /
   na tasya agnir na viṣaṃ na śastraṃ krameṇa kāye kṛta sapavitre //	na tasya agniH na vizam na Sastram krameNa kAye kRta sa-pavitre //
   saced asau āghātane upasthite utkṛṣṭaśastre vadhake ca saṃmukham /	saced asO AGAtane upasTite utkRzwa-Sastre vaDake ca saMmuKam /
   anusmaranto avalokiteśvaraṃ te khaṇḍakhaṇḍaṃ prapateyuḥ śastrāḥ //	anusmarantaH avalokiteSvaram te KaNxa-KaNxam prapateyuH SastrAH //
   saced udgṛhītaṃ pi bhaveta śastraṃ bhañjitvā pāṇiṃ dharaṇīṃ pateyuḥ /	saced udgRhItam pi Baveta Sastram BaQjitvA pANim DaraNIm pateyuH /
   na tasya kāye nipateya kiṃcid anyatra karma pūrimena yat kṛtam //	na tasya kAye nipateya kiMcid anyatra karma pUrimena yat kRtam //
   samagradevā imaṃ gāthāṃ bhāṣiṣuḥ /	samagra-devAH imam gATAm BAzizuH /
   namo 'stu te buddha anantagocarā namo 'stu te satyaprakāśakā mune /	namaH astu te budDa ananta-gocarA namaH astu te satya-prakASakAH mune /
   satyaṃ pratiṣṭhāya prajāya mocase sarve ca kāmāḥ saphālā bhavantu //	satyam pratizWAya prajAya mocase sarve ca kAmAH sa-PAlAH Bavantu //
   (Msp 35)	(Msp 35)
   mama sarvasatvānāṃ ca svāhā //	mama sarva-satvAnAm ca svAhA //
   tato brahmā mahābrahmā utthito 'tha kṛtāñjaliḥ /	tatas brahmA mahA-brahmA utTitaH aTa kRtAQjaliH /
   subhāṣitā iyaṃ vidyā mahāsāhasrapramardinī //	su-BAzitA iyam vidyA mahA-sAhasra-pramardinI //
   vidyām aham pravakṣāmi dārakānāṃ hitaṃkarī /	vidyAm aham pravakzAmi dArakAnAm hitaMkarI /
   buddhavīraṃ namasyāmi dharmarājaṃ śubhākaraṃ //	budDa-vIram namasyAmi DarmarAjam SuBa-akaram //
   yena prathamato vidyā jaṃbudvīpe prakāśitā /	yena praTamatas vidyA jaMbudvIpe prakASitA /
   dharmāya ca viśiṣṭhāya saṃghāya ca gaṇottame //	DarmAya ca viSizWAya saMGAya ca gaNa-uttame //
   buddhasya pādau vanditvā brahmā vacanam abravīt /	budDasya pAdO vanditvA brahmA vacanam abravIt /
   buddhāḥ pratyekabuddhāś ca buddhānāṃ śrāvakāś ca ye //	budDAH pratyekabudDAH ca budDAnAm SrAvakAH ca ye //
   ṛṣayo lokapālāś ca yāvanto devatāpi ca /	RzayaH lokapAlAH ca yAvantaH devatA-api ca /
   ito mānuṣyalokataḥ sarva ete samutthitāḥ //	itas mAnuzya-lokataH sarve ete samutTitAH //
   santīha rākṣasā ghorā garbharakṣā mahāmune /	santi-iha rAkzasAH GorAH garBa-rakzA mahA-mune /
   śakyo na te 'pi ca draṣṭuṃ nāpi śakyāś caturdiśam //	SakyaH na te api ca drazwum na-api SakyAH caturdiSam //
   yāsāṃ putro na jāyante yāsāṃ garbho na tiṣṭhati /	yAsAm putraH na jAyante yAsAm garBaH na tizWati /
   naranārīsaṃprayogena saṃpramuhyanti indriyā //	nara-nArI-saMprayogena saMpramuhyanti indriyAH //
   putrabījaṃ vināśyanti kalalaṃ vā sabudbudaṃ /	putra-bIjam vinASyanti kalalam vA sa-budbudam /
   niṣpannā garbhayā ca strī jāyate na viśalyate //	nizpannA garBayA ca strI jAyate na viSalyate //
   nāmāni teṣām ākhyāse lokanātha śṛṇohi me /	nAmAni tezAm AKyAse lokanATa SRNohi me /
   mañjuko mṛgarājaś ca skandāpasmāramuṣṭikā //	maQjukaH mRgarAjaH ca skandApasmAra-muzwikAH //
   mātṛkā jāmikaś caiva kāminī revatī tathā /	mAtRkA jAmikaH ca-eva kAminI revatI taTA /
   pūtanā mātṛnandā ca śakuniḥ kaṇṭhapāṇinī //	pUtanA mAtRnandA ca SakuniH kaNWa-pANinI //
   mukhamaṇḍitikālambā carante sarvamedinī /	muKa-maNxitika-AlambA carante sarva-medinI /
   ete grahāḥ pañcadaśā dārakānāṃ bhayaṃkarāḥ //	ete grahAH paQcadaSAH dArakAnAm BayaMkarAH //
   vakṣolakṣaṇarūpāṇi yathā gṛhṇanti dārakān /	vakzaH-lakzaNa-rUpANi yaTA gRhNanti dArakAn /
   mañjukena gṛhītasya cakṣusī parivartate //	maQjukena gRhItasya cakzusI parivartate //
   mṛgarājagṛhītasya chardir bhavati dāruṇā /	mRgarAja-gRhItasya CardiH Bavati dAruNAH /
   skandena pragṛhītasya skandau cāleti dārakaḥ //	skandena pragRhItasya skandO cAla-iti dArakaH //
   apasmāragṛhītas tu pheṇaṃ lālāṃ ca muñcati /	apasmAra-gRhItaH tu PeNam lAlAm ca muQcati /
   muṣṭikāpragṛhītasya muṣṭibaddhā na muñcati //	muzwikA-pragRhItasya muzwi-badDA na muQcati //
   mātṛkāsaṃgṛhītasya stanate hasate tathā /	mAtRkA-saMgRhItasya stanate hasate taTA /
   (Msp 36)	(Msp 36)
   jāmikāsaṃgṛhītas tu nābhinandati sa stanau //	jAmikA-saMgRhItaH tu na-aBinandati sa stanO //
   kāminīpragṛhītas tu prasuptaḥ saṃprarodati /	kAminI-pragRhItaH tu prasuptaH saMprarodati /
   revatīpragṛhītas tu jihvā dantaiḥ prakhādati //	revatI-pragRhItaH tu jihvA dantEH praKAdati //
   pūtanāpragṛhītas tu kāsate bhanate tathā /	pUtanA-pragRhItaH tu kAsate Banate taTA /
   mātṛnandāgṛhītas tu vicitrarūpam ādiśet //	mAtR-nandA-gRhItaH tu vicitra-rUpam AdiSet //
   śakunīpragṛhītasya gandhipūtiṃ pravāyate /	SakunI-pragRhItasya ganDi-pUtim pravAyate /
   kaṇṭhapāṇigṛhītasya kaṇṭhaḥ saṃparirudhyate //	kaNWa-pANigRhItasya kaNWaH saMpariruDyate //
   mukhamaṇḍīgṛhītas tu jvaryate ca viricyate /	muKamaNxI-gRhItaH tu jvaryate ca viricyate /
   ālambāpragṛhītasya hikkāśvāsaś ca jāyate //	Alamba-apragRhItasya hikkA-ASvAsaH ca jAyate //
   tatra rūpaṃ samākhyāsye yathā trāsyanti dārakān /	tatra rUpam samAKyAsye yaTA trAsyanti dArakAn /
   mañjuko gavarūpeṇa mṛgarājo mṛgo yathā //	maQjukaH gava-rUpeNa mRgarAjaH mRgaH yaTA //
   skandaḥ kumārarūpeṇa apasmāraḥ śṛgālavat /	skandaH kumAra-rUpeNa apasmAraH SRgAla-vat /
   muṣṭikā kākarūpeṇa chāgarūpeṇa mātṛkā //	muzwikA kAka-rUpeNa CAga-rUpeNa mAtRkAH //
   jāmikā aśvarūpeṇa ghoṣarūpeṇa kāminī /	jAmikA aSva-rUpeNa Goza-rUpeNa kAminI /
   revatī śvānarūpeṇa śukarūpeṇa pūtanā //	revatI SvAna-rUpeNa Suka-rUpeNa pUtanA //
   mātṛnandā viḍālena śakuni pakṣirūpiṇī /	mAtR-nandA vixAlena Sakuni pakzi-rUpiNI /
   kaṇṭhapāṇī kaukkuṭena aulūkena mukhamaṇḍikā //	kaNWa-pANI kOkkuwena OlUkena muKamaNxikA //
   ālambā jatrurūpeṇa etās trāsyanti dārakāḥ /	AlambAH jatru-rUpeNa etAH trAsyanti dArakAH /
   etāḥ śukraharā ghorā dārakānāṃ bhayaṃkarāḥ //	etAH Sukra-harAH GorAH dArakAnAm BayaMkarAH //
   etāḥ samānayiṣyāmi sūtrapāśena karṣitāḥ /	etAH samAnayizyAmi sUtra-pASena karzitAH /
   candano nāma gandharvo yakṣasenāpatir mahān //	candanaH nAma ganDarvaH yakza-senApatiH mahAn //
   tasya lekhaṃ ca mudrāṃ ca datvā dūtyena preṣayet /	tasya leKam ca mudrAm ca datvA dUtyena prezayet /
   ugrān grantha samānehi tvaṃ tān pañcadaśān grahān //	ugrAn granTa samAne-hi tvam tAn paQcadaSAn grahAn //
   tena tatkṣaṇam ānītāḥ pañcabandhanapīḍitāḥ /	tena tad-kzaNam AnItAH paQca-banDana-pIxitAH /
   tato 'bravīt mahābrahmā lokanāthaṃ kṛtāñjaliḥ //	tatas abravIt mahA-brahmA lokanATam kRtAQjaliH //
   etāni tāni bhūtāni bījaṃ nāśenti prāṇinām /	etAni tAni BUtAni bIjam nASenti prANinAm /
   teṣāṃ daṇḍaṃ praṇeṣyāmi lokanāthasya saṃmukhaṃ //	tezAm daNxam praNezyAmi lokanATasya saMmuKam //
   yasyā na jāyate putro jāto vā yasya gṛhyate /	yasyAH na jAyate putraH jAtaH vA yasya gRhyate /
   śiṣyā saddharmacaraṇa aṣṭamīṃ sa caturdaśim //	SizyA sadDarma-caraNa azwamIm sa caturdaSim //
   caityaṃ saṃpūjayitvā tu susnātāḥ suvibhūṣitāḥ /	cEtyam saMpUjayitvA tu su-snAtAH su-viBUzitAH /
   (Msp 37)	(Msp 37)
   sarṣapāliptadharaṇīṃ puṣpagandhasamākulāḥ //	sarzapa-Alipta-DaraNIm puzpa-ganDa-samAkulAH //
   pañcaraṅgena sūtreṇa granthīnāṃ kārayec chatam /	paQca-raFgena sUtreNa granTInAm kArayet Satam /
   ardharātre sthite kāle mūṣṭiṃ sthitvā tu sarṣapān //	arDarAtre sTite kAle mUzwim sTitvA tu sarzapAn //
   brahmanirmitam ity āhur brahmaṇā ca prakaṃpitāḥ /	brahma-nirmitam iti AhuH brahmaNA ca prakaMpitAH /
   yāvad dvādaśavarṣāṇāṃ kumārāṇāṃ hitaṃkarī //	yAvat dvAdaSa-varzANAm kumArANAm hitaMkarI //
   yo imām atikramed vidyāsūtraṃ brahmaṇā nirmitām /	yaH imAm atikramet vidyA-sUtram brahmaNA nirmitAm /
   saptadhāsya sphuṭen mūrdhā arjakasyeva mañjarī //	saptaDA-asya sPuwet mUrDA arjakasya-iva maQjarI //
   syād yathedam /	syAt yaTA-idam /
   aṅge vaṅge bhaṅge / bhavane / inandi vinandi / mulali / giri / garari /	aFge vaFge BaFge / Bavane / inandi vinandi / mulali / giri / garari /
   garuṇi / śaruṇi / girigavare / locane / roṣaṇe / lasane / rocane / alabhe	garuNi / SaruNi / giri-gavare / locane / rozaNe / lasane / rocane / alaBe
   / aṅgane / alaphe talaphe / prakarṣaṇi svāhā //	/ aFgane / alaPe talaPe / prakarzaNi svAhA //
   kṣipraṃ saṃtiṣṭhatāṃ garbhaḥ samyag vardhantu indriyā /	kzipram saMtizWatAm garBaH samyak varDantu indriyAH /
   garbhasthāḥ sukhino bhontu mā ca naśyantu jātakāḥ //	garBa-sTAH suKinaH Bontu mA ca naSyantu jAtakAH //
   svasthaḥ saṃtiṣṭhatāṃ garbhaḥ kālena parimucyate /	svasTaH saMtizWatAm garBaH kAlena parimucyate /
   nānāraṅgāṇi sūtrāṇi akṣatā gaurasarṣapāḥ //	nAnA-raFgANi sUtrANi akzatAH gOrasarzapAH //
   eṣā rakṣā samākhyātā ciraṃ jīvantu dārakāḥ /	ezA rakzA samAKyAtA ciram jIvantu dArakAH /
   tato 'tha śāstā sarvajña imāṃ gāthām udāharet //	tatas aTa SAstA sarvajQaH imAm gATAm udAharet //
   rakṣito bhavantu garbhaḥ sukhaṃ modantu dārakāḥ /	rakzitaH Bavantu garBaH suKam modantu dArakAH /
   syād yathedaṃ /	syAt yaTA-idam /
   bodhi bodhi / mahābodhi / bodhānumate / phalini / bahuphale / śikṣe /	boDi boDi / mahA-boDi / boDa-anumate / Palini / bahu-Pale / Sikze /
   śikṣāsāravate / sāgale / durāsade / dūrāgame / śūraprāpte / śūravate /	SikzA-sAravate / sAgale / durAsade / dUra-Agame / SUra-prApte / SUravate /
   bhage / bhagābhage / bhagini / nivāriṇi svāhā //	Bage / Baga-ABage / Bagini / nivAriNi svAhA //
   tato grahāḥ pañcadaśāḥ sarvadā rudhirāśinaḥ /	tatas grahAH paQcadaSAH sarvadA ruDira-ASinaH /
   namaskṛtvāñjalikarā lokanāthaṃ samabruvan //	namaskRtvA-aQjali-karAH lokanATam samabruvan //
   yatredaṃ nagare sūtraṃ grāme vā yadi vā gṛhe /	yatra-idam nagare sUtram grAme vA yadi vA gRhe /
   nātra bālā mariṣyanti yatra tiṣṭhet subhāṣitaṃ //	na-atra bAlAH marizyanti yatra tizWet su-BAzitam //
   anuvṛṣṭyā bhajiṣyāmo yathā tava mahāmuni /	anuvRzwyA BajizyAmaH yaTA tava mahA-muni /
   namo bhagavate buddhāya namo brahmaṇe sidhyantu //	namaH Bagavate budDAya namaH brahmaNe siDyantu //
   mantrapadās tārayantu imāṃ vidyāṃ brahmā manyatu svāhā //	mantra-padAH tArayantu imAm vidyAm brahmA manyatu svAhA //
   atha vaiśramaṇo mahārāja ekāṃsam uttarāsaṃgaṃ kṛtvā kṛtāñjalir (Msp 38)	aTa vESramaNaH mahA-rAja eka-aMsam uttarAsaMgam kRtvA kRtAQjaliH (Msp 38)
   bhagavantaṃ namasyamāno 'vocat /	Bagavantam namasyamAnaH avocat /
   yaḥ kaścid bhadanta bhagavan śrāvaka idaṃ mahāsāhasrapramardanīsūtram	yaH kaScid Badanta Bagavan SrAvakaH idam mahA-sAhasra-pramardanI-sUtram
   udgṛhṇayād vārayed vācayed deśayet paryavāpnuyāt tena vā bahuśrutena yogaḥ	udgRhNayAt vArayet vAcayet deSayet paryavApnuyAt tena vA bahu-Srutena yogaH
   karaṇīyaḥ / caityapūjā pareṇa bhavitavyam / aṣṭamyāṃ caturdaśyāṃ	karaNIyaH / cEtya-pUjA pareNa Bavitavyam / azwamyAm caturdaSyAm
   pañcadaśyāṃ ca tv ete yakṣasyodāracaityapūjāṃ kṛtvā vidyā āvartayitavyā /	paQcadaSyAm ca tu ete yakzasya-udAra-cEtya-pUjAm kRtvA vidyA AvartayitavyA /
   tasyāṣṭamyāṃ catvāro rājapuruṣā mahārājānāṃ purataḥ samanvāharanti nāma	tasya-azwamyAm catvAraH rAja-puruzAH mahA-rAjAnAm puratas samanvAharanti nAma
   codghoṣayanti / caturdaśyāṃ caturṇāṃ mahārājānāṃ purataḥ samanvāharanti	ca-udGozayanti / caturdaSyAm caturNAm mahA-rAjAnAm puratas samanvAharanti
   nāma codghoṣayanti / pañcadaśyāṃ svayam eva catvāro mahārājānaḥ	nAma ca-udGozayanti / paQcadaSyAm svayam eva catvAraH mahA-rAjAnaH
   samanvāharanti nāma codghoṣayanti //	samanvAharanti nAma ca-udGozayanti //
   sarvasatvahitānukaṃpīvatāyaṃ bhagavataḥ śrāvako ya idaṃ	sarva-satva-hita-anukaMpIvata-ayam BagavataH SrAvakaH yaH idam
   mahāsāhasrapramardanīsūtram udgṛhṇati dhārayati vācayati paryavāpnoti /	mahA-sAhasra-pramardanI-sUtram udgRhNati DArayati vAcayati paryavApnoti /
   tasya ca bhadanta bhagavan vayaṃ catvāro mahārājānaś	tasya ca Badanta Bagavan vayam catvAraH mahA-rAjAnaS
   cīvarapiṇḍapātaśayanaglānapratyayabhaiṣajyapariṣkārair autsukyaṃ	cIvara-piNxapAta-Sayana-glAna-pratyaya-BEzajya-parizkArEH Otsukyam
   kariṣyāmaḥ / satkṛtaś ca bhaviṣyati / sarvasatvair gurukṛtaś ca mānitaś ca	karizyAmaH / satkRtaH ca Bavizyati / sarva-satvEH gurukRtaH ca mAnitaH ca
   pūjitaś ca rājñāṃ rājamahāmātrāṇāṃ ca bhaviṣyati /	pUjitaH ca rAjQAm rAja-mahAmAtrANAm ca Bavizyati /
   anyatīrthakaśravaṇabrāhmaṇaparivrājakānāṃ pūjyo bhaviṣyati	anya-tIrTaka-SravaNa-brAhmaNa-parivrAjakAnAm pUjyaH Bavizyati
   mitrāmitramadhyagato 'pi satkṛto bhaviṣyati / te ca śrāddhena kulaputreṇa	mitra-amitra-maDya-gataH api satkRtaH Bavizyati / te ca SrAdDena kula-putreNa
   vā kuladuhitrā vā śucinā bhavitavyam / śucikāyena	vA kula-duhitrA vA SucinA Bavitavyam / Suci-kAyena
   śucivastrābharaṇaśayanopakaraṇaviśeṣeṇa / na kudeśalābhena na	Suci-vastra-ABaraNa-Sayana-upakaraNa-viSezeNa / na ku-deSa-lABena na
   kumitrasaṃsargeṇa na kudeśavāsasaṃprayuktena bhavitavyam / yasya ca	kumitra-saMsargeNa na ku-deSa-vAsa-saMprayuktena Bavitavyam / yasya ca
   bhūtagrahagṛhītasya purata idaṃ mahāsāhasrapramardanī nāma sūtraṃ	BUta-graha-gRhItasya puratas idam mahAsAhasrapramardanI nAma sUtram
   śrāvayiṣyati / tasya catvāro mahārājānaḥ svayam eva rakṣāvaraṇaguptiṃ	SrAvayizyati / tasya catvAraH mahA-rAjAnaH svayam eva rakzA-AvaraNa-guptim
   saṃvidhāsyanti / evaṃ maharddhikaṃ bhadanta bhagavan	saMviDAsyanti / evam mahardDikam Badanta Bagavan
   mahāsāhasrapramardanīsūtraṃ yasyāpi gṛhe ekam api rātriṃ divaṃ vāsaṃ	mahA-sAhasra-pramardanI-sUtram yasya-api gRhe ekam api rAtrim divam vAsam
   kalpayiṣyati / tasya saṃvatsaraṃ yāvad amanuṣyā avatāraṃ na lapsyanti /	kalpayizyati / tasya saMvatsaram yAvat amanuzyAH avatAram na lapsyanti /
   namasyanīyaś ca bhaviṣyati sarvabhūtagaṇasya yaḥ idaṃ	namasyanIyaH ca Bavizyati sarva-BUta-gaNasya yaH idam
   mahāsāhasrapramardanīsūtraṃ dhārayiṣyati / tasya kāṅkṣataś catvāro	mahA-sAhasra-pramardanI-sUtram DArayizyati / tasya kAFkzataH catvAraH-
   mahārājāno sukham upadarśayanti / kimaṅga punar itare yakṣarākṣasāḥ / tat	mahA-rAjAnaH suKam upadarSayanti / kim-aFga punar itare yakza-rAkzasAH / tat-
   kasya hetor ye kecil loke vidyā (Msp 39) saṃvidhāsyanti / satvānāṃ hitāya	kasya hetoH ye kecid loke vidyAH (MsB 39) saMviDAsyanti / satvAnAm hitAya
   / imāni mantrapadāni tebhyo varapravaraśreṣṭhaviśiṣṭottamāni /	/ imAni mantra-padAni teByaH vara-pravara-SrezWa-viSizwa-uttamAni /
   gaṃbhīravipulo pramāṇāni dūrāvataraṇā asādhāraṇā iyaṃ dharmamudrā //	gaMBIra-vipulaH pramANAni dUra-avataraNAH asADAraNAH iyam DarmamudrA //
   athendraś ca sahasrākṣo devarāja śacīpatiḥ /	aTa-indraH ca sahasrAkzaH devarAja SacIpatiH /
   prāñjalistho namaskṛtvā lokanāthaṃ samabravīt //	prAQjali-sTaH namaskRtvA lokanATam samabravIt //
   subhāṣitā iyaṃ vidyā sarvalokahitaṃkarī /	su-BAzitA iyam vidyA sarva-loka-hitaMkarI /
   vidyām aham pravakṣāmi mantrauṣadhisamāyutam //	vidyAm aham pravakzAmi mantra-ozaDi-samAyutam //
   śirīṣapuṣpam apāmārgam agaruḥ kaṭakāphalaṃ /	SirIza-puzpam apAmArgam agaruH kawakA-Palam /
   śaileyam eḍamañjiṣṭhā sūkarī markaṭī jayā //	SEleyam examaQjizWA sUkarI markawI jayA //
   paripelavaṃ rasaṃ vīrā sāmakaṃ tagaraṃ busā /	paripelavam rasam vIrA sAmakam tagaram busA /
   candanāvartanaṃ kuṣṭhaṃ nakhaṃ patrakataṃ varā //	candana-Avartanam kuzWam naKam patrakatam varAH //
   priyaṃgu rocanā spṛkkā sarṣapāś ca manaḥśilāḥ /	priyaMgu rocanA spRkkA sarzapAH ca manaHSilAH /
   tvacaṃ ca kuṅkumaṃ hiṅgupatrasaṃyuktavarṇakam //	tvacam ca kuFkumam hiFgu-patra-saMyukta-varNakam //
   eṣāṃ ca saṃyutāvartiḥ sarvagrahapramocanī /	ezAm ca saMyutAvartiH sarva-graha-pramocanI /
   sarvabhūtavikāreṣu eṣā netrāñjanī smṛtāḥ //	sarva-BUta-vikArezu ezA netrAQjanI smRtAH //
   gṛhītā yena mucyanti bhūtavajraśanīśaraiḥ /	gRhItAH yena mucyanti BUta-vajra-SanI-SarEH /
   mahāvṛkṣeṣu leptavyaṃ mahācaitye tathaiva ca //	mahA-vRkzezu leptavyam mahA-cEtye taTA-eva ca //
   yo hi paśyati tat sthānaṃ bhūtebhyo na bhayaṃ tataḥ /	yaH hi paSyati tat sTAnam BUteByaH na Bayam tatas /
   sthānaṃ na tatra bhūtānāṃ nānyeṣām ahitaiṣiṇām //	sTAnam na tatra BUtAnAm na-anyezAm ahita-eziNAm //
   bherīśaṅkhamṛdaṅgāni paṇavāṃś cāpi lepayet /	BerI-SaFKa-mRdaFgAni paNavAn ca-api lepayet /
   yāvac chrūyati śabdo 'dya trasante bhūtamaṇḍalāḥ //	yAvat SrUyati SabdaH adya trasante BUta-maNxalAH //
   yakṣāṇi lepayed vāpi pakṣiṇāṃ grāmacāriṇām /	yakzANi lepayet vA-api pakziNAm grAma-cAriNAm /
   yatrāsau vrajate pakṣī diśaṃ cāpi digantaram //	yatra-asO vrajate pakzI diSam ca-api digantaram //
   sthānaṃ na tatra bhūtānāṃ nānyeṣām ahitaiṣiṇām /	sTAnam na tatra BUtAnAm na-anyezAm ahita-eziNAm /
   saritsrotastaḍāgeṣu prakṣiped yatra tatra vā //	sarit-srotaH-taxAgezu prakzipet yatra tatra vA //
   samantād yojanaṃ tatra svasti śāntir bhaviṣyati /	samantAt yojanam tatra svasti SAntiH Bavizyati /
   api śastranipāteṣu paracakrasamāgame //	api Sastra-nipAtezu para-cakra-samAgame //
   sarvamarmeṣu leptavyaṃ svastinā uttariṣyati /	sarva-marmezu leptavyam svastinA uttarizyati /
   galagaṇḍeṣu cārśeṣu vaisarpapiṭakeṣu ca //	gala-gaNxezu ca-arSezu vEsarpa-piwakezu ca //
   viṣadaṣṭe viṣapīte pītvā kṣipraṃ pramucyate /	viza-dazwe viza-pIte pItvA kzipram pramucyate /
   (Msp 40)	(Msp 40)
   etena lepayed gātraṃ sarvakākhordacchedanam //	etena lepayet gAtram sarva-kAKoH-da=-Cedanam //
   vivādottāraṇaṃ siddhaṃ rājadvāraparimocanam /	vivAda-uttAraNam sidDam rAja-dvAra-parimocanam /
   asiddhaḥ siddham āpnoti īśvaratvam anīśvaram //	asidDaH sidDam Apnoti ISvara-tvam anISvaram //
   aputro labhate putram adhano labhate dhanam /	aputraH laBate putram aDanaH laBate Danam /
   yāvad vidyādharasthānāṃ mantrāṇi tāni sādhayet //	yAvat vidyADara-sTAnAm mantrANi tAni sADayet //
   tiryagyonigate caiva tat syād vṛkṣaphaleṣu ca /	tiryagyoni-gate ca-eva tat syAt vRkza-Palezu ca /
   vidyādharasya prajño 'sya śantikaraṃ śubhaṃkaram //	vidyADarasya prajQaH asya Santi-karam SuBaMkaram //
   tatra mantrapadāny asti indrasya vacanaṃ yathā /	tatra mantra-padAni asti indrasya vacanam yaTA /
   syād yathedam /	syAt yaTA-idam /
   akrame / vikrame / bhūtaghoṣe / bhūtaṃgame / dahani / dhadhare /	akrame / vikrame / BUtaGoze / BUtaMgame / dahani / DaDare /
   dharadhare / dadhini / nikhume / khukhume / khakha khakha / sāraṃgame /	DaraDare / daDini / niKume / KuKume / KaKa KaKe / sAraMgame /
   candre / capale / halime / hale hariṇi svāhā //	candre / capale / halime / hale hariNi svAhA //
   svasty astu mama sarvasatvānāṃ ca sarvadigvidigbhyaḥ svāhā //	svasti astu mama sarva-satvAnAm ca sarva-diS-vidigByaH svAhA //
   nihatāḥ sarvapāpāni svāhā //	nihatAH sarva-pApAni svAhA //
   tato brahmā ca śakraś ca lokapālā maheśvaraḥ /	tatas brahmA ca SakraH ca lokapAlAH maheSvaraH /
   yakṣasenāpatayaḥ sarve hārītī ca saputrikā //	yakza-senApatayaH sarve hArItI ca sa-putrikA //
   ekavāgekasvarā avocat prāñjalīkṛtāḥ /	eka-vAc-eka-svarAH avocat prAQjalIkRtAH /
   sahasrasūryapradyotaḥ pūrṇacandraprabhāsvaraḥ //	sahasra-sUrya-pradyotaH pUrNa-candra-praBAsvaraH //
   sadevamānuṣe loke sadṛśas te na vidyate /	sa-deva-mAnuze loke sadRSaH te na vidyate /
   acintyā suprayuktā ca yakṣarākṣasamardanī //	acintyA suprayuktA ca yakza-rAkzasa-mardanI //
   rājapramocanī nāma vidyā vairāgyapālanī /	rAjapramocanI nAma vidyA vErAgya-pAlanI /
   sāhasrapramardanī nāma mahārājā śubhodayā //	sAhasrapramardanI nAma mahA-rAjA SuBa-udayA //
   yuddhasaṃgrāmavijayā sarvaśatrupramardanī /	yudDa-saMgrAma-vijayA sarva-Satru-pramardanI /
   mahāsāhasrake loke rakṣārthaṃ sūtram uttamam //	mahA-sAhasrake loke rakzA-arTam sUtram uttamam //
   namas te puruṣavīra namas te puruṣottama /	namaH te puruza-vIra namaH te puruzottamaH /
   añjalisthā namaskṛtvā tatraivāntaradhāyiṣu //	aQjali-sTA namaskRtvA tatra-eva-antara-DAyizu //
   atha bhagavān sāyāhnakālasamaye pratisaṃlayanād utthāya bhikṣūn	aTa BagavAn sAyAhna-kAla-samaye pratisaMlayanAt utTAya BikzUn
   āmantrayāmāsa /	AmantrayAmAsa /
   udgṛhṇadhvaṃ bhikṣavo mahāsāhasrapramardanīśūtraṃ dhārayata vācayata	udgRhNaDvam BikzavaH mahA-sAhasra-pramardanI-SUtram DArayataH vAcayata
   paryavāpnuyāt / tad bhaviṣyati / sadevakasya lokasya (Msp 41) dīrgharātram	paryavApnuyAt / tat Bavizyati / sa-devakasya lokasya (MsB 41) dIrGarAtram
   arthāya hitāya sukhāya sparśavihāratāyai / yaḥ kaścid bhikṣavo mama	arTAya hitAya suKAya sparSa-vihAra-tAyE / yaH kaScid BikzavaH mama
   śravaka etena mahāsāhasrapramardanīsūtreṇa śuṣkavṛkṣasyāpi paritrāṇaṃ	SravakaH etena mahA-sAhasra-pramardanI-sUtreNa Suzka-vRkzasya-api paritrANam
   badhnīyāt parigrahaṃ tasya patrapuṣpaphalāni jayeran / kimaṅga punaḥ	baDnIyAt parigraham tasya patra-puzpa-PalAni jayeran / kim-aFga punar-
   savijñānasya kāyasyānyatra pūrvakarmavipākena //	sa-vijQAnasya kAyasya-anyatra pUrva-karma-vipAkena //
   evam uktās te bhikṣavo bhagavantam etad avocat /	evam uktAH te BikzavaH Bagavantam etat avocat /
   yānīmāni bhadanta bhagavan pañcamahārakṣāsūtrāṇi bhāṣitāni / syād yathedam	yAni-imAni Badanta Bagavan paQca-mahArakzA-sUtrANi BAzitAni / syAt yaTA-idam
   / mahāsāhasrapramardanī / mahāmāyūrī mahāśītavatī mahāpratisarā	/ mahA-sAhasra-pramardanI / mahAmAyUrI mahA-SItavatI mahA-pratisarA
   mahāmantrānusāraṇī ceti / tāni ca bhagavatā	mahA-mantra-anusAraNI ca-iti / tAni ca BagavatA
   pañcāmiṣaparivarjinenānujñatāni vācayitavyāni / piṇḍapātraṃ ca bhojanaṃ	paQca-Amiza-parivarjinena-anujQatAni vAcayitavyAni / piNxa-pAtram ca Bojanam
   niśrāya pravrajyā vyākṛtā / alpaṃ ca bhagavan piṇḍapātraṃ	niSrAya pravrajyA vyAkRtAH / alpam ca Bagavan piNxa-pAtram
   pañcāmiṣaparivarjitam / idam eva bahutaraṃ yad idaṃ pañcāmiṣasaṃsṛṣṭaṃ	paQca-Amiza-parivarjitam / idam eva bahutaram yat idam paQca-Amiza-saMsRzwam
   tatra vayaṃ bhagavan kathaṃ pratipadyāmaḥ //	tatra vayam Bagavan kaTam pratipadyAmaH //
   evam ukte bhagavān tān bhikṣūn etad avocat /	evam ukte BagavAn tAn BikzUn etat avocat /
   tena hi bhikṣavo yo hy etat mahāsāhasrapramardanīsūtraṃ dhārayitavyam /	tena hi BikzavaH yaH hi etat mahA-sAhasra-pramardanI-sUtram DArayitavyam /
   tenākṣateyaṃ dhāraṇī ātmarakṣāyai dhārayitavyā / tena hi piṇḍapātraṃ	tena-akzateyam DAraNI Atma-rakzAyE DArayitavyA / tena hi piNxa-pAtram
   parigṛhītā āhāre pratikūlasaṃjñotpādayitavyā / pañcāmiṣasaṃsṛṣṭapiṇḍapātre	parigRhItAH AhAre pratikUla-saMjQA-utpAdayitavyA / paQca-Amiza-saMsRzwa-piNxa-pAtre
   pañcāmiṣaparivarjitasaṃjñotpādayitavyā / sarvasaṃskṛte anityasaṃjñā /	paQca-Amiza-parivarjita-saMjQA-utpAdayitavyA / sarva-saMskRte anitya-saMjQA /
   anitye duḥkhasaṃjñā / duḥkhe anātmasaṃjñā / anātmany	anitye duHKa-saMjQA / duHKe anAtma-saMjQA / anAtmani-
   aśubhasaṃjñotpādayitavyā / kutaḥ pañcāmiṣāṇi kasya vā pañcāmiṣāṇi / ko vā	aSuBa-saMjQA-utpAdayitavyA / kutas paQca-AmizANi kasya vA paQca-AmizANi / kaH vA
   pañcāmiṣāṇi paribhojyante / nāsti satvaḥ kutaḥ satvaḥ / sa satvo	paQca-AmizANi pariBojyante / na-asti satvaH kutas satvaH / sa satvaH-
   nopalabhyate / tatra cāhāra pañcāmiṣāsaṃsṛṣṭasaṃjñakaraṇīyā / ātmarakṣā	na-upalaByate / tatra ca-AhAra paQca-AmizA-saMsRzwa-saMjQa-karaNIyA / Atma-rakzA
   aṣṭamyāṃ caturdaśyāṃ pañcadaśyāṃ ca rājagotrāya kanyāya susnātāya	azwamyAm caturdaSyAm paQcadaSyAm ca rAja-gotrAya kanyAya su-snAtAya
   subhūṣitāya ahorātro vapuṣṭāya pañcaśikṣāpadaparigṛhītayā lohitaṃ sūtraṃ	su-BUzitAya ahorAtraH vapuzwAya paQca-SikzA-pada-parigRhItayA lohitam sUtram
   caturguṇaṃ kārayitvā mantradhāreṇa vidyā smarayitavyā / granthiṃ kṛtvā tat	caturguNam kArayitvA mantra-DAreNa vidyA smarayitavyA / granTim kRtvA tat-
   sūtraṃ navena śastreṇa cchitvā dagdhā ratnabhaṇḍo vā udakaparipūrṇaṃ kṛtvā	sUtram navena SastreNa cCitvA dagDA ratna-BaNxaH vA udaka-paripUrNam kRtvA
   puṣpair ācchādayitvā nānāgandhena dhūpayitvā iyaṃ vidyā āvartayitavyā /	puzpEH AcCAdayitvA nAnA-ganDena DUpayitvA iyam vidyA AvartayitavyA /
   yāvat taj jātaṃ sūtraṃ bhājane prādurbhavati / tac ca pāṇau bandhayitvā	yAvat tat jAtam sUtram BAjane prAdurBavati / tat ca pANO banDayitvA
   vācyam //	vAcyam //
   (Msp 42)	(Msp 42)
   brahmaṇair vipralabdhena śākyasiṃhena tāyinā /	brahmaNEH vipralabDena SAkya-siMhena tAyinA /
   sa viṣaṃ giriguptena bhojanam upanāmitam //	sa vizam giri-guptena Bojanam upanAmitam //
   pratigṛhya tataḥ śāstā nirviṣīkṛtya bhojinām /	pratigRhya tatas SAstA nirvizIkRtya BojinAm /
   etena satyavākyena amṛtaṃ bhontu bhojanam //	etena satya-vAkyena amRtam Bontu Bojanam //
   vipaśyino devatāyāḥ śikhino viśvabhuvas tathā /	vipaSyinaH devatAyAH SiKinaH viSvaBuvaH taTA /
   krakucchandaprasannāc ca devatāyā mahābalāḥ //	krakucCanda-prasannAt ca devatAyAH mahA-balAH //
   kanakākhyadevendrāḥ śrīmataḥ kāśyapasya ca /	kanaka-AKya-deva-indrAH SrImataH kASyapasya ca /
   prasannāḥ śākyasiṃhasya brahmendrās trideśeśvarāḥ //	prasannAH SAkya-siMhasya brahma-indrAH trideSa-ISvarAH //
   catvāro lokapālāś ca māṇibhadro maheśvaraḥ /	catvAraH lokapAlAH ca mANiBadraH maheSvaraH /
   rākṣasī ca mahākālī caṇḍacaṇḍālinī tathā //	rAkzasI ca mahAkAlI caNxacaNxAlinI taTA //
   idaṃ puṣpaṃ ca gandhaṃ ca pratigṛhṇantu mamāhutim /	idam puzpam ca ganDam ca pratigRhNantu mama-Ahutim /
   prīṇitā pūjitā bhūtvā ete śodhantu bhojanam //	prINitA pUjitAH BUtvA ete SoDantu Bojanam //
   pañcāmiṣeṇa saṃsṛṣṭam asaṃsṛṣṭaṃ karontu me /	paQca-AmizeNa saMsRzwam asaMsRzwam karontu me /
   apañcāmiṣasaṃsṛṣṭaṃ sarvaṃ bhujāmi bhojanam //	apaQca-Amiza-saMsRzwam sarvam BujAmi Bojanam //
   sarveṣāṃ bījagrāmāṇāṃ pratiṣṭhā pṛthivīrasāḥ /	sarvezAm bIja-grAmANAm pratizWA pRTivI-rasAH /
   sarvabhojanasaṃsṛṣṭam asaṃsṛṣṭaṃ bhavantu me //	sarva-Bojana-saMsRzwam asaMsRzwam Bavantu me //
   chinnaṃ dagdhaṃ yathā sūtraṃ tādṛśaṃ bhavate punaḥ /	Cinnam dagDam yaTA sUtram tAdRSam Bavate punar /
   tathā bhojanasaṃsṛṣṭam asaṃsṛṣṭaṃ karontu me //	taTA Bojana-saMsRzwam asaMsRzwam karontu me //
   syād yathedam /	syAt yaTA-idam /
   khakhame / khakha khakha / khukhume / sime sime / sihune / simi sime /	Ka-Kame / KaKa KaKe / KuKume / sime sime / sihune / simi sime /
   svasti svasti svasti svasti / śānti śānti sārāgri / pañcāmiṣeṇa saṃsṛṣṭaṃ	svasti svasti svasti svasti / SAnti SAnti sAra-agri / paQca-AmizeNa saMsRzwam
   yathā hāra nirāmiṣam / yena dagdhaṃ yathā sūtraṃ satyaṃ kurvantu tādṛśam	yaTA hAra nirAmizam / yena dagDam yaTA sUtram satyam kurvantu tAdRSam
   syād yathedam //	syAt yaTA-idam //
   kalake / kalale / balanikaruṇalāye / khalume / agnisaṃkrāmani svāhā //	kalake / kalale / bala-nikaruNa-lAye / Kalume / agni-saMkrAmani svAhA //
   vipaśyibuddhaṃ śaraṇam upaimi / śikhinaṃ ca buddhaṃ sugataṃ ca viśvabhum /	vipaSyi-budDam SaraNam upEmi / SiKinam ca budDam sugatam ca viSvaBum /
   krakucchandabuddhaṃ kanakamuniṃ ca kāśyapam / viśāradaṃ śakyamuniṃ ca	krakucCanda-budDam kanaka-munim ca kASyapam / viSAradam Sakya-munim ca
   gautamam / etena saptān narottamānāṃ puṣpaiś ca gandhaiś ca śarīrapūjāṃ	gOtamam / etena saptAn nara-uttamAnAm puzpEH ca ganDEH ca SarIra-pUjAm
   kāyena vācā (Msp 43) manasā ca kṛtvā prasannacittaśaraṇaṃ hy upaimi /	kAyena vAcA (Msp 43) manasA ca kRtvA prasanna-citta-SaraNam hi upEmi /
   eteṣu buddheṣu maharddhikeṣu yā devatāḥ santi abhiprasannāḥ / tā devatā	etezu budDezu mahardDikezu yAH devatAH santi aBiprasannAH / tAH devatA
   āttamanā udagrāḥ kurvanti śāntiṃ ca nityam / svasty astu mama	Atta-manAH udagrAH kurvanti SAntim ca nityam / svasti astu mama
   sarvasatvānāṃ ca svāhā //	sarva-satvAnAm ca svAhA //
   idam avocad bhagavān āttamanās te ca bhikṣavo bodhisatvā sā ca sarvāvatī	idam avocat BagavAn Atta-manAH te ca BikzavaH boDisatvA sA ca sarvAvatI
   parṣat sadevamānuṣāsuragandharvaś ca loko bhagavato bhāṣitam abhyanandann	parzad sa-deva-mAnuza-asura-ganDarvaH ca lokaH BagavataH BAzitam aByanandan=-
   iti //	iti //
   āryamahāsāhasrapramardanī nama mahāyānasūtraṃ samāptam //	Arya-mahA-sAhasra-pramardanI nama mahAyAna-sUtram samAptam //
