   MSuAv [1] (GBM 1451.8) // punar api mahārāja yan mayā anuttarāṃ	MSuO [1] (GBm 1451.8) // punar api mahA-rAja yat mayA anuttarAm
   samyaksaṃbodhiṃ prārthayatā satvahitaṃ (GBM 1550.1) kṛtaṃ tac chrūyatāṃ.	samyaksaMboDim prArTayatA satva-hitam (GBm 1550.1) kRtam tat SrUyatAM.
   MSuAv [2] bhūtapūrvaṃ mahārāja rājā babhūva mahāsudarśano nāma saptabhi	MSuO [2] BUta-pUrvam mahA-rAja rAjA baBUva mahAsudarSanaH nAma saptaBi
   ratnaiḥ samanvāgataḥ catasṛbhiś ca mānuṣikābhi riddhibhiḥ. katamaiḥ	ratnEH samanvAgataH catasRBiH ca mAnuzika-aBi ridDiBiH. katamEH
   saptabhi ratnaiḥ, tadyathā (GBM 1550.2) cakraratnena	saptaBi ratnEH, tat-yaTA (GBm 1550.2) cakraratnena
   hastiratnenāśvaratnena maṇiratnena strīratnena gṛhapatiratnena	hasti-ratnena-aSva-ratnena maNi-ratnena strI-ratnena gRhapati-ratnena
   pariṇāyakaratnena saptamena. katamābhiś catasṛbhiḥ mānuṣikābhi riddhibhiḥ	pariNAyaka-ratnena saptamena. katamABiH catasRBiH mAnuzika-aBi ridDiBiH
   samanvāgata, rājā (GBM 1550.3) mahārāja mahāsudarśano dīrghāyur abhūc	samanvAgata, rAjA (GBm 1550.3) mahA-rAja mahAsudarSanaH dIrGa-AyuH aBUt-
   cirasthitikaḥ. sa caturaśītiṃ varṣasahasrāṇi kumārakrīḍāyāṃ krīḍitavāṃ,	cira-sTitikaH. sa caturaSItim varza-sahasrANi kumAra-krIxAyAm krIxitavAM,
   caturaśītiṃ varṣasahasrāṇi yauvarājyaṃ kāritavāṃ, (GBM 1550.4) caturaśītiṃ	caturaSItim varza-sahasrANi yOvarAjyam kAritavAn, (GBm 1550.4) caturaSItim
   varṣasahasrāṇi mahārājyaṃ kāritavāṃ, caturaśītiṃ varṣasahasrāṇi	varza-sahasrANi mahA-rAjyam kAritavAn, caturaSItim varza-sahasrANi
   rājarṣibrahmacaryam acārṣīd. yan mahārāja rājā mahāsudarśano (GBM 1550.5)	rAjarzi-brahmacaryam acArzId. yat mahA-rAja rAjA mahAsudarSanaH (GBm 1550.5)
   dīrghāyur abhūc cirasthitikaś caturaśītiṃ varṣasahasrāṇi yāvad	dIrGa-AyuH aBUt cira-sTitikaH caturaSItim varza-sahasrANi yAvat-
   rājarṣibrahmacaryam acārṣī, iyaṃ rājño mahāsudarśanasya riddhir ity	rAjarzi-brahmacaryam acArzI, iyam rAjQaH mahAsudarSanasya ridDiH iti-
   ucyate.	ucyate.
   MSuAv [3] punar aparaṃ mahārāja (GBM 1550.6) rājā mahāsudarśano 'bhirūpo	MSuO [3] punar aparam mahA-rAja (GBm 1550.6) rAjA mahAsudarSanaH aBirUpaH-
   'bhūd darśanīyaḥ prāsādikaḥ atikrāntaś ca mānuṣaṃ varṇam asaṃprāptaś ca	aBUt darSanIyaH prAsAdikaH atikrAntaH ca mAnuzam varNam asaMprAptaH ca
   divyaṃ varṇaṃ. yan mahārāja rājā mahāsudarśano 'bhirūpo 'bhūd darśanīyaḥ	divyam varNaM. yat mahA-rAja rAjA mahAsudarSanaH aBirUpaH aBUt darSanIyaH
   (GBM 1550.7) prāsādikaḥ atikrāntaś ca mānuṣaṃ varṇam asaṃprāptaś ca divyaṃ	(GBm 1550.7) prAsAdikaH atikrAntaH ca mAnuzam varNam asaMprAptaH ca divyam
   varṇaṃ, iyaṃ rājño mahāsudarśanasya riddhir ity ucyate. //	varNaM, iyam rAjQaH mahAsudarSanasya ridDiH iti ucyate. //
   MSuAv [4] punar aparaṃ mahārāja rājā mahāsudarśano 'lpābādho (GBM 1550.8)	MSuO [4] punar aparam mahA-rAja rAjA mahAsudarSanaH alpa-AbADaH (GBm 1550.8)
   'bhūd arogajātīyaḥ samapācanyā grahaṇyā samanvāgato nātyuṣṇayā nātiśītayā	aBUt aroga-jAtIyaH samapAcanyA grahaNyA samanvAgataH na-ati-uzNayA na-ati-SItayA
   avyābādhayā ṛtusukhayā yayāsyāśitapītakhāditāsvāditāni samyak sukhena (GBM	avyAbADayA Rtu-suKayA yayAsya-aSita-pIta-KAdita-AsvAditAni samyak suKena (GBm
   1551.1) paripākaṃ gacchanti yan mahārāja rājā mahāsudarśano 'lpābādho	1551.1) paripAkam gacCanti yat mahA-rAja rAjA mahAsudarSanaH alpa-AbADaH-
   'bhūd arogajātīyaḥ pūrvavad,	aBUt aroga-jAtIyaH pUrvavat-,
   iyaṃ rājño mahāsudarśanasya riddhir ity ucyate. //	iyam rAjQaH mahAsudarSanasya ridDiH iti ucyate. //
   MSuAv [5] punar aparaṃ mahārāja rājā mahāsudarśano naigamajānapadānāṃ	MSuO [5] punar aparam mahA-rAja rAjA mahAsudarSanaH nEgama-jAnapadAnAm
   priyaś cābhūn	priyaH ca-aBUt-
   manāpaś ca (GBM 1551.2) tadyathā putrāṇāṃ pitā. rājño 'pi mahāsudarśanasya	manApaH ca (GBm 1551.2) tat-yaTA putrANAm pitA. rAjQaH api mahAsudarSanasya
   naigamajānapadā priyaś cābhūvan manaāpaś ca tadyathā pituḥ putrāḥ. eko	nEgama-jAnapadA priyaH ca-aBUvat manaApaH ca tat-yaTA pituH putrAH. ekaH-
   'yaṃ mahārāja samayo rājā mahāsudarśana (GBM 1551.3) udyānabhūmiṃ niryān	ayam mahA-rAja samayaH rAjA mahA-sudarSana (GBm 1551.3) udyAna-BUmim niryAn
   sārathim āmantrayate. śanais tāvat sārathe mandamandaṃ rathaṃ preraya	sAraTim Amantrayate. SanEs tAvat sAraTe manda-mandam raTam preraya
   yāvad ahaṃ ciracirā	yAvat aham ciracirA
   naigamajānapadāṃ drakṣyāmi (sic; Matsumura prakṣyāmi). naigamajānapadā api	nEgama-jAnapadAm drakzyAmi (sic; Matsumura prakzyAmi). nEgama-jAnapadAH api
   sārathim (GBM 1551.4) āmantrayante. śanais tāvat sārathe mandamandaṃ	sAraTim (GBm 1551.4) Amantrayante. SanEs tAvat sAraTe manda-mandam
   rathaṃ preraya yāvad vayaṃ ciracirā devaṃ drakṣyāmaḥ (sic; Matsumura	raTam preraya yAvat vayam ciracirAH devam drakzyAmaH (sic; Mat-sumura
   prakṣyāmaḥ). yan mahārāja rājā mahāsudarśano naigamajānapadānāṃ priyaś	prakzyAmaH). yat mahA-rAja rAjA mahAsudarSanaH nEgama-jAnapadAnAm priyaS
   (GBM 1551.5) cābhūn manāpaś ca tadyathā putrāṇāṃ pitā rājño 'pi	(GBm 1551.5) ca-aBUt manApaH ca tat-yaTA putrANAm pitA rAjQaH api
   mahāsudarśanasya naigamajānapadāḥ priyaś cābhūvan manāpaś ca tadyathā	mahAsudarSanasya nEgama-jAnapadAH priyaH ca-aBUvat manApaH ca tat-yaTA
   pituḥ (sic; Matsumura om.) putrā, iyaṃ rajño mahāsudarśanasya (GBM 1551.6)	pituH (sic; Mat-sumuraH om.) putrA, iyam rajQaH mahAsudarSanasya (GBm 1551.6)
   riddhir ity ucyate.	ridDiH iti ucyate.
   MSuAv [6] athāpareṇa samayena naigamajānapadāḥ prabhūtaṃ hiraṇyasuvarṇam	MSuO [6] aTa-apareNa samayena nEgama-jAnapadAH praBUtam hiraNya-suvarNam
   ādāya maṇiratnaṃ kaṃbalaratnaṃ ca, yena rājā mahāsudarśanas	AdAya maNi-ratnam kaMbala-ratnam ca, yena rAjA mahAsudarSana-s
   tenopasaṃkrāntā (GBM 1551.7) upasaṃkramya rājānaṃ mahāsudarśanam idam	tena-upasaMkrAntA (GBm 1551.7) upasaMkramya rAjAnam mahA-sudarSanam idam
   avocan. idam asmābhir devam uddiśya prabhūtaṃ hiraṇyasuvarṇaṃ maṇiratnam	avocan. idam asmABiH devam uddiSya praBUtam hiraNya-suvarNam maNi-ratnam
   ānītaṃ kaṃbalaratnaṃ ca. tad devaḥ pratigṛhṇātv (GBM 1551.8) anukaṃpām	AnItam kaMbala-ratnam ca. tat devaH pratigRhNAtu (GBm 1551.8) anukaMpAm
   upādāya. alaṃ grāmaṇyaḥ saṃvidyante me idam evaṃrūpaṃ	upAdAya. alam grAmaNyaH saMvidyante me idam evaMrUpam
   dhanajātam ity uktvā nādhivāsayati. dvir api trir api naigamajānapadā	Dana-jAtam iti uktvA na-aDivAsayati. dvis api tris api nEgama-jAnapadA
   rājānaṃ mahāsudarśanam (GBM 1552.1) idam avocan. idam asmābhir devam	rAjAnam mahAsudarSanam (GBm 1552.1) idam avocan. idam asmABiH devam
   uddiśya prabhūtaṃ hiraṇyasuvarṇam ānītaṃ maṇiratnaṃ kaṃbalaratnaṃ ca. tad	uddiSya praBUtam hiraNya-suvarNam AnItam maNi-ratnam kaMbala-ratnam ca. tat-
   devaḥ pratigṛhṇātv anukaṃpām upādāya. dvir api trir api rājā mahāsudarśano	devaH pratigRhNAtu anukaMpAm upAdAya. dvis api tris api rAjA mahA-sudarSanaH-
   naigamajānapadān idam avocat. (GBM 1552.4) alaṃ grāmaṇyaḥ saṃvidyante me	nEgama-jAnapadAn idam avocat. (GBm 1552.4) alam grAmaNyaH saMvidyante me
   idam evaṃrūpaṃ dhanajātam ity uktvā nādhivāsayati. atha naigamajānapadānām	idam evaMrUpam Dana-jAtam iti uktvA na-aDivAsayati. aTa nEgama-jAnapadAnAm
   etad abhavan. nāsmākaṃ pratirūpaṃ syād yad asmābhir (GBM 1552.5) devam	etat aBavan. na-asmAkam pratirUpam syAt yat asmABiH (GBm 1552.5) devam
   uddiśya prabhūtaṃ hiraṇyasuvarṇam ānītaṃ maṇiratnaṃ kaṃbalaratnaṃ ca, yad	uddiSya praBUtam hiraNya-suvarNam AnItam maNi-ratnam kaMbala-ratnam ca, yat-
   vayaṃ punar apy ādāya svakasvakāni niveśanāni prakrāmema, yan nu vayaṃ	vayam punar api AdAya sva-ka-svakAni niveSanAni prakrAmema, yat nu vayam
   (GBM 1552.6) rājño mahāsudarśanasya purastān mahāntaṃ hiraṇyasuvarṇasya	(GBm 1552.6) rAjQaH mahAsudarSanasya purastAt mahAntam hiraNya-suvarNasya
   rāśim ākīrya maṇiratnaṃ kaṃbalaratnaṃ caikānte upanikṣipya etat te deva	rASim AkIrya maNi-ratnam kaMbala-ratnam ca-ekAnte upanikzipya etat te deva
   dhanajātam ity uktvā nirapekṣāḥ (GBM 1552.7) prakrāmema. iti	Dana-jAtam iti uktvA nirapekzAH (GBm 1552.7) prakrAma-ima. iti
   naigamajānapadā rājño mahāsudarśanasya purastān mahāntaṃ hiraṇyasuvarṇasya	nEgama-jAnapadAH rAjQaH mahAsudarSanasya purastAt mahAntam hiraNya-suvarNasya
   rāśim ākīrya maṇiratnaṃ kaṃbalaratnaṃ caikānte upanikṣipya etat te (GBM	rASim AkIrya maNi-ratnam kaMbala-ratnam ca-ekAnte upanikzipya etat te (GBm
   1552.8) deva dhanajātam ity uktvā nirapekṣāḥ prakrāntāḥ.	1552.8) deva Dana-jAtam iti uktvA nirapekzAH prakrAntAH.
   MSuAv [7] atha rājño mahāsudarśanasyaitad abhavat*. saṃpannaṃ me	MSuO [7] aTa rAjQaH mahAsudarSanasya-etat aBavat*. saMpannam me
   dhanajātaṃ dharmeṇa nādharmeṇa. yanv ahaṃ dharmyaṃ prāsādaṃ (GBM 1553.1)	Dana-jAtam DarmeNa na-aDarmeNa. yanu aham Darmyam prAsAdam (GBm 1553.1)
   māpayeyam. aśrauṣuś caturaśīti koṭṭarājasahasrāṇi rājā mahāsudarśana	mApayeyam. aSrOzuH caturaSIti kowwa-rAja-sahasrANi rAjA mahA-sudarSana
   udyukto dharmyaṃ prāsādaṃ māpayitum. iti śrutvā ca punar yena rājā	udyuktaH Darmyam prAsAdam mApayitum. iti SrutvA ca punar yena rAjA
   mahāsudarśanaḥ tenopasaṃkrāntā. (GBM 1553.2) upasaṃkramya rājānaṃ	mahAsudarSanaH tena-upasaMkrAntA. (GBm 1553.2) upasaMkramya rAjAnam
   mahāsudarśanam idam avocaṃ. alpotsuko devo bhavatu dharmyāt prāsādād.	mahAsu-darSanam idam avocaM. alpa-utsukaH devaH Bavatu DarmyAt prAsAdAt-.
   vayaṃ devasya dharmyaṃ prāsādaṃ māpayiṣyāmo. 'laṃ (sic; Matsumura lpaṃ)	vayam devasya Darmyam prAsAdam mApayizyAmaH-. alam (sic; MatsumuraH lpaM)
   grāmaṇyaḥ (GBM 1553.3) saṃvidyante me idam evaṃrūpaṃ dhanajātaṃ ity uktvā	grAmaNyaH (GBm 1553.3) saMvidyante me idam evaMrUpam Dana-jAtam iti uktvA
   nādhivāsayati. dvir api trir api caturaśītiṃ koṭṭarājasahasrāṇi rājānaṃ	na-aDivAsayati. dvis api tris api caturaSItim kowwa-rAja-sahasrANi rAjAnam
   mahāsudarśanam idam avocaṃ. alpotsuko (GBM 1553.4) devo bhavatu dharmyāt	mahAsu-darSanam idam avocaM. alpa-utsukaH (GBm 1553.4) devaH Bavatu DarmyAt-
   prāsādād. vayaṃ devasya dharmyaṃ prāsādaṃ māpayiṣyāmo. dvir api trir api	prAsAdAd. vayam devasya Darmyam prAsAdam mApayizyAmo. dvis api tris api
   rājā mahāsudarśanaś caturaśītiṃ koṭṭarājasahasrāṇi-m-idam (GBM 1553.5)	rAjA mahA-sudarSanaH caturaSItim kowwa-rAja-sahasra-aNi-m-idam (GBm 1553.5)
   avocat. alaṃ grāmaṇyaḥ saṃvidyante me idam evaṃrūpaṃ dhanajātam ity uktvā	avocat. alam grAmaNyaH saMvidyante me idam evaMrUpam Dana-jAtam iti uktvA
   nādhivāsayati.	na-aDivAsayati.
   MSuAv [8] atha tad eke koṭṭarājānāṃ rājño mahāsudarśanasya pādayor	MSuO [8] aTa tat eke kowwarAjAnAm rAjQaH mahAsudarSanasya pAdayoH-
   nipatya, (GBM 1553.6) eke bāhū pragṛhya, eke cīvarakarṇake pragṛhya, eke	nipatya, (GBm 1553.6) eke bAhU pragRhya, eke cIvarakarNake pragRhya, eke
   yena rājā mahāsudarśanas tenāṃjaliṃ praṇamayya rājānaṃ mahāsudarśanam idam	yena rAjA mahAsudarSanaH tena-aMjalim praNamayya rAjAnam mahA-sudarSanam idam
   avocan*. alpotsuko devo bhavatu (GBM 1553.7) dharmyāt prāsādād. vayaṃ	avocan*. alpa-utsukaH devaH Bavatu (GBm 1553.7) DarmyAt prAsAdAd. vayam
   devasya dharmyaṃ prāsādaṃ māpayiṣyāmo. 'dhivāsayati rājā mahāsudarśanaś	devasya Darmyam prAsAdam mApayizyAmaH-. aDivAsayati rAjA mahA-sudarSanaH-
   caturaśīti koṭṭarājasahasrāṇāṃ tūṣṇīṃbhāvena.	caturaSIti kowwa-rAja-sahasrANAm tUzNIMBAvena.
   MSuAv [9] atha caturaśīti (GBM 1553.8) koṭṭarājasahasrāṇi rājño	MSuO [9] aTa caturaSIti (GBm 1553.8) kowwa-rAja-sahasrANi rAjQaH-
   mahāsudarśanasya tūṣṇīṃbhāvenādhivāsanāṃ viditvā svakasvakāni vijitāni	mahAsudarSanasya tUzNIMBAvena-aDivAsanAm viditvA sva-ka-svakAni vijitAni
   gatvā prabhūtaṃ hiraṇyasuvarṇam ādāya ekaikaṃ (GBM 1554.1) ca	gatvA praBUtam hiraNya-suvarNam AdAya ekEkam (GBm 1554.1) ca
   ratnastaṃbhaṃ yena rājā mahāsudarśanas tenopasaṃkrāntā, upasaṃkramya	ratna-staMBam yena rAjA mahA-sudarSanaH tena-upasaMkrAntA, upasaMkramya
   rājānaṃ mahāsudarśanam idam avocan*. kutra vayaṃ devasya dharmyaṃ prāsādaṃ	rAjAnam mahA-sudarSanam idam avocan*. kutra vayam devasya Darmyam prAsAdam
   māpayiṣyāmaḥ (GBM 1554.2) kiyantaṃ vā. tena hi yūyaṃ grāmaṇyaḥ pūrveṇa	mApayizyAmaH (GBm 1554.2) kiyantam vA. tena hi yUyam grAmaNyaH pUrveNa
   kuśāvatyāṃ dharmyaṃ prāsādaṃ māpayataḥ yojanam āyāmena yojanaṃ vistāreṇa.	kuSAvatyAm Darmyam prAsAdam mApayataH yojanam AyAmena yojanam vistAreNa.
   evaṃ deveti caturaśīti koṭṭarājasahasrāṇi (GBM 1554.3) rājño	evam deva-iti caturaSIti kowwa-rAja-sahasrANi (GBm 1554.3) rAjQaH-
   mahāsudarśanasya pratiśrutya pūrveṇa kuśāvatyāṃ dharmyaṃ prāsādaṃ	mahAsudarSanasya pratiSrutya pUrveNa kuSAvatyAm Darmyam prAsAdam
   māpayanti yojanam āyāmena yojanaṃ vistāreṇa.	mApayanti yojanam AyAmena yojanam vistAreNa.
   MSuAv [10.1] dharmye mahārāja prāsāde (GBM 1554.4) caturvidhāḥ prācīnā	MSuO [10.1] Darmye mahA-rAja prAsAde (GBm 1554.4) caturviDAH prAcInA
   māpitā abhūvaṃ suvarṇamayā rupyamayā vaiḍūryamayā sphaṭikamayāḥ.	mApitAH aBUvam suvarNa-mayAH rupya-mayAH vExUrya-mayA sPawika-mayAH.
   MSuAv [10.2] dharmye prāsāde caturvidhā nyāsā nyastā (sic; Matsumura	MSuO [10.2] Darmye prAsAde caturviDAH nyAsAH nyastAH (sic; Mat-sumura
   nyaktā) abhūvaṃ suvarṇamayā (GBM 1554.5) rupyamayā vaiḍūryamayā	nyaktA) aBUvam suvarNa-mayA (GBm 1554.5) rupya-mayA vExUrya-mayA
   sphaṭikamayāḥ.	sPawika-mayAH.
   MSuAv [10.3] dharmye prāsāde caturvidhā staṃbhā ucchṛtā abhūvaṃ	MSuO [10.3] Darmye prAsAde caturviDA staMBAH ucCRtAH aBUvam
   suvarṇamayā rupyamayā vaiḍūryamayā sphaṭikamayāḥ. suvarṇamayasya (GBM	suvarNa-mayAH rupya-mayAH vExUrya-mayA sPawika-mayAH. suvarNa-mayasya (GBm
   1554.6) staṃbhasya rupyamayaḥ kuṃbhakaḥ tṛkaṭakaḥ śīrṣako gosārako māpito	1554.6) staMBasya rupya-mayaH kuMBakaH tRkawakaH SIrzakaH gosArakaH mApitaH-
   'bhūd. rupyamayasya suvarṇamayo. vaiḍūryamayasya sphaṭikamayaḥ.	aBUt-. rupya-mayasya suvarNam-ayo. vExUrya-mayasya sPawika-mayaH.
   sphaṭikamayasya (GBM 1554.7) staṃbhasya vaiḍūryamayaḥ kuṃbhakaḥ tṛkaṭakaḥ	sPawika-mayasya (GBm 1554.7) staMBasya vExUrya-mayaH kuMBakaH tRkawakaH
   śīrṣako gosārako māpito 'bhūd.	SIrzakaH gosArakaH mApitaH aBUt-.
   MSuAv [10.4] dharmye prāsāde caturvidhā avasaṃgā māpitā abhūvan*	MSuO [10.4] Darmye prAsAde caturviDAH avasaMgAH mApitAH aBUvan*
   sauvarṇamayā rupyamayā (GBM 1554.8) vaiḍūryamayā sphaṭikamayā.	sOvarNa-mayA rupya-mayA (GBm 1554.8) vExUrya-mayA sPawika-mayA.
   MSuAv [1O.5] dharmye prāsāde caturvidhā annāgrā māpitā abhūvaṃ suvarṇamayā	MSuO [1O.5] Darmye prAsAde caturviDAH anna-agrA mApitA aBUvam suvarNa-mayA
   rupyamayā vaiḍūryamayā sphaṭikamayā.	rupya-mayA vExUrya-mayA sPawika-mayA.
   MSuAv [10.6] dharmye prāsāde (GBM 1555.1) caturvidhā baladharaṇyā māpitā	MSuO [10.6] Darmye prAsAde (GBm 1555.1) caturviDA balaDaraNyA mApitA
   abhūvaṃ suvarṇamayyo rupyamayyaḥ vaiḍūryamayyo sphaṭikamayyaḥ.	aBUvam suvarNa-mayyaH rupya-mayyaH vExUrya-mayyaH sPawika-mayyaH.
   MSuAv [lO.7] dharmye prāsāde caturvidhā niryūhā māpitā abhūvan*	MSuO [lO.7] Darmye prAsAde caturviDAH niryUhAH mApitAH aBUvan*
   suvarṇamayāni (GBM 1555.2) rupyamayāni vaiḍūryamayāṇi sphaṭikamayāni.	suvarNa-mayAni (GBm 1555.2) rupya-mayAni vExUrya-mayANi sPawika-mayAni.
   MSuAv [10.8] dharmyaḥ prāsādaś caturvidhaiḥ phalakaiḥ cchanno 'bhūt*	MSuO [10.8] DarmyaH prAsAdaH caturviDEH PalakEH cCannaH aBUt-*
   suvarṇamayai rupyamayaiḥ vaiḍūryamayaiḥ sphaṭikamayaiḥ.	suvarNa-mayEH rupya-mayEH vExUrya-mayEH sPawika-mayEH.
   MSuAv [10.9] dharmye prāsāde (GBM 1555.3) caturvidhāni sopānāni māpitāny	MSuO [10.9] Darmye prAsAde (GBm 1555.3) caturviDAni sopAnAni mApitAni-
   abhūvan* suvarṇamayāni rupyamayāni vaiḍūryamayāni sphaṭikamayāni.	aBUvan* suvarNa-mayAni rupya-mayAni vExUrya-mayAni sPawika-mayAni.
   MSuAv [10.10] dharmyaḥ prāsādaḥ caturvidhābhir vedikābhiḥ parikṣipto 'bhūt	MSuO [10.10] DarmyaH prAsAdaH caturviDABiH vedikABiH parikziptaH aBUt-
   (GBM 1555.4) suvarṇamayībhi rupyamayībhi vaiḍūryamayībhi sphaṭikamayībhiḥ.	(GBm 1555.4) suvarNa-mayIBi rupya-mayIBi vExUrya-mayIBi sPawika-mayIBiH.
   suvarṇamayyā vedikāyāḥ rupyamayaḥ ālaṃbanam adhiṣṭhānaṃ sūcako māpito	suvarNa-mayyAH vedikAyAH rupya-mayaH AlaMbanam aDizWAnam sUcakaH mApitaH-
   'bhūt*. rupyamayyā (GBM 1555.5) suvarṇamayaḥ, vaiḍūryamayyā sphaṭikamayaḥ,	aBUt*. rupya-mayyAH (GBm 1555.5) suvarNa-mayaH, vExUrya-mayyA sPawika-mayaH,
   sphaṭikamayyā vaiḍūryamaya-m-ālaṃbanam adhiṣṭhānaṃ sūcako māpito 'bhūt*.	sPawika-mayyA vExUryam-aya--m-a-AlaMbanam aDizWAnam sUcakaH mApitaH aBUt*.
   MSuAv [10.11] dharmye prāsāde caturvidhāni (GBM 1555.6) kūṭāgārāṇi	MSuO [10.11] Darmye prAsAde caturviDAni (GBm 1555.6) kUwAgArANi
   māpitāni abhūvan* suvarṇamayāni rupyamayāni vaiḍūryamayāni sphaṭikamayāni.	mApitAni aBUvan* suvarNa-mayAni rupya-mayAni vExUrya-mayAni sPawika-mayAni.
   suvarṇamaye kūṭāgāre rupyamayaḥ paryaṃka sthāpito 'bhūt* (GBM 1555.7)	suvarNa-maye kUwAgAre rupya-mayaH paryaMka sTApitaH aBUt* (GBm 1555.7)
   paṭṭikāstṛto goṇikāstṛtas tūlikāstṛtaḥ citṛkāstṛto vyahatikāstṛtaḥ	pawwikAstRtaH goNikAstRtaH tUlikAstRtaH citRkA-AstRtaH vyahatika-AstRtaH
   palalikāstṛtaḥ kāliṃgaprāvārapratyāstaraṇaḥ sottarocchadapaṭaḥ	palalikAstRtaH kAliMga-prAvAra-pratyAstaraNaH sa-uttara-ucCada-pawaH
   ubhayatopahitalohitopadhānaḥ. (GBM 1555.8) rupyamaye suvarṇamayaḥ,	uBayata-upahita-lohita-upaDAnaH. (GBm 1555.8) rupya-maye suvarNa-mayaH,
   vaiḍūryamaye sphaṭikamayaḥ, sphaṭikamaye mahārāja kūṭāgāre vaiḍūryamayaḥ	vExUrya-maye sPawika-mayaH, sPawika-maye mahA-rAja kUwAgAre vExUrya-mayaH
   paryaṅkaḥ sthāpito 'bhūt paṭṭikāstṛto (GBM 1556.1) goṇikāstṛtas	paryaFkaH sTApitaH aBUt pawwikA-AstRtaH (GBm 1556.1) goNikAH-tRtas
   tūlikāstṛtaḥ citrikāstṛtaḥ vyahatikāstṛto palalikāstṛtaḥ	tUlikAstRtaH citrikAstRtaH vyahatikAstRtaH palalikAstRtaH
   kāliṃgaprāvārapratyāstaraṇaḥ sottarocchadapaṭa	kAliMga-prAvAra-pratyAstaraNaH sa-uttara-ucCada-pawa
   ubhayatopahitalohitopadhānaḥ. (GBM 1556.2)	uBayata-upahita-lohita-upaDAnaH. (GBm 1556.2)
   MSuAv [10.12] suvarṇamayasya kūṭāgārasya purastād rupyamayas tālo māpito	MSuO [10.12] suvarNa-mayasya kUwAgArasya purastAt rupya-mayaH tAlaH mApitaH-
   'bhūt suvarṇamayena patreṇa puṣpeṇa phalena. rupyamayasya suvarṇamayo,	aBUt suvarNa-mayena patreNa puzpeNa Palena. rupya-mayasya suvarNam-ayaH-,
   (GBM 1556.3) vaiḍūryamayasya sphaṭikamayaḥ, sphaṭikamayasya kūṭāgārasya	(GBm 1556.3) vExUrya-mayasya sPawika-mayaH, sPawika-mayasya kUwAgArasya
   purastād vaiḍūryamayaḥ tālo māpito 'bhūt sphaṭikamayena patreṇa puṣpeṇa	purastAt vExUrya-mayaH tAlaH mApitaH aBUt sPawika-mayena patreNa puzpeNa
   phalena.	Palena.
   MSuAv [10.13] teṣāṃ khalu (GBM 1556.4) tālānāṃ vāyunā īryamāṇānāṃ ayam	MSuO [10.13] tezAm Kalu (GBm 1556.4) tAlAnAm vAyunA IryamANAnAm ayam
   evaṃrūpo manojñaḥ śabdo niścarati. tadyathā paṃcāṃgikasya tūryasya	evaMrUpaH manojQaH SabdaH niScarati. tat-yaTA paMcAMgikasya tUryasya
   kuśalena puruṣeṇa samyaksupravāditasya. (GBM 1556.5)	kuSalena puruzeNa samyak-su-pravAditasya. (GBm 1556.5)
   MSuAv [10.14] dharmyaḥ prāsādaḥ kanakavālukāstṛto 'bhūc	MSuO [10.14] DarmyaH prAsAdaH kanaka-vAlukA-AstRtaH aBUt-
   candanavāripariṣikto hemajālāvanaddho suvarṇakaṅkaṇikāvṛtaḥ.	candana-vAri-pariziktaH hema-jAla-avanadDaH suvarNa-kaFkaNikA-AvRtaH.
   MSuAv [11] atha caturaśītiḥ koṭṭarājasahasrāṇi (GBM 1556.6)	MSuO [11] aTa caturaSItiH kowwa-rAja-sahasrANi (GBm 1556.6)
   sarvajātakṛtaniṣṭhitaṃ dharmyaṃ prasādaṃ viditvā dharmyasya prāsādasya	sarva-jAta-kRta-nizWitam Darmyam prasAdam viditvA Darmyasya prAsAdasya
   purastād dharmyāṃ puṣkariṇīṃ māpayanti yojanam āyāmena yojanaṃ vistāreṇa.	purastAt DarmyAm puzkariNIm mApayanti yojanam AyAmena yojanam vistAreNa.
   dharmyā (GBM 1556.7) puṣkariṇī caturvidhābhir iṣṭakābhiś citābhūt	DarmyA (GBm 1556.7) puzkariNI caturviDABiH izwakABiH citA-aBUt
   suvarṇamayībhiḥ rupyamayībhi vaiḍūryamayībhiḥ sphaṭikamayībhiḥ. dharmyāyaṃ	suvarNa-mayIBiH rupya-mayIBi vExUrya-mayIBiH sPawika-mayIBiH. Darmya-ayam
   puṣkariṇyāṃ caturvidhāni sopānāni (GBM 1556.8) māpitāny abhūvan	puzkariNyAm caturviDAni sopAnAni (GBm 1556.8) mApitAni aBUvan
   suvarṇamayāni rupyamayāni vaiḍūryamayāni sphaṭikamayāni. dharmyā	suvarNa-mayAni rupya-mayAni vExUrya-mayAni sPawikam-ayAni. DarmyA
   puṣkariṇīś caturvidhābhir vedikābhiḥ parikṣiptābhūt* suvarṇamayībhi (GBM	puzkariNIH caturviDABiH vedikABiH parikziptA-BUt* suvarNa-mayIBi (GBm
   1557.1) rupyamayībhi vaiḍūryamayībhiḥ sphaṭikamayībhiḥ. suvarṇamayyā	1557.1) rupya-mayIBi vExUrya-mayIBiH sPawika-mayIBiH. suvarNa-mayyA
   mahārāja vedikāyā rupyamayam ālaṃbanam adhiṣṭhānaṃ sūcako māpito 'bhūt*.	mahA-rAja vedikAyAH rupya-mayam AlaMbanam aDizWAnam sUcakaH mApitaH aBUt*.
   rupyamayyāḥ suvarṇamayaṃ, (GBM 1557.2) vaiḍūryamayyāḥ sphaṭikamayaṃ,	rupya-mayyAH suvarNa-mayan, (GBm 1557.2) vExUrya-mayyAH sPawika-mayaM,
   sphaṭikamayyāḥ vaiḍūryamayam ālaṃbanam adhiṣṭhānaṃ sūcako māpito 'bhūt*.	sPawika-mayyAH vExUrya-mayam AlaMbanam aDizWAnam sUcakaH mApitaH aBUt*.
   dharmyāṃ puṣkariṇyāṃ vividhāni jalajāni mālyāni ropitāny (GBM 1557.3)	DarmyAm puzkariNyAm viviDAni jala-jAni mAlyAni ropitAni (GBm 1557.3)
   abhūvan tadyathotpalaṃ padmaṃ kumudaṃ puṇḍarīkaṃ saugandhikaṃ	aBUvan tat-yaTA-utpalam padmam kumudam puNxarIkam sOganDikam
   mṛdugandhikaṃ sarvartukaṃ sarvakālikaṃ anāvṛtaṃ sarvajanasya. dharmyāyā	mRdu-ganDikam sarvartukam sarva-kAlikam anAvRtam sarva-janasya. DarmyAyAH-
   mahārāja puṣkariṇyā ubhayatīre (GBM 1557.4) vividhāni sthalajāni mālyāni	mahA-rAja puzkariNyAH uBaya-tIre (GBm 1557.4) viviDAni sTala-jAni mAlyAni
   ropitāny abhūvan* tadyathā atimuktaś caṃpaka pāṭalā vārṣikā mallikā	ropitAni aBUvan* tat-yaTA atimuktaH caMpaka pAwalA vArzikA mallikA
   navamālikā sumanā yūthikā dhānuṣkārī sarvartukaṃ (GBM 1557.5) sarvakālikam	navamAlikA sumanAH yUTikA DAnuzkArI sarvartukam (GBm 1557.5) sarva-kAlikam
   anāvṛtaṃ sarvajanasya. dharmyā puṣkariṇī kanakavālukāstṛtābhūc	anAvRtam sarva-janasya. DarmyA puzkariNI kanaka-vAlukA-AstRtA-aBUc
   candanavāriṣiktā hemajālāvanatā suvarṇakaṃkaṇikāvṛtā.	candana-vAriziktA hema-jAla-avanatA suvarNa-kaMkaNikA-AvRtA.
   MSuAv [12] atha caturaśīti (GBM 1557.6) koṭṭarājasahasrāṇi	MSuO [12] aTa caturaSIti (GBm 1557.6) kowwa-rAja-sahasrANi
   sarvajātakṛtaniṣṭhitāṃ dharmyāṃ puṣkariṇīṃ viditvā dharmyāyāḥ puṣkariṇyā	sarva-jAta-kRta-nizWitAm DarmyAm puzkariNIm viditvA DarmyAyAH puzkariNyA
   purastād dharmyaṃ tālavanaṃ māpayanti yojanam āyāmena (GBM 1557.7) yojanaṃ	purastAt Darmyam tAla-vanam mApayanti yojanam AyAmena (GBm 1557.7) yojanam
   vistāreṇa. dharmye mahārāja tālavane caturvidhās tālā māpitā abhūvan*	vistAreNa. Darmye mahA-rAja tAla-vane caturviDAH tAlAH mApitAH aBUvan*
   suvarṇamayā rupyamayā vaiḍūryamayā sphaṭikamayā. suvarṇamayasya (GBM	suvarNa-mayAH rupya-mayA vExUrya-mayA sPawika-mayA. suvarNa-mayasya (GBm
   1557.8) tālasya rupyamayaṃ patraṃ puṣpaṃ phalaṃ māpitam abhūd.	1557.8) tAlasya rupya-mayam patram puzpam Palam mApitam aBUt-.
   rupyamayasya suvarṇamayaṃ, vaiḍūryamayasya sphaṭikamayaṃ, sphaṭikamayasya	rupya-mayasya suvarNa-mayan, vExUrya-mayasya sPawika-mayan, sPawika-mayasya
   vaiḍūryamayaṃ patraṃ puṣpaṃ phalaṃ (GBM 1558.1) māpitam abhūt. teṣāṃ khalu	vExUrya-mayam patram puzpam Palam (GBm 1558.1) mApitam aBUt. tezAm Kalu
   tālānāṃ vāyunā īryamanānām ayaṃ evaṃrūpo manojñaḥ śabdo niścarati.	tAlAnAm vAyunA Irya-manAnAm ayam evaMrUpaH manojQaH SabdaH niScarati.
   tadyathā paṃcāṃgikasya tūryasya kuśalena puruṣeṇa (GBM 1558.2)	tat-yaTA paMcAMgikasya tUryasya kuSalena puruzeNa (GBm 1558.2)
   samyaksupravāditasya. dharmyaṃ tālavanaṃ caturvidhābhir vedikābhiḥ	samyak-su-pravAditasya. Darmyam tAla-vanam caturviDABiH vedikABiH
   parikṣiptam abhūt suvarṇamayībhi rupyamayībhiḥ vaiḍūryamayībhiḥ	parikziptam aBUt suvarNa-mayIBi rupya-mayIBiH vExUrya-mayIBiH
   sphaṭikamayībhiḥ. suvarṇamayyā (GBM 1558.3) vedikāyā rupyamayam ālaṃbanam	sPawika-mayIBiH. suvarNa-mayyA (GBm 1558.3) vedikAyAH rupya-mayam AlaMbanam
   adhiṣṭhānaṃ sūcako māpito 'bhūt*. rupyamayyā suvarṇamayaṃ, vaiḍūryamayyā	aDizWAnam sUcakaH mApitaH aBUt-*. rupya-mayyA suvarNa-mayan, vExUrya-mayyA
   sphaṭikamayaṃ, sphaṭikamayyā vaiḍūryamayam ālaṃbanam (GBM 1558.4)	sPawika-mayan, sPawika-mayyAH vExUrya-mayam AlaMbanam (GBm 1558.4)
   adhiṣṭhānaṃ sūcako māpito 'bhūt*. dharmyaṃ tālavanaṃ kanakavālukāstṛtam	aDizWAnam sUcakaH mApitaH aBUt-*. Darmyam tAla-vanam kanaka-vAlukA-AstRtam
   abhūc candanavāripariṣiktaṃ hemajālāvanataṃ suvarṇakaṃkaṇikāvṛtam. (GBM	aBUt candana-vAri-pariziktam hema-jAla-avanatam suvarNa-kaMkaNikA-AvRtam. (GBm
   MSuAv [13.1] atha caturaśīti koṭṭarājasahasrāṇi sarvajātakṛtaniṣṭhitaṃ	MSuO [13.1] aTa caturaSIti kowwa-rAja-sahasrANi sarva-jAta-kRta-nizWitam
   dharmyaṃ prāsādaṃ dharmyāṃ puṣkariṇīṃ dharmyaṃ tālavanaṃ viditvā yena rājā	Darmyam prAsAdam DarmyAm puzkariNIm Darmyam tAla-vanam viditvA yena rAjA
   mahāsudarśanas (GBM 1558.6) tenopasaṃkrāntāny. upasaṃkramya rājānaṃ	mahAsudarSanaH (GBm 1558.6) tena-upasaMkrAntAny. upasaMkramya rAjAnam
   mahāsudarśanam idam avocan*. sarvajātakṛtaniṣṭhito devasya dharmyaḥ	mahAsu-darSanam idam avocan*. sarva-jAta-kRta-nizWitaH devasya DarmyaH
   prāsādo dharmyā puṣkariṇī (GBM 1558.7) dharmyaṃ tālavanaṃ. yasyedānīṃ	prAsAdaH DarmyA puzkariNI (GBm 1558.7) Darmyam tAla-vanan. yasya-idAnIm
   devaḥ kālaṃ manyate. atha rājño mahāsudarśanasyaitad abhavan. na mama	devaH kAlam manyate. aTa rAjQaH mahAsudarSanasya-etat aBavan. na mama
   pratirūpaṃ syād yad aham evam eva tatprathamato dharmyaṃ prāsādam	pratirUpam syAt yat aham evam eva tat-praTamatas Darmyam prAsAdam
   adhinivaseyaṃ. (GBM 1558.8) yanv ahaṃ ye me vijite sādhurūpasaṃmatāḥ	aDinivaseyaM. (GBm 1558.8) yanu aham ye me vijite sADu-rUpa-saMmatAH
   śramaṇabrāhmaṇāḥ prativasanti te tāṃ dharmye prāsāde bhojayitvā	SramaNa-brAhmaNAH prativasanti te tAm Darmye prAsAde BojayitvA
   pratyekapratyekaṃ navena duṣyayugenācchadayeyam. (GBM 1559.1)	pratyeka-pratyekam navena duzya-yugena-AcCadayeyam. (GBm 1559.1)
   MSuAv [13.2] atha rājā mahāsudarśano ye 'sya vijite sādhurūpasaṃmatāḥ	MSuO [13.2] aTa rAjA mahAsudarSanaH ye asya vijite sADu-rUpa-saMmatAH
   śrāmaṇabrāhmaṇāḥ prativasanti tāṃ dharmye prāsāde bhojayitvā	SrAmaNa-brAhmaNAH prativasanti tAm Darmye prAsAde BojayitvA
   pratyekapratyekaṃ (GBM 1559.2) navena duṣyayugenācchādayati. atha rājño	pratyeka-pratyekam (GBm 1559.2) navena duzya-yugena-AcCAdayati. aTa rAjQaH-
   mahāsudarśanasyaitad abhavan. na mama pratirūpaṃ syād yad ahaṃ dharmye	mahAsudarSanasya-etat aBavan. na mama pratirUpam syAt yat aham Darmye
   prāsāde paṃcabhiḥ kāmaguṇais samarpitaḥ (GBM 1559.3) samanvaṃgībhūtaḥ	prAsAde paMcaBiH kAma-guNEH samarpitaH (GBm 1559.3) samanvaMgIBUtaH
   krīḍeyaṃ rameyaṃ paricārayeyaṃ. yanv ahaṃ dharmyaṃ prāsādaṃ abhiruhy';	krIxA-iyam rameyam paricArayeyan. yanu aham Darmyam prAsAdam aBiruhy-a;
   ekena puruṣeṇopasthāyakena rājarṣibrahmacaryaṃ careyaṃ. (GBM 1559.4) atha	ekena puruzeNa-upasTAyakena rAjarzi-brahmacaryam careyaM. (GBm 1559.4) aTa
   rājā mahāsudarśano dharmyaṃ prāsādam abhiruhy'; ekena puruṣeṇopasthāyakena	rAjA mahAsudarSanaH Darmyam prAsAdam aBiruhy-a; ekena puruzeNa-upasTAyakena
   rājarṣibrahmacaryam acārṣīd.	rAjarzi-brahmacaryam acArzId.
   MSuAv [14] atha rājā mahāsudarśanaḥ suvarṇamayaṃ (GBM 1559.5) kūṭāgāraṃ	MSuO [14] aTa rAjA mahAsudarSanaH suvarNa-mayam (GBm 1559.5) kUwAgAram
   praviśya rupyamaye paryaṃke paryaṃkena niṣadya viviktaṃ kāmair viviktaṃ	praviSya rupya-maye paryaMke paryaMkena nizadya viviktam kAmEH viviktam
   pāpakair akuśalair dharmaiḥ savitarkaṃ savicāraṃ vivekajaṃ (GBM 1559.6)	pApakEH akuSalEH DarmEH sa-vitarkam sa-vicAram viveka-jam (GBm 1559.6)
   prītisukhaṃ prathamaṃ dhyānam upasaṃpadya viharati. rupyamayā paryaṃkād	prIti-suKam praTamam DyAnam upasaMpadya viharati. rupya-mayA paryaMkAt-
   avatīrya suvarṇamayāt kūṭāgārān niṣkramya rupyamayaṃ kūṭāgāraṃ praviśya	avatIrya suvarNa-mayAt kUwAgArAn nizkramya rupya-mayam kUwAgAram praviSya
   suvarṇamaye (GBM 1559.7) paryaṃke paryaṃkena niṣadya viviktaṃ kāmair yāvat	suvarNa-maye (GBm 1559.7) paryaMke paryaMkena nizadya viviktam kAmEH yAvat-
   prathamaṃ dhyānam upasaṃpadya viharati. suvarṇamayāt paryaṃkād avatīrya	praTamam DyAnam upasaMpadya viharati. suvarNa-mayAt paryaMkAt avatIrya
   rupyamayāt kūṭāgārān niṣkramya vaiḍūryamayaṃ (GBM 1559.8) kūṭāgāraṃ	rupya-mayAt kUwAgArAn nizkramya vExUrya-mayam (GBm 1559.8) kUwAgAram
   praviśya sphaṭikamaye paryaṃke paryaṃkena niṣadya viviktaṃ kāmair yāvat	praviSya sPawika-maye paryaMke paryaMkena nizadya viviktam kAmEH yAvat-
   prathamaṃ dhyānam upasaṃpadya viharati. sphaṭikamayāt paryaṃkād avatīrya	praTamam DyAnam upasaMpadya viharati. sPawika-mayAt paryaMkAt avatIrya
   (GBM 1560.1) vaiḍūryamayāt kūṭāgāran niṣkramya sphaṭikamayaṃ kūṭāgāraṃ	(GBm 1560.1) vExUrya-mayAt kUwAgAran nizkramya sPawika-mayam kUwa-AgAram
   praviśya vaiḍūryamaye paryaṃke paryaṃkena niṣadya viviktaṃ kāmair yāvat	praviSya vExUrya-maye paryaMke paryaMkena nizadya viviktam kAmEH yAvat-
   prathamaṃ dhyānam upasaṃpadya (GBM 1560.2) viharati.	praTamam DyAnam upasaMpadya (GBm 1560.2) viharati.
   MSuAv [15] atha caturaśīti strīsahasrāṇi yena strīratnaṃ tenopasaṃkrāntā	MSuO [15] aTa caturaSIti strI-sahasrANi yena strI-ratnam tena-upasaMkrAntA
   upasaṃkramya strīratnam idam avocan*. yat khalu devi jānīthā, ciradṛṣṭo	upasaMkramya strI-ratnam idam avocan*. yat Kalu devi jAnITA, cira-dRzwaH-
   'smābhir (GBM 1560.3) devaḥ, paritṛṣitāḥ smo devasya darśanena, icchāmo	asmABiH (GBm 1560.3) devaH, paritRzitAH smaH devasya darSanena, icCAmaH-
   vayaṃ devaṃ draṣṭuṃ. tena hi yūyaṃ bhaginyaḥ āgamayata yāvad ahaṃ	vayam devam drazwuM. tena hi yUyam BaginyaH Agamayata yAvat aham
   pariṇāyakaratnam avalokayāmi. atha (GBM 1560.4) strīratnaṃ	pariNAyaka-ratnam avalokayAmi. aTa (GBm 1560.4) strI-ratnam
   pariṇāyakaratnaṃ dūtena prakrośyedam avocat*. yat khalu senāpate jānīyāc,	pariNAyaka-ratnam dUtena prakroSya-idam avocat*. yat Kalu senApate jAnIyAc,
   ciradṛṣṭo 'smābhir deva, paritṛṣitā smo devasya darśanena, (GBM 1560.5)	cira-dRzwaH asmABiH deva, paritRzitA smaH devasya darSanena, (GBm 1560.5)
   icchāmo vayaṃ devaṃ draṣṭuṃ. tena hi yūyaṃ bhaginyaḥ sarvā pītālaṃkārā	icCAmaH vayam devam drazwuM. tena hi yUyam BaginyaH sarvA pIta-alaMkArA
   bhavata pītavastrā pītamālyābharaṇānulepanā pītaparivārā. yāvad (GBM	Bavata pIta-vastrA pIta-mAlya-ABaraNa-anulepanA pIta-parivArA. yAvat (GBm
   1560.6) ahaṃ caturaśītiṃ koṭṭarājasahasrāṇi sannipātayāmi, caturaśītiṃ	1560.6) aham caturaSItim kowwa-rAja-sahasrANi sannipAtayAmi, caturaSItim
   nāgasahasrāṇy upoṣadhanāgarājapramukhāni, caturaśītim aśvasahasrāṇi (GBM	nAga-sahasrANi upozaDa-nAga-rAja-pramuKAni, caturaSItim aSva-sahasrANi (GBm
   1560.7) vālāhāśvarājapramukhāni, caturaśīti rathasahasrāṇi	1560.7) vAlAha-aSva-rAja-pramuKAni, caturaSIti raTa-sahasrANi
   nandīghoṣarathapramukhāni. tathā bhavatv iti tāḥ śriyaḥ pratiśrutya (GBM	nandI-Goza-raTa-pramuKAni. taTA Bavatu iti tAH SriyaH pratiSrutya (GBm
   1560.8) striyaḥ sarvāḥ pītālaṃkārābhūvaṃ pītavastrāḥ	1560.8) striyaH sarvAH pIta-alaMkAra-aBUvam pIta-vastrAH
   pītamālyābharaṇānulepanāḥ pītaparivārāḥ. atha pariṇāyakaratnaṃ caturaśītiṃ	pIta-mAlya-ABaraNa-anulepanAH pIta-parivArAH. aTa pariNAyaka-ratnam caturaSItim
   koṭṭarājasahasrāṇi (GBM 1561.1) sannipātya, caturaśīti nāgasahasrāṇi	kowwa-rAja-sahasrANi (GBm 1561.1) sannipAtya, caturaSIti nAga-sahasrANi
   poṣadhanāgarājapramukhāni, caturaśītiṃ aśvasahasrāṇi	pozaDa-nAga-rAja-pramuKAni, caturaSItim aSva-sahasrANi
   vālāhāśvarājapramukhāni, caturaśītiṃ rathasahasrāṇi (GBM 1561.2)	vAlAha-aSva-rAja-pramuKAni, caturaSItim raTa-sahasrANi (GBm 1561.2)
   nandīghoṣarathapramukhāni sannipātya, strīratnaṃ nandīghoṣarathe āropya,	nandI-Goza-raTa-pramuKAni sannipAtya, strI-ratnam nandI-Goza-raTe Aropya,
   avaśiṣṭā striyaḥ pratyekapratyekaratheṣv āropya, kuśāvatyā niṣkramya, (GBM	avaSizwA striyaH pratyeka-pratyeka-raTezu Aropya, kuSAvatyAH nizkramya, (GBm
   1561.3) yena dharmyaḥ prāsādas tenopasaṃkrāntāḥ. tena khalu samayena	1561.3) yena DarmyaH prAsAdaH tena-upasaMkrAntAH. tena Kalu samayena
   dharmyasya prāsādasyādhastād uccaśabdamahāśabdo mahājanakāyasya ca	Darmyasya prAsAdasya-aDastAt ucca-Sabda-mahA-SabdaH mahA-jana-kAyasya ca
   nirghoṣo 'bhud.	nirGozaH aBud.
   MSuAv [16] aśrauṣīd (GBM 1561.4) rājā mahāsudarśano dharmyasya	MSuO [16] aSrOzIt (GBm 1561.4) rAjA mahAsudarSanaH Darmyasya
   prāsādasyādhastād uccaśabdamahāśabdo mahājanakāyasya ca nirghoṣo 'bhūc.	prAsAdasya-aDastAt ucca-Sabda-mahA-SabdaH mahA-jana-kAyasya ca nirGozaH aBUt-.
   chrutva ca punar upasthāyakaṃ puruṣam āmantrayate. (GBM 1561.5) kim etad	Crutva ca punar upasTAyakam puruzam Amantrayate. (GBm 1561.5) kim etat-
   bhoḥ puruṣa dharmyasya prāsādasyādhastād uccaśabdamahāśabdo	BoH puruza Darmyasya prAsAdasya-aDastAt ucca-Sabda-mahA-SabdaH-
   mahājanakāyasya ca nirghoṣaḥ. etāni deva caturaśītiṃ strīsahasrāṇi (GBM	mahA-jana-kAyasya ca nirGozaH. etAni deva caturaSItim strI-sahasrANi (GBm
   1561.6) strīratnapramukhāni dharmyasya prāsādasyādhastāt tiṣṭhanti devaṃ	1561.6) strI-ratna-pramuKAni Darmyasya prAsAdasya-aDastAt tizWanti devam
   draṣṭukāmāni, caturaśītiḥ koṭṭarājasahasrāṇi pariṇāyakaratnapramukhāni,	drazwu-kAmAni, caturaSItiH kowwa-rAja-sahasrANi pariNAyaka-ratna-pramuKAni,
   (GBM 1561.7) caturaśīti nāgasahasrāṇy upoṣadhanāgarājapramukhāni,	(GBm 1561.7) caturaSIti nAga-sahasrANi upozaDa-nAga-rAja-pramuKAni,
   caturaśītim aśvasahasrāṇi vālāhāśvarājapramukhāni, caturaśītiṃ	caturaSItim aSva-sahasrANi vAlAha-aSva-rAja-pramuKAni, caturaSItim
   rathasahasrāṇi (GBM 1561.8) nandīghoṣarathapramukhāni dharmyasya	raTa-sahasrANi (GBm 1561.8) nandI-Goza-raTa-pramuKAni Darmyasya
   prāsādasyādhastāt tiṣṭhanti. atha rājā mahāsudarśana upasthāyakaṃ puruṣam	prAsAdasya-aDastAt tizWanti. aTa rAjA mahAsudarSanaH upasTAyakam puruzam
   āmantrayate. tena hi tvaṃ bhoḥ (GBM 1562.1) puruṣa dharmyasya	Amantrayate. tena hi tvam BoH (GBm 1562.1) puruza Darmyasya
   prāsādasyādhastāt sauvarṇaṃ bhadrāsanaṃ prajñapaya, yatrāhaṃ niṣadya	prAsAdasya-aDastAt sOvarNam BadrAsanam prajQapaya, yatra-aham nizadya
   mahājanakāyam apekṣyāmy. evaṃ devety upasthāyakaḥ puruṣo rājño	mahA-jana-kAyam apekzyAmy. evam deva-iti upasTAyakaH puruzaH rAjQaH-
   mahāsudarśanasya (GBM 1562.2) pratiśrutya dharmyasya prāsādasyādhastāt	mahAsudarSanasya (GBm 1562.2) pratiSrutya Darmyasya prAsAdasya-aDastAt-
   sauvarṇaṃ bhadrāsanaṃ prajñapya yena rājā mahāsudarśanas tenopasaṃkrāntaḥ.	sOvarNam BadrAsanam prajQapya yena rAjA mahA-sudarSanaH tena-upasaMkrAntaH.
   upasaṃkramya rājānaṃ mahāsudarśanam (GBM 1562.3) idam avocat. prajñaptaṃ	upasaMkramya rAjAnam mahAsudarSanam (GBm 1562.3) idam avocat. prajQaptam
   devasya dharmyasya prāsādasyādhastāt sauvarṇaṃ bhadrāsanaṃ. yasyedānīṃ	devasya Darmyasya prAsAdasya-aDastAt sOvarNam BadrAsanaM. yasya-idAnIm
   devaḥ kālaṃ manyate.	devaH kAlam manyate.
   MSuAv [17] adrākṣīd rājā mahāsudarśano dharmyāt (GBM 1562.4) prāsādād	MSuO [17] adrAkzIt rAjA mahAsudarSanaH DarmyAt (GBm 1562.4) prAsAdAt-
   avatāran* (sic; Matsumura: dha(rmasya prāsādasyādhastā)t) sarvās tāḥ	avatAran* (sic; Mat-sumura: Da(rmasya prAsAdasya-aDasta-a)t) sarvAH tAH
   striyaḥ pītālaṃkārāḥ pītavastrāḥ pītamālyābharaṇānulepanāḥ pītaparivārāḥ.	striyaH pIta-alaMkArAH pIta-vastrAH pIta-mAlya-ABaraNa-anulepanAH pIta-parivArAH.
   dṛṣṭvā ca punar asyaitad (GBM 1562.5) abhavat. atirañjanīyo batāyaṃ	dRzwvA ca punar asya-etat (GBm 1562.5) aBavat. atiraQjanIyaH bata-ayam
   mātṛgrāma iti viditvā indriyāṇy utkṣipaty. adrākṣī strīratnaṃ rājānaṃ	mAtR-grAmaH iti viditvA indriyANi utkzipaty. adrAkzI strI-ratnam rAjAnam
   mahāsudarśanam indriyāṇy utkṣipantaṃ (GBM 1562.6) dṛṣṭvā punar asyā etad	mahAsu-darSanam indriyANi utkzipantam (GBm 1562.6) dRzwvA punar asyAH etat-
   abhavad. yathā khalu devo 'smākaṃ dṛṣṭvā indriyāṇy utkṣipati. mā haiva	aBavad. yaTA Kalu devaH asmAkam dRzwvA indriyANi utkzipati. mA ha-eva
   devo 'smābhir anarthiko bhaviṣyatīti. atha rājā mahāsudarśano (GBM 1562.7)	devaH asmABiH anarTikaH Bavizyati-iti. aTa rAjA mahAsudarSanaH (GBm 1562.7)
   dharmyāt prāsādād avatīrya sauvarṇe bhadrāsane niṣaṇṇo. 'tha strīratnaṃ	DarmyAt prAsAdAt avatIrya sOvarNe BadrAsane nizaNNo. aTa strI-ratnam
   yena rajā mahāsudarśanas tenopasaṃkrāntam. upasaṃkramya rājño (GBM 1562.8)	yena rajAH mahAsudarSanaH tena-upasaMkrAntam. upasaMkramya rAjQaH (GBm 1562.8)
   mahāsudarśanasya pādayor nipatya rājānaṃ mahāsudarśanam idam avocat*.	mahAsudarSanasya pAdayoH nipatya rAjAnam mahA-sudarSanam idam avocat*.
   etāni devasya caturaśītiḥ strīsahasrāṇi, yatra devac chandaṃ janayatv	etAni devasya caturaSItiH strI-sahasrANi, yatra devat Candam janayatv
   apekṣāṃ karotu devo (GBM 1563.1) jīvite. caturaśīti koṭṭarājasahasrāṇi	apekzAm karotu devaH (GBm 1563.1) jIvite. caturaSIti kowwa-rAja-sahasrANi
   pariṇāyakaratnapramukhāni, caturaśīti nāgasahasrāṇy	pariNAyaka-ratna-pramuKAni, caturaSIti nAga-sahasrANi-
   upoṣadhanāgarājapramukhāni, caturaśītim (GBM 1563.2) aśvasahasrāṇi	upozaDa-nAga-rAja-pramuKAni, caturaSItim (GBm 1563.2) aSva-sahasrANi
   vālāhāśvarājapramukhāni, caturaśītiṃ rathasahasrāṇi	vAlAha-aSva-rAja-pramuKAni, caturaSItim raTa-sahasrANi
   nandīghoṣarathapramukhāni, caturaśītin nagarasahasrāṇi	nandI-Goza-raTa-pramuKAni, caturaSItin nagara-sahasrANi
   kuśāvatīrājadhānīpramukhāni, (GBM 1563.3) atra devac chandaṃ janayatv	kuSAvatI-rAjaDAnI-pramuKAni, (GBm 1563.3) atra devat Candam janayatv
   apekṣāṃ karotu devo jīvite. pūrve ca tvaṃ māṃ bhagini mitravattayā	apekzAm karotu devaH jIvite. pUrve ca tvam mAm Bagini mitravat-tayA
   samudācarasi sā tvam etarhi sapatnavattayā. (GBM 1563.4)	samudAcarasi sA tvam etarhi sapatnavat-tayA. (GBm 1563.4)
   MSuAv [18] atha strīratnaṃ rājñā mahāsudarśanena bhaginivādena	MSuO [18] aTa strI-ratnam rAjQA mahAsudarSanena Bagi-nivAdena
   samudācaritaṃ prārodīd, aśrūṇi pravartayaty, evaṃ cāha. yathā khalu devo	samudAcaritam prArodId, aSrUNi pravartayaty, evam ca-aha. yaTA Kalu devaH-
   'smākaṃ (GBM 1563.5) bhaginivādena samudācarati na cirā devāsmākaṃ devena	asmAkam (GBm 1563.5) Bagi-nivAdena samudAcarati na cirAH deva-asmAkam devena
   sārdhaṃ nānābhāvo bhaviṣyati vinābhāvo viprayogo visaṃyogaḥ. atha	sArDam nAnABAvaH Bavizyati vinA-aBAvaH viprayogaH visaMyogaH. aTa
   strīratnaṃ cīvareṇāśrūṇi (GBM 1563.6) pramṛjya [O. von Hinüber, "Die	strI-ratnam cIvareNa-aSrUNi (GBm 1563.6) pramRjya [O. von Hinüber, "Die
   Bestimmung der Schulzugehörigkeit buddhistischer Texte nach sprachlichen	Bestimmung deH SSulzu-gehö-rigkeit budDiH-tisCeH Texte naH spraCliCet-
   Kriterien", Zur Schulzugehörigkeit von Werken der Hīnayāna-Literatur	KriteH-ien", ZuH SSulzu-gehörigkeit von Werken deH HIna-yAna--Literatur
   (Symposium zur Buddhismusforschung, III,1), ed. H. Bechert, Göttingen 1985	(Symposium zuH BudDi-smusfoH-H-Cung, III,1), ed. H. BeCert, Göttinget 1985
   (AAWG, 149), Erster Teil, pp. 73, Anm. 46: puṃjya] rājño mahāsudarśanasya	(AAWG, 149), EH-steH Teil, pp. 73, Anm. 46: puMjya] rAjQaH mahAsudarSanasya
   pādayor nipatya rājānaṃ mahāsudarśanam idam avocat*. yathā kathaṃ pūrve	pAdayoH nipatya rAjAnam mahA-sudarSanam idam avocat*. yaTA kaTam pUrve
   vayaṃ devaṃ mitravattayā samudācarāmas (GBM 1563.7) tathā vayam etarhi	vayam devam mitravat-tayA samudAcarAmaH (GBm 1563.7) taTA vayam etarhi
   samudācarāmo na sapatnavattayā. ehi tvaṃ bhaginy, evaṃ vada. alpakaṃ deva	samudAcarAmaH na sapatnavat-tayA. ehi tvam Baginy, evam vada. alpakam deva
   jīvitaṃ manuṣyāṇāṃ. gamanīyaḥ saṃparāyaḥ, kartavyaṃ (GBM 1563.8) kuśalaṃ,	jIvitam manuzyANAM. gamanIyaH saMparAyaH, kartavyam (GBm 1563.8) kuSalaM,
   caritavyaṃ brahmacaryaṃ. nāsti jātasyāmaraṇaṃ. so 'pi deva	caritavyam brahmacaryan. na-asti jAtasya-amaraNaM. saH api deva
   kṣaṇalavamuhūrto na prajñāyate yatra devasya sarveṇa sarvaṃ śarīranikṣepo	kzaNa-lava-muhUrtaH na prajQAyate yatra devasya sarveNa sarvam SarIra-nikzepaH-
   bhaviṣyati. (GBM 1564.1) yo devasya caturaśītiṣu strīsahasreṣu cchando vā	Bavizyati. (GBm 1564.1) yaH devasya caturaSItizu strI-sahasrezu cCandaH vA
   rāgo vā sneho vā prema vā ālayo vā niyantir adhyavasānaṃ vā taṃ devaḥ	rAgaH vA snehaH vA prema vA AlayaH vA niyantiH aDyavasAnam vA tam devaH
   prajahātu nirapekṣo (GBM 1564.2) devo bhavatu jīvite. yo devasya	prajahAtu nirapekzaH (GBm 1564.2) devaH Bavatu jIvite. yaH devasya
   caturaśītiṣu koṭṭarājasahasreṣu pariṇāyakaratnapramukheṣu, caturaśītiṣu	caturaSItizu kowwa-rAja-sahasrezu pariNAyaka-ratna-pramuKa-izu, caturaSItizu
   nāgasahasreṣūpoṣadhanāgarājapramukheṣu, (GBM 1564.3)	nAga-sahasrezu-upozaDa-nAga-rAja-pramuKa-izu, (GBm 1564.3)
   caturaśītiṣu-r-aśvasahasreṣu vālāhāśvarājapramukheṣu, caturaśītiṣu	caturaSItizu-r-aSva-sahasrezu vAlAha-aSva-rAja-pramuKa-izu, caturaSItizu
   rathasahasreṣu nandīghoṣarathapramukheṣu, caturaśītiṣu (GBM 1564.4)	raTa-sahasrezu nandI-Goza-raTa-pramuKa-izu, caturaSItizu (GBm 1564.4)
   nagarasahasreṣu kuśāvatīrājadhānīpramukheṣu cchando vā rāgo vā sneho vā	nagara-sahasrezu kuSAvatI-rAjaDAnI-pramuKezu cCandaH vA rAgaH vA snehaH vA
   prema vā ālayo vā niyantir adhyavasānaṃ (GBM 1564.5) vā taṃ devaḥ	prema vA AlayaH vA niyantiH aDyavasAnam (GBm 1564.5) vA tam devaH
   parijahātu nirapekṣo devo bhavatu jīvite. evaṃ hi tvaṃ bhagini	parijahAtu nirapekzaH devaH Bavatu jIvite. evam hi tvam Bagini
   mitravattayā samudācara mā sapatnavattayā.	mitravat-tayA samudAcara mA sapatnavat-tayA.
   MSuAv [19] idānīṃ vayaṃ devaṃ (GBM 1564.6) mitravattayā samudacarāmo, na	MSuO [19] idAnIm vayam devam (GBm 1564.6) mitravat-tayA samudacarAmo, na
   sapatnavattayā. alpakaṃ deva jīvitaṃ manuṣyāṇāṃ gamanīyaḥ sāṃparāyaḥ,	sapatnavat-tayA. alpakam deva jIvitam manuzyANAm gamanIyaH sAMparAyaH,
   kartavyaṃ kuśalaṃ, caritavyaṃ brahmacaryaṃ. (GBM 1564.7) nāsti	kartavyam kuSalaM, caritavyam brahmacaryaM. (GBm 1564.7) na-asti
   jātasyāmaraṇaṃ so 'pi deva kṣaṇalavamuhūrto na prajñāyate yatra devasya	jAtasya-amaraNam saH api deva kzaNa-lava-muhUrtaH na prajQAyate yatra devasya
   sarveṇa sarvaṃ śarīranikṣepo bhaviṣyati. yo devasya caturaśītiṣu (GBM	sarveNa sarvam SarIra-nikzepaH Bavizyati. yaH devasya caturaSItizu (GBm
   1564.8) strīsahasreṣu cchando vā rāgo vā sneho vā prema vā ālayo vā	1564.8) strI-sahasrezu cCandaH vA rAgaH vA snehaH vA prema vA AlayaH vA
   niyantir adhyavasānaṃ vā taṃ devaḥ prajahātu nirapekṣo devo bhavatu	niyantiH aDyavasAnam vA tam devaH prajahAtu nirapekzaH devaH Bavatu
   jīvite. (GBM 1565.1) yo devasya caturaśītiṣu koṭṭarājasahasreṣu	jIvite. (GBm 1565.1) yaH devasya caturaSItizu kowwa-rAja-sahasrezu
   pariṇāyakaratnapramukheṣu, caturaśītiṣu nāgasahasreṣu	pariNAyaka-ratna-pramuKa-izu, caturaSItizu nAga-sahasrezu
   upoṣadhanāgarājapramukheṣu, caturaśītiṣv (GBM 1565.2) aśvasahasreṣu	upozaDa-nAga-rAja-pramuKa-izu, caturaSItizu (GBm 1565.2) aSva-sahasrezu
   vālāhāśvarājapramukheṣu, caturaśītiṣu rathasahasreṣu	vAlAha-aSva-rAja-pramuKa-izu, caturaSItizu raTa-sahasrezu
   nandīghoṣarathapramukheṣu, caturaśītiṣu nagarasahasreṣu	nandI-Goza-raTa-pramuKa-izu, caturaSItizu nagara-sahasrezu
   kuśāvatīrājadhānīpramukheṣu (GBM 1565.3) cchando va rāgo vā sneho vā prema	kuSAvatI-rAjaDAnI-pramuKezu (GBm 1565.3) cCandaH va rAgaH vA snehaH vA prema
   vā ālayo vā niyantir adhyavasānaṃ vā taṃ devaḥ prajahātu nirapekṣo devo	vA AlayaH vA niyantiH aDyavasAnam vA tam devaH prajahAtu nirapekzaH devaH-
   bhavatu jīvite.	Bavatu jIvite.
   MSuAv [20] atha rājā mahāsudarśanaḥ (GBM 1565.4) strīratnenānenāvavādena	MSuO [20] aTa rAjA mahAsudarSanaH (GBm 1565.4) strI-ratnena-anena-avavAdena
   codito dharmyaṃ prāsādam abhiruhya suvarṇamayaṃ kūṭāgāraṃ praviśya	coditaH Darmyam prAsAdam aBiruhya suvarNa-mayam kUwAgAram praviSya
   rupyamaye paryaṃke paryaṃkena niṣadya maitrīsahagatena (GBM 1565.5)	rupya-maye paryaMke paryaMkena nizadya mEtrI-saha-gatena (GBm 1565.5)
   cittenāvaireṇāsapatnenāvyābādhena vipulena mahadgatenāpramāṇena	cittena-avEreNa-Asapatnena-avyAbADena vipulena mahat-gatena-apramANena
   subhāvitenaikāṃ diśam adhimucya spharitvopasaṃpadya viharati. (GBM 1565.6)	su-BAvitena-ekAm diSam aDimucya sParitvA-upasaMpadya viharati. (GBm 1565.6)
   tathā dvitīyāṃ tathā tṛtīyāṃ tathā caturthīm ity ūrdhvam adhas tiryak	taTA dvitIyAm taTA tRtIyAm taTA caturTIm iti UrDvam aDas tiryak-
   sarvaśas sarvam imaṃ lokaṃ maitrīsahagatena	sarvaSas sarvam imam lokam mEtrI-saha-gatena
   cittenāvaireṇāsapatnenāvyābādhena (GBM 1565.7) vipulena	cittena-avEreNa-Asapatnena-avyAbADena (GBm 1565.7) vipulena
   mahadgatenāpramāṇena subhāvitenaikāṃ diśam adhimucya spharitvopasaṃpadya	mahat-gatena-apramANena su-BAvitena-ekAm diSam aDimucya sParitvA-upasaMpadya
   viharati. rupyamayāt paryaṃkād avatīrya suvarṇamayāt kūṭāgārān niṣkramya	viharati. rupya-mayAt paryaMkAt avatIrya suvarNa-mayAt kUwAgArAn nizkramya
   rupyamayaṃ (GBM 1565.8) kūṭāgāraṃ praviśya suvarṇamaye paryaṃke paryaṃkena	rupya-mayam (GBm 1565.8) kUwAgAram praviSya suvarNa-maye paryaMke paryaMkena
   niṣadya karuṇāsahagatena cittenāvaireṇa yāvad adhimucya	nizadya karuNA-sahagatena cittena-avEreNa yAvat aDimucya
   spharitvopasaṃpadya viharati. (GBM 1566.1) suvarṇamayāt paryaṃkād avatīrya	sParitvA-upasaMpadya viharati. (GBm 1566.1) suvarNa-mayAt paryaMkAt avatIrya
   rupyamayāt kūṭāgārān niṣkramya vaiḍūryamayaṃ kūṭāgāraṃ praviśya	rupya-mayAt kUwAgArAn nizkramya vExUrya-mayam kUwAgAram praviSya
   sphaṭikamaye paryaṃke paryaṃkena niṣadya muditāsahagatena cittena (GBM	sPawika-maye paryaMke paryaMkena nizadya mudita-asahagatena cittena (GBm
   1566.2) yāvad adhimucya spharitvopasaṃpadya viharati. sphaṭikamayāt	1566.2) yAvat aDimucya sParitvA-upasaMpadya viharati. sPawika-mayAt-
   paryaṃkād avatīrya vaiḍūryamayāt kūṭāgarān niṣkramya sphaṭikamayaṃ	paryaMkAt avatIrya vExUrya-mayAt kUwAgarAt nizkramya sPawika-mayam
   kūṭāgāraṃ praviśya vaiḍūryamaye (GBM 1566.3) paryaṃke paryaṃkena	kUwAgAram praviSya vExUrya-maye (GBm 1566.3) paryaMke paryaMkena
   niṣadyopekṣāsahagatena cittena yāvad adhimucya spharitvopasaṃpadya	nizadya-upekzA-sahagatena cittena yAvat aDimucya sParitvA-upasaMpadya
   viharati.	viharati.
   MSuAv [21] atha rājā mahāsudarśanaś caturo brahmāṃ (GBM 1566.4) vihārāṃ	MSuO [21] aTa rAjA mahA-sudarSanaH caturaH brahmAm (GBm 1566.4) vihArAm
   bhāvayitvā kāmeṣu kāmacchandaṃ prahāya tadbahulavihārī	BAvayitvA kAmezu kAma=-Candam prahAya tad-bahula-vihArI
   brahmalokasabhāgatāyām upapanno. rājño mahāsudarśanasyeyam (sic; Matsumura	brahma-loka-saBA-gatAyAm upapanno. rAjQaH mahAsudarSanasya-iyam (sic; Mat-sumura
   -nasyenaṃ) evaṃ (GBM 1566.5) anubhūtā maraṇāntikī vedanā, tadyathā	-nasyenaM) evam (GBm 1566.5) anuBUtA maraNa-antikI vedanA, tat-yaTA
   balavataḥ puruṣasya subhojanaṃ bhuktavato muhūrtaṃ syād bhaktaklamaḥ.	balavataH puruzasya su-Bojanam BuktavataH muhUrtam syAt Bakta-klamaH.
   MSuAv [22] yāvac ca mahārāja kuśinagarī, yāvac (GBM 1566.6) ca nadī	MSuO [22] yAvat ca mahA-rAja kuSinagarI, yAvat (GBm 1566.6) ca nadI
   hiraṇyavatī, yāvac ca yamakasālavanaṃ, yāvac ca mallānāṃ	hiraNyavatI, yAvat ca yamakasAla-vanan, yAvat ca mallAnAm
   mukuṭabandhanacaityam atrāntarā dvādaśa yojanāni sāmantakena yatra	mukuwa-banDana-cEtyam atra-antarA dvAdaSa yojanAni sAmantakena yatra
   tathāgatasya ṣaṭkṛtvaḥ (GBM 1566.7) śarīranikṣepo 'bhūt sa ca rājñaḥ	taTAgatasya zaz-kRtvas (GBm 1566.7) SarIra-nikzepaH aBUt sa ca rAjQaH
   kṣatriyasya mūrdhābhiṣiktasya iha saptamikāṃ vārāṃ. tac ca	kzatriyasya mUrDABiziktasya iha saptamikAm vArAn. tat ca
   tathāgatasyārhataḥ samyaksaṃbuddhasya nāhaṃ mahārāja taṃ pṛthivīpradeśaṃ	taTAgatasya-arhataH samyaksaMbudDasya na-aham mahA-rAja tam pRTivI-pradeSam
   (GBM 1566.8) samanupaśyāmi yadivā pūrvasyāṃ diśi yadivā dakṣiṇasyāṃ yadivā	(GBm 1566.8) samanupaSyAmi yat-ivA pUrvasyAm diSi yat-ivA dakziNasyAm yat-ivA
   paścimasyāṃ yadivā uttarasyāṃ diśi yatra tathāgatasyāṣṭamaṃ vā	paScimasyAm yat-ivA uttarasyAm diSi yatra taTAgatasya-azwamam vA
   śarīranikṣepo bhaviṣyati. tat kasya (GBM 1567.1) hetoḥ.	SarIra-nikzepaH Bavizyati. tat kasya (GBm 1567.1) hetoH.
   ucchinnā tathāgatasya mahārāja bhavanetrī / (sic; Matsumura (samu)cchinnā)	ucCinnA taTAgatasya mahA-rAja Bava-netrI / (sic; Mat-sumuraH (samu)cCinnA)
   vikṣīṇo jātisaṃsāro nāstīdānīṃ punarbhava // 1 // iti //	vikzINaH jAti-saMsAraH na-asti-idAnIm punarBavaH // 1 // iti //
   antaroddānaṃ	antara-uddAnam
   prācīnanyāsastaṃbhā avasaṃgā annāgrabaladharaṇyaniryūhā / (GBM 1567.2)	prAcInanyAsa-staMBAH avasaMgAH anna-agra-bala-DaraNya-niryUhAH / (GBm 1567.2)
   phalakasopānavedikā kūṭatālakanakāś ca // 2 // iti	Palaka-sopAna-vedikA kUwa-tAla-kanakAH ca // 2 // iti
   MSuAv [23] atha rājā mahāsudarśano dharme prāsāde paṃca	MSuO [23] aTa rAjA mahAsudarSanaH Darme prAsAde paMca
   pratyekabuddhaśatāni bhojayitvā (GBM 1567.3) pratyekapratyekaṃ	pratyekabudDa-SatAni BojayitvA (GBm 1567.3) pratyeka-pratyekam
   duṣyayugenācchādayitvā gāthāṃ bhāsate.	duzya-yugena-AcCAdayitvA gATAm BAsate.
   labdhvā hi vipulaṃ cittaṃ na pramādyed vicakṣaṇaḥ /	labDvA hi vipulam cittam na pramAdyet vicakzaNaH /
   dadyāt saṃpannaśīlebhyo yatra ridhyanti dakṣiṇā // 3 //	dadyAt saMpanna-SIleByaH yatra riDyanti dakziNA // 3 //
   evaṃ datveha medhāvī (GBM 1567.4) śrāddho muktena cetasā /	evam datvA-iha meDAvI (GBm 1567.4) SrAdDaH muktena cetasA /
   avyābādhasukhe loke upapadyeta paṇḍitaḥ // 4 // iti.	avyAbADa-suKe loke upapadyeta paNxitaH // 4 // iti.
   MSuAv [24] syāt khalu mahārājānyas sa tena kālena tena samayena	MSuO [24] syAt Kalu mahA-rAjAnyaH sa tena kAlena tena samayena
   mahāsudarśano (GBM 1567.5) nāma rājā cakravartī caturdvīpeśvaraḥ saptabhi	mahAsudarSanaH (GBm 1567.5) nAma rAjA cakravartI catur-dvIpa-ISvaraH saptaBi
   ratnaiḥ samanvāgataḥ catasṛbhi mānuṣikābhi riddhibhir iti, na khalv evaṃ	ratnEH samanvAgataH catasRBi mAnuzika-aBi ridDiBiH iti, na Kalu evam
   draṣṭavyaṃ. aham eva sa tena (GBM 1567.6) kālena tena samayena	drazwavyan. aham eva sa tena (GBm 1567.6) kAlena tena samayena
   mahārājābhūvan mahāsudarśano nāma rājā cakravartī caturdvīpeśvaraḥ	mahA-rAja-aBUvat mahAsudarSanaH nAma rAjA cakravartI catur-dvIpa-ISvaraH
   saptabhi ratnaiḥ samanvāgataḥ catasṛbhi mānuṣikābhi riddhibhiḥ (GBM	saptaBi ratnEH samanvAgataH catasRBi mAnuzika-aBi ridDiBiH (GBm
   1567.7) iti. syāt khalu mahārāja tena mayā dānena vā dānasaṃvibhāgena vā	1567.7) iti. syAt Kalu mahA-rAja tena mayA dAnena vA dAna-saMviBAgena vA
   anuttarā samyaksaṃbodhir adhigateti, na khalv evaṃ draṣṭavyaṃ. api tu tad	anuttarA samyaksaMboDiH aDigata-iti, na Kalu evam drazwavyan. api tu tat-
   dānam anuttarāyās samyaksaṃbodheḥ (GBM 1567.8) hetumātrakaṃ	dAnam anuttarAyAH samyaksaMboDeH (GBm 1567.8) hetu-mAtrakam
   pratyayamātrakaṃ saṃbhāramātrakam iti.	pratyaya-mAtrakam saMBAra-mAtrakam iti.
   mahāsudarśanāvadānaḥ samāpta.	mahA-su-darSana-avadAnaH samApta.
