   a	a
   vācaka-	vAcaka-
   saṃjñaka-	saMjQaka-
   hāṭaka-	hAwaka-
   kaṇṭaka-	kaNwaka-
   riṣṭaka-	rizwaka-
   atikrāntaka-	atikrAntaka-
   cintaka-	cintaka-
   pravartaka-	pravartaka-
   utpādaka-	utpAdaka-
   chandaka-	Candaka-
   virodhaka-	viroDaka-
   sanaka-	sanaka-
   ambaka-	ambaka-
   paramaka-	paramaka-
   ātmaka-	Atmaka-
   brahmaka-	brahmaka-
   āraṇyaka-	AraNyaka-
   naraka-	naraka-
   kāraka-	kAraka-
   tāraka-	tAraka-
   śarīraka-	SarIraka-
   putraka-	putraka-
   mūlaka-	mUlaka-
   pāvaka-	pAvaka-
   sevaka-	sevaka-
   pūrvaka-	pUrvaka-
   svaka-	svaka-
   daśaka-	daSaka-
   viṃśaka-	viMSaka-
   hiṃsaka-	hiMsaka-
   yuṣmāka-	yuzmAka-
   asmāka-	asmAka-
   laukika-	lOkika-
   vācika-	vAcika-
   rājika-	rAjika-
   yājñika-	yAjQika-
   sphaṭika-	sPawika-
   naiṣṭhika-	nEzWika-
   kāruṇika-	kAruNika-
   naimittika-	nEmittika-
   antika-	antika-
   aikāntika-	EkAntika-
   vaidika-	vEdika-
   adhika-	aDika-
   paryavasānika-	paryavasAnika-
   āhnika-	Ahnika-
   sāmika-	sAmika-
   dhārmika-	DArmika-
   abhyudayika-	aByudayika-
   kāyika-	kAyika-
   vaikārika-	vEkArika-
   rātrika-	rAtrika-
   traikālika-	trEkAlika-
   tātkālika-	tAtkAlika-
   sāttvika-	sAttvika-
   paurvika-	pOrvika-
   deśika-	deSika-
   kauśika-	kOSika-
   mānasika-	mAnasika-
   nāsika-	nAsika-
   śrutīka-	SrutIka-
   anīka-	anIka-
   kaṇḍarīka-	kaNxarIka-
   puṇḍarīka-	puNxarIka-
   naighaṇṭuka-	nEGaNwuka-
   śuka-	Suka-
   bhikṣuka-	Bikzuka-
   eka-	eka-
   loka-	loke--
   śloka-	Sloka-
   śoka-	Soka-
   aṇka-	aNka-
   catuṣka-	catuzka-
   muṣka-	muzka-
   manaska-	manaska-
   uraska-	uraska-
   yāska-	yAska-
   kha-	Ka-
   makha-	maKa-
   mukha-	muKa-
   sukha-	suKa-
   duḥkha-	duHKa-
   śaṇkha-	SaNKa-
   ga-#'1	ga-#a1
   ga-#'2	ga-#a2
   bhaga-	Baga-
   chāga-	CAga-
   nāga-	nAga-
   bhāga-	BAga-
   vibhāga-	viBAga-
   parityāga-	parityAga-
   rāga-	rAga-
   atiga-	atiga-
   anuga-	anuga-
   yuga-	yuga-
   kārtayuga-	kArtayuga-
   vega-	vega-
   bhoga-	Boga-
   yoga-	yoga-
   prayoga-	prayoga-
   viyoga-	viyoga-
   saṃyoga-	saMyoga-
   roga-	roga-
   aṇga-	aNga-
   bhaṇga-	BaNga-
   sāraṇga-	sAraNga-
   śṛṇga-	SRNga-
   garga-	garga-
   apavarga-	apavarga-
   svarga-	svarga-
   sarga-	sarga-
   visarga-	visarga-
   utsarga-	utsarga-
   mārga-	mArga-
   agha-	aGa-
   megha-	meGa-
   ogha-	oGa-
   saṃgha-	saMGa-
   dīrgha-	dIrGa-
   ca	ca
   dadhīca-	daDIca-
   śauca-	SOca-
   pañca-	paQca-
   viriñca-	viriQca-
   ja-	ja-
   aja-	aja-
   gaja-	gaja-
   vraja-	vraja-
   bhiṣaja-	Bizaja-
   vairāja-	vErAja-
   vāja-	vAja-
   bīja-	bIja-
   anuja-	anuja-
   bhuja-	Buja-
   muñja-	muQja-
   jña-	jQa-
   yajña-	yajQa-
   śakaṭa-	Sakawa-
   lalāṭa-	lalAwa-
   vāṭa-	vAwa-
   puṭa-	puwa-
   kūṭa-	kUwa-
   aṣṭa-	azwa-
   praṇaṣṭa-	praNazwa-
   naṣṭa-	nazwa-
   pranaṣṭa-	pranazwa-
   bhraṣṭa-	Brazwa-
   paribhraṣṭa-	pariBrazwa-
   iṣṭa-#'2	izwa-#a2
   ādiṣṭa-	Adizwa-
   uddiṣṭa-	uddizwa-
   nirdiṣṭa-	nirdizwa-
   abhinirdiṣṭa-	aBinirdizwa-
   vinirdiṣṭa-	vinirdizwa-
   kliṣṭa-	klizwa-
   viṣṭa-	vizwa-
   upaviṣṭa-	upavizwa-
   upopaviṣṭa-	upopavizwa-
   praviṣṭa-	pravizwa-
   āviṣṭa-	Avizwa-
   samāviṣṭa-	samAvizwa-
   śiṣṭa-	Sizwa-
   viśiṣṭa-	viSizwa-
   anuśiṣṭa-	anuSizwa-
   juṣṭa-	juzwa-
   tuṣṭa-	tuzwa-
   duṣṭa-	duzwa-
   dṛṣṭa-	dRzwa-
   pṛṣṭa-	pRzwa-
   sṛṣṭa-	sRzwa-
   visṛṣṭa-	visRzwa-
   hṛṣṭa-	hRzwa-
   kaṭha-	kaWa-
   pāṭha-	pAWa-
   pīṭha-	pIWa-
   kaṇṭha-	kaNWa-
   vaikuṇṭha-	vEkuNWa-
   ṣaṣṭha-	zazWa-
   kāṣṭha-	kAzWa-
   niṣṭha-	nizWa-
   dharmiṣṭha-	DarmizWa-
   variṣṭha-	varizWa-
   vasiṣṭha-	vasizWa-
   pṛṣṭha-	pRzWa-
   jyeṣṭha-	jyezWa-
   śreṣṭha-	SrezWa-
   oṣṭha-	ozWa-
   jaḍa-	jaxa-
   garuḍa-	garuxa-
   aṇḍa-	aNxa-
   khaṇḍa-	KaNxa-
   mārtaṇḍa-	mArtaNxa-
   daṇḍa-	daNxa-
   piṇḍa-	piNxa-
   muṇḍa-	muNxa-
   gūḍha-	gUXa-
   vyūḍha-	vyUXa-
   samārūḍha-	samArUXa-
   adhirūḍha-	aDirUXa-
   dṛḍha-	dRXa-
   samupoḍha-	samupoXa-
   gaṇa-	gaNa-
   kramaṇa-	kramaNa-
   brāhmaṇa-	brAhmaNa-
   nārāyaṇa-	nArAyaNa-
   prāyaṇa-	prAyaNa-
   caraṇa-	caraNa-
   avataraṇa-	avataraNa-
   maraṇa-	maraNa-
   varaṇa-	varaNa-
   śaraṇa-	SaraNa-
   apaharaṇa-	apaharaNa-
   āharaṇa-	AharaNa-
   kāraṇa-	kAraNa-
   cāraṇa-	cAraNa-
   dhāraṇa-	DAraNa-
   saṃdhāraṇa-	saMDAraNa-
   samīraṇa-	samIraNa-
   vīraṇa-	vIraNa-
   śravaṇa-	SravaNa-
   lavaṇa-	lavaNa-
   rāvaṇa-	rAvaNa-
   vibhūṣaṇa-	viBUzaNa-
   roṣaṇa-	rozaNa-
   lakṣaṇa-	lakzaNa-
   īkṣaṇa-	IkzaNa-
   vimokṣaṇa-	vimokzaNa-
   saṃkarṣaṇa-	saMkarzaNa-
   dharṣaṇa-	DarzaNa-
   harṣaṇa-	harzaNa-
   grahaṇa-	grahaNa-
   upabṛṃhaṇa-	upabRMhaNa-
   bāṇa-	bANa-
   vikriyamāṇa-	vikriyamANa--
   pramāṇa-	pramANa-
   bhāṣamāṇa-	BAzamANa-
   sisṛkṣamāṇa-	sisRkzamANa-
   parīmāṇa-	parImANa-
   nirmāṇa-	nirmANa-
   purāṇa-	purANa-
   paurāṇa-	pOrANa-
   paritrāṇa-	paritrANa-
   prāṇa-	prANa-
   atharvāṇa-	aTarvANa-
   nirvāṇa-	nirvANa-
   vikurvāṇa-	vikurvANa-
   dakṣiṇa-	dakziNa-
   kṣīṇa-	kzINa-
   guṇa-	guNa-
   varuṇa-	varuNa-
   dāruṇa-	dAruNa-
   gauṇa-	gONa-
   karṇa-	karNa-
   parṇa-	parNa-
   sauparṇa-	sOparNa-
   varṇa-	varNa-
   ākīrṇa-	AkIrNa-
   saṃkīrṇa-	saMkIrNa-
   vistīrṇa-	vistIrNa-
   tūrṇa-	tUrNa-
   pūrṇa-	pUrNa-
   kṛṣṇa-	kRzNa-
   tṛṣṇa-	tRzNa-
   ekata-	ekata-
   gata-	gata-
   upagata-	upagata-
   abhyupagata-	aByupagata-
   āgata-	Agata-
   upāgata-	upAgata-
   samupāgata-	samupAgata-
   samāgata-	samAgata-
   abhyāgata-	aByAgata-
   adhigata-	aDigata-
   abhigata-	aBigata-
   anugata-	anugata-
   saṃgata-	saMgata-
   udgata-	udgata-
   praṇata-	praNata-
   nata-	nata-
   vinata-	vinata-
   pāśupata-	pASupata-
   bata	bata
   mata-	mata-
   anumata-	anumata-
   yata-	yata-
   prayata-	prayata-
   niyata-	niyata-
   saṃyata-	saMyata-
   udyata-	udyata-
   rata-	rata-
   bharata-	Barata-
   bhārata-	BArata-
   virata-	virata-
   vrata-	vrata-
   bhāgavata-	BAgavata-
   daivata-	dEvata-
   sātvata-	sAtvata-
   parvata-	parvata-
   śāśvata-	SASvata-
   sārasvata-	sArasvata-
   vaivasvata-	vEvasvata-
   śata-	Sata-
   hata-	hata-
   samāhata-	samAhata-
   pratihata-	pratihata-
   nihata-	nihata-
   ghāta-	GAta-
   upaghāta-	upaGAta-
   abhighāta-	aBiGAta-
   vighāta-	viGAta-
   saṃghāta-	saMGAta-
   jāta-	jAta-
   jñāta-	jQAta-
   vijñāta-	vijQAta-
   tāta-	tAta-
   snāta-	snAta-
   pāta-	pAta-
   yāta-	yAta-
   khyāta-	KyAta-
   ākhyāta-	AKyAta-
   pratyākhyāta-	pratyAKyAta-
   vikhyāta-	viKyAta-
   abhivikhyāta-	aBiviKyAta-
   saṃkhyāta-	saMKyAta-
   parisaṃkhyāta-	parisaMKyAta-
   ghrāta-	GrAta-
   aṇkita-	aNkita--
   vegita-	vegita-
   racita-	racita-
   niścita-	niScita-
   viniścita-	viniScita-
   jita-	jita-
   parājita-	parAjita-
   pūjita-	pUjita-
   pratipūjita-	pratipUjita-
   saṃpūjita-	saMpUjita-
   varjita-	varjita-
   vivarjita-	vivarjita-
   saṃjñita-	saMjQita-
   abhisaṃjñita-	aBisaMjQita-
   paṭhita-	paWita-
   pratiṣṭhita-	pratizWita-
   dhiṣṭhita-	DizWita-
   adhiṣṭhita-	aDizWita-
   anuṣṭhita-	anuzWita-
   tāḍita-	tAxita-
   paṇḍita-	paNxita-
   anuvarṇita-	anuvarNita-
   nipatita-	nipatita-
   pātita-	pAtita-
   abhipātita-	aBipAtita-
   cintita-	cintita-
   pravartita-	pravartita-
   kīrtita-	kIrtita-
   prakīrtita-	prakIrtita-
   parikīrtita-	parikIrtita-
   anukīrtita-	anukIrtita-
   saṃkīrtita-	saMkIrtita-
   kathita-	kaTita-
   prathita-	praTita-
   utthita-	utTita-
   samutthita-	samutTita-
   sthita-	sTita-
   upasthita-	upasTita-
   samupasthita-	samupasTita-
   saṃpratyupasthita-	saMprati-upasTita-
   prasthita-	prasTita-
   avasthita-	avasTita-
   paryavasthita-	paryavasTita-
   vyavasthita-	vyavasTita-
   āsthita-	AsTita-
   samāsthita-	samAsTita-
   saṃsthita-	saMsTita-
   pratipādita-	pratipAdita-
   utpādita-	utpAdita-
   abhyāsādita-	aByAsAdita-
   vidita-	vidita-
   saṃvidita-	saMvidita-
   udita-	udita-
   nivedita-	nivedita-
   codita-	codita-
   śabdita-	Sabdita-
   abhiśabdita-	aBiSabdita-
   anuśabdita-	anuSabdita-
   pratibodhita-	pratiboDita-
   vivardhita-	vivarDita-
   janita-	janita-
   mānita-	mAnita-
   jñāpita-	jQApita-
   tāpita-	tApita-
   sthāpita-	sTApita-
   adhyāpita-	aDyApita-
   prāpita-	prApita-
   kupita-	kupita-
   arpita-	arpita-
   darpita-	darpita-
   kalpita-	kalpita-
   upakalpita-	upakalpita-
   parikalpita-	parikalpita-
   saṃkalpita-	saMkalpita-
   kṣubhita-	kzuBita-
   stambhita-	stamBita-
   mita-	mita-
   samita-	samita-
   stimita-	stimita-
   saṃmita-	saMmita-
   nirmita-	nirmita-
   parinirmita-	parinirmita-
   vinirmita-	vinirmita-
   āpyāyita-	ApyAyita-
   vicārita-	vicArita-
   pravicārita-	pravicArita-
   uccārita-	uccArita-
   mārita-	mArita-
   vinivārita-	vinivArita-
   īrita-	Irita-
   udīrita-	udIrita-
   samīrita-	samIrita-
   trita-	trita-
   tandrita-	tandrita-
   āśrita-	ASrita-
   upāśrita-	upASrita-
   samāśrita-	samASrita-
   jvalita-	jvalita-
   vyākulita-	vyAkulita-
   pāvita-	pAvita-
   bhāvita-	BAvita-
   śrāvita-	SrAvita-
   niṣevita-	nizevita-
   saṃniṣevita-	saMnizevita-
   sevita-	sevita-
   dvita-	dvita-
   anvita-	anvita-
   samanvita-	samanvita-
   garvita-	garvita-
   prakāśita-	prakASita-
   deśita-	deSita-
   ādeśita-	AdeSita-
   āveśita-	AveSita-
   saṃśita-	saMSita-
   karśita-	karSita-
   sparśita-	sparSita-
   abhilaṣita-	aBilazita-
   manīṣita-	manIzita-
   tuṣita-	tuzita-
   adhyuṣita-	aDyuzita-
   ruṣita-	ruzita-
   bhūṣita-	BUzita-
   saṃśleṣita-	saMSlezita-
   rakṣita-	rakzita-
   lakṣita-	lakzita-
   pārikṣita-	pArikzita-
   nirīkṣita-	nirIkzita-
   prekṣita-	prekzita-
   prokṣita-	prokzita-
   marṣita-	marzita-
   asita-	asita-
   paryavasita-	paryavasita-
   avabhāsita-	avaBAsita-
   īpsita-	Ipsita-
   hita-	hita-
   rahita-	rahita-
   sahita-	sahita-
   āhita-	Ahita-
   samāhita-	samAhita-
   abhihita-	aBihita-
   vihita-	vihita-
   mohita-	mohita-
   vimohita-	vimohita-
   upabṛṃhita-	upabRMhita-
   paribṛṃhita-	paribRMhita-
   antarhita-	antarhita-
   gīta-	gIta-
   pragīta-	pragIta-
   udgīta-	udgIta-
   atīta-	atIta-
   samatīta-	samatIta-
   adhīta-	aDIta-
   nīta-	nIta-
   upanīta-	upanIta-
   vinīta-	vinIta-
   anunīta-	anunIta-
   sphīta-	sPIta-
   vikrīta-	vikrIta-
   prīta-	prIta-
   vīta-	vIta-
   gṛhīta-	gRhIta-
   nigṛhīta-	nigRhIta-
   anugṛhīta-	anugRhIta-
   uta	uta
   stuta-	stuta-
   saṃstuta-	saMstuta-
   adbhuta-	adButa-
   saṃyuta-	saMyuta-
   cyuta-	cyuta-
   pracyuta-	pracyuta-
   māruta-	mAruta-
   druta-	druta-
   śruta-	Sruta-
   viśruta-	viSruta-
   samabhipluta-	samaBipluta-
   suta-	suta-
   huta-	huta-
   samuddhūta-	samudDUta-
   vinirdhūta-	vinirDUta-
   pravinirdhūta-	pravinirDUta-
   pūta-	pUta-
   bhūta-	BUta-
   abhibhūta-	aBiBUta-
   saṃbhūta-	saMBUta-
   udbhūta-	udBUta-
   samudbhūta-	samudBUta-
   sūta-	sUta-
   prasūta-	prasUta-
   hūta-	hUta-
   upahūta-	upahUta-
   āhūta-	AhUta-
   ṛta-	Rta-
   kṛta-	kRta-
   ghṛta-	GRta-
   dhṛta-	DRta-
   uddhṛta-	udDRta-
   samuddhṛta-	samudDRta-
   saṃbhṛta-	saMBRta-
   mṛta-	mRta--
   smṛta-	smRta-
   vṛta-#'1	vRta-#a1
   vṛta-#'2	vRta-#a2
   āvṛta-	AvRta-
   samāvṛta-	samAvRta-
   parivṛta-	parivRta-
   saṃvṛta-	saMvRta-
   abhisaṃvṛta-	aBisaMvRta-
   nirvṛta-	nirvRta-
   sṛta-	sRta-
   prasṛta-	prasRta-
   avasṛta-	avasRta-
   niḥsṛta-	niHsRta-
   viniḥsṛta-	viniHsRta-
   hṛta-	hRta-
   apahṛta	apahRta
   samudāhṛta-	samudAhRta-
   pratyāhṛta-	pratyAhRta-
   vyāhṛta-	vyAhRta-
   nāciketa-	nAciketa-
   upeta-	upeta-
   sameta-	sameta-
   śveta-	Sveta-
   bhakta-	Bakta-
   vibhakta-	viBakta-
   vyakta-	vyakta-
   sakta-	sakta-
   vyatirikta-	vyatirikta-
   ukta-	ukta-
   bhukta-	Bukta-
   upabhukta-	upaBukta-
   mukta-	mukta-
   vimukta-	vimukta-
   nirmukta-	nirmukta-
   vinirmukta-	vinirmukta-
   yukta-	yukta-
   prayukta-	prayukta-
   saṃprayukta-	saMprayukta-
   samāyukta-	samAyukta-
   niyukta-	niyukta-
   saṃyukta-	saMyukta-
   udyukta-	udyukta-
   nirukta-	nirukta-
   prokta-	prokta-
   datta-	datta-
   yatta-	yatta-
   citta-	citta-
   pitta-	pitta-
   nimitta-	nimitta-
   vṛtta-	vRtta-
   pravṛtta-	pravRtta-
   upāvṛtta-	upAvRtta-
   vyāvṛtta-	vyAvRtta-
   nivṛtta-	nivRtta-
   saṃnivṛtta-	saMnivRtta-
   saṃvṛtta-	saMvRtta-
   anta-	anta-
   danta-	danta-
   vaijayanta-	vEjayanta-
   hanta	hanta
   dānta-	dAnta-
   ākrānta-	AkrAnta-
   atikrānta-	atikrAnta-
   vikrānta-	vikrAnta-
   saṃkrānta-	saMkrAnta-
   anusaṃkrānta-	anusaMkrAnta-
   saṃbhrānta-	saMBrAnta-
   śrānta-	SrAnta-
   pariśrānta-	pariSrAnta-
   viśrānta-	viSrAnta-
   śānta-	SAnta-
   ājñapta-	AjQapta-
   tapta-	tapta-
   śapta-	Sapta-
   sapta-	sapta-
   samāpta-	samApta-
   vyāpta-	vyApta-
   prāpta-	prApta-
   anuprāpta-	anuprApta-
   samanuprāpta-	samanuprApta-
   saṃprāpta-	saMprApta-
   avāpta-	avApta-
   lipta-	lipta-
   kṣipta-	kzipta-
   vinikṣipta-	vinikzipta-
   gupta-	gupta-
   saṃgupta-	saMgupta-
   supta-	supta-
   ārta-	Arta-
   pūrta-	pUrta-
   muhūrta-	muhUrta-
   samasta-	samasta--
   apadhvasta-	apaDvasta-
   hasta-	hasta--
   anuśāsta-	anuSAsta-
   atha	aTa
   patha-	paTa-
   nātha-	nATa-
   avabhṛtha-	avaBRTa-
   artha-	arTa-
   pārtha-	pArTa-
   tīrtha-	tIrTa-
   caturtha-	caturTa-
   stha-	sTa-
   vānaprastha-	vAnaprasTa-
   da-	da-
   pada-	pada-
   āspada-	Aspada-
   nārada-	nArada-
   prada-	prada-
   upaniṣada-	upanizada-
   āda-	Ada-
   nināda-	ninAda-
   pāda-	pAda-
   vāda-	vAda-
   apavāda-	apavAda-
   saṃvāda-	saMvAda-
   prasāda-	prasAda-
   uda-	uda-
   nuda-	nuda-
   bheda-	Beda-
   veda-	veda-
   sveda-	sveda-
   niṣpanda-	nizpanda-
   parispanda-	parispanda-
   aravinda-	aravinda-
   govinda-	govinda-
   śabda-	Sabda-
   dha-	Da-
   vadha-	vaDa-
   auṣadha-	OzaDa-
   budha-	buDa-
   vibudha-	vibuDa-
   ayudha-	ayuDa-
   mṛdha-	mRDa-
   medha-	meDa-
   pratiṣedha-	pratizeDa-
   utsedha-	utseDa-
   dvaidha-	dvEDa-
   krodha-	kroDa-
   dagdha-	dagDa-
   snigdha-	snigDa-
   baddha-	badDa-
   śrāddha-	SrAdDa-
   samiddha-	samidDa-
   siddha-	sidDa-
   prabuddha-	prabudDa-
   pratibuddha-	pratibudDa-
   vibuddha-	vibudDa-
   yuddha-	yudDa-
   niruddha-	nirudDa-
   kruddha-	krudDa-
   śuddha-	SudDa-
   pariśuddha-	pariSudDa-
   viśuddha-	viSudDa-
   samṛddha-	samRdDa-
   andha-	anDa-
   gandha-	ganDa-
   bandha-	banDa-
   ardha-	arDa-
   na	na
   gagana-	gagana-
   cana	cana
   vacana-	vacana-
   pravacana-	pravacana-
   virocana-	virocana-
   jana-	jana-
   vyajana-	vyajana-
   bhājana-	BAjana-
   yājana-	yAjana-
   bhojana-	Bojana-
   yojana-	yojana-
   añjana-	aQjana-
   khaṇḍana-	KaNxana-
   sanātana-	sanAtana-
   purātana-	purAtana-
   cetana-	cetana-
   pravartana-	pravartana-
   kīrtana-	kIrtana-
   anukīrtana-	anukIrtana-
   kathana-	kaTana-
   mathana-	maTana-
   manthana-	manTana-
   sadana-	sadana-
   utpādana-	utpAdana-
   mādana-	mAdana-
   utsādana-	utsAdana-
   sūdana-	sUdana-
   chedana-	Cedana-
   candana-	candana-
   nandana-	nandana-
   sanandana-	sanandana-
   prasyandana-	prasyandana-
   ardana-	ardana-
   pratardana-	pratardana-
   dhana-	Dana-
   ārādhana-	ArADana-
   nidhana-	niDana-
   bodhana-	boDana-
   bandhana-	banDana-
   indhana-	inDana-
   vardhana-	varDana-
   snapana-	snapana-
   tāpana-	tApana-
   sthāpana-	sTApana-
   māpana-	mApana-
   vikampana-	vikampana-
   gamana-	gamana-
   abhigamana-	aBigamana-
   vāmana-	vAmana-
   ayana-	ayana-
   nayana-	nayana-
   apanayana-	apanayana-
   adhyayana-	aDyayana-
   śayana-	Sayana-
   dvaipāyana-	dvEpAyana-
   vaiśaṃpāyana-	vESaMpAyana-
   saṃprakṣālana-	saMprakzAlana-
   vana-	vana-
   bhavana-	Bavana-
   yavana-	yavana-
   cyavana-	cyavana-
   havana-	havana-
   pāvana-	pAvana-
   bhāvana-	BAvana-
   bhuvana-	Buvana-
   svana-	svana-
   aśana-	aSana-
   praṇāśana-	praNASana-
   nāśana-	nASana-
   vināśana-	vinASana-
   karśana-	karSana-
   darśana-	darSana-
   nidarśana-	nidarSana-
   sparśana-	sparSana-
   sana-	sana-
   āsana-	Asana-
   anuśāsana-	anuSAsana-
   pāṃsana-	pAMsana-
   gahana-	gahana-
   avagāhana-	avagAhana-
   vāhana-	vAhana-
   mohana-	mohana-
   jñāna-	jQAna-
   vijñāna-	vijQAna-
   saṃtāna-	saMtAna-
   sthāna-	sTAna-
   dāna-	dAna-
   saṃpradāna-	saMpradAna-
   pradhāna-	praDAna-
   nidhāna-	niDAna-
   vidhāna-	viDAna-
   pāna-	pAna-
   māna-	mAna-
   vivardhamāna-	vivarDamAna-
   jāyamāna-	jAyamAna-
   vivāyamāna-	vivAyamAna-
   pīyamāna-	pIyamAna-
   stūyamāna-	stUyamAna-
   arcyamāna-	arcyamAna-
   ijyamāna-	ijyamAna-
   upavījyamāna-	upavIjyamAna-
   pūjyamāna-	pUjyamAna-
   pīḍyamāna-	pIxyamAna-
   kathyamāna-	kaTyamAna-
   tapyamāna-	tapyamAna-
   dīpyamāna-	dIpyamAna-
   jijñāsamāna-	jijQAsamAna-
   vimāna-	vimAna-
   mahimāna-	mahimAna-
   unmāna-	unmAna-
   yāna-	yAna-
   ākhyāna-	AKyAna-
   upākhyāna-	upAKyAna-
   pratyākhyāna-	pratyAKyAna-
   parisaṃkhyāna-	parisaMKyAna-
   dhyāna-	DyAna-
   anudhyāna-	anuDyAna-
   glāna-	glAna-
   śmaśāna-	SmaSAna-
   īśāna-	ISAna-
   vasāna-	vasAna-
   avasāna-	avasAna-
   ajina-	ajina-
   kaṭhina-	kaWina-
   dina-	dina-
   prācīna-	prAcIna-
   kānīna-	kAnIna-
   līna-	lIna-
   saṃlīna-	saMlIna-
   hīna-	hIna-
   vihīna-	vihIna-
   phalguna-	Palguna-
   arjuna-	arjuna-
   maithuna-	mETuna-
   phena-	Pena-
   bhagna-	Bagna-
   magna-	magna-
   lagna-	lagna-
   vilagna-	vilagna-
   saṃlagna-	saMlagna-
   udvigna-	udvigna-
   ghna-	Gna-
   vighna-	viGna-
   ratna-	ratna-
   anna-	anna-
   praticchanna-	praticCanna-
   prapanna-	prapanna-
   āpanna-	Apanna-
   saṃpanna-	saMpanna-
   utpanna-	utpanna-
   samutpanna-	samutpanna-
   niṣpanna-	nizpanna-
   prasanna-	prasanna-
   chinna-	Cinna-
   bhinna-	Binna-
   pradyumna-	pradyumna-
   praśna-	praSna-
   kṛtsna-	kRtsna-
   pa-#'1	pa-#a1
   pa-#'2	pa-#a2
   apa	apa
   &.wu hṛ apa	&.wu hR apa
   &.wu dhvaṃs apa	&.wu Dvan apa
   kacchapa-	kacCapa-
   japa-	japa-
   viṣṭapa-	vizwapa-
   ātapa-	Atapa-
   kaśyapa-	kaSyapa-
   pāpa-	pApa-
   śāpa-	SApa-
   adhipa-	aDipa-
   samīpa-	samIpa-
   dvīpa-	dvIpa-
   upa	upa
   &.wu sthā upa	&.wu sTAH upa
   &.wu yā upa	&.wu yAH upa
   &.wu i upa	&.wu i upa
   &.wu nī upa	&.wu nI upa
   &.wu hṛ upa	&.wu hR upa
   &.wu hve upa	&.wu hve upa
   &.wu vīj upa	&.wu vIt upa
   &.wu bhuj upa	&.wu But upa
   &.wu pad upa	&.wu pad upa
   &.wu kḹp upa	&.wu k?B upa
   &.wu gam upa	&.wu gam upa
   &.wu kram upa	&.wu kram upa
   &.wu diś upa	&.wu diH upa
   &.wu viś upa	&.wu viH upa
   &.wu spṛś upa	&.wu spRH upa
   &.wu ās upa	&.wu As upa
   &.wu bṛh upa	&.wu bRm upa
   &.wu viś upa, upa	&.wu viH upa, upa
   &.wu sthā sam, prati, upa	&.wu sTA sam, prati, upa
   &.wu gam abhi, upa	&.wu gam aBi, upa
   &.wu sthā sam, upa	&.wu sTA sam, upa
   &.wu gam sam, upa	&.wu gam sam, upa
   &.wu vah sam, upa	&.wu vah sam, upa
   kūpa-	kUpa-
   rūpa-	rUpa-
   prakopa-	prakopa-
   sarpa-	sarpa-
   alpa-	alpa-
   kalpa-	kalpa-
   saṃkalpa-	saMkalpa-
   saṃjalpa-	saMjalpa-
   puṣpa-	puzpa-
   kaiṭabha-	kEwaBa-
   labha-	laBa-
   nābha-	nABa-
   lābha-	lABa-
   ubha-	uBa-
   śubha-	SuBa-
   saubha-	sOBa-
   kumbha-	kumBa-
   garbha-	garBa-
   hairaṇyagarbha-	hEraNyagarBa-
   darbha-	darBa-
   āgama-	Agama-
   samāgama-	samAgama-
   jaṇgama-	jaNgama-
   pañcama-	paQcama-
   aṣṭama-	azwama-
   tama-	tama-
   gūḍhatama-	gUXatama-
   gautama-	gOtama-
   sattama-	sattama-
   uttama-	uttama-
   saptama-	saptama-
   prathama-	praTama-
   dama-	dama-
   kardama-	kardama-
   yama-	yama-
   niyama-	niyama-
   saṃyama-	saMyama-
   rama-	rama-
   parama-	parama-
   krama-	krama-
   vikrama-	vikrama-
   āśrama-	ASrama-
   śama-	Sama-
   sama-	sama-
   kāma-	kAma-
   nāma	nAma
   rāma-	rAma-
   ārāma-	ArAma-
   grāma-	grAma-
   lalāma-	lalAma-
   vāma-	vAma-
   paścima-	paScima-
   kṣema-	kzema-
   soma-	soma-
   bhauma-	BOma-
   padma-	padma-
   dharma-	Darma-
   bhīṣma-	BIzma-
   lakṣma-	lakzma-
   sūkṣma-	sUkzma-
   sma	sma
   brāhma-	brAhma-
   caya-	caya-
   niścaya-	niScaya-
   jaya-	jaya-
   ejaya-	ejaya-
   catuṣṭaya-	catuzwaya-
   udaya-	udaya-
   abhyudaya-	aByudaya-
   hṛdaya-	hRdaya-
   vinaya-	vinaya-
   bhaya-	Baya-
   guṇamaya-	guNa-maya-
   astamaya-	astamaya-
   kuśamaya-	kuSa-maya-
   samaya-	samaya-
   āmaya-	Amaya-
   kanakāmaya-	kanaka-Amaya-
   tejomaya-	tejaH-maya-
   āpomaya-	ApaH-maya-
   hiraṇmaya-	hiraNmaya-
   vismaya-	vismaya-
   apyaya-	api-aya-
   paryaya-	paryaya-
   vyaya-	vyaya-
   āśraya-	ASraya-
   saṃśraya-	saMSraya-
   malaya-	malaya-
   pralaya-	pralaya-
   ālaya-	Alaya-
   anvaya-	anvaya-
   śaya-	Saya-
   āśaya-	ASaya-
   saṃśaya-	saMSaya-
   viṣaya-	vizaya-
   kṣaya-	kzaya-
   saṃkṣaya-	saMkzaya-
   haya-	haya-
   kāya-	kAya-
   dāya-	dAya-
   adhyāya-	aDyAya-
   upādhyāya-	upADyAya-
   nyāya-	nyAya-
   paryāya-	paryAya-
   sahāya-	sahAya-
   yajñiya-	yajQiya-
   kṣatriya-	kzatriya-
   indriya-	indriya-
   priya-	priya-
   atikramaṇīya-	atikramaNIya-
   nārāyaṇīya-	nArAyaNIya-
   śravaṇīya-	SravaNIya-
   śrāvaṇīya-	SrAvaNIya-
   dvitīya-	dvitIya-
   tṛtīya-	tRtIya-
   bodhanīya-	boDanIya-
   sparśanīya-	sparSanIya-
   somīya-	somIya-
   svasrīya-	svasrIya-
   jñeya-	jQeya-
   vijñeya-	vijQeya-
   anuṣṭheya-	anuzWeya-
   vārṣṇeya-	vArzNeya-
   daiteya-	dEteya-
   kaunteya-	kOnteya-
   deya-	deya-
   dheya-	Deya-
   peya-	peya-
   prameya-	prameya-
   parimeya-	parimeya-
   ākhyeya-	AKyeya-
   ghreya-	Greya-
   pāṇḍaveya-	pANxaveya-
   ārṣeya-	Arzeya-
   toya-	toya-
   śakya-	Sakya-
   vākya-	vAkya-
   nāsikya-	nAsikya-
   trailokya-	trElokya-
   pratarkya-	pratarkya-
   sakhya-	saKya-
   mukhya-	muKya--
   saukhya-	sOKya-
   saṃkhya-	saMKya-
   sāṃkhya-	sAMKya-
   arghya-	arGya-
   vācya-	vAcya-
   raucya-	rOcya-
   abhyarcya-	aByarcya-
   ājya-	Ajya-
   rājya-	rAjya-
   sāmrājya-	sAmrAjya-
   pūjya-	pUjya-
   upabhojya-	upaBojya-
   yojya-	yojya-
   niyojya-	niyojya-
   pārameṣṭhya-	pAramezWya-
   tāṇḍya-	tANxya-
   āḍhya-	AXya-
   karmaṇya-	karmaNya-
   brahmaṇya-	brahmaNya-
   hiraṇya-	hiraNya-
   prāmāṇya-	prAmANya-
   traiguṇya-	trEguNya-
   puṇya-	puNya-
   vareṇya-	vareNya-
   dhiṣṇya-	DizNya-
   prājāpatya-	prAjApatya-
   satya-	satya-
   nāsatya-	nAsatya-
   āditya-	Aditya-
   nitya-	nitya-
   daitya-	dEtya-
   śaitya-	SEtya-
   cintya-	cintya-
   agastya-	agastya-
   pulastya-	pulastya-
   tathya-	taTya-
   utathya-	utaTya-
   ātithya-	AtiTya-
   arthya-	arTya-
   gārhasthya-	gArhasTya-
   adya	adya
   ādya-	Adya-
   pādya-	pAdya-
   bhedya-	Bedya-
   vedya-	vedya-
   vandya-	vandya-
   madhya-	maDya-
   medhya-	meDya-
   anya-	anya-
   dhanya-	Danya-
   dhānya-	DAnya-
   śūnya-	SUnya-
   japya-	japya-
   prāpya-	prApya-
   vairūpya-	vErUpya-
   raibhya-	rEBya-
   ramya-	ramya-
   kāmya-	kAmya-
   yāmya-	yAmya-
   sāmya-	sAmya-
   māhātmya-	mAhAtmya-
   dharmya-	Darmya-
   jayya-	jayya-
   nyāyya-	nyAyya-
   āścarya-	AScarya--
   pāraṃparya-	pAraMparya-
   varya-	varya-
   aiśvarya-	ESvarya-
   ārya-	Arya-
   kārya-	kArya-
   ācārya-	AcArya-
   vaiḍūrya-	vExUrya-
   sūrya-	sUrya-
   agrya-	agrya-
   pitrya-	pitrya-
   śalya-	Salya-
   paripālya-	paripAlya-
   vālakhilya-	vAlaKilya-
   tulya-	tulya-
   kavya-	kavya-
   yaṣṭavya-	yazwavya-
   draṣṭavya-	drazwavya-
   vyākhyātavya-	vyAKyAtavya-
   vartitavya-	vartitavya-
   bādhitavya-	bADitavya-
   phalitavya-	Palitavya-
   sevitavya-	sevitavya-
   prāśitavya-	prASitavya-
   vaktavya-	vaktavya-
   mantavya-	mantavya-
   nihantavya-	nihantavya-
   kartavya-	kartavya-
   bhavya-	Bavya-
   bābhravya-	bABravya-
   savya-	savya-
   havya-	havya-
   divya-	divya-
   sevya-	sevya-
   ānupūrvya-	AnupUrvya-
   vaśya-	vaSya-
   prāśya-	prASya-
   dṛśya-	dRSya-
   spṛśya-	spRSya-
   vaiśya-	vESya-
   tiṣya-	tizya-
   bhaviṣya-	Bavizya-
   śiṣya-	Sizya-
   manuṣya-	manuzya-
   pradhṛṣya-	praDRzya-
   dveṣya-	dvezya-
   sadasya-	sadasya-
   yaśasya-	yaSasya-
   rahasya-	rahasya-
   āsya-	Asya-
   upāsya-	upAsya-
   amāvāsya-	amAvAsya-
   anuśāsya-	anuSAsya-
   hiṃsya-	hiMsya-
   matsya-	matsya-
   viṣahya-	vizahya-
   grāhya-	grAhya-
   sāhya-	sAhya-
   guhya-	guhya-
   kara-	kara-
   makara-	makara-
   puṣkara-	puzkara-
   pauṣkara-	pOzkara-
   avaskara-	avaskara-
   sāgara-	sAgara-
   gargara-	gargara-
   cara-	cara-
   jara-	jara-
   dhanyatara-	Danyatara-
   paratara-	paratara-
   balavattara-	balavattara-
   uttara-	uttara-
   antara-	antara-
   vistara-	vistara-
   dara-	dara-
   badara-	badara-
   udara-	udara-
   dhara-	Dara-
   nara-	nara-
   para-	para-
   apara-	apara-
   mara-	mara-
   vara-	vara-
   pravara-	pravara-
   sthāvara-	sTAvara-
   vivara-	vivara-
   kalevara-	kalevara-
   adhvara-	aDvara-
   īśvara-	ISvara-
   aiśvara-	ESvara-
   svara-	svara-
   parāśara-	parASara-
   kṣara-	kzara-
   sara-	sara-
   hara-	hara-
   kāra-	kAra-
   adhikāra-	aDikAra-
   vikāra-	vikAra-
   adhīkāra-	aDIkAra-
   saṃskāra-	saMskAra-
   ācāra-	AcAra-
   samuccāra-	samuccAra-
   tāra-	tAra-
   udāra-	udAra-
   ādhāra-	ADAra-
   nāra-	nAra-
   pāra-	pAra-
   bhāra-	BAra-
   saṃbhāra-	saMBAra-
   kumāra-	kumAra-
   dvāra-	dvAra-
   sāra-	sAra-
   hāra-	hAra-
   āhāra-	AhAra-
   saṃhāra-	saMhAra-
   cira-	cira-
   rucira-	rucira-
   sthira-	sTira-
   śarīra-	SarIra-
   vīra-	vIra-
   kṣīra-	kzIra-
   aṇkura-	aNkura-
   ātura-	Atura-
   madhura-	maDura-
   pura-	pura-
   mura-	mura-
   sura-	sura-
   asura-	asura-
   dūra-	dUra-
   mayūra-	mayUra-
   svaira-	svEra-
   ghora-	Gora-
   cakra-	cakra-
   śakra-	Sakra-
   agra-	agra-
   ugra-	ugra--
   vyāghra-	vyAGra-
   śīghra-	SIGra-
   kṛcchra-	kRcCra-
   vajra-	vajra-
   rāṣṭra-	rAzwra-
   tvāṣṭra-	tvAzwra-
   tra-	tra-
   atra	atra
   tatra	tatra
   patra-	patra-
   yatra	yatra
   kalatra-	kalatra-
   sarvatra	sarvatra
   kṣatra-	kzatra-
   nakṣatra-	nakzatra-
   gātra-	gAtra-
   rātra-	rAtra-
   citra-	citra-
   gaṇitra-	gaNitra-
   mitra-	mitra-
   pavitra-	pavitra-
   dauhitra-	dOhitra-
   putra-	putra-
   sūtra-	sUtra-
   vṛtra-	vRtra-
   netra-	netra-
   kṣetra-	kzetra-
   gotra-	gotra-
   stotra-	stotra-
   hotra-	hotra-
   pautra-	pOtra-
   vaktra-	vaktra-
   chattra-	Cattra-
   sattra-	sattra-
   tantra-	tantra-
   mantra-	mantra-
   śāstra-	SAstra-
   bhadra-	Badra-
   chidra-	Cidra-
   samudra-	samudra-
   sāmudra-	sAmudra-
   rudra-	rudra-
   kṣudra-	kzudra-
   śūdra-	SUdra-
   candra-	candra-
   indra-	indra-
   aindra-	Endra-
   pra	pra
   &.wu jñā pra	&.wu jQA pra
   &.wu sthā pra	&.wu sTA pra
   &.wu dā pra	&.wu dA pra
   &.wu mā pra	&.wu mA pra
   &.wu hā pra	&.wu hA pra
   &.wu i pra	&.wu i pra
   &.wu nī pra	&.wu nI pra
   &.wu lī pra	&.wu lI pra
   &.wu cyu pra	&.wu cyu pra
   &.wu dru pra	&.wu dru pra
   &.wu bhū pra	&.wu BU pra
   &.wu brū pra	&.wu brU pra
   &.wu sū pra	&.wu sU pra
   &.wu kṛ pra	&.wu kR pra
   &.wu sṛ pra	&.wu sR pra
   &.wu gai pra	&.wu gE pra
   &.wu tark pra	&.wu tarc pra
   &.wu vac pra	&.wu vat pra
   &.wu yuj pra	&.wu yuj pra
   &.wu pūj pra	&.wu pUj pra
   &.wu sṛj pra	&.wu sRt pra
   &.wu vṛt pra	&.wu vRd pra
   &.wu kīrt pra	&.wu kIrD pra
   &.wu pad pra	&.wu pad pra
   &.wu vad pra	&.wu vat pra
   &.wu sad pra	&.wu sat pra
   &.wu bādh pra	&.wu bAD pra
   &.wu budh pra	&.wu buD pra
   &.wu vṛdh pra	&.wu vRD pra
   &.wu āp pra	&.wu Ap pra
   &.wu kḹp pra	&.wu k?B pra
   &.wu nam pra	&.wu nam pra
   &.wu yam pra	&.wu yam pra
   &.wu kram pra	&.wu kram pra
   &.wu car pra	&.wu car pra
   &.wu jval pra	&.wu jvat pra
   &.wu aś#'2 pra	&.wu aS#a2 pra
   &.wu naś pra	&.wu naH pra
   &.wu kāś pra	&.wu kAH pra
   &.wu diś pra	&.wu diH pra
   &.wu viś pra	&.wu viH pra
   &.wu dṛś pra	&.wu dRH pra
   &.wu bhāṣ pra	&.wu BAz pra
   &.wu dhṛṣ pra	&.wu DRz pra
   &.wu cakṣ pra	&.wu cakz pra
   &.wu īkṣ pra	&.wu Ikz pra
   &.wu ukṣ pra	&.wu ukz pra
   &.wu vas pra	&.wu vaH pra
   &.wu śās pra	&.wu SAs pra
   &.wu ah pra	&.wu ah pra
   &.wu grah pra	&.wu grah pra
   &.wu āp anu, pra	&.wu Ap anu, pra
   &.wu viś anu, pra	&.wu viH anu, pra
   &.wu āp sam, anu, pra	&.wu Ap sam, anu, pra
   &.wu lī sam, pra	&.wu lI sam, pra
   &.wu vac sam, pra	&.wu vat sam, pra
   &.wu yuj sam, pra	&.wu yuj sam, pra
   &.wu āp sam, pra	&.wu Ap sam, pra
   vipra-	vipra-
   kṣipra-	kzipra-
   śubhra-	SuBra-
   tīvra-	tIvra-
   miśra-	miSra-
   vyāmiśra-	vyAmiSra-
   jasra-	jasra-
   dasra-	dasra-
   sahasra-	sahasra-
   hiṃsra-	hiMsra-
   cala-	cala-
   jala-	jala-
   ākhaṇḍala-	AKaNxala-
   maṇḍala-	maNxala-
   tala-	tala-
   śītala-	SItala-
   upala-	upala-
   phala-	Pala-
   bala-	bala-
   mala-	mala-
   kamala-	kamala-
   kaśmala-	kaSmala-
   kevala-	kevala-
   kuśala-	kuSala-
   vatsala-	vatsala-
   kautūhala-	kOtUhala-
   kāla-	kAla-
   pāñcāla-	pAQcAla-
   jāla-	jAla-
   pātāla-	pAtAla-
   nāla-	nAla-
   pāla-	pAla-
   pravāla-	pravAla-
   jvāla-	jvAla-
   viśāla-	viSAla-
   kila	kila
   khila-	Kila-
   jaṭila-	jawila-
   tila-	tila-
   anila-	anila-
   kapila-	kapila-
   salila-	salila-
   nīla-	nIla-
   ślīla-	SlIla-
   kula-	kula-
   samākula-	samAkula-
   vyākula-	vyAkula-
   tula-	tula-
   mātula-	mAtula-
   vipula-	vipula-
   kūla-	kUla-
   sthūla-	sTUla-
   śārdūla-	SArdUla-
   mūla-	mUla-
   śūla-	SUla-
   paila-	pEla-
   śukla-	Sukla-
   &.wu sthā ava	&.wu sTAH ava
   &.wu sṛ ava	&.wu sR ava
   &.wu pat ava	&.wu pad ava
   &.wu āp ava	&.wu Ap ava
   &.wu īkṣ ava	&.wu Ikz ava
   &.wu bhās ava	&.wu BAH ava
   &.wu sthā pari, ava	&.wu sTA pari, ava
   &.wu so pari, ava	&.wu saH pari, ava
   &.wu sthā vi, ava	&.wu sTAH vi, ava
   &.wu so vi, ava	&.wu saH vi, ava
   bhārgava-	BArgava-
   pāṇḍava-	pANxava-
   arṇava-	arNava-
   vaiṣṇava-	vEzNava-
   mādhava-	mADava-
   bāndhava-	bAnDava-
   nava-	nava-
   dānava-	dAnava-
   mānava-	mAnava-
   bhava-	Bava-
   prabhava-	praBava-
   saṃbhava-	saMBava-
   udbhava-	udBava-
   samudbhava-	samudBava-
   gālava-	gAlava-
   keśava-	keSava-
   prasava-	prasava-
   bhāva-	BAva-
   prabhāva-	praBAva-
   iva	iva
   pārthiva-	pArTiva-
   diva-	diva-
   śiva-	Siva-
   jīva-	jIva-
   rājīva-	rAjIva-
   bhuva-	Buva-
   svāyaṃbhuva-	svAyaMBuva-
   dhruva-	Druva-
   sruva-	sruva-
   eva	eva
   deva-	deva-
   vāsudeva-	vAsudeva-
   daiva-	dEva-
   kva	kva
   kaṇva-	kaNva-
   ekatva-	ekatva-
   rājatva-	rAja-tva-
   kaṇṭhatva-	kaNWa-tva-
   vaikuṇṭhatva-	vEkuNWa-tva-
   vṛṣaṇatva-	vRzaNa-tva-
   anupītatva-	anupIta-tva-
   vyaktatva-	vyakta-tva-
   mukhyatva-	muKya-tva-
   vānaratva-	vAnara-tva-
   kumāratva-	kumAra-tva-
   putratva-	putra-tva-
   dravatva-	drava-tva-
   bhakṣatva-	Bakza-tva-
   adhyakṣatva-	aDyakza-tva-
   ekāntitva-	ekAnti-tva-
   yonitva-	yoni-tva-
   pitṛtva-	pitR-tva-
   tattva-	tattva-
   sattva-	sattva-
   mahattva-	mahat-tva-
   manastva-	manaH-tva-
   dvaṃdva-	dvaMdva-
   ūrdhva-	UrDva-
   gandharva-	ganDarva-
   sarva-	sarva-
   pūrva-	pUrva-
   aśva-	aSva-
   viśva-	viSva-
   pārśva-	pArSva-
   sva-	sva-
   daśa-	daSa-
   vaśa-	vaSa-
   śaśa-	SaSa-
   kāśa-	kASa-
   prakāśa-	prakASa-
   ākāśa-	AkASa-
   pratīkāśa-	pratIkASa-
   saṃkāśa-	saMkASa-
   ḍāśa-	xASa-
   nāśa-	nASa-
   vināśa-	vinASa-
   īśa-	ISa-
   kuśa-	kuSa-
   kṛśa-	kRSa-
   dṛśa-	dRSa-
   keśa-	keSa-
   hṛṣīkeśa-	hRzIkeSa-
   deśa-	deSa-
   samuddeśa-	samuddeSa-
   aṃśa-	aMSa-
   vaṃśa-	vaMSa-
   darśa-	darSa-
   sparśa-	sparSa-
   jhaṣa-	Jaza-
   kalmaṣa-	kalmaza-
   jyotiṣa-	jyotiza-
   dhanuṣa-	Danuza-
   mānuṣa-	mAnuza-
   puruṣa-	puruza-
   kaluṣa-	kaluza-
   cākṣuṣa-	cAkzuza-
   nahuṣa-	nahuza-
   vṛṣa-	vRza-
   meṣa-	meza-
   śeṣa-	Seza-
   viśeṣa-	viSeza-
   ghoṣa-	Goza-
   paritoṣa-	paritoza-
   doṣa-	doza-
   roṣa-	roza-
   śoṣa-	Soza-
   dakṣa-	dakza-
   pakṣa-	pakza-
   antarikṣa-	antarikza-
   nirīkṣa-	nirIkza-
   ukṣa-	ukza-
   śaikṣa-	SEkza-
   mokṣa-	mokza-
   varṣa-	varza-
   śīrṣa-	SIrza-
   sa	sa
   vighasa-	viGasa-
   rājasa-	rAjasa-
   vaikhānasa-	vEKAnasa-
   mānasa-	mAnasa-
   tāmasa-	tAmasa-
   kārṣṇāyasa-	kArzNAyasa-
   śreyasa-	Sreyasa-
   rasa-	rasa-
   aṇgirasa-	aNgirasa-
   āṇgirasa-	ANgirasa-
   aurasa-	Orasa-
   trasa-	trasa-
   lālasa-	lAlasa-
   divasa-	divasa-
   sādhvasa-	sADvasa-
   svasa-	svasa-
   rākṣasa-	rAkzasa-
   bhāsa-	BAsa-
   prabhāsa-	praBAsa-
   samāsa-	samAsa-
   viparyāsa-	viparyAsa-
   vyāsa-	vyAsa-
   vāsa-	vAsa-
   āvāsa-	AvAsa-
   adhivāsa-	aDivAsa-
   nivāsa-	nivAsa-
   hāsa-	hAsa-
   itihāsa-	itihAsa-
   bisa-	bisa-
   kaṃsa-	kaMsa-
   haṃsa-	haMsa-
   vatsa-	vatsa-
   ha	ha
   graha-	graha-
   pragraha-	pragraha-
   nigraha-	nigraha-
   parigraha-	parigraha-
   vigraha-	vigraha-
   anugraha-	anugraha-
   saṃgraha-	saMgraha-
   pulaha-	pulaha-
   vaha-	vaha-
   udvaha-	udvaha-
   saha	saha
   varāha-	varAha-
   vārāha-	vArAha-
   vāha-	vAha-
   iha	iha
   leliha-	leliha-
   vyūha-	vyUha-
   gṛha-	gRha-
   geha-	geha-
   deha-	deha-
   sneha-	sneha-
   siṃha-	siMha-
   nārasiṃha-	nArasiMha-
   arha-	arha-
   &.wu jñā ā	&.wu jQA A
   &.wu sthā ā	&.wu sTA A
   &.wu dā ā	&.wu dA A
   &.wu dhā ā	&.wu DA A
   &.wu yā ā	&.wu yA A
   &.wu khyā ā	&.wu KyA A
   &.wu pyā ā	&.wu pyAH A
   &.wu śri ā	&.wu Sri A
   &.wu nī ā	&.wu nI A
   &.wu ṛ ā	&.wu R A
   &.wu stṛ ā	&.wu stR A
   &.wu vṛ#'1 ā	&.wu vR#a1 A
   &.wu hṛ ā	&.wu hR A
   &.wu k-ṛ ā	&.wu k-R A
   &.wu hve ā	&.wu hve A
   &.wu lok ā	&.wu lok A
   &.wu vṛt ā	&.wu vRt A
   &.wu math ā	&.wu maT A
   &.wu pad ā	&.wu pad A
   &.wu sad ā	&.wu sat A
   &.wu rādh ā	&.wu rAD A
   &.wu gam ā	&.wu gam A
   &.wu kram ā	&.wu kram A
   &.wu han sam ā	&.wu han sam A
   &.wu diś ā	&.wu diH A
   &.wu viś ā	&.wu viH A
   &.wu spṛś ā	&.wu spRH A
   &.wu bhāṣ ā	&.wu BAz A
   &.wu cakṣ ā	&.wu cakz A
   &.wu grah ā	&.wu grah A
   &.wu ghrā upa, ā	&.wu GrA upa, A
   &.wu śri upa, ā	&.wu Sri upa, A
   &.wu vṛt upa, ā	&.wu vRd upa, A
   &.wu gam upa, ā	&.wu gam upa, A
   &.wu dhāv upa, ā	&.wu DO upa, A
   &.wu spṛś upa, ā	&.wu spRH upa, A
   &.wu sthā sam, upa, ā	&.wu sTA sam, upa, A
   &.wu khyā prati, ā	&.wu KyA prati, A
   &.wu hṛ prati, ā	&.wu hR prati, A
   &.wu vas adhi, ā	&.wu vaH aDi, A
   &.wu i abhi, ā	&.wu i aBi, A
   &.wu sad abhi, ā	&.wu sat aBi, A
   &.wu gam abhi, ā	&.wu gam aBi, A
   &.wu khyā vi, ā	&.wu KyA vi, A
   &.wu hṛ vi, ā	&.wu hR vi, A
   &.wu vṛt vi, ā	&.wu vRd vi, A
   &.wu kul vi, ā	&.wu kul vi, A
   &.wu hṛ ud, ā	&.wu hR ud, A
   &.wu hṛ sam, ud, ā	&.wu hR sam, ud, A
   &.wu sthā sam, ā	&.wu sTA sam, A
   &.wu dhā sam, ā	&.wu DA sam, A
   &.wu i sam, ā	&.wu i sam, A
   &.wu śri sam, ā	&.wu Sri sam, A
   &.wu nī sam, ā	&.wu nI sam, A
   &.wu vṛ#'1 sam, ā	&.wu vR#a1 sam, A
   &.wu yuj sam, ā	&.wu yuj sam, A
   &.wu sad sam, ā	&.wu sat sam, A
   &.wu rabh sam, ā	&.wu raB sam, A
   &.wu gam sam, ā	&.wu gam sam, A
   &.wu viś sam, ā	&.wu viH sam, A
   &.wu ruh sam, ā	&.wu ruh sam, A
   kanyakā-	kanyakA-
   dvārakā-	dvArakA-
   iṣīkā-	izIkA-
   tarkā-	tarkA-
   śākhā-	SAKA-
   lekhā-	leKA-
   &.wu gā#'2	&.wu gA#a2
   gaṇgā-	gaNgA-
   icchā-	icCA-
   ṛcchā-	RcCA-
   prajā-	prajA-
   pūjā-	pUjA-
   saṃpūjā-	saMpUjA-
   &.wu jñā	&.wu jQA
   ājñā-	AjQA-
   saṃjñā-	saMjQA-
   jaṭā-	jawA-
   pratiṣṭhā-	pratizWA-
   niṣṭhā-	nizWA-
   iḍā-	ixA-
   dakṣiṇā-	dakziNA-
   tṛṣṇā-	tRzNA-
   tā-	tA-
   kaṇṭhatā-	kaNWa-tA-
   caraṇatā-	caraNa-tA-
   vyaktatā-	vyakta-tA-
   citratā-	citra-tA-
   nīlatā-	nIla-tA-
   devatā-	devatA-
   vanitā-	vanitA-
   saṃhitā-	saMhitA-
   śmaśrutā-	SmaSrutA-
   tretā-	tretA-
   muktā-	muktA-
   cintā-	cintA-
   kathā-	kaTA-
   tathā	taTA
   yathā	yaTA
   anyathā	anyaTA
   sarvathā	sarvaTA
   &.wu sthā	&.wu sTA
   avasthā-	avasTA-
   &.wu dā	&.wu dA
   kadā	kadA
   gadā-	gadA-
   tadā	tadA
   yadā	yadA
   nityadā	nityadA
   sadā	sadA
   maryādā-	maryAdA-
   &.wu dhā	&.wu DA
   ekadhā	ekaDA
   vidhā-	viDA-
   dvidhā	dviDA
   bahudhā	bahuDA
   saṃdhā-	saMDA-
   śraddhā-	SradDA-
   caturdhā	caturDA
   mānanā-	mAnanA-
   bhāvanā-	BAvanA-
   nānā	nAnA
   vinā	vinA
   senā-	senA-
   &.wu snā	&.wu snA
   &.wu pā#'1	&.wu pA#a1
   &.wu pā#'2	&.wu pA#a2
   ambā-	ambA-
   bhā-	BA-
   &.wu bhā	&.wu BA
   prabhā-	praBA-
   ābhā-	ABA-
   nibhā-	niBA-
   śobhā-	SoBA-
   mā	mA
   &.wu mā	&.wu mA
   kṣamā-	kzamA-
   samā-	samA-
   umā-	umA-
   &.wu yā	&.wu yA
   māyā-	mAyA-
   kriyā-	kriyA-
   vikriyā-	vikriyA-
   &.wu khyā	&.wu KyA
   prakhyā-	praKyA-
   ākhyā-	AKyA-
   kṛtyā-	kRtyA-
   vidyā-	vidyA-
   vadhyā-	vaDyA-
   saṃdhyā-	saMDyA-
   vandhyā-	vanDyA-
   kanyā-	kanyA-
   kāmyā-	kAmyA-
   śayyā-	SayyA-
   caryā-	caryA-
   ahalyā-	ahalyA-
   jarā-	jarA-
   parā-	parA-
   &.wu ji parā	&.wu ji parA
   dhārā-	DArA-
   māthurā-	mATurA-
   purā	purA
   &.wu ghrā	&.wu GrA
   daṃṣṭrā-	daMzwrA-
   &.wu trā	&.wu trA
   mātrā-	mAtrA-
   nidrā-	nidrA-
   kalā-	kalA-
   mekhalā-	meKalA-
   mālā-	mAlA-
   jvālā-	jvAlA-
   velā-	velA-
   vā	vA
   &.wu vā	&.wu vA
   vaḍavā-	vaxavA-
   grīvā-	grIvA-
   jihvā-	jihvA-
   āśā-	ASA-
   diśā-	diSA-
   śuśrūṣā-	SuSrUzA-
   bhikṣā-	BikzA-
   śikṣā-	SikzA-
   dīkṣā-	dIkzA-
   rasā-	rasA-
   nāsā-	nAsA-
   pipāsā-	pipAsA-
   hiṃsā-	hiMsA-
   &.wu hā	&.wu hA
   guhā-	guhA-
   &.wu i	&.wu i
   sakhi-	saKi-
   dadhīci-	daDIci-
   marīci-	marIci-
   śuci-	Suci-
   &.wu ji	&.wu ji
   ṣaṣṭi-	zazwi-
   iṣṭi-	izwi-
   diṣṭi-	dizwi-
   dṛṣṭi-	dRzwi-
   sṛṣṭi-	sRzwi-
   maṇi-	maNi-
   dharaṇi-	DaraNi-
   pāṇi-	pANi-
   indrāṇi-	indrANi-
   maitrāvaruṇi-	mEtrAvaruNi-
   ati	ati
   &.wu i ati	&.wu i ati
   &.wu gam ati	&.wu gam ati
   &.wu kram ati	&.wu kram ati
   &.wu ric vi, ati	&.wu rit vi, ati
   &.wu i sam, ati	&.wu i sam, ati
   gati-	gati-
   āgati-	Agati-
   saṃtati-	saMtati-
   pati-	pati-
   mati-	mati-
   yati-	yati-
   prati	prati
   &.wu sthā prati	&.wu sTA prati
   &.wu bhā prati	&.wu BA prati
   &.wu vac prati	&.wu vat prati
   &.wu pūj prati	&.wu pUj prati
   &.wu chad prati	&.wu Cat prati
   &.wu pad prati	&.wu pad prati
   &.wu budh prati	&.wu buD prati
   &.wu han prati	&.wu han prati
   &.wu grah prati	&.wu grah prati
   viṃśati-	viMSati-
   jāti-	jAti-
   jñāti-	jQAti-
   iti	iti
   upaciti-	upaciti-
   sthiti-	sTiti-
   diti-	diti-
   aditi-	aditi-
   śiti-	Siti-
   kṣiti-	kziti-
   gīti-	gIti-
   prīti-	prIti-
   dyuti-	dyuti-
   śruti-	Sruti-
   upaśruti-	upaSruti-
   āhuti-	Ahuti-
   bhūti-	BUti-
   vibhūti-	viBUti-
   prakṛti-	prakRti-
   ākṛti-	AkRti-
   dhṛti-	DRti-
   prabhṛti-	praBRti-
   smṛti-	smRti-
   bhakti-	Bakti-
   vyakti-	vyakti-
   śakti-	Sakti-
   utpatti-	utpatti-
   vṛtti-	vRtti-
   pravṛtti-	pravRtti-
   āvṛtti-	AvRtti-
   nivṛtti-	nivRtti-
   kānti-	kAnti-
   śānti-	SAnti-
   samāpti-	samApti-
   prāpti-	prApti-
   kīrti-	kIrti-
   mūrti-	mUrti-
   asti	asti
   dāśarathi-	dASaraTi-
   sārathi-	sAraTi-
   atithi-	atiTi-
   asthi-	asTi-
   yadi	yadi
   ādi-	Adi-
   dhi-	Di-
   &.wu sthā dhi	&.wu sTAH Di
   adhi	aDi
   &.wu sthā adhi	&.wu sTAH aDi
   &.wu pā#'2 adhi	&.wu pA#a2 aDi
   &.wu i adhi	&.wu i aDi
   &.wu gam adhi	&.wu gam aDi
   &.wu vas adhi	&.wu vaH aDi
   &.wu ās adhi	&.wu AH aDi
   &.wu ruh adhi	&.wu rum aDi
   &.wu i pra, adhi	&.wu i pra, aDi
   dadhi-	daDi-
   oṣadhi-	ozaDi-
   samādhi-	samADi-
   nidhi-	niDi-
   saṃnidhi-	saMniDi-
   vidhi-	viDi-
   saṃdhi-	saMDi-
   siddhi-	sidDi-
   buddhi-	budDi-
   ni	ni
   &.wu sthā ni	&.wu sTAH ni
   &.wu lī ni	&.wu lI ni
   &.wu yuj ni	&.wu yuj ni
   &.wu pat ni	&.wu pad ni
   &.wu vṛt ni	&.wu vRd ni
   &.wu vid#'1 ni	&.wu vid#a1 ni
   &.wu rudh ni	&.wu ruD ni
   &.wu han ni	&.wu han ni
   &.wu yam ni	&.wu yam ni
   &.wu śam ni	&.wu Sam ni
   &.wu sev ni	&.wu sev ni
   &.wu as#'2 ni	&.wu as#a2 ni
   &.wu vas ni	&.wu vaH ni
   &.wu grah ni	&.wu grah ni
   &.wu vṛ#'1 vi, ni	&.wu vR#a1 vi, ni
   &.wu kṣip vi, ni	&.wu kzip vi, ni
   &.wu vṛt sam, ni	&.wu vRt sam, ni
   &.wu sev sam, ni	&.wu seu sam, ni
   dhamani-	Damani-
   dhvani-	Dvani-
   glāni-	glAni-
   jaimini-	jEmini-
   muni-	muni-
   yoni-	yoni-
   agni-	agni-
   pṛśni-	pRSni-
   api	api
   kapi-	kapi-
   śipi-	Sipi-
   abhi	aBi
   &.wu dhā abhi	&.wu DAH aBi
   &.wu stu abhi	&.wu stu aBi
   &.wu bhū abhi	&.wu BU aBi
   &.wu sic abhi	&.wu sit aBi
   &.wu arc abhi	&.wu ar aBi
   &.wu yaj abhi	&.wu yat aBi
   &.wu pat abhi	&.wu pad aBi
   &.wu vṛt abhi	&.wu vRt aBi
   &.wu vad abhi	&.wu vat aBi
   &.wu śabd abhi	&.wu Sabt aBi
   &.wu han abhi	&.wu han aBi
   &.wu gam abhi	&.wu gam aBi
   &.wu dhāv abhi	&.wu DO aBi
   &.wu laṣ abhi	&.wu laH aBi
   &.wu bhāṣ abhi	&.wu BAz aBi
   &.wu as#'2 abhi	&.wu as#a2 aBi
   &.wu stu sam, abhi	&.wu stu sam, aBi
   &.wu plu sam, abhi	&.wu plu sam, aBi
   &.wu gam sam, abhi	&.wu gam sam, aBi
   nābhi-	nABi-
   bhūmi-	BUmi-
   &.wu smi	&.wu smi
   ari-	ari-
   &.wu mā pari	&.wu mA pari
   &.wu vṛ#'1 pari	&.wu vR#a1 pari
   &.wu prach pari	&.wu praC pari
   &.wu tyaj pari	&.wu tyat pari
   &.wu śvaj pari	&.wu Svad pari
   &.wu paṭh pari	&.wu paW pari
   &.wu kīrt pari	&.wu kIrt pari
   &.wu śudh pari	&.wu SuD pari
   &.wu āp pari	&.wu Ap pari
   &.wu kḹp pari	&.wu k?B pari
   &.wu kram pari	&.wu kram pari
   &.wu śram pari	&.wu Sram pari
   &.wu pāl pari	&.wu pAd pari
   &.wu bhraṃś pari	&.wu BraM pari
   &.wu bṛh pari	&.wu bRh pari
   upari	upari
   hari-	hari-
   vāri-	vAri-
   giri-	giri-
   taittiri-	tEttiri-
   tri-	tri-
   atri-	atri-
   rātri-	rAtri-
   kali-	kali-
   añjali-	aQjali-
   bali-	bali-
   vi	vi
   &.wu jñā vi	&.wu jQAH vi
   &.wu dhā vi	&.wu DA vi
   &.wu khyā vi	&.wu KyA vi
   &.wu vā vi	&.wu vA vi
   &.wu hā vi	&.wu hA vi
   &.wu i vi	&.wu i vi
   &.wu nī vi	&.wu nI vi
   &.wu krī vi	&.wu krI vi
   &.wu śru vi	&.wu Sru vi
   &.wu dhū vi	&.wu DU vi
   &.wu kṛ vi	&.wu kR vi
   &.wu stṛ vi	&.wu stR vi
   &.wu hṛ vi	&.wu hR vi
   &.wu ś-ṛ vi	&.wu S-R vi
   &.wu lag vi	&.wu lak vi
   &.wu muc vi	&.wu mud vi
   &.wu bhaj vi	&.wu Bat vi
   &.wu raj vi	&.wu rat vi
   &.wu vṛj vi	&.wu vRd vi
   &.wu sṛj vi	&.wu sRt vi
   &.wu añj vi	&.wu aQj vi
   &.wu budh vi	&.wu buD vi
   &.wu śudh vi	&.wu SuD vi
   &.wu vṛdh vi	&.wu vRD vi
   &.wu āp vi	&.wu Ap vi
   &.wu kṣip vi	&.wu kzip vi
   &.wu nam vi	&.wu nam vi
   &.wu ram vi	&.wu ram vi
   &.wu kram vi	&.wu kram vi
   &.wu śram vi	&.wu Sram vi
   &.wu car vi	&.wu car vi
   &.wu phal#'2 vi	&.wu Pal#a2 vi
   &.wu naś vi	&.wu naH vi
   &.wu viś vi	&.wu viH vi
   &.wu śiṣ vi	&.wu Siz vi
   &.wu vah vi	&.wu vah vi
   &.wu sah vi	&.wu sah vi
   &.wu muh vi	&.wu muh vi
   &.wu cint pra, vi	&.wu cint pra, vi
   &.wu car pra, vi	&.wu car pra, vi
   &.wu khyā abhi, vi	&.wu KyAH aBi, vi
   &.wu raj abhi, vi	&.wu rat aBi, vi
   &.wu bhaj sam, vi	&.wu Bat sam, vi
   kavi-	kavi-
   ravi-	ravi-
   vāsavi-	vAsavi-
   dvi-	dvi-
   ṛṣi-	Rzi-
   &.wu kṣi	&.wu kzi
   akṣi-	akzi-
   kukṣi-	kukzi-
   hi	hi
   ī-	I-
   visargikī-	visargikI-
   śacī-	SacI-
   dharaṇī-	DaraNI-
   vāṇī-	vANI-
   rohiṇī-	rohiNI-
   jagatī-	jagatI-
   sarasvatī-	sarasvatI-
   nadī-	nadI-
   vedī-	vedI-
   dhī-	DI-
   nī-	nI-
   &.wu nī	&.wu nI
   jananī-	jananI-
   medinī-	medinI-
   kakudminī-	kakudminI-
   nalinī-	nalinI-
   patnī-	patnI-
   lakṣmī-	lakzmI-
   trayī-	trayI-
   badarī-	badarI-
   purī-	purI-
   sāvitrī-	sAvitrI-
   strī-	strI-
   &.wu prī	&.wu prI
   śrī-	SrI-
   &.wu lī	&.wu lI
   sthalī-	sTalI-
   pṛthivī-	pRTivI-
   devī-	devI-
   pṛthvī-	pRTvI-
   urvī-	urvI-
   &.wu śī	&.wu SI
   mānuṣī-	mAnuzI-
   pauruṣī-	pOruzI-
   tāmasī-	tAmasI-
   paurṇamāsī-	pOrNamAsI-
   mahī-	mahI-
   ikṣvāku-	ikzvAku-
   bhṛgu-	BRgu-
   laghu-	laGu-
   pāṇḍu-	pANxu-
   aṇu-	aNu-
   sthāṇu-	sTANu-
   viṣṇu-	vizNu-
   prabhaviṣṇu-	praBavizNu-
   tu	tu
   kratu-	kratu-
   dhātu-	DAtu-
   ṛtu-	Rtu-
   hetu-	hetu-
   jantu-	jantu-
   mantu-	mantu-
   &.wu stu	&.wu stu
   pṛthu-	pRTu-
   &.wu du	&.wu du
   yadu-	yadu-
   indu-	indu-
   bindu-	bindu-
   madhu-	maDu-
   sādhu-	sADu-
   bāndhu-	bAnDu-
   nu	nu
   anu	anu
   &.wu sthā anu	&.wu sTAH anu
   &.wu i anu	&.wu i anu
   &.wu nī anu	&.wu nI anu
   &.wu prach anu	&.wu praC anu
   &.wu varṇ anu	&.wu varN anu
   &.wu kīrt anu	&.wu kIrt anu
   &.wu nad anu	&.wu nat anu
   &.wu śabd anu	&.wu Sabd anu
   &.wu man anu	&.wu man anu
   &.wu gam anu	&.wu gam anu
   &.wu paś anu	&.wu paH anu
   &.wu bhāṣ anu	&.wu BAH anu
   &.wu iṣ anu	&.wu iH anu
   &.wu śās anu	&.wu SAH anu
   &.wu grah anu	&.wu grah anu
   &.wu i sam, anu	&.wu i sam, anu
   &.wu vṛt sam, anu	&.wu vRt sam, anu
   tanu-	tanu-
   manu-	manu-
   hanu-	hanu-
   bhānu-	BAnu-
   kṛśānu-	kRSAnu-
   sūnu-	sUnu-
   ripu-	ripu-
   kaśipu-	kaSipu-
   prabhu-	praBu-
   vibhu-	viBu-
   vāyu-	vAyu-
   &.wu cyu	&.wu cyu
   manyu-	manyu-
   ādhvaryu-	ADvaryu-
   dasyu-	dasyu-
   cāru-	cAru-
   kuru-	kuru-
   guru-	guru-
   puru-	puru-
   meru-	meru-
   śatru-	Satru-
   &.wu dru	&.wu dru
   &.wu śru	&.wu Sru
   aśru-	aSru-
   khalu	Kalu
   kamaṇḍalu-	kamaNxalu-
   paśu-	paSu-
   paraśu-	paraSu-
   āśu-	ASu-
   aṃśu-	aMSu-
   śuśrūṣu-	SuSrUzu-
   didṛkṣu-	didRkzu-
   su	su
   &.wu su	&.wu su
   vasu-	vasu-
   jijñāsu-	jijQAsu-
   īpsu-	Ipsu-
   &.wu hu	&.wu hu
   bahu-	bahu-
   bāhu-	bAhu-
   tanū-	tanU-
   &.wu pū	&.wu pU
   bhū-	BU-
   &.wu bhū	&.wu BU
   &.wu brū	&.wu brU
   bhrū-	BrU-
   &.wu sū	&.wu sU
   &.wu ṛ	&.wu R
   &.wu kṛ	&.wu kR
   yaṣṭṛ-	yazwR-
   draṣṭṛ-	drazwR-
   sraṣṭṛ-	srazwR-
   dhātṛ-	DAtR-
   mātṛ-	mAtR-
   bhrātṛ-	BrAtR-
   pitṛ-	pitR-
   bhavitṛ-	BavitR-
   savitṛ-	savitR-
   prāśitṛ-	prASitR-
   duhitṛ-	duhitR-
   hotṛ-	hotR-
   vaktṛ-	vaktR-
   vettṛ-	vettR-
   mantṛ-	mantR-
   hantṛ-	hantR-
   goptṛ-	goptR-
   kartṛ-	kartR-
   bhartṛ-	BartR-
   &.wu dhṛ	&.wu DR
   boddhṛ-	bodDR-
   nṛ-	nR-
   &.wu bhṛ	&.wu BR
   &.wu mṛ	&.wu mR
   &.wu smṛ	&.wu smR
   &.wu vṛ#'1	&.wu vR#a1
   &.wu vṛ#'2	&.wu vR#a2
   &.wu sṛ	&.wu sR
   svasṛ-	svasR-
   &.wu hṛ	&.wu hR
   &.wu t-ṛ	&.wu t-R
   &.wu d-ṛ	&.wu d-R
   &.wu p-ṛ	&.wu p-R
   ṛte	Rte
   &.wu hve	&.wu hve
   he	he
   &.wu gai	&.wu gE
   vai	vE
   go-	go-
   aho	aho
   huṃ	hum
   oṃ	om
   pṛthak	pRTak-
   &.wu śak	&.wu Sak
   dhṛk-	DRk-
   &.wu aṇk	&.wu aNk
   pṛthag	pRTak-
   &.wu lag	&.wu lag
   &.wu pac	&.wu pac
   &.wu rac	&.wu rac
   &.wu vac	&.wu vac
   &.wu yāc	&.wu yAc
   vāc-	vAc-
   &.wu muc	&.wu muc
   ṛc-	Rc-
   udañc-	udaQc-
   samyañc-	samyaQc-
   viṣvañc-	vizvaQc-
   prāñc-	prAQc-
   arvāñc-	arvAQc-
   &.wu arc	&.wu arc
   &.wu prach	&.wu praC
   &.wu bhaj	&.wu Baj
   yaj-	yaj-
   &.wu yaj	&.wu yaj
   &.wu tyaj	&.wu tyaj
   &.wu raj	&.wu raj
   &.wu vraj	&.wu vraj
   bhāj-	BAj-
   rāj-	rAj-
   virāj-	virAj-
   bhuj-	Buj-
   &.wu bhuj	&.wu Buj
   &.wu yuj	&.wu yuj
   &.wu pūj	&.wu pUj
   &.wu vṛj	&.wu vRj
   sṛj-	sRj-
   &.wu sṛj	&.wu sRj
   &.wu majj	&.wu majj
   &.wu bhañj	&.wu BaQj
   &.wu sañj	&.wu saQj
   vaṣaṭ	vazaw-
   samrāṭ-	samrAj--
   &.wu ceṣṭ	&.wu cezw
   &.wu paṭh	&.wu paW
   &.wu tāḍ	&.wu tAx
   &.wu pīḍ	&.wu pIx
   &.wu krīḍ	&.wu krIx
   jagat-	jagat-
   gacchat-	gacCat-
   icchat-	icCat-
   yajat-	yajat-
   virājat-	virAjat-
   sṛjat-	sRjat-
   utsṛjat-	utsRjat-
   samupātiṣṭhat-	samupAtizWat-
   patat-	patat-
   vartat-	vartat-
   abhivadat-	aBivadat-
   saṃvadat-	saMvadat-
   sanat-	sanat-
   ghnat-	Gnat-
   &.wu pat	&.wu pad-
   japat-	japat-
   tapat-	tapat-
   kramat-	kramat-
   matimat-	matimat-
   prītimat-	prItimat--
   dyutimat-	dyutimat-
   bhaktimat-	Baktimat-
   śaktimat-	Saktimat-
   mūrtimat-	mUrtimat-
   buddhimat-	budDimat-
   samṛddhimat-	samRdDimat-
   dhīmat-	DImat-
   śrīmat-	SrImat--
   vasumat-	vasumat-
   garutmat-	garutmat-
   cakṣuṣmat-	cakzuzmat-
   &.wu yat	&.wu yat-
   ālokayat-	Alokayat-
   abhyarcayat-	aByarcayat-
   ceṣṭayat-	cezwayat-
   cintayat-	cintayat-
   pravicintayat-	pravicintayat-
   āvartayat-	Avartayat-
   kīrtayat-	kIrtayat-
   kathayat-	kaTayat-
   anunādayat-	anunAdayat-
   bodhayat-	boDayat-
   randhayat-	ranDayat-
   tāpayat-	tApayat-
   smayat-	smayat-
   udīrayat-	udIrayat-
   mahayat-	mahayat-
   kiyat-	kiyat-
   tapyat-	tapyat-
   naśyat-	naSyat-
   paśyat-	paSyat-
   bhaviṣyat-	Bavizyat-
   carat-	carat-
   bharat-	Barat-
   śarat-	Sarat-
   udgirat-	udgirat-
   bibhrat-	biBrat-
   jvalat-	jvalat-
   prajvalat-	prajvalat-
   bhagavat-	Bagavat-
   vegavat-	vegavat-
   bhogavat-	Bogavat-
   dṛṣṭavat-	dRzwavat-
   pṛṣṭavat-	pRzwavat-
   guṇavat-	guNavat-
   gatavat-	gatavat-
   hatavat-	hatavat-
   ākhyātavat-	AKyAtavat-
   ārādhitavat-	ArADitavat-
   kalpitavat-	kalpitavat-
   pālitavat-	pAlitavat-
   darśitavat-	darSitavat-
   gītavat-	gItavat-
   adhītavat-	aDItavat-
   prādhītavat-	prADItavat-
   gṛhītavat-	gRhItavat-
   kṛtavat-	kRtavat-
   uddhṛtavat-	udDRtavat-
   uktavat-	uktavat-
   dattavat-	dattavat-
   parikrāntavat-	parikrAntavat-
   prāptavat-	prAptavat-
   gandhavat-	ganDavat-
   pratāpavat-	pratApavat-
   rūpavat-	rUpavat-
   puṣpavat-	puzpavat-
   bhavat-	Bavat-
   himavat-	himavat-
   ātmavat-	Atmavat-
   sahāyavat-	sahAyavat-
   balavat-	balavat--
   sattvavat-	sattvavat-
   viśeṣavat-	viSezavat-
   vigrahavat-	vigrahavat-
   prajāvat-	prajAvat--
   prajñāvat-	prajQAvat-
   tāvat-	tAvat--
   etāvat-	etAvat--
   yathāvat	yaTAvat-
   kṣamāvat-	kzamAvat--
   yāvat-	yAvat--
   kriyāvat-	kriyAvat--
   īrṣyāvat-	IrzyA-avat-
   vidhivat-	viDivat--
   abhijagmivat-	aBijagmivat-
   śṛṇvat-	SRNvat-
   kurvat-	kurvat-
   śaśvat-	SaSvat-
   vivasvat-	vivasvat-
   pañcāśat-	paQcASat-
   triṃśat-	triMSat-
   sat-	sat-
   vasat-	vasat-
   āsat-	Asat-
   praśāsat-	praSAsat-
   parīpsat-	parIpsat-
   mahat-	mahat-
   vahat-	vahat-
   udvahat-	udvahat-
   bṛhat-	bRhat-
   paścāt	paScAt-
   purastāt	purastAt-
   āyāt-	AyAt-
   bhasmasāt	BasmasAt-
   sarit-	sarit-
   vidyut-	vidyut-
   marut-	marut-
   kṛt-	kRt-
   &.wu vṛt	&.wu vRt
   &.wu cint	&.wu cint
   &.wu kīrt	&.wu kIrt
   &.wu kath	&.wu kaT
   &.wu math	&.wu maT
   &.wu prath	&.wu praT
   kad-	kad-
   &.wu gad	&.wu gad
   &.wu chad	&.wu Cad
   tad-	tat--
   etad-	etat--
   enad-	enad-
   pad-	pad-
   &.wu pad	&.wu pad
   saṃpad-	saMpad-
   mad-	mad-
   yuṣmad-	yuzmad--
   asmad-	asmad--
   yad-	yat--
   &.wu vad	&.wu vad
   tvad-	tvad--
   upaniṣad-	upanizad-
   sad-	sad-
   &.wu sad	&.wu sat-
   cid	cit-
   &.wu chid	&.wu Cid
   bhid-	Bid-
   &.wu bhid	&.wu Bid
   vid-#'1	vid-#a1
   &.wu vid#'1	&.wu vid#a1
   &.wu vid#'2	&.wu vid#a2
   saṃvid-	saMvid--
   svid	svid-
   &.wu sthā ud	&.wu sTAH ud
   &.wu i ud	&.wu i ud
   &.wu bhū ud	&.wu BU ud
   &.wu kṛ ud	&.wu kR ud
   &.wu dhṛ ud	&.wu DR ud
   &.wu hṛ ud	&.wu hR ud
   &.wu g-ṛ ud	&.wu g-R ud
   &.wu t-ṛ ud	&.wu t-R ud
   &.wu gai ud	&.wu gE ud
   &.wu vij ud	&.wu vij ud
   &.wu yuj ud	&.wu yuj ud
   &.wu sṛj ud	&.wu sRt ud
   &.wu pat ud	&.wu pad ud
   &.wu pad ud	&.wu pad ud
   &.wu sad ud	&.wu sat ud
   &.wu gam ud	&.wu gam ud
   &.wu yam ud	&.wu yam ud
   &.wu car ud	&.wu car ud
   &.wu īr ud	&.wu IH ud
   &.wu diś ud	&.wu diH ud
   &.wu vah ud	&.wu vah ud
   &.wu sthā sam, ud	&.wu sTA sam, ud
   &.wu i sam, ud	&.wu i sam, ud
   &.wu dhū sam, ud	&.wu DU sam, ud
   &.wu bhū sam, ud	&.wu BU sam, ud
   &.wu hṛ sam, ud	&.wu hR sam, ud
   &.wu pad sam, ud	&.wu pad sam, ud
   &.wu kṣip sam, ud	&.wu kzip sam, ud
   kakud-	kakud-
   &.wu cud	&.wu cud
   &.wu nud	&.wu nud
   mṛd-	mRd-
   hṛd-	hRd-
   &.wu vand	&.wu vand
   &.wu śabd	&.wu Sabd
   &.wu radh	&.wu raD
   &.wu vadh	&.wu vaD
   &.wu bādh	&.wu bAD
   &.wu sādh	&.wu sAD
   &.wu sidh	&.wu siD
   &.wu budh	&.wu buD
   yudh-	yuD-
   &.wu yudh	&.wu yuD
   &.wu krudh	&.wu kruD
   &.wu śudh	&.wu SuD
   kṣudh-	kzuD-
   &.wu vṛdh	&.wu vRD
   &.wu bandh	&.wu banD
   &.wu jan	&.wu jan
   rājan-	rAjan-
   mūrdhan-	mUrDan-
   &.wu man	&.wu man
   dāman-	dAman-
   dhāman-	DAman-
   nāman-	nAman-
   sāman-	sAman-
   preman-	preman-
   vyoman-	vyoman-
   roman-	roman-
   ātman-	Atman-
   janman-	janman-
   pāpman-	pApman-
   karman-	karman-
   dharman-	Darman-
   uṣman-	uzman-
   śleṣman-	Slezman-
   yakṣman-	yakzman-
   bhasman-	Basman-
   brahman-	brahman-
   yajvan-	yajvan-
   adhvan-	aDvan-
   atharvan-	aTarvan-
   han-	han-
   &.wu han	&.wu han
   ekākin-	ekAkin-
   catuṣkin-	catuzkin-
   bhogin-	Bogin-
   yogin-	yogin-
   śikhaṇḍin-	SiKaNxin-
   pāṇin-	pANin-
   prāṇin-	prANin-
   yatin-	yatin-
   vratin-	vratin-
   ghātin-	GAtin-
   kṛtin-	kRtin-
   antin-	antin-
   vartin-	vartin-
   anuvartin-	anuvartin-
   pathin-	paTin-
   granthin-	granTin-
   arthin-	arTin-
   sthin-	sTin-
   anunādin-	anunAdin-
   vādin-	vAdin-
   vedin-	vedin-
   kapardin-	kapardin-
   gandhin-	ganDin-
   vyāpin-	vyApin-
   rūpin-	rUpin-
   garbhin-	garBin-
   saṃyamin-	saMyamin-
   kāmin-	kAmin-
   gāmin-	gAmin-
   anugāmin-	anugAmin-
   svāmin-	svAmin-
   kṣemin-	kzemin-
   dharmin-	Darmin-
   vijayin-	vijayin-
   kārin-	kArin-
   adhikārin-	aDikArin-
   cārin-	cArin-
   vicārin-	vicArin-
   dhārin-	DArin-
   anusārin-	anusArin-
   śarīrin-	SarIrin-
   sahasrin-	sahasrin-
   balin-	balin-
   śālin-	SAlin-
   bhāvin-	BAvin-
   aśvin-	aSvin-
   tapasvin-	tapasvin-
   yaśasvin-	yaSasvin-
   vaśin-	vaSin-
   āśin-	ASin-
   rāśin-	rASin-
   keśin-	keSin-
   darśin-	darSin-
   anubhāṣin-	anuBAzin-
   manīṣin-	manIzin-
   eṣin-	ezin-
   akṣin-	akzin-
   kāṇkṣin-	kANkzin-
   vāsin-	vAsin-
   nivāsin-	nivAsin-
   dehin-	dehin-
   ap-	ap-
   &.wu jap	&.wu jap
   &.wu tap	&.wu tap
   &.wu svap	&.wu svap
   &.wu śap	&.wu Sap
   &.wu āp	&.wu Ap
   &.wu lip	&.wu lip
   &.wu kṣip	&.wu kzip
   &.wu dīp	&.wu dIp
   &.wu kup	&.wu kup
   &.wu gup	&.wu gup
   &.wu tṛp	&.wu tRp
   &.wu dṛp	&.wu dRp
   &.wu kḹp	&.wu k?p
   &.wu labh	&.wu laB
   &.wu śubh	&.wu SuB
   &.wu kṣubh	&.wu kzuB
   &.wu stambh	&.wu stamB
   &.wu kam	&.wu kam
   &.wu gam	&.wu gam
   satatam	satatam
   katham	kaTam
   ittham	itTam
   &.wu dam	&.wu dam
   idam-	idam-
   &.wu nam	&.wu nam
   nūnam	nUnam
   &.wu yam	&.wu yam
   svayam	svayam
   &.wu ram	&.wu ram
   varam-	varam-
   &.wu kram	&.wu kram
   &.wu śram	&.wu Sram
   evam	evam
   śam	Sam
   &.wu śam	&.wu Sam
   sam	sam
   &.wu jñā sam	&.wu jQA sam
   &.wu sthā sam	&.wu sTA sam
   &.wu dhā sam	&.wu DA sam
   &.wu mā sam	&.wu mA sam
   &.wu khyā sam	&.wu KyA sam
   &.wu i sam	&.wu i sam
   &.wu lī sam	&.wu lI sam
   &.wu stu sam	&.wu stu sam
   &.wu yu sam	&.wu yu sam
   &.wu bhū sam	&.wu BU sam
   &.wu bhṛ sam	&.wu BR sam
   &.wu vṛ#'1 sam	&.wu vR#a1 sam
   &.wu hṛ sam	&.wu hR sam
   &.wu k-ṛ sam	&.wu k-R sam
   &.wu lag sam	&.wu lak sam
   &.wu yuj sam	&.wu yuj sam
   &.wu pūj sam	&.wu pUj sam
   &.wu vṛt sam	&.wu vRd sam
   &.wu cint sam	&.wu cint sam
   &.wu kīrt sam	&.wu kIrt sam
   &.wu pad sam	&.wu pad sam
   &.wu vad sam	&.wu vat sam
   &.wu vid#'1 sam	&.wu vid#a1 sam
   &.wu cud sam	&.wu cud sam
   &.wu ṛdh sam	&.wu RD sam
   &.wu indh sam	&.wu inD sam
   &.wu jan sam	&.wu jan sam
   &.wu āp sam	&.wu Ap sam
   &.wu kṣip sam	&.wu kziB sam
   &.wu gup sam	&.wu gup sam
   &.wu kḹp sam	&.wu k?B sam
   &.wu kamp sam	&.wu kamB sam
   &.wu gam sam	&.wu gam sam
   &.wu yam sam	&.wu yam sam
   &.wu kram sam	&.wu kram sam
   &.wu bhram sam	&.wu Bram sam
   &.wu car sam	&.wu car sam
   &.wu īr sam	&.wu IH sam
   &.wu dṛś sam	&.wu dRH sam
   &.wu śliṣ sam	&.wu SliH sam
   &.wu as#'2 sam	&.wu as#a2 sam
   &.wu grah sam	&.wu grah sam
   &.wu jñā abhi, sam	&.wu jQAH aBi, sam
   &.wu vṛ#'1 abhi, sam	&.wu vR#a1 aBi, sam
   &.wu khyā pari, sam	&.wu KyA pari, sam
   &.wu kram anu, sam	&.wu kram anu, sam
   kim-	kim-
   &.wu stim	&.wu stim
   idānīm	idAnIm
   &.wu mahay	&.wu mahay
   &.wu car	&.wu car
   antar	antar
   &.wu dhā antar	&.wu DAH antar
   punar	punar-
   svar-	svar-
   ahar-	ahar-
   &.wu īr	&.wu Ir
   catur-	catur--
   muhur	muhur-
   &.wu phal#'1	&.wu Pal#a1
   &.wu jval	&.wu jval
   &.wu pāl	&.wu pAl
   div-	div-
   &.wu sev	&.wu sev
   &.wu garv	&.wu garv
   &.wu aś#'1	&.wu aS#a1
   &.wu naś	&.wu naH-
   &.wu paś	&.wu paS
   &.wu vaś	&.wu vaS
   diś-	diS-
   &.wu diś	&.wu diS
   &.wu kliś	&.wu kliS
   viś-	viS-
   &.wu viś	&.wu viS
   &.wu kṛś	&.wu kRS
   dṛś-	dRS-
   &.wu dṛś	&.wu dRS
   &.wu spṛś	&.wu spRS
   &.wu bhraṃś	&.wu BraMS
   &.wu saṃś	&.wu saMS
   ṣaṣ-	zaz-
   &.wu bhāṣ	&.wu BAz
   &.wu iṣ	&.wu iz
   &.wu dviṣ	&.wu dviz
   &.wu juṣ	&.wu juz
   &.wu tuṣ	&.wu tuz
   &.wu duṣ	&.wu duz
   muṣ-	muz-
   &.wu muṣ	&.wu muz
   &.wu ruṣ	&.wu ruz
   &.wu bhūṣ	&.wu BUz
   &.wu kṛṣ	&.wu kRz
   &.wu mṛṣ	&.wu mRz
   &.wu hṛṣ	&.wu hRz
   &.wu rakṣ	&.wu rakz
   &.wu lakṣ	&.wu lakz
   &.wu as#'1	&.wu as#a1
   okas-	oka-s-
   vacas-	vacas-
   vācas-	vAcas-
   varcas-	varcas-
   rajas-	rajas-
   tejas-	tejas-
   ojas-	ojas-
   añjas-	aQjas-
   ūrjas-	Urjas-
   atas	atas
   ekatas	ekatas
   tatas	tatas-
   pādatas	pAdatas
   nāmatas	nAmatas
   yatas	yatas-
   uttaratas	uttaratas-
   agratas	agratas
   śāstratas	SAstratas
   tattvatas	tattvatas
   sarvatas	sarvatas-
   pārśvatas	pArSvatas-
   itas	itas
   mūrtitas	mUrtitas
   āditas	Aditas
   kutas	kutas-
   cetas-	cetas-
   adas-	adas-
   sadas-	sadas-
   yādas-	yAdas-
   rodas-	rodas-
   chandas-	Candas-
   adhas	aDas
   medhas-	meDas-
   manas-	manas-
   vanas-	vanas-
   uśanas-	uSanas-
   tapas-	tapas-
   nabhas-	naBas-
   ambhas-	amBas-
   mas-	mas-
   tamas-	tamas-
   namas-	namas-
   trayas-	trayas-
   vayas-	vayas-
   bhūyas	BUyas-
   śreyas-	Sreyas-
   sadyas-	sadyas-
   taras-	taras-
   paras-	para-s-
   saras-	saras-
   apsaras-	apsaras-
   aṇgiras-	aNgiras-
   śiras-	Siras-
   uras-	uras-
   puras	puras
   &.wu vas	&.wu vas
   śravas-	Sravas-
   upeyivas-	upeyivas-
   vidvas-	vidvas-
   śataśas	SataSas-
   yaśas-	yaSas-
   nityaśas	nitya-Sas-
   sarvaśas	sarva-Sas-
   bahuśas	bahuSas-
   rakṣas-	rakzas-
   sahas-	sahas-
   &.wu ās	&.wu As
   &.wu śās	&.wu SAs
   svārocis-	svArocis-
   arcis-	arcis-
   jyotis-	jyotis-
   nis	nis
   &.wu mā nis	&.wu mA nis
   &.wu ci nis	&.wu ci nis
   &.wu vṛ#'1 nis	&.wu vR#a1 nis
   &.wu sṛ nis	&.wu sR nis
   &.wu vac nis	&.wu vat nis
   &.wu muc nis	&.wu mud nis
   &.wu math nis	&.wu maT nis
   &.wu pad nis	&.wu pad nis
   &.wu diś nis	&.wu diH nis
   &.wu īkṣ nis	&.wu Ikz nis
   &.wu diś abhi, nis	&.wu diH aBi, nis
   &.wu mā pari, nis	&.wu mA pari, nis
   &.wu mā vi, nis	&.wu mA vi, nis
   &.wu ci vi, nis	&.wu ci vi, nis
   &.wu dhū vi, nis	&.wu DU vi, nis
   &.wu sṛ vi, nis	&.wu sR vi, nis
   &.wu muc vi, nis	&.wu mut vi, nis
   &.wu diś vi, nis	&.wu diH vi, nis
   &.wu dhū pra, vi, nis	&.wu DU pra, vi, nis
   &.wu īkṣ sam, nis	&.wu Ikz sam, nis
   havis-	havis-
   dvis	dvi-s
   barhis-	barhis-
   āśīs-	ASIs-
   yajus-	yajus-
   dus-	dus-
   prādus	prAdus
   vapus-	vapus-
   āyus-	Ayus-
   cakṣus-	cakzus-
   śanais	SanEs-
   bhos	BoH-
   &.wu śaṃs	&.wu SaMs
   puṃs-	puMs-
   &.wu ah	&.wu ah
   &.wu dah	&.wu dah
   &.wu rah	&.wu rah
   &.wu grah	&.wu grah
   &.wu vah	&.wu vah
   &.wu snih	&.wu snih
   &.wu lih	&.wu lih
   &.wu guh	&.wu guh
   &.wu muh	&.wu muh
   ruh-	ruh-
   &.wu ruh	&.wu ruh
   &.wu jāgṛh	&.wu jAgRh
   bṛh-	bRh-
   &.wu bṛh	&.wu bRh
   &.wu arh	&.wu arh
