   na bhetavyam+ na boddhavyam+ & na śrāvyam+ vādinas+ vacaḥ |	na Betavyam+ na bodDavyam+ & na SrAvyam+ vAdinas+ vacaH |
   jhaṭiti prativaktavyam+ & sabhāsu vijigīṣubhiḥ || NKv_1 ||	Jawiti prativaktavyam+ & saBAsu vijigIzuBiH || NKu-_1 ||
   asaṃbhramas+ vilajjatvam+ & avajñā prativādini |	asaMBramas+ vilajja-tvam+ & avajQA prativAdini |
   hāsas+ rājñas+ stavas+ ca+ iti & pañca+ ete jaya+hetavas+ || NKv_2 ||	hAsas+ rAjQas+ stavas+ ca+ iti & paQca+ ete jaya+-hetavas+ || NKu-_2 ||
   uccais+ udghoṣya jetavyam+ & madhya+sthas+ cet+	uccEs+ udGozya jetavyam+ & maDya+-sTas+ ced-+
   apaṇḍitas+\var{udghoṣya\lem \ed; udghuṣya \L} |	apaNxita-s+\var{-udGozya\lem \ed; udGuzya \L} |
   paṇḍitas+ yadi tatra+ eva & pakṣa+pātas+ adhiropyatām || NKv_3 ||	paNxitas+ yadi tatra+ eva & pakza+pAtas+ aDiropyatAm || NKu-_3 ||
   lobhas+ hetus+ dhanam+ sādhyam+ & dṛṣṭāntas+ tu purohitas+ |	loBas+ hetus+ Danam+ sADyam+ & dRzwAntas+ tu purohitas+ |
   ātmotkarṣas+ nigamanam & anumāneṣu+ ayam+ vidhis+ || NKv_4 ||	Atma-utkarzas+ nigamanam & anumAna-izu+ ayam+ viDis+ || NKu-_4 ||
   abhyāsyam+ lajjamānena & tattvam+ jijñāsunā ciram |	aByAsyam+ lajjamAnena & tattvam+ jijQAsunA ciram |
   jigīṣunā hriyam+ tyaktvā & kāryas+ kolāhalas+ mahān || NKv_5 ||	jigIzunA hriyam+ tyaktvA & kAryas+ kolAhalas+ mahAn || NKu-_5 ||
   pāṭhanais+ grantha+nirmāṇais+ & pratiṣṭhā tāvat+ āpyate |	pAWanEs+ granTa+-nirmANa-es+ & pratizWA tAvat+ Apyate |
   evam ca tathya+vyutpattis+ & āyuṣas+ ante bhavet+ na vā || NKv_6 ||	evam ca taTya+-vyutpattis+ & Ayuzas+ ante Bavet+ na vA || NKu-_6 ||
   stotāras+ ke bhaviṣyanti & mūrkhasya jagatī+tale |	stota-aras+ ke Bavizyanti & mUrKasya jagatI+-tale |
   na stauti cet+ svayam+ ca svam+ & kadā tasya+ astu nirvṛtis+ || NKv_7 ||	na stOti cet+ svayam+ ca svam+ & kadA tasya+ astu nirvRtis+ || NKu-_7 ||
   vācyatām+ samayas+ atītas+& spaṣṭam+ agre bhaviṣyati |	vAcya-tAm+ samayas+ atItas+& spazwam+ agre Bavizyati |
   iti pāṭhayatām+ granthe& kāṭhinyam+ kutra vartate || NKv_8 ||	iti pAWayatAm+ granTe& kAWinyam+ kutra vartate || NKu-_8 ||
   agatitvam+ atiśraddhā& jñāna+ābhāsena tṛptatā |	agati-tvam+ atiSradDA& jQAna-+ABAsena tRpta-tA |
   trayas+ śiṣya+guṇās+ hi+ ete& mūrkha+ācāryasya bhāgya+jās+ || NKv_9 ||	trayas+ Sizya+-guNAs+ hi+ ete& mUrKa+AcAryasya BAgya+jAs+ || NKu-_9 ||
   yadi na kva+ api vidyāyāṃ& sarvathā kramate matis+ |	yadi na kva+ api vidyAyAM& sarvaTA kramate matis+ |
   māntrikās tu bhaviṣyāmas+ & yoginas+ yatayas+ api vā || NKv_10 ||	mAntrikAH tu BavizyAmas+ & yoginas+ yatayas+ api vA || NKu-_10 ||
   avilambena saṃsiddhau+& māntrikais+ āpyate yaśas+ |	avilambena saMsidDO+& mAntrikA-es+ Apyate yaSas+ |
   vilambe karma+bāhulyaṃ& vikhyāpya+ avāpyate dhanam || NKv_11 ||	vilambe karma+-bAhulyan& viKyApya+ avApyate Danam || NKu-_11 ||
   sukham+ sukhiṣu duḥkhe+ api& jīvanam+ duḥkha+śāliṣu %em: sukhe sukhiṣu |	suKam+ suKizu duHKe+ api& jIvanam+ duHKa+-SAlizu %em: suKe suKizu |
   anugrahāyate yeṣāṃ& te dhanyās+ khalu māntrikās+ || NKv_12 ||	anugrahAyate yezAM& te DanyAs+ Kalu mAntrikAs+ || NKu-_12 ||
   yāvat+ ajñānatas+ maunam+& ācāras+ vā vilakṣaṇas+ |	yAvat+ ajQAnatas+ mOnam+& AcAras+ vA vilakzaNas+ |
   tāvat+ māhātmya+rūpeṇa& paryavasyati māntrike -aḥ || NKv_13 ||	tAvat+ mAhAtmya+-rUpeNa& paryavasyati mAntrike -aH || NKu-_13 ||
   cārān vicārya daivajñais+& vaktavyam+ bhūbhujām+ phalam |	cArAn vicArya dEva-jQEs+& vaktavyam+ BUBujAm+ Palam |
   graha+cāra+parijñānaṃ& teṣām āvaśyakam+ yatas+ || NKv_14 ||	graha+cAra+-parijQAnan& tezAm AvaSya-kam+ yatas+ || NKu-_14 ||
   putras+ iti+ eva pitari& kanyakā+ iti+ eva mātari |	putras+ iti+ eva pitari& kanyakA+ iti+ eva mAtari |
   garbha+praśneṣu kathayan& daivajñas+ vijayī bhavet || NKv_15 ||	garBa+-praSnezu kaTayan& dEvajQas+ vijayI Bavet || NKu-_15 ||
   āyus+praśne dīrgham āyus+& vācyam+ mauhūrtikais+ janais+ |	Ayus+praSne dIrGam Ayus+& vAcyam+ mOhUrtikEs+ janEs+ |
   jīvantas+ bahumanyante& mṛtās+ prakṣyanti kam+ punas+ || NKv_16 ||	jIvantas+ bahu-manyante& mRtAs+ prakzyanti kam+ punas+ || NKu-_16 ||
   sarvam+ koṭi+dvaya+upetaṃ& sarvam+ kāla+dvaya+avadhi |	sarvam+ kowi+-dvaya-+upetan& sarvam+ kAla+dvaya-+avaDi |
   sarvam+ vyāmiśram iva ca& vaktavyam+ daiva+cintakais+ || NKv_17 ||	sarvam+ vyAmiSram iva ca& vaktavyam+ dEva+cintakEs+ || NKu-_17 ||
   nirdhanānām+ dhana+avāptiṃ& dhaninām adhikam+ dhanam |	nirDanAnAm+ Dana-+avAptiM& DaninAm aDikam+ Danam |
   bruvāṇās+ sarvathā grāhyā& lokais+ jyautiṣikās+ janās+ || NKv_18 ||	bruvANAs+ sarvaTA grAhyA& loka-es+ jyOtizikAs+ janAs+ || NKu-_18 ||
   śatasya lābhe tāmbūlaṃ& sahasrasya tu bhojanam |	Satasya lABe tAmbUlaM& sahasrasya tu Bojanam |
   daivajñānām upālambhas+& nityas+ kārya+viparyaye || NKv_19 ||	dEvajQAnAm upAlamBas+& nityas+ kArya+-viparyaye || NKu-_19 ||
   api sāgara+paryantā& vicetavyā vasuṃdharā |	api sAgara+-paryantA& vicetavyA vasuMDarA |
   deśas+ hi+ aratni+mātre+ api& nāsti daivajña+varjitas+ || NKv_20 ||	deSas+ hi+ aratni+-mAtre+ api& na-asti dEvajQa+-varjitas+ || NKu-_20 ||
   vārān ke cit+ grahān ke cit+& ke cit+ ṛkṣāṇi jānate |	vArAn ke cit+ grahAn ke cit+& ke cit+ RkzANi jAnate |
   tritayam+ ye vijānanti& te vācas+patayas+ svayam || NKv_21 ||	tritayam+ ye vijAnanti& te vAcas+patayas+ svayam || NKu-_21 ||
   naimittikās+ svapna+dṛśas+& devatānām [[amī trayas+]] |	nEmittikAs+ svapna+dRSas+& devatAnAm [[amI trayas+]] |
   nisarga+śatravas+ sṛṣṭās+ & daivajñānām+ amī trayas+ || NKv_22 ||	nisarga+-Satra-vas+ sRzwAs+ & dEvajQAnAm+ amI trayas+ || NKu-_22 ||
   svasthais+ asādhya+rogais+ ca& jantubhis+ na+ asti kim+ cana |	svasTa-es+ asADya+-rogEs+ ca& jantuBis+ na+ asti kim+ cana |
   kātarās+ dīrgha+rogās+ ca& bhiṣajām+ bhāgya+hetavas+ || NKv_23 ||	kAtarAs+ dIrGa-+rogAs+ ca& BizajAm+ BAgya+-hetavas+ || NKu-_23 ||
   na+ atidhairyam+ pradātavyaṃ& na+ atibhītis+ ca rogiṇi |	na+ ati-DEryam+ pradAtavyan& na+ ati-BItis+ ca rogiNi |
   naiścintyāt+ na+ ādime dānaṃ& nairāśyāt+ eva na+ antime || NKv_24 ||	nEH-cintyAt+ na+ Adime dAnaM& nErASyAt+ eva na+ antime || NKu-_24 ||
   bhaiṣajyam+ tu yathākāmaṃ& pathyam+ tu kaṭhinam+ vadet |	BEzajyam+ tu yaTAkAmaM& paTyam+ tu kaWinam+ vadet |
   ārogyam+ vaidya+māhātmyāt+& anyathātvam apathyatas+ || NKv_25 ||	Arogyam+ vEdya+mAhAtmyAt+& anyaTAtvam apaTyatas+ || NKu-_25 ||
   nidānam+ roga+nāmāni& sātmya+asātmye cikitsitam |	nidAnam+ roga+nAmAni& sAtmya+asAtmye cikitsitam |
   sarvam api+ upadekṣyanti& rogiṇas+ sadane striyas+ || NKv_26 ||	sarvam api+ upadekzyanti& rogiNas+ sadane striyas+ || NKu-_26 ||
   jṛmbhamāṇeṣu rogeṣu& mriyamāṇeṣu jantuṣu |	jRmBamANezu roga-izu& mriyamANezu jantuzu |
   roga+tattveṣu śanakais+& vyutpadyante cikitsakās+ || NKv_27 ||	roga+-tattvezu SanakEs+& vyutpadyante cikitsa-kAs+ || NKu-_27 ||
   pravartana+artham ārambhe& madhye tu+ auṣadha+hetave |	pravartana-+arTam AramBe& maDye tu+ OzaDa+-hetave |
   bahumāna+artham ante ca& jihīrṣanti cikitsakās+ || NKv_28 ||	bahu-mAna-+arTam ante ca& jihIrzanti cikitsa-kAs+ || NKu-_28 ||
   lipsamāneṣu vaidyeṣu& cirāt+ āsādya rogiṇam |	lipsamAnezu vEdyezu& cirAt+ AsAdya rogiNam |
   dāyādās+ saṃprarohanti& daivajñās+ māntrikās+ api || NKv_29 ||	dAyAdAs+ saMprarohanti& dEva-jQAs+ mAntrikAs+ api || NKu-_29 ||
   rogasya+ upakrame sāntvaṃ& madhye kim+ cit+ dhana+vyayas+ |	rogasya+ upakrame sAntvaM& maDye kim+ cit+ Dana+-vyayas+ |
   śanais+ anādaras śāntau& snātas+ vaidyam+ na paśyati || NKv_30 ||	SanEs+ anAdaraH SAntO& snAtas+ vEdyam+ na paSyati || NKu-_30 ||
   daivajñatvam+ māntrikatā& bhaiṣajyam+ cāṭu+kauśalam |	dEvajQa-tvam+ mAntrika-tA& BEzajyam+ cAwu+kOSalam |
   eka+ekam artha+lābhāya& dvi+tri+yogas+ tu durlabhas+ || NKv_31 ||	eka-+ekam arTa+lABAya& dvi+tri+-yoga-s+ tu durlaBas+ || NKu-_31 ||
   anṛtam+ cāṭuvādas+ ca& dhana+yogas+ mahān ayam |	anRtam+ cAwuvAdas+ ca& Dana+-yogas+ mahAn ayam |
   satyam+ vaiduṣyam iti+ eṣa& yogas+ dāridrya+kārakas+ || NKv_32 ||	satyam+ vEduzyam iti+ eza& yogas+ dAridrya+kArakas+ || NKu-_32 ||
   kātaryam+ durvinītatvam+& kārpaṇyam avivekatām |	kAtaryam+ durvinIta-tvam+& kArpaNyam aviveka-tAm |
   sarvam+ mārjanti kavayah+ śālīnām+ muṣṭi+kiṃkarās+ || NKv_33 ||	sarvam+ mArjanti kavayah+ SAlI-nAm+ muzwi+kiMkarAs+ || NKu-_33 ||
   na kāraṇam apekṣante& kavayas+ stotum udyatās+ |	na kAraNam apekzante& kavayas+ stotum udyatAs+ |
   kim+ cit+ astuvatām teṣām+& jihvā phuraphurāyate || NKv_34 ||	kim+ cit+ astuvatAm tezAm-+& jihvA PuraPurAyate || NKu-_34 ||
   stutam+ stuvanti kavayas+& na svatas+ guṇa+darśinas+ |	stutam+ stuvanti kavayas+& na svatas+ guNa+-darSinas+ |
   kītas+ kas+ cit+ alis+ nāma& kiyatī tatra varṇanā || NKv_35 ||	kItas+ kas+ cit+ alis+ nAma& kiyatI tatra varNanA || NKu-_35 ||
   ekā+ eva kavitā puṃsām+& grāmāya+ aśvāya hastine |	ekA+ eva kavi-tA puMsAm+& grAma-aya+ aSvAya hastine |
   antatas+ annāya vastrāya& tāmbūlāya ca kalpate || NKv_36 ||	antatas+ annAya vastra-aya& tAmbUlAya ca kalpate || NKu-_36 ||
   śabda+ākhyam aparam+ brahma& saṃdarbheṇa pariṣkṛtam |	Sabda+AKyam aparam+ brahma& saMdarBeNa parizkRtam |
   vikrīyate katipayais+& vṛthā+ anyais+ viniyujyate || NKv_37 ||	vikrIyate katipayEH-+& vRTA+ anyEs+ viniyujyate || NKu-_37 ||
   varṇayanti nara+ābhāsān+& vāṇīm+ labdhvā+ api ye janās+ |	varNayanti nara-+a-ABAsAn-+& vANIm+ labDvA+ api ye janAs+ |
   labdhvā+ api kāma+dhenum+ te & lāṅgale viniyuñjate || NKv_38 ||	labDvA+ api kAm-a+Denum+ te & lAFgale viniyuQjate || NKu-_38 ||
   praśaṃsantas+ nara+ābhāsān+& pralapantas+ anyathā+ anyathā |	praSaMsantas+ nara+a-ABAsAn-+& pralapantas+ anyaTA+ anyaTA |
   katham+ tarantu kavayas+ & kāma+pāramya+vādinas+ || NKv_39 ||	kaTam+ tarantu kavayas+ & kAma+pAramya+vAdinas+ || NKu-_39 ||
   yat+ sandarbhe yat+ ullekhe & yat+ vyaṅgye nibhṛtam+ manas+ |	yat+ sandarBe yat+ ulleKe & yat+ vyaFgye niBRtam+ manas+ |
   samādhes+ api tat+ jyāyās+ & śaṃkaras+ yadi varṇyate % 40 || NKv_40 ||	samADes+ api tat+ jyAyAs+ & SaMkaras+ yadi varNyate % 40 || NKu-_40 ||
   [bandhavas+]	[banDavas+]
   gṛhiṇī bhaginī tasyās+ & śvaśurau śyālas+ iti+ api |	gRhiNI BaginI tasya-as+ & SvaSurO SyAlas+ iti+ api |
   prāṇinām kalinā sṛṣṭās+ & pañca prāṇās+ ime+ apare || NKv_41 ||	prANinAm kalinA sRzwAs+ & paQca prANAs+ ime+ apare || NKu-_41 ||
   jāmātaras+ bhāgineyās+ & mātulās+ dāra+bāndhavās+ |	jAmAta-ras+ BAgineyAs+ & mAtulAs+ dAra+bAnDavAs+ |
   ajñātās+ eva gṛhiṇām+ & bhakṣayanti+ ākhu+vat+ gṛhe || NKv_42 ||	ajQAta-as+ eva gRhiNAm+ & Bakzayanti+ AKu+vat+ gRhe || NKu-_42 ||
   mātulasya balam+ mātā & jāmātus+ duhitā balam |	mAtulasya balam+ mAtA & jAmAtus+ duhitA balam |
   śvaśurasya balam+ bhāryā & svayam eva+ atithes+ balam || NKv_43 ||	SvaSurasya balam+ BAryA & svayam eva+ atiTes+ balam || NKu-_43 ||
   jāmātus+ vakratā tāvat+& yāvat+ śyālasya bālatā |	jAmAtus+ vakra-tA tAvat-+& yAvat+ SyAlasya bAla-tA |
   prabudhyamāne sāralyam+ & prabuddhe+ asmin+ palāyanam || NKv_44 ||	prabuDyamAne sAralyam+ & prabudDe+ asmin+ palAyanam || NKu-_44 ||
   bhāryā jyeṣṭhā śiśus+ śyālas+ & śvaśrūs+ svātantrya+vartinī |	BAryA jyezWA SiSus+ SyAlas+ & SvaSrUs+ svAtantrya+vartinI |
   śvaśuras+ tu pravāsī+ iti & jāmātus+ bhāgya+dhoraṇī || NKv_45 ||	SvaSuras+ tu pravAsI+ iti & jAmAtus+ BAgya+DoraNI || NKu-_45 ||
   bhūṣaṇais+ vāsanais+ pātrais+ & putrāṇām upalālanais+ |	BUzaNEs+ vAsanEs+ pAtrEs+ & putrANAm upalAla-nEs+ |
   sakṛt+ āgatya gacchantī & kanyā nirmārṣṭi mandiram || NKv_46 ||	sakRt+ Agatya gacCantI & kanyA nirmArzwi mandiram || NKu-_46 ||
   gṛhiṇī sva+janam+ vakti & śuṣka+āhāram+ mita+āśanam |	gRhiNI sva+janam+ vakti & Suzka-+AhAram+ mita-+ASanam |
   pati+pakṣyān+ tu bahu+āśān & kṣīra+pān+ taskarān+ api || NKv_47 ||	pati+-pakzyAn+ tu bahu-+ASAn & kzIra+pAn+ taskarAn+ api || NKu-_47 ||
   bhārye dve putra+śālinyau & bhaginī pati+varjitā |	BArye dve putra+-SAlinyO & BaginI pati+-varjitA |
   aśrānta+kalahas+ nāma & yogas+ ayam+ gṛha+medhinām || NKv_48 ||	aSrAnta+-kalahas+ nAma & yogas+ ayam+ gRha+meDinAm || NKu-_48 ||
   bhārye dve bahavas+ putrās+& dāridryam+ roga+saṃbhavas+ |	BArye dve bahavas+ putrAs+& dAridryam+ roga+-saMBavas+ |
   jīrṇau ca mātā+pitarau+& ekaikam+ naraka+adhikam || NKv_49 ||	jIrNO ca mAtA-a+-pita-rO+& ekEkam+ naraka-+aDikam || NKu-_49 ||
   [uttama+ṛṇās+]	[uttama+RNAs+]
   smṛte sīdanti gātrāṇi & dṛṣṭe prajñā vinaśyati |	smRte sIdanti gAtrANi & dRzwe prajQA vinaSyati |
   aho mahat+ idam+ bhūtam& uttama+ṛṇa+abhiśābdhitam || NKv_50 ||	aho mahat+ idam+ BUtam& uttama+RNa-+aBiSAbDitam || NKu-_50 ||
   antakas+ api hi jantūnām& anta+kālam apekṣate |	antakas+ api hi jantU-nAm& anta+kAlam apekzate |
   na kāla+niyamas+ kas+ cit+& uttamārṇasya vidyate || NKv_51 ||	na kAla+niyamas+ kas+ cit+& uttamArNasya vidyate || NKu-_51 ||
   na paśyāmas+ mukhe daṃṣṭrām+ & na pāśam+ vā kara+añjale |	na paSyAmas+ muKe daMzwrAm+ & na pASam+ vA kara-+aQjale |
   uttamārṇam avekṣya+ eva & tathā+ api+ udvejite manas+ || NKv_52 ||	uttamArNam avekzya+ eva & taTA+ api+ udvejite manas+ || NKu-_52 ||
   [dāridryam+]	[dAridryam+]
   śatrau sāntvam+ pratīkāras+ & sarva+rogeṣu bheṣajam |	SatrO sAntvam+ pratIkAras+ & sarva-+rogezu Bezajam |
   mṛtyau mṛtyuñjaya+dhyānam+& dāridrye tu na kim+ cana || NKv_53 ||	mRtyO mRtyuQjaya+-DyAnam+& dAridrye tu na kim+ canaH || NKu-_53 ||
   śaktim+ karoti saṃcāre & śīta+uṣṇe marṣayati+ api |	Saktim+ karoti saMcAre & SIta+uzNe marzayati+ api |
   dīpayati+ udare vahnim+ & dāridryam+ parama+auṣadham || NKv_54 ||	dIpayati+ udare vahnim+ & dAridryam+ parama-+a-OzaDam || NKu-_54 ||
   giram+ skhalantīm+ mīlantīm+ & dṛṣṭim+ pādau visaṃsthulau	giram+ sKalantIm+ mIlantIm+ & dRzwim+ pAdO visaMsTulO
   \var{visaṃsthulau\lem \em; visaṃsphuṭau \ed} |	\var{visaMsTula-o\lem \em; visaMsPuwO \ed} |
   protsāhayati yācñāyām+ & rāja+ājñā+ iva daridratā || NKv_55 ||	protsAhayati yAcQA-AyAm+ & rAja-+AjQA+ iva daridra-tA || NKu-_55 ||
   jīryanti rāja+vidveṣās+& jīryanti+ avihitāni+ api |	jIryanti rAja+-vidveza-As+& jIryanti+ avihitAni+ api |
   ākiṃcanya+bala+āḍhyānām+& antatas+ aśmā+ api jīryati || NKv_56 ||	AkiMcanya+-bala+AXyA-nAm-+& antatas+ aSmA+ api jIryati || NKu-_56 ||
   na+ asya corās+ na piśunās+ & na dāyādās+ na pārthivās+ |	na+ asya ca-urAs+ na piSunAs+ & na dAyAdAs+ na pArTivAs+ |
   dainyam+ rājyāt+ api jyāyas+ & yadi tattvam+ prabudhyate || NKv_57 ||	dEnyam+ rAjya-at+ api jyAyas+ & yadi tattvam+ prabuDyate || NKu-_57 ||
   [dhaninas+]	[Da-ninas+]
   prakāśayati+ ahaṃkāram+ & pravartayati taskarān |	prakASayati+ ahaMkAram+ & pravartayati taskarAn |
   protsāhayati dāyādān+ & lākṣmīs+ kim+ cit+ upasthitā || NKv_58 ||	protsAhayati dAyAdAn+ & lAkzmIs+ kim+ cit+ upasTitAH || NKu-_58 ||
   viḍambayanti ye nityam+ & vidagdhān+ dhaninas+ janās+ |	vixambayanti ye nityam+ & vidagDAn+ Daninas+ janAs+ |
   te+ eva tu viḍambyante & śriyā kim+cit+upekṣitās+ || NKv_59 ||	te+ eva tu vixambyante & SriyA kim-+cit+-upekzitAs+ || NKu-_59 ||
   prāmāṇya+buddhis+ stotreṣu & devatā+buddhis+ ātmani |	prAmANya+-budDis+ stotrezu & devatA+-budDis+ Atmani |
   kīṭa+buddhis+ manuṣyeṣu & nūtanāyās+ śriyas+ phalam+ || NKv_60 ||	kIwa-+budDis+ manuzyezu & nUtana-AyAs+ Sriyas+ Palam+ || NKu-_60 ||
   śṛṇvantas+ eva pṛcchanti & paśyantas+ api na jānate |	SRNvantas+ eva pRcCanti & paSyantas+ api na jAnate |
   viḍambanāni dhanikās+ & stotrāṇi+ iti+ eva manvate || NKv_61 ||	vixambanAni DanikAs+ & stotrANi+ iti+ eva manvate || NKu-_61 ||
   āvṛtya śrī+madena+ andhān+ & anyonya+kṛta+saṃvidas+ |	AvRtya SrI+madena+ anDAn+ & anyonya+kRta+-saMvid-as+ |
   svairam+ hasanti+ pārśva+sthās+ & bāla+unmatta+piśāca+vat || NKv_62 ||	svEram+ hasanti+ pArSva+sTAs+ & bAla+unmatta+piSAca+vat || NKu-_62 ||
   stotavyais+ stūyante nityam+ & sevanīyais+ ca sevyate |	stotavyEs+ stUyante nityam+ & sevanIyEs+ ca sevyate |
   na bibheti na jihreti & tathā+ api dhanikas+ janas+ || NKv_63 ||	na biBeti na jihrA-iti & taTA+ api Danikas+ janas+ || NKu-_63 ||
   kṣaṇa+mātram+ graha+āveśas+ & yāma+mātram+ surā+madas+ |	kzaNa+-mAtram+ graha+AveSas+ & yAma+-mAtram+ surA+-madas+ |
   lakṣmī+madas+ tu mūrkhāṇām+ & ā+deham+ anuvartate || NKv_64 ||	lakzmI+-madas+ tu mUrKANAm+ & A+deham+ anuvartate || NKu-_64 ||
   śrīs+ māsam+ ardha+māsam+ vā & ceṣṭitvā vinivartate |	SrI-s+ mAsam+ arDa+mAsam+ vA & cezwitvA vinivartate |
   vikāras+ tu tat+ārabdhas+ & nityam+ laśuna+gandha+vat || NKv_65 ||	vikAras+ tu tat+a-ArabDas+ & nityam+ laSuna+-ganDa+vat || NKu-_65 ||
   kaṇṭḥe madas+ kodrava+jas+ & hṛdi tāmbūla+jas+ madas+ |	kaNwHe madas+ kodrava+-jas+ & hRdi tAmbUla+jas+ madas+ |
   lakṣmī+madas+ tu sarvāṅge & putra+dāra+mukheṣu+ api || NKv_66 ||	lakzmI+-madas+ tu sarva-aFge & putra+-dAra+-muKa-izu+ api || NKu-_66 ||
   yatra+ āsīt+ asti vā lakṣmīs+ & tatra+ unmadas+ pravartatām |	yatra+ AsIt+ asti vA lakzmIs+ & tatra+ unmadas+ pravartatAm |
   kule+ api+ avatarati+ eṣa & kuṣṭhā+apasmāra+vat+ katham+ || NKv_67 ||	kule+ api+ avatarati+ eza & kuzWA+apasmAra+vat+ kaTam+ || NKu-_67 ||
   adhyāpayanti śāstrāṇi & tṛṇīkurvanti paṇḍitān |	aDyApayanti SAstrANi & tRNIkurvanti paNxitAn |
   vismārayanti jātim+ svām+ & varāṭās+ pañcaṣā kare || NKv_68 ||	vismArayanti jAtim+ svAm+ & varAwAs+ paQcazA kare || NKu-_68 ||
   bibhartu bhṛtyān+ dhanikas+ & dattām+ vā deyam+ arthiṣu |	biBartu BRtyAn+ Danikas+ & dattAm+ vA deyam+ arTizu |
   yāvat+ yācaka+sādharmyam+ & tāvat+ lokas+ na mṛṣyati || NKv_69 ||	yAvat+ yAcaka+-sADarmyam+ & tAvat+ loka-s+ na mRzyati || NKu-_69 ||
   [piśunās+]	[piSunAs+]
   dhana+bhāras+ hi lokasya & piśunais+ eva dhāryate |	Dana+BAras+ hi lokasya & piSuna-es+ eva DAryate |
   katham+ te tam+ laghūkartum+ & yatante+ aparathā svatas+ || NKv_70 ||	kaTam+ te tam+ laGUkartum+ & yatante+ aparaTA svatas+ || NKu-_70 ||
   śrama+anurūpam+ piśune & kim+ upakriyate nṛpais+ |	Srama-+anurUpam+ piSune & kim+ upakriyate nRpa-es+ |
   dvi+guṇam+ tri+guṇam+ ca+ eva+ & kṛta+antas+ lālayiṣyati || NKv_71 ||	dvi+guNam+ tri+guNam+ ca+ eva+ & kRta+antas+ lAlayizyati || NKu-_71 ||
   Gokarṇe Bhadrakarṇe ca & japas+ duṣkarma+nāśanas+ |	GokarNe BhadrakarNe ca & japas+ duzkarma+-nASanas+ |
   rāja+karṇe japas+ sadyas+ & sarva+karma+vināśanas+ || NKv_72 ||	rAja+-karNe japas+ sadyas+ & sarva+karma+-vinASanas+ || NKu-_72 ||
   na sva+artham+ kim+cit+ icchanti & na preryante ca kena cit |	na sva-+arTam+ kim-+cit+ icCanti & na preryante ca kena cit |
   para+artheṣu pravartante & śaṭhās+ santas+ ca tulya+vat || NKv_73 ||	para-+arTezu pravartante & SaWAs+ santas+ ca tulya+vat || NKu-_73 ||
   kāla+antare hi+ anarthāya & gṛdhras+ geha+upari sthitas+ |	kAla+antare hi+ anarTAya & gRDras+ geha+-upari sTitas+ |
   khalas+ gṛha+samīpa+sthas+ & sadyas+ anarthāya dehinām || NKv_74 ||	Kalas+ gRha+-samIpa+-sTas+ & sadyas+ anarTAya dehinAm || NKu-_74 ||
   [lobhinas+]	[loBinas+]
   śuṣka+upavāsas+ dharmeṣu & bhaiṣajyeṣu ca laṅghanam |	Suzka+upavAsas+ Darmezu & BEzajyezu ca laFGanam |
   japa+yajñas+ ca yajñeṣu & rocate lobha+śālinām || NKv_75 ||	japa+-yajQas+ ca yajQezu & rocate loBa+-SAlinAm || NKu-_75 ||
   kim+ vakṣyati+ iva dhanikāt+ & yāvat+ udvijate+ adhanas+ |	kim+ vakzyati+ iva DanikAt+ & yAvat+ udvijate+ aDanas+ |
   kim+ prakṣyati+ iti lubdhas+ api & tāvat+ udvijate tatas+ || NKv_76 ||	kim+ prakzyati+ iti lubDas+ api & tAvat+ udvijate tatas+ || NKu-_76 ||
   sarvam+ ātithya+śāstra+artham+ & sākṣāt+ kurvanti lobhinas+ |	sarvam+ AtiTya+SAstra-+arTam+ & sAkzAt+ kurvanti loBinas+ |
   bhikṣākabalam+ eka+ekam+ & ye hi paśyanti Meru+vat || NKv_77 ||	BikzAka-balam+ eka-+ekam+ & ye hi paSyanti Meru+vat || NKu-_77 ||
   dhana+pālas+ piśācas+ hi & datte svāmini+ upasthite |	Dana+pAlas+ piSAcas+ hi & datte svAmini+ upasTite |
   dhana+lubdhas+ piśācas+ tu & na kasmai cana ditsate || NKv_78 ||	Dana+lubDas+ piSAcas+ tu & na kasmE cana ditsate || NKu-_78 ||
   dātāras+ arthibhis+ arthyante & dātṛbhis+ punas+ arthinas+ |	dAtA-ras+ arTiBis+ arTyante & dAtRBis+ punas+ arTinas+ |
   kartṛ+karma+vyatīhārāt+ & aho nimna+unnatam+ kiyat || NKv_79 ||	kartR+karma+-vyatIha-arAt+ & aho nimna+unnatam+ kiyat || NKu-_79 ||
   svasmin+ asati na+ arthasya & rakṣakas+ saṃbhavet+ iti |	svasmin+ asati na+ arTasya & rakzakas+ saMBavet+ iti |
   niścitya+ evam+ svayam+ api & bhuṅkte lubdhas+ katham+ cana || NKv_80 ||	niScitya+ evam+ svayam+ api & BuFkte lubDas+ kaTam+ canaH || NKu-_80 ||
   prasthāsyamānas+ praviśet+ & pratiṣṭheta dine dine |	prasTAsya-mAnas+ praviSet+ & pratizWeta dine dine |
   vicitrān+ ullikhet+ vighnān+ & tiṣṭhāsus+ atithis+ ciram+ || NKv_81 ||	vicitrAn+ ulliKet+ viGnAn+ & tizWAsus+ atiTis+ ciram+ || NKu-_81 ||
   [dhārmikās+]	[DArmikAs+]
   pradīyate viduṣi+ ekam+ & kavau daśa naṭe śatam+ |	pradIyate viduzi+ ekam+ & kavO daSa nawe Satam+ |
   sahasram+ dāmbhike loke & śrotriye tu na kim+cana || NKv_82 ||	sahasram+ dAmBike loke & Srotriye tu na kim+canaH || NKu-_82 ||
   ghaṭakam+ samyak+ārādhya & vairāgyam+ paramam+ vahet+ |	Gawakam+ samyak+ArADya & vErAgyam+ paramam+ vahet+ |
   tāvat+ arthās+ prasiddhyanti & yāvat+ cāpalam+ āvṛtam+ || NKv_83 ||	tAvat+ arTAs+ prasidDyanti & yAvat+ cApalam+ AvRtam+ || NKu-_83 ||
   ekatas+ sarva+śāstrāṇi & tulasī+kāṣṭham+ ekatas+ |	ekatas+ sarva+-SAstrANi & tulasI+-kAzWam+ ekatas+ |
   vaktavyam+ kim+ cit+ iti+ uktam+ & vastutas+ tulasī parā || NKv_84 ||	vaktavyam+ kim+ cit+ iti+ uktam+ & vastutas+ tulasI parA || NKu-_84 ||
   vismṛtam+ vāhaṭena+ idam+ & tulasyās+ paṭhatā guṇan+ |	vismRtam+ vAhawena+ idam+ & tulasyAs+ paWatA guNan+ |
   viśva+saṃmohinī vitta&dāyinī+ iti guṇa+dvayam+ || NKv_85 ||	viSva+-saMmohinI vitta&-dAyinI+ iti guNa+-dvayam+ || NKu-_85 ||
   kaupīnam+ bhasita+ālepas+ & darbhā+ rudra+akṣa+mālikā |	kOpInam+ Basita-+Alepas+ & darBA+ rudra-+akza+mAlikA |
   maunam+ eka+āsikā ca+ iti & mūrkha+saṃjīvanāni ṣaṭ || NKv_86 ||	mOnam+ eka+AsikA ca+ iti & mUrKa+-saMjIvanAni zaw || NKu-_86 ||
   vāsas+ puṇyeṣu tīrtheṣu & & prasiddhas+ ca mṛtas+ gurus+ |	vAsas+ puNyezu tIrTezu & & prasidDas+ ca mRtas+ gurus+ |
   adhyāpana+āvṛttayas+ ca & kīrtanīyās+ dhana+arthibhis+ || NKv_87 ||	aDyApana+A-vRttayas+ ca & kIrtanIyAs+ Dana+arTiBis+ || NKu-_87 ||
   mantra+bhraṃśe saṃpradāyas+ & prayogas+ cyuta+saṃkṛtau |	mantra+BraMSe saMpradAyas+ & prayogas+ cyuta+-saMkRtO |
   deśa+dharmas+ tu+ anācāre & pṛcchatām+ siddham+ uttaram+ || NKv_88 ||	deSa+-Darmas+ tu+ anAcAre & pRcCatAm+ sidDam+ uttaram+ || NKu-_88 ||
   yathā jānanti bahavas+ & yathā vakṣyanti dātari |	yaTA jAnanti bahavas+ & yaTA vakzyanti dAtari |
   tathā dharmam+ caret+ sarvam+ & na vṛthā kim+ cit+ ācaret || NKv_89 ||	taTA Darmam+ caret+ sarvam+ & na vRTA kim+ cit+ Acaret || NKu-_89 ||
   sadā japa+paṭas+ haste & madhye madhye+ akṣi+mīlanam+ |	sadA japa+-pawas+ haste & maDye maDye+ akzi+mIla-nam+ |
   sarvam+ brahma+ iti vādas+ ca & sadyas+pratyaya+hetavas+ || NKv_90 ||	sarvam+ brahma+ iti vAdas+ ca & sadyas+-pratyaya-+hetavas+ || NKu-_90 ||
   ā+madhya+ahnam+ nadī+vāsas+ & samāje devatā+arcanam+ |	A+maDya-+ahnam+ nadI+-vAsas+ & samAje devatA-+arcanam+ |
   satatam+ śuci+veṣas+ ca & iti+ etat+ dambhasya jīvitam+ || NKv_91 ||	satatam+ Suci+vezas+ ca & iti+ etat+ damBasya jIvitam+ || NKu-_91 ||
   tāvat+ dīrgham+ nitya+karma & yāvat+ syāt+ draṣṭṛ+melanam+ |	tAvat+ dIrGam+ nitya+karma & yAvat+ syAt+ drazwR+melanam+ |
   tāvat+saṃkṣipyate sarvam+ & yāvat+ draṣṭā na vidyate || NKv_92 ||	tAvat+-saMkzipyate sarvam+ & yAvat+ drazwA na vidyate || NKu-_92 ||
   ānanda+bāṣpa+romāñcau & yasya svecchā+vaśaṃvadau |	Ananda+-bAzpa+romAQcO & yasya sva-icCA-a+vaSaMvadO |
   kim+ tasya sādhanais+ anyais+ & kiṃkarās+ sarva+pārthivās+ || NKv_93 ||	kim+ tasya sADanEs+ anyEs+ & kiMkarAs+ sarva+pArTivAs+ || NKu-_93 ||
   [durjanās+]	[duH-janAs+]
   daṇḍyamānās+ vikurvanti & lālyamānās+ tatas+ tarām+ |	daNxya-mAnAs+ vikurvanti & lAlyamAnAs+ tatas+ tarAm+ |
   durjanānām+ atas+ nyāyyam+ & dūrāt+ eva visarjanam+ || NKv_94 ||	durjanAnAm+ atas+ nyAyyam+ & dUra-at+ eva visarjanam+ || NKu-_94 ||
   adānam+ īṣat+dānam+ ca & kim+cit+kopāya durdhiyām+ |	adAnam+ Izat-+dAnam+ ca & kim+cit+-kopAya durDiyAm+ |
   saṃpūrṇa+dānam+ prakṛtis+ & virāmas+ vaira+kāraṇam+ || NKv_95 ||	saMpUrNa+dAnam+ prakRtis+ & virAmas+ vEra+-kAraNam+ || NKu-_95 ||
   jyāyān+ asaṃstavas+ duṣṭais+ & īrṣyāyai saṃstavas+ punas+ |	jyAyAn+ asaMstavas+ duzwa-es+ & IrzyAyE saMstavas+ punas+ |
   apatya+saṃbandha+vidhis+ & sva+anarthāya+ eva kevalam+ || NKv_96 ||	apatya+-saMbanDa+-viDi-s+ & sva-+anarTa-aya+ eva kevalam+ || NKu-_96 ||
   jñātā+ iyam+ jñāna+hīnatvam+ & piśunatvam+ daridratā |	jQAtA+ iyam+ jQAna+-hIna-tvam+ & piSuna-tvam+ daridra-tA |
   milanti yadi catvāri & tat+ diśe+ api namas+ namas+ || NKv_97 ||	milanti yadi catvAri & tat+ diSe+ api namas+ namas+ || NKu-_97 ||
   para+chidreṣu hṛdayam+ & para+vārtāsu ca śravas+ |	para+Cidrezu hRdayam+ & para+vArtAsu ca Sravas+ |
   para+marmāsu vācam+ ca & khalānām+ asṛjat+ vidhis+ || NKv_98 ||	para+-marmAsu vAcam+ ca & KalA-nAm+ asRjat+ viDis+ || NKu-_98 ||
   viṣeṇa puccha+lagnena & vṛścikas+ prāṇinām+ iva |	vizeNa pucCa+-lagnena & vRScikas+ prANi-nAm+ iva |
   Kalinā daśama+aṃśena & sarvas+ kālas+ api dāruṇas+ || NKv_99 ||	KalinA daSama+aMSena & sarva-s+ kAlas+ api dAruNas+ || NKu-_99 ||
   yatra bhāryā+giras+ vedās+ & yatra dharmas+ artha+sādhanam+ |	yatra BAryA+giras+ vedAs+ & yatra Darmas+ arTa+-sADanam+ |
   yatra sva+pratibhā mānam+ & tasmai śrī+kalaye namas+ || NKv_100 ||	yatra sva+-pratiBA mAnam+ & tasmE SrI+-kalaye namas+ || NKu-_100 ||
   kāmam+ astu jagat+ sarvam+ & kālasya+ asya vaśaṃvadam+ |	kAmam+ astu jagat+ sarvam+ & kAlasya+ asya vaSaMvadam+ |
   kāla+kālam+ prapannānām+ & kālas+ kim+ nas+ kariṣyati ? || NKv_101 ||	kAla+-kAlam+ prapannAnAm+ & kAlas+ kim+ nas+ karizyati ? || NKu-_101 ||
   kavinā Nīlakaṇṭhena & Kales+ etat+ viḍambanam |	kavinA NIla-kaNWena & Kales+ etat+ vixambanam |
   racitam+ viduṣām+ prītyai & rājāsthāna+anumodanam || NKv_102 ||	racitam+ viduzAm+ prItyE & rAja-AsTAna-+anumodanam || NKu-_102 ||
   iti Nīlakaṇṭha+viracitam+ Kaliviḍambanam+ saṃpūrṇam+	iti NIla-kaNWa+-viracitam+ Kali-vixambanam+ saMpUrNam+
