   NySBh_5,1.0 sādharmyavaidharmyābhyāṃ pratyavasthānasya vikalpāj	NI-SBh_5,1.0 sADarmya-vEDarmyAByAm pratyavasTAnasya vikalpa-aj
   jātibahutvam iti saṃkṣepeṇoktaṃ, tad vistareṇa vibhajyate tāḥ khalv imā	jAti-bahutvam iti saMkzepeNa-uktaM, tat vistareNa viBajyate tAH Kalu imA
   jātayaḥ sthāpanāhetau prayukte caturviṃśatiḥ pratiṣedhahetavaḥ /	jAtayaH sTApana-ahetO prayukte caturviMSatiH pratizeDa-hetavaH /
   NyS_5,1.1	NyH-_5,1.1
   sādharmyavaidharmyotkarṣāpakarṣavarṇyāvarṇyavikalpasādhyaprāptyaprāptiprasaṅgapratidṛṣṭāntānutpattisaṃśayaprakaraṇāhetvarthāpattyaviśeṣopapattyupalabdhyanupalabdhyanityanityakāryasamāḥ	sADarmya-vEDarmya-utkarza-apakarza-varNyAvarNya-vikalpa-sADya-prApti-aprApti-prasaFga-pratidRzwAnta-anutpatti-saMSaya-prakaraNA-hetu-arTApatti-avi
   NySBh_5,1.1 jāteḥ saṃkṣepeṇoktāyā vistaro vaktavya itīdānīm ārabhyate	NI-SBh_5,1.1 jAteH saMkzepeNa-uktAyAH vistaraH vaktavyaH iti-idAnIm AraByate
   sādharmyādisūtram	sADarmya-Adi-sUtram
   sādharmyavaidharmyotkarṣāpakarṣavarṇyāvarṇyavikalpasādhyaprāptyaprāptiprasaṅgapratidṛṣṭāntānutpattisaṃśayaprakaraṇāhetvarthāpattyaviśeṣopapattyupalabdhyanupalabdhyanityanityakāryasamāḥ	sADarmya-vEDarmya-utkarza-apakarza-varNyAvarNya-vikalpa-sADya-prApti-aprApti-prasaFga-pratidRzwAnta-anutpatti-saMSaya-prakaraNA-hetu-arTApatti-avi
   / sādharmyeṇa pratyavasthānam aviśiṣyamāṇaṃ sthāpanāhetutaḥ sādharmyasamaḥ	/ sADarmyeNa pratyavasTAnam aviSizyamANam sTApanA-hetutaH sADarmya-samaH
   / aviśeṣaṃ tatra tatrodāhariṣyāmaḥ / evaṃ vaidharmyasamaprabhṛtayo 'pi	/ aviSezam tatra tatra-udAharizyAmaH / evam vEDarmya-sama-praBRtayaH api
   nirvaktavyāḥ // NySBh_20//	nirvaktavyAH // Ni-H-Bh_20//
   NyS_5,1.2 sādharmyavaidharmyābhyām upasaṃhāre taddharmaviparyayopapatteḥ	NyH-_5,1.2 sADarmya-vEDarmyAByAm upasaMhAre tad-Darma-viparyaya-upapatteH
   sādharmyavaidharmyasamau //	sADarmya-vEDarmya-samO //
   NySBh_5,1.2 sādharmyeṇopasaṃhāre sādhyadharmaviparyayopapatteḥ	Ni-SBh_5,1.2 sADarmyeNa-upasaMhAre sADya-Darma-viparyaya-upapatteH
   sādharmyeṇaiva pratyavasthānam aviśiṣyamāṇaṃ sthāpanāhetutaḥ	sADarmyeNa-eva pratyavasTAnam aviSizyamANam sTApanA-hetutaH
   sādharmyasamaḥ pratiṣedhaḥ / nidarśanaṃ kriyāvān ātmā dravyasya	sADarmya-samaH pratizeDaH / nidarSanam kriyAvAn AtmA dravyasya
   kriyāhetuguṇayogāt / dravyaṃ loṣṭaḥ kriyāhetuguṇayuktaḥ kriyāvāṃs tathā	kriyA-hetu-guNa-yogAt / dravyam lozwaH kriyA-hetu-guNa-yuktaH kriyAvAn taTA
   cātmā tasmāt kriyāvān iti / evam upasaṃhṛte paraḥ sādharmyeṇaiva	ca-AtmA tasmAt kriyAvAn iti / evam upasaMhRte paraH sADarmyeNa-eva
   pratyavatiṣṭhate niṣkriya ātmā vibhuno dravyasya niṣkriyatvād vibhu	pratyavatizWate nizkriyaH AtmA viBunaH dravyasya nizkriya-tvAt viBu
   cākāśaṃ niṣkriyaṃ ca tathā cātmā tasmān niṣkriya iti / na cāsti	ca-AkASam nizkriyam ca taTA ca-AtmA tasmAt nizkriyaH iti / na ca-asti
   viśeṣahetuḥ kriyāvatsādharmyāt kriyāvatā bhavitavyaṃ na punar	viSeza-hetuH kriyAvat-sADarmyAt kriyAvatA Bavitavyam na punar-
   akriyasādharmyād niṣkriyeṇeti / viśeṣahetvabhāvāt sādharmyasamaḥ	akriya-sADarmyAt nizkriyeNa-iti / viSeza-hetu-aBAvAt sADarmya-samaH
   pratiṣedho bhavati / atha vaidharmyasamaḥ kriyāhetuguṇayukto loṣṭaḥ	pratizeDaH Bavati / aTa vEDarmya-samaH kriyA-hetu-guNa-yuktaH lozwaH
   paricchinno dṛṣṭo na ca tathātmā tasmān na loṣṭavat kriyāvān iti / na	paricCinnaH dRzwaH na ca taTA-AtmA tasmAt na lozwa-vat kriyAvAn iti / na
   cāsti viśeṣahetuḥ kriyāvatsādharmyāt kriyāvatā bhavitavyaṃ na punaḥ	ca-asti viSeza-hetuH kriyAvat-sADarmyAt kriyAvatA Bavitavyam na punar-
   kriyāvadvaidharmyād akriyeṇeti viśeṣahetvabhāvād vaidharmyasamaḥ /	kriyAvat-vEDarmyAt akriyeNa-iti viSeza-hetu-aBAvAt vEDarmya-samaH /
   vaidharmyeṇa copasaṃhāraḥ niṣkriya ātmā vibhutvāt kriyāvad dravyam avibhu	vEDarmyeNa ca-upasaMhAraH nizkriyaH AtmA viBu-tvAt kriyAvat dravyam aviBu
   dṛṣṭaṃ niṣkriyaṃ loṣṭaḥ na ca tathātmā tasmān niṣkriya iti / vaidharmyeṇa	dRzwam nizkriyam lozwaH na ca taTA-AtmA tasmAt nizkriyaH iti / vEDarmyeNa
   pratyavasthānaṃ niṣkriyaṃ dravyam ākāśaṃ kriyāhetuguṇarahitaṃ dṛṣṭaṃ na ca	pratyavasTAnam nizkriyam dravyam AkASam kriyA-hetu-guNa-rahitam dRzwam na ca
   tathātmā tasmān na niṣkriya iti / na cāsti viśeṣahetuḥ kriyāvadvaidharmyān	taTA-AtmA tasmAt na nizkriyaH iti / na ca-asti viSeza-hetuH kriyAvat-vEDarmyAn
   niṣkriyeṇa bhavitavyaṃ na punar akriyavaidharmyāt kriyāvateti	nizkriyeNa Bavitavyam na punar akriya-vEDarmyAt kriyAvatA-iti
   viśeṣahetvabhāvād vaidharmyasamaḥ / atha sādharmyasamaḥ kriyāvāṃl loṣṭaḥ	viSeza-hetu-aBAvAt vEDarmya-samaH / aTa sADarmya-samaH kriyAvAn lozwaH
   kriyāhetuguṇayukto dṛṣṭaḥ tathā cātmā tasmāt kriyāvān iti na cāsti	kriyA-hetu-guNa-yuktaH dRzwaH taTA ca-AtmA tasmAt kriyAvAn iti na ca-asti
   viśeṣahetuḥ kriyāvadvaidharmyān niṣkriyo na punaḥ kriyāvatsādharmyāt	viSeza-hetuH kriyAvat-vEDarmyAt nizkriyaH na punar kriyAvat-sADarmyAt-
   kriyāvān iti viśeṣahetvabhāvāt sādharmyasamaḥ //	kriyAvAn iti viSeza-hetu-aBAvAt sADarmya-samaH //
   NyS_5,1.3 gotvād gosiddhivat tatsiddhiḥ //	NyH-_5,1.3 go-tvAt go-sidDi-vat tad-sidDiH //
   NySBh_5,1.3 sādharmyamātreṇa vaidharmyamātreṇa ca sādhyasādhane	NI-SBh_5,1.3 sADarmya-mAtreNa vEDarmya-mAtreNa ca sADya-sADane
   pratijñāyamāne syād avyavasthā sā tu dharmaviśeṣe nopapadyate gosādharmyād	pratijQAyamAne syAt avyavasTA sA tu Darma-viSeze na-upapadyate go-sADarmyAt-
   gotvāj jātiviśeṣād gauḥ sidhyati na tu sāsnādisambandhāt /	go-tvAt jAti-viSezAt gOH siDyati na tu sAsnAdi-sambanDAt /
   aśvādivaidharmyād gotvād eva gauḥ sidhyati na guṇādibhedāt / tac caitat	aSva-Adi-vEDarmyAt go-tvAt eva gOH siDyati na guNa-Adi-BedAt / tat ca-etat-
   kṛtavyākhyānam avayavaprakaraṇe pramāṇānām abhisambandhāc	kRta-vyAKyAnam avayava-prakaraNe pramANAnAm aBisambanDAt-
   caikārthakāritvaṃ samānaṃ vākye iti / hetvābhāsāśrayā khalv iyam	ca-eka-arTa-kAri-tvam samAnam vAkye iti / hetvABAsa-ASrayA Kalu iyam
   avyavastheti //	avyavasTA-iti //
   NyS_5,1.4 sādhyadṛṣṭāntayor dharmavikalpād ubhayasādhyatvāc	NyH-_5,1.4 sADya-dRzwAntayoH Darma-vikalpAt uBaya-sADya-tvAt-
   cotkarśāpakarśavarṇyāvarṇyavikalpasādhyasamāḥ //	ca-utkarSApa-karSavarNyAvarNya-vikalpa-sADya-samAH //
   NySBh_5,1.4 dṛṣṭāntadharmaṃ sādhye samāsañjayata utkarśasamaḥ / yadi	Ni-SBh_5,1.4 dRzwAnta-Darmam sADye samAsaQjayate utkarSa-samaH / yadi
   kriyāhetuguṇayogāl loṣṭavat kriyāvān ātmā loṣṭavad eva sparśavān api	kriyA-hetu-guNa-yogAt lozwa-vat kriyAvAn AtmA lozwa-vat eva sparSavAn api
   prāpnoti / atha na sparśavāṃl loṣṭavat kriyāvān api na prāpnoti viparyaye	prApnoti / aTa na sparSavAn lozwa-vat kriyAvAn api na prApnoti viparyaye
   vā viśeṣo vaktavya iti / sādhye dharmābhāvaṃ dṛṣṭāntāt prasañjayato	vA viSezaH vaktavyaH iti / sADye Darma-aBAvam dRzwAntAt prasaQjayataH-
   'pakarśasamaḥ / loṣṭaḥ khalu kriyāvān avibhur dṛṣṭaḥ kāmam ātmāpi kriyāvān	apakarSa-samaH / lozwaH Kalu kriyAvAn aviBuH dRzwaH kAmam AtmA-api kriyAvAn
   avibhur astu viparyaye vā viśeṣo vaktavya iti / khyāpanīyo varṇyo	aviBuH astu viparyaye vA viSezaH vaktavyaH iti / KyApanIyaH varNyaH-
   viparyayād avarṇyaḥ tāv etau sādhyadṛṣṭāntadharmau viparyasyato	viparyayAt avarNyaH tO etO sADya-dRzwAnta-DarmO viparyasyataH-
   varṇyāvarṇyasamau bhavataḥ / sādhanadharmayukte dṛṣṭānte	varNyAvarNya-samO BavataH / sADana-Darma-yukte dRzwAnte
   dharmāntaravikalpāt sādhyadharmavikalpaṃ prasañjayato vikalpasamaḥ /	Darma-antara-vikalpAt sADya-Darma-vikalpam prasaQjayataH vikalpa-samaH /
   kriyāhetuguṇayuktaṃ kiṃcid guru yathā loṣṭaḥ kiṃcil laghu yathā vāyuḥ evaṃ	kriyA-hetu-guNa-yuktam kiMcid guru yaTA lozwaH kiMcid laGu yaTA vAyuH evam
   kriyāhetuguṇayuktaṃ kiṃcit kriyāvat syād yathā loṣṭaḥ kiṃcid akriyaṃ	kriyA-hetu-guNa-yuktam kiMcid kriyAvat syAt yaTA lozwaH kiMcid akriyam
   yathātmā viśeṣo vā vācya iti / hetvādyavayavasāmarthyayogī dharmaḥ sādhyaḥ	yaTA-AtmA viSezaH vA vAcyaH iti / hetu-Adi-avayava-sAmarTya-yogI DarmaH sADyaH
   taṃ dṛṣṭānte prasañjayataḥ sādhyasamaḥ / yadi yathā loṣṭas tathātmā	tam dRzwAnte prasaQjayataH sADya-samaH / yadi yaTA lozwaH taTA-AtmA
   prāptas tarhi yathātmā tathā loṣṭa iti / sādhyaś cāyam ātmā kriyāvān iti	prAptaH tarhi yaTA-AtmA taTA lozwaH iti / sADyaH ca-ayam AtmA kriyAvAn iti
   kāmaṃ loṣṭo 'pi sādhyaḥ atha naivaṃ na tarhi yathā loṣṭaḥ tathātmā //	kAmam lozwaH api sADyaH aTa na-evam na tarhi yaTA lozwaH taTA-AtmA //
   eteṣām uttaram	etezAm uttaram
   NyS_5,1.5 kiṃcitsādharmyād upasaṃhārasiddher vaidharmyād apratiṣedhaḥ //	NyH-_5,1.5 kiMcid-sADarmyAt upasaMhAra-sidDeH vEDarmyAt apratizeDaH //
   NySBh_5,1.5 alabhyaḥ siddhasya nihnavaḥ / siddhaṃ ca kiṃcitsādhatmyād	Ni-H-Bh_5,1.5 alaByaH sidDasya nihnavaH / sidDam ca kiMcid-sADatmyAt-
   upamānaṃ yathā gaus tathā gavaya iti tatra na labhyo gogavayayor	upamAnam yaTA gOH taTA gavayaH iti tatra na laByaH go-ga-vayayoH-
   dharmavikalpaś codayitum / evaṃ sādhake dharme dṛṣṭāntādisāmarthyayukte na	Darma-vikalpaH codayitum / evam sADake Darme dRzwAnta-Adi-sAmarTya-yukte na
   labhyaḥ sādhyadṛṣṭāntayor dharmavikalpād vaidharmyāt pratiṣedho vaktum iti	laByaH sADya-dRzwAntayoH Darma-vikalpAt vEDarmyAt pratizeDaH vaktum iti
   NyS_5,1.6 sādhyātideśāc ca dṛṣṭāntopapatteḥ //	NyH-_5,1.6 sADya-atideSAt ca dRzwAnta-upapatteH //
   NySBh_5,1.6 yatra laukikaparīkṣakāṇāṃ buddhisāmyaṃ tenāviparīto 'rtho	Ni-SBh_5,1.6 yatra lOkika-parIkzakANAm budDi-sAmyam tena-aviparItaH arTaH-
   'tidiśyate prajñāpanārtham / evaṃ sādhyātideśād dṛṣṭānte upapadyamāne	atidiSyate prajQApana-arTam / evam sADya-atideSAt dRzwAnte upapadyamAne
   sādhyatvam anupapannam iti //	sADya-tvam anupapannam iti //
   NyS_5,1.7 prāpya sādhyam aprāpya vā hetoḥ prāptyāviśiṣṭatvād	NyH-_5,1.7 prApya sADyam aprApya vA hetoH prAptyA-viSizwa-tvAt-
   aprāptyāsādhakatvāc ca prāptyaprāptisamau //	aprApti-A-asADaka-tvAt ca prApti-aprApti-samO //
   NySBh_5,1.7 hetuḥ prāpya vā sādhyaṃ sādhayed aprāpya vā ? na tāvat prāpya	Ni-SBh_5,1.7 hetuH prApya vA sADyam sADayet aprApya vA ? na tAvat prApya
   prāptyām aviśiṣṭatvād asādhakaḥ / dvayor vidyamānayoḥ prāptau satyāṃ kiṃ	prAptyAm aviSizwa-tvAt asADakaH / dvayoH vidyamAnayoH prAptO satyAm kim
   kasya sādhakaṃ sādhyaṃ vā ? aprāpya sādhakaṃ na bhavati nāprāptaḥ pradīpaḥ	kasya sADakam sADyam vA ? aprApya sADakam na Bavati na-aprAptaH pradIpaH
   prakāśayatīti / prāptyā pratyavasthānaṃ prāptisamaḥ aprāptyā	prakASayati-iti / prAptyA pratyavasTAnam prApti-samaH aprAptyA
   pratyavasthānam aprāptisamaḥ //	pratyavasTAnam aprApti-samaH //
   anayor uttaram	anayoH uttaram
   NyS_5,1.8 ghaṭādiniṣpattidarśanāt pīḍane cābhicārād apratiṣedhaḥ //	NyH-_5,1.8 Gawa-Adi-nizpatti-darSanAt pIxane ca-aBicArAt apratizeDaH //
   NySBh_5,1.8 ubhayathā khalv ayuktaḥ pratiṣedhaḥ kartṛkaraṇādhikaraṇāni	NI-SBh_5,1.8 uBayaTA Kalu ayuktaH pratizeDaH kartR-karaNa-aDikaraNAni
   prāpya mṛdaṃ ghaṭādikāryaṃ niṣpādayanti abhicārāc ca pīḍane sati dṛṣṭam	prApya mRdam Gawa-Adi-kAryam nizpAdayanti aBicArAt ca pIxane sati dRzwam
   aprāpya sādhakatvam iti //	aprApya sADaka-tvam iti //
   NyS_5,1.9 dṛṣṭāntasya kāraṇānapadeśāt pratyavasthānāc ca pratidṛṣṭāntena	NyH-_5,1.9 dRzwAntasya kAraNa-anapadeSAt pratyavasTAnAt ca pratidRzwAntena
   prasaṅgapratidṛṣṭāntasamau//	prasaFga-pratidRzwAnta-samO//
   NySBh_5,1.9 sādhanasyāpi sādhanaṃ vaktavyam iti prasaṅgena pratyavasthānaṃ	NI-SBh_5,1.9 sADanasya-api sADanam vaktavyam iti prasaFgena pratyavasTAnam
   prasaṅgasamaḥ pratiṣedhaḥ / kriyāhetuguṇayogī kriyāvāṃl loṣṭa iti hetur	prasaFga-samaH pratizeDaH / kriyA-hetu-guNa-yogI kriyAvAn lozwaH iti hetuH-
   nāpadiśyate na ca hetum antereṇa siddhir astīti / pratidṛṣṭāntena	na-apadiSyate na ca hetum antereNa sidDiH asti-iti / pratidRzwAntena
   pratyavasthānaṃ pratidṛṣṭāntasamaḥ / kriyāvān ātmā kriyāhetuguṇayogād	pratyavasTAnam pratidRzwAnta-samaH / kriyAvAn AtmA kriyA-hetu-guNa-yogAt-
   loṣṭavad ity ukte pratidṛṣṭānta upādīyate kriyāhetuguṇayuktam ākāśaṃ	lozwa-vat iti ukte pratidRzwAntaH upAdIyate kriyA-hetu-guNa-yuktam AkASam
   niṣkriyaṃ dṛṣṭam iti kaḥ punar ākāśasya kriyāhetuguṇaḥ ? vāyunā saṃyogaḥ	nizkriyam dRzwam iti kaH punar AkASasya kriyA-hetu-guNaH ? vAyunA saMyogaH
   saṃskārāpekṣaḥ vāyuvanaspatisaṃyogavad iti //	saMskAra-apekzaH vAyu-vanaspati-saMyoga-vat iti //
   anayor uttaram	anayoH uttaram
   NyS_5,1.10 pradīpopādānaprasaṅgavinivṛttivat tadvinivṛttiḥ //	NyH-_5,1.10 pradIpa-upAdAna-prasaFga-vinivRtti-vat tad-vinivRttiH //
   NySBh_5,1.10 idaṃ tāvad ayaṃ pṛṣṭo vaktum arhati atha ke pradīpam	NI-SBh_5,1.10 idam tAvat ayam pRzwaH vaktum arhati aTa ke pradIpam
   upādadate kimarthaṃ veti ? didṛkṣamāṇā dṛśyadarśanārtham iti / atha	upAdadate kimarTam vA-iti ? didRkzamANAH dRSya-darSana-arTam iti / aTa
   pradīpaṃ didṛkṣamāṇāḥ pradīpāntaraṃ kasmān nopādadate ? antareṇāpi	pradIpam didRkzamANAH pradIpa-antaram kasmAt na-upAdadate ? antareNa-api
   pradīpāntataṃ dṛśyate pradīpaḥ tatra pradīpadarśanārthaṃ pradīpopādānaṃ	pradIpa-antatam dRSyate pradIpaH tatra pradIpa-darSana-arTam pradIpa-upAdAnam
   nirarthakam / atha dṛṣṭāntaḥ kimartham ucyata iti aprajñātasya	nirarTakam / aTa dRzwAntaH kimarTam ucyate iti aprajQAtasya
   jñāpanārtham iti / atha dṛṣṭānte kāraṇāpadeśaḥ kimarthaṃ deśyate[mṛgyate]	jQApana-arTam iti / aTa dRzwAnte kAraNa-apadeSaH kim-arTam deSyate[mRgyate]
   ? yadi prajñāpanārthaṃ prajñāto dṛṣṭāntaḥ / sa khalu "laukikaparīkṣakāṇāṃ	? yadi prajQApana-arTam prajQAtaH dRzwAntaH / sa Kalu "lOkika-parIkzakANAm
   yasminn arthe buddhisāmyaṃ sa dṛṣṭānta" iti tatprajñāpanārthaḥ	yasmin arTe budDi-sAmyam sa dRzwAnta" iti tad-prajQApana-arTaH
   kāraṇāpadeśo nirarthaka iti prasaṅgasamasyottaram //	kAraNa-apadeSaH nirarTakaH iti prasaFga-samasya-uttaram //
   atha pratidṛṣṭāntasamasyottaram	aTa pratidRzwAnta-samasya-uttaram
   NyS_5,1.11 pratidṛṣṭāntahetutve ca nāhetur dṛṣṭāntaḥ //	NyH-_5,1.11 pratidRzwAnta-hetu-tve ca na-ahetuH dRzwAntaH //
   NySBh_5,1.11 pratidṛṣṭāntaṃ bruvatā na viśeṣahetur apadiśyate anena	NI-SBh_5,1.11 pratidRzwAntam bruvatA na viSeza-hetuH apadiSyate anena
   prakāreṇa pratidṛṣṭānataḥ sādhako na dṛṣṭānta iti / evaṃ	prakAreNa pratidRzwa-AnataH sADakaH na dRzwAntaH iti / evam
   pratidṛṣṭāntahetutve nāhetur dṛṣṭānta ity upapadyate / sa ca kathaṃ hetur	pratidRzwAnta-hetu-tve na-ahetuH dRzwAntaH iti upapadyate / sa ca kaTam hetuH-
   na syāt ? yady apratiṣiddhaḥ sādhakaḥ syād iti //	na syAt ? yadi apratizidDaH sADakaH syAt iti //
   NyS_5,1.12 prāg utpatteḥ kāraṇābhāvād anutpattisamaḥ //	NyH-_5,1.12 prAk utpatteH kAraNa-aBAvAt anutpatti-samaH //
   NySBh_5,1.12 anityaḥ śabdaḥ prayatnānantarīyakatvād ghaṭavad ity ukte	Ni-H-Bh_5,1.12 anityaH SabdaH prayatna-anantarIyaka-tvAt Gawa-vat iti ukte
   apara āha prāg utpatter anutpanne śabde prayatnānantarīyakatvam	aparaH Aha prAk utpatteH anutpanne Sabde prayatna-AnantarIyaka-tvam
   anityatvakāraṇaṃ nāsti, tadabhāvān nityatvaṃ prāptaṃ, nityasya cotpattir	anitya-tva-kAraNam nAsti, tad-aBAvAt nitya-tvam prAptaM, nityasya ca-utpattiH-
   nāsti / anutpattyā pratyavasthānam anutpattisamaḥ //	na-asti / anutpattyA pratyavasTAnam anutpatti-samaH //
   asyottaram	asya-uttaram
   NyS_5,1.13 tathābhāvād utpannasya kāraṇopapatter na kāraṇapratiṣedhaḥ //	NyH-_5,1.13 taTA-aBAvAt utpannasya kAraNa-upapatteH na kAraNa-pratizeDaH //
   NySBh_5,1.13 tathābhāvād utpannasyeti / utpannaḥ khalv ayaṃ śabda iti	NI-SBh_5,1.13 taTA-aBAvAt utpannasya-iti / utpannaH Kalu ayam SabdaH iti
   bhavati / prāg utapatteḥ śabda eva nāsti, utpannasya śabdabhāvāc chabdasya	Bavati / prAk utapatteH SabdaH eva nAsti, utpannasya Sabda-BAvAt Sabdasya
   sataḥ prayatnānantarīyakatvam anityatvakāraṇam upapadyate, kāraṇopapatter	sataH prayatna-AnantarIyaka-tvam anitya-tva-kAraNam upapadyate, kAraNa-upapatteH-
   ayukto 'yaṃ doṣaḥ "prāg utpatteḥ kāraṇābhāvād" iti //	ayuktaH ayam dozaH "prAk utpatteH kAraNa-aBAvAd" iti //
   NyS_5,1.14 sāmānya+dṛṣṭāntayor aindriyakatve samāne nityānityasādharmyāt	NyH-_5,1.14 sAmAnya+dRzwAntayoH Endriyaka-tve samAne nitya-anitya-sADarmyAt
   saṃśayasamaḥ //	saMSaya-samaH //
   NySBh_5,1.14 anityaḥ śabdaḥ prayatnānantarīyakatvād ghaṭavad ity ukte	Ni-H-Bh_5,1.14 anityaH SabdaH prayatna-anantarIyaka-tvAt Gawa-vat iti ukte
   hetau saṃśayena pratyavatiṣṭate sati prayatnānantarīyakatve asty evāsya	hetO saMSayena pratyavatizwate sati prayatna-anantarIyaka-tve asti eva-asya
   nityena sāmānyena sādharmyam aindriyakatvam, asti ca ghaṭenānityena, ato	nityena sAmAnyena sADarmyam Endriyaka-tvam, asti ca Gawena-anityena, atas-
   nityānityasādharmyād anivṛttiḥ saṃśaya iti //	nitya-anitya-sADarmyAt anivRttiH saMSayaH iti //
   asyottaram	asya-uttaram
   NyS_5,1.15 sādharmyāt saṃśaye na saṃśayo vaidharmyād ubhayathā vā saṃśaye	NyH-_5,1.15 sADarmyAt saMSaye na saMSayaH vEDarmyAt uBayaTA vA saMSaye
   'tyantasaṃśayaprasaṅgo nityatvānabhyupagamāc ca sāmānysyāpratiṣedhaḥ //	atyanta-saMSaya-prasaFgaH nitya-tva-anaByupagamAt ca sAmAnysya-apratizeDaH //
   NySBh_5,1.15 viśeṣād vaidharmyād avadhāryamāṇe 'rthe puruṣa iti, na	Ni-SBh_5,1.15 viSezAt vEDarmyAt avaDAryamANe arTe puruzaH iti, na
   sthāṇupuruṣasādharmyāt saṃśayo 'vakāśaṃ labhate / evaṃ vaidharmyād viśeṣāt	sTANu-puruza-sADarmyAt saMSayaH avakASam laBate / evam vEDarmyAt viSezAt-
   prayatnānantarīyakatvād avadhāryamāṇe śabdasyānityatve	prayatna-anantarIyaka-tvAt avaDAryamANe Sabdasya-anitya-tve
   nityānityasādharmyāt saṃśayo 'vakāśaṃ na labhate / yadi vai labhate, tataḥ	nitya-anitya-sADarmyAt saMSayaH avakASam na laBate / yadi vE laBate, tatas-
   sthāṇupuruṣasādharmyānucchedād atyantaṃ saṃśayaḥ syāt / gṛhyamāṇe ca	sTANu-puruza-sADarmya-anucCedAt atyantam saMSayaH syAt / gRhyamANe ca
   viśeṣe nityaṃ sādharmyaṃ saṃśayahetur iti nābhyupagamyate / na hi	viSeze nityam sADarmyam saMSaya-hetuH iti na-aByupagamyate / na hi
   gṛhyamāṇe puruṣasya viśeṣe sthāṇupuruṣasādharmyaṃ saṃśayahetur bhavati //	gRhyamANe puruzasya viSeze sTANu-puruza-sADarmyam saMSaya-hetuH Bavati //
   NyS_5,1.16 ubhayasādharmyāt prakriyāsiddheḥ prakaraṇasamaḥ //	NyH-_5,1.16 uBaya-sADarmyAt prakriyA-sidDeH prakaraNa-samaH //
   NySBh_5,1.16 ubhayena nityena cānityena ca sādharmyāt pakṣapratipakṣayoḥ	Ni-SBh_5,1.16 uBayena nityena ca-anityena ca sADarmyAt pakza-pratipakzayoH
   pravṛttiḥ prakriyā / anityaḥ śabdaḥ prayatnānantarīyakatvād ghaṭavad ity	pravRttiH prakriyA / anityaH SabdaH prayatna-anantarIyaka-tvAt Gawa-vat iti-
   ekaḥ pakṣaṃ pravarttayati, dvitīyaś ca nityasādharmyāt pratipakṣaṃ	ekaH pakzam pravarttayati, dvitIyaH ca nitya-sADarmyAt pratipakzam
   pravarttayati nityaḥ śabdaḥ śrāvaṇatvāc chabdatvavad iti / evaṃ ca sati	pravarttayati nityaH SabdaH SrAvaNa-tvAt Sabda-tva-vat iti / evam ca sati
   prayatnānantarīyakatvād iti hetur anityasādharmyeṇa ucyamāno na prakaraṇam	prayatna-anantarIyaka-tvAt iti hetuH anitya-sADarmyeNa ucyamAnaH na prakaraNam
   ativarttate , prakaraṇānativṛtter nirṇayānativartanam / samānaṃ caitan	ativarttate , prakaraNa-anativRtteH nirNaya-anativartanam / samAnam ca-etat-
   nityasādharmyeṇocyamāṇe hetau / tad idaṃ prakaraṇānativṛttyā	nitya-sADarmyeNa-ucyamANe hetO / tat idam prakaraNa-anativRttyA
   pratyavasthānaṃ prakaraṇasamaḥ / samānaṃ caitad vaidharmye 'pi,	pratyavasTAnam prakaraNa-samaH / samAnam ca-etat vEDarmye api,
   ubhayavaidharmyāt prakriyāsiddheḥ prakaraṇasama iti //	uBaya-vEDarmyAt prakriyA-sidDeH prakaraNa-samaH iti //
   NyS_5,1.17 pratipakṣāt prakaraṇasiddheḥ pratiṣedhānupapattiḥ	NyH-_5,1.17 pratipakzAt prakaraNa-sidDeH pratizeDa-anupapattiH
   pratipakṣopapatteḥ //	pratipakza-upapatteH //
   NySBh_5,1.17 ubhayasādharmyāt prakriyāsiddhaṃ bruvatā pratipakṣāt	NI-SBh_5,1.17 uBaya-sADarmyAt prakriyA-sidDam bruvatA pratipakzAt-
   prakriyāsiddhir uktā bhavati / yady ubhayasādharmyaṃ, tatra ekataraḥ	prakriyA-sidDiH uktA Bavati / yadi uBaya-sADarmyan, tatra ekataraH
   pratipakṣa ity evaṃ saty upapannaḥ pratipakṣo bhavati / pratipakṣopapatter	pratipakzaH iti evam sati upapannaH pratipakzaH Bavati / pratipakza-upapatteH-
   anupapannaḥ pratiṣedhaḥ, yadi pratipakṣopapattiḥ pratiṣedho nopapadyate,	anupapannaH pratizeDaH, yadi pratipakza-upapattiH pratizeDaH na-upapadyate,
   atha pratiṣedhopapattiḥ pratipakṣo nopapadyate, pratipakṣopapattiḥ	aTa pratizeDa-upapattiH pratipakzaH na-upapadyate, pratipakza-upapattiH
   pratiṣedhopapattiś ceti vipratiṣiddham iti / tattvānavadhāraṇāc ca	pratizeDa-upapattiH ca-iti vipratizidDam iti / tattva-anavaDAraNAt ca
   prakriyāsiddhir viparyaye prakaraṇāvasānāt, tattvāvadhāraṇe hy avasitaṃ	prakriyA-sidDiH viparyaye prakaraNa-avasAnAt, tattva-avaDAraNe hi avasitam
   prakaraṇaṃ bhavatīti //	prakaraNam Bavati-iti //
   NyS_5,1.18 traikālyāsiddher hetor ahetusamaḥ //	NyH-_5,1.18 trEkAlya-asidDeH hetoH ahetu-samaH //
   NySBh_5,1.18 hetuḥ sādhanam, tat sādhyāt pūrvaṃ paścāt saha vā bhavet /	Ni-SBh_5,1.18 hetuH sADanam, tat sADyAt pUrvam paScAt saha vA Bavet /
   yadi pūrvaṃ sādhanam, asati sādhye kasya sādhanam ? atha paścād, asati	yadi pUrvam sADanam, asati sADye kasya sADanam ? aTa paScAt-, asati
   sādhane kasyedaṃ sādhyam ? atha yugapat sādhyasādane, dvayor vidyamānayoḥ	sADane kasya-idam sADyam ? aTa yugapad sADya-sAdane, dvayoH vidyamAnayoH
   kiṃ kasya sādhanaṃ kiṃ kasya sādhyam iti hetur ahetunā na viśiṣyate /	kim kasya sADanam kim kasya sADyam iti hetuH ahetunA na viSizyate /
   ahetunā sādharmyāt prayavasthānam ahetusamaḥ //	ahetunA sADarmyAt prayavasTAnam ahetu-samaH //
   NyS_5,1.19 na hetutaḥ sādhyasiddhes traikālyāsiddhiḥ //	NyH-_5,1.19 na hetutaH sADya-sidDeH trEkAlya-asidDiH //
   NySBh_5,1.19 na traikālyāsiddhiḥ / kasmāt ? hetutaḥ sādhyasiddheḥ /	Ni-SBh_5,1.19 na trEkAlya-asidDiH / kasmAt ? hetutaH sADya-sidDeH /
   nirvartanīyasya nirvṛttir vijñeyasya vijñānam ubhayaṃ kāraṇato dṛśyate, so	nirvartanIyasya nirvRttiH vijQeyasya vijQAnam uBayam kAraNatas dRSyate, saH-
   'yaṃ mahān pratyakṣaviṣaya udāharaṇam iti / yat tu khalūktam asati sādhye	ayam mahAn pratyakza-vizayaH udAharaNam iti / yat tu Kalu-uktam asati sADye
   kasya sādhanam iti ? yat tu nirvatyate yac ca vijñāpyate tasyeti //	kasya sADanam iti ? yat tu nirvatyate yat ca vijQApyate tasya-iti //
   NyS_5,1.20 pratiṣedānupapatteś ca pratiṣeddhavyāpratiṣedhaḥ //	NyH-_5,1.20 pratizeda-anupapatteH ca pratizedDavya-apratizeDaH //
   NySBh_5,1.20 pūrvaṃ paścād yugapad vā pratiṣedha iti nopapadyate,	NI-SBh_5,1.20 pUrvam paScAt yugapad vA pratizeDaH iti na-upapadyate,
   pratiṣedhānupapatteḥ sthāpanāhetuḥ siddha iti //	pratizeDa-anupapatteH sTApanA-hetuH sidDaH iti //
   NyS_5,1.21 arthāpattitaḥ pratipakṣasiddher arthāpattisamaḥ //	NyH-_5,1.21 arTApattitaH pratipakza-sidDeH arTApatti-samaH //
   NySBh_5,1.21 anityaḥ śabdaḥ prayatnānantarīyakatvād ghaṭavad iti sthāpite	Ni-H-Bh_5,1.21 anityaH SabdaH prayatna-anantarIyaka-tvAt Gawa-vat iti sTApite
   pakṣe arthāpattyā pratipakṣaṃ sādhayato 'rthāpattisamaḥ / yadi	pakze arTApattyA pratipakzam sADayataH arTApatti-samaH / yadi
   prayatnānantarīyakatvād anityasādharmyād anityaḥ śabda iti, arthād	prayatna-anantarIyaka-tvAt anitya-sADarmyAt anityaH SabdaH iti, arTAt-
   āpadyate nityasādharmyān nitya iti, asti cāsya nityena sādharmyam	Apadyate nitya-sADarmyAt nityaH iti, asti ca-asya nityena sADarmyam
   asparśatvam iti //	asparSa-tvam iti //
   asyottaram	asya-uttaram
   NyS_5,1.22 anuktasyārthāpatteḥ pakṣahāner upapattir anuktatvād	NyH-_5,1.22 anuktasya-arTApatteH pakza-hAneH upapattiH anukta-tvAt-
   anaikānatikatvāc cārthāpatteḥ //	anEka-Anatika-tvAt ca-arTApatteH //
   NySBh_5,1.22 anupapādya sāmarthyam anuktam arthād āpadyate iti bruvataḥ	NI-SBh_5,1.22 anupapAdya sAmarTyam anuktam arTAt Apadyate iti bruvataH
   pakṣahāner upapattir anuktatvāt, anityapakṣasiddhāv arthād āpannaṃ	pakza-hAneH upapattiH anukta-tvAt, anitya-pakza-sidDO arTAt Apannam
   nityapakṣasya hānir iti / anaikānatikatvāc cārthāpatteḥ / ubhayapakṣasamā	nitya-pakzasya hAniH iti / anEka-Anatika-tvAt ca-arTApatteH / uBaya-pakza-samA
   ceyam arthāpattiḥ / yadi nityasādharmyād asparśatvād ākāśavac ca nityaḥ	ca-iyam arTApattiH / yadi nitya-sADarmyAt asparSa-tvAt AkASa-vat ca nityaH
   śabdaḥ, arthād āpanna, anityasādharmyāt prayatnānantarīyakatvād anitya iti	SabdaH, arTAt Apanna, anitya-sADarmyAt prayatna-anantarIyaka-tvAt anityaH iti
   / na ceyaṃ viparyayamātrād ekāntenārthāpattiḥ / na khalu vai ghaṇasya	/ na ca-iyam viparyaya-mAtrAt ekAntena-arTApattiH / na Kalu vE GaNasya
   grāvṇaḥ patanam ity arthād āpadyate dravāṇām apāṃ patanābhāva iti //	grAvNaH patanam iti arTAt Apadyate dravANAm apAm patana-aBAvaH iti //
   NyS_5,1.23 ekadharmopapatter aviśeṣe sarvāviśeṣaprasaṅgāt sadbhāvopapatter	NyH-_5,1.23 eka-Darma-upapatteH aviSeze sarva-aviSeza-prasaFgAt sadBAva-upapatteH-
   aviśeṣasamaḥ //	aviSeza-samaH //
   NySBh_5,1.23 eko dharmaḥ prayatnānantarīyakatvaṃ śabdaghaṭayor upapadyata	Ni-SBh_5,1.23 ekaH DarmaH prayatna-AnantarIyaka-tvam Sabda-GawayoH upapadyata
   ity aviśeṣe ubhayor anityatve, sarvāviśeṣaḥ prasajyate / katham ?	iti aviSeze uBayoH anitya-tve, sarva-aviSezaH prasajyate / kaTam ?
   sadbhāvopapatteḥ / eko dharmaḥ sadbhāvaḥ sarvasyopapadyate,	sadBAva-upapatteH / ekaH DarmaH sadBAvaH sarvasya-upapadyate,
   sadbhāvopapatteḥ sarvāviśeṣaprasaṅgāt pratyavasthānam aviśeṣasamaḥ //	sadBAva-upapatteH sarva-aviSeza-prasaFgAt pratyavasTAnam aviSeza-samaH //
   NyS_5,1.24 kvacit taddharmopapatteḥ kvacic cānupapatteḥ pratiṣedhābhāvaḥ	NyH-_5,1.24 kvacid tad-Darma-upapatteH kvacid ca-anupapatteH pratizeDa-aBAvaH
   NySBh_5,1.24 yathā sādhyadṛṣṭāntayor ekadharmasya	NI-SBh_5,1.24 yaTA sADya-dRzwAntayoH eka-Darmasya
   prayatnānantarīyakatvasyopapatter anityatvaṃ dharmāntaram aviśeṣaḥ, naivaṃ	prayatna-anantarIyaka-tvasya-upapatteH anitya-tvam Darma-antaram aviSezaH, na-evam
   sarvabhāvānāṃ sadbhāvopapattinimittaṃ dharmāntaram asti, yena aviśeṣaḥ	sarva-BAvAnAm sadBAva-upapatti-nimittam Darma-antaram asti, yena aviSezaH
   syāt / atha matam anityatvam eva dharmānataraṃ sadbhāvopapattinimittaṃ	syAt / aTa matam anitya-tvam eva Darma-Anataram sadBAva-upapatti-nimittam
   bhāvānāṃ sarvatra syād iti, evaṃ khalu vai kalpyamāne anityāḥ sarve bhāvāḥ	BAvAnAm sarvatra syAt iti, evam Kalu vE kalpyamAne anityAH sarve BAvAH
   sadbhāvopapatter iti pakṣaḥ prāpnoti / tatra pratijñārthavyatiriktam anyad	sadBAva-upapatteH iti pakzaH prApnoti / tatra pratijQA-arTa-vyatiriktam anyat-
   udāharaṇaṃ nāsti, anudāharaṇaś ca hetur nāstīti / pratijñaikadeśasya	udAharaNam nAsti, anudAharaNaH ca hetuH na-asti-iti / pratijQa-eka-deSasya
   codāharaṇatvam anupapannam, na hi sādhyam udāharaṇaṃ bhavati / sataś ca	ca-udAharaNa-tvam anupapannam, na hi sADyam udAharaNam Bavati / sataH ca
   nityānityabhāvād anityatvānupapattiḥ / tasmāt sadbhāvopapatteḥ	nitya-aniti-aBAvAt anitya-tva-anupapattiH / tasmAt sadBAva-upapatteH
   sarvāviśeṣaprasaṅga iti nirabhidheyam etad vākyam iti / sarvabhāvānāṃ	sarva-aviSeza-prasaFgaH iti niraBiDeyam etat vAkyam iti / sarva-BAvAnAm
   sadbhāvopapatter anityatvam iti bruvatānujñātaṃ śabdasyānityatvaṃ,	sadBAva-upapatteH anitya-tvam iti bruvata-anujQAtam Sabdasya-anitya-tvaM,
   tatrānupapannaḥ pratiṣedha iti //	tatra-anupapannaH pratizeDaH iti //
   NyS_5,1.25 ubhayakāraṇopapatter upapattisamaḥ //	NyH-_5,1.25 uBaya-kAraNa-upapatteH upapatti-samaH //
   NySBh_5,1.25 yady anityatvakāraṇam upapadyate śabdasyety anityaḥ śabdo	NI-SBh_5,1.25 yadi anitya-tva-kAraNam upapadyate Sabdasya-iti anityaH SabdaH-
   nityatvakāraṇam apy upapadyate 'syāsparśatvam iti nityatvam apy upapadyate	nitya-tva-kAraNam api upapadyate asya-asparSa-tvam iti nitya-tvam api upapadyate
   / ubhayasyānityatvasya nityatvasya ca kāraṇopapattyā pratyavasthānam	/ uBayasya-anitya-tvasya nitya-tvasya ca kAraNa-upapattyA pratyavasTAnam
   upapattisamaḥ //	upapatti-samaH //
   NyS_5,1.26 upapattikāraṇābhyanujñānād apratiṣedhaḥ //	NyH-_5,1.26 upapatti-kAraNa-aByanujQAnAt apratizeDaH //
   NySBh_5,1.26 ubhayakāraṇopapatter iti bruvatā nānityatvakāraṇopapatter	Ni-SBh_5,1.26 uBaya-kAraNa-upapatteH iti bruvatA na-anitya-tva-kAraNa-upapatteH-
   anityatvaṃ pratiṣidhyate, yadi pratiṣidhyate nobhayakāraṇopapattiḥ syāt /	anitya-tvam pratiziDyate, yadi pratiziDyate na-uBaya-kAraNa-upapattiH syAt /
   ubhayakāraṇopapattivacanād anityatvakāraṇopapattir abhyanujñāyate,	uBaya-kAraNa-upapatti-vacanAt anitya-tva-kAraNa-upapattiH aByanujQAyate,
   abhyanujñānād anupapannaḥ pratiṣedhaḥ / vyāghātāt pratiṣedha iti cet,	aByanujQAnAt anupapannaH pratizeDaH / vyAGAtAt pratizeDaH iti ced-,
   samāno vyāghātaḥ / ekasya nityatvānityatvaprasaṅgaṃ vyāhataṃ bruvatoktaṃ	samAnaH vyAGAtaH / ekasya nitya-tva-anitya-tva-prasaFgam vyAhatam bruvata-uktam
   pratiṣedha iti cet ? svapakṣaparapakṣayoḥ samāno vyāghātaḥ, sa ca	pratizeDaH iti ced ? sva-pakza-para-pakzayoH samAnaH vyAGAtaH, sa ca
   naikatarasya sādhaka iti //	na-ekatarasya sADakaH iti //
   NyS_5,1.27 nirdiṣṭakāraṇābhāve 'py upalambhād upalabdhisamaḥ //	NyH-_5,1.27 nirdizwa-kAraNa-aBAve api upalamBAt upalabDi-samaH //
   NySBh_5,1.27 nirdiṣṭasya prayatnānantarīyakatvasyānityatvakāraṇasyābhāve	Ni-SBh_5,1.27 nirdizwasya prayatna-AnantarIyaka-tvasya-anitya-tva-kAraNasya-aBAve
   'pi vāyunodanād vṛkṣaśākhābhaṅgajasya śabdasyānityatvam upalabhyate /	api vAyunodanAt vRkza-SAKA-BaFga-jasya Sabdasya-anitya-tvam upalaByate /
   nirdiṣṭasya sādhanasyābhāve 'pi sādhyadharmopalabdhyā pratyavasthānam	nirdizwasya sADanasya-aBAve api sADya-Darma-upalabDyA pratyavasTAnam
   upalabdhisamaḥ //	upalabDi-samaH //
   asyottaram	asya-uttaram
   NyS_5,1.28 kāraṇāntarād api taddharmopapatter apratiṣedhaḥ //	NyH-_5,1.28 kAraNa-antarAt api tad-Darma-upapatteH apratizeDaH //
   NySBh_5,1.28 prayatnānantarīyakatvād iti bruvatā kāraṇata utpattir	NI-SBh_5,1.28 prayatna-anantarIyaka-tvAt iti bruvatA kAraNatas utpattiH-
   abhidhīyate, na kāryasya kāraṇaniyamaḥ / yadi ca kāraṇāntarād apy	aBiDIyate, na kAryasya kAraNa-niyamaH / yadi ca kAraNa-antarAt api-
   utpadyamānasya śabdasya tad anityatvam upapadyate, kim atra pratiṣidhyata	utpadyamAnasya Sabdasya tat anitya-tvam upapadyate, kim atra pratiziDyata
   iti //	iti //
   na prāg uccāraṇād vidyamānasya śabdasyānupalabdhiḥ, kasmāt ?	na prAk uccAraNAt vidyamAnasya Sabdasya-anupalabDiH, kasmAt ?
   āvaraṇādyanupalabdheḥ / yathā vidyamānasyodakāder arthasyāvaraṇāder	AvaraNa-Adi-anupalabDeH / yaTA vidyamAnasya-udaka-AdeH arTasya-AvaraNa-AdeH-
   anupalabdhiḥ naivaṃ śabdasyāgrahaṇakāraṇenāvaranādinānupalabdhiḥ / gṛhyeta	anupalabDiH na-evam Sabdasya-agrahaNa-kAraNena-avarana-AdinA-anupalabDiH / gRhyeta
   caitad asyāgrahaṇakāraṇam udakādivat, na gṛhyate / tasmād udakādiviparītaḥ	ca-etat asya-agrahaNa-kAraNam udaka-Adi-vat, na gRhyate / tasmAt udaka-Adi-viparItaH
   śabdo 'nupalabhyamāna iti /	SabdaH anupalaByamAnaH iti /
   NyS_5,1.29 tadanupalabdher anupalambhād abhāvasiddhau tadviparītopapatter	NyH-_5,1.29 tad-anupalabDeH anupalamBAt aBAva-sidDO tad-viparIta-upapatteH-
   anupalabdhisamaḥ //	anupalabDi-samaH //
   NySBh_5,1.29 teṣām āvaraṇādīnām anupalabdhir nopalabhyate / anupalambhān	NI-SBh_5,1.29 tezAm AvaraNa-AdInAm anupalabDiH na-upalaByate / anupalamBAn
   nāstīty abhāvo 'syāḥ sidhyati / abhāvasiddhau hetvabhāvāt tadviparītam	na-asti-iti aBAvaH asyAH siDyati / aBAva-sidDO hetu-aBAvAt tad-viparItam
   astitvam āvaraṇādīnām avadhāryate / tadviparītopapatter yatpratijñātaṃ "na	astitvam AvaraNa-AdInAm avaDAryate / tad-viparIta-upapatteH yat-pratijQAtam "na
   prāg uccāraṇād vidyamānasya śabdasyānupalabdhir ity" etan na sidhyati / so	prAk uccAraNAt vidyamAnasya Sabdasya-anupalabDiH ity" etat na siDyati / saH-
   'yaṃ "hetur āvaraṇādyanupalabdher" ity āvaraṇādiṣu cāvaraṇādyanupalabdhau	ayam "hetuH AvaraNa-Adi-anupalabDer" iti AvaraNa-Adizu ca-AvaraNa-Adi-anupalabDO
   ca samayānupalabdhyā pratyavasthito 'nupalabdhisamo bhavati //	ca samaya-anupalabDyA pratyavasTitaH anupalabDi-samaH Bavati //
   asya uttaram	asya uttaram
   NyS_5,1.30 anupalambhātmakatvād anupalabdher ahetuḥ //	NyH-_5,1.30 anupalamBa-Atmaka-tvAt anupalabDeH ahetuH //
   NySBh_5,1.30 āvaraṇādyanupalabdhir nāsti, anupalambhād ity ahetuḥ / kasmāt	NI-SBh_5,1.30 AvaraNa-Adi-anupalabDiH nAsti, anupalamBAt iti ahetuH / kasmAt-
   ? anupalambhātmakatvād anupalabdheḥ / upalambhābhāvamātratvād anupalabdheḥ	? anupalamBa-Atmaka-tvAt anupalabDeH / upalamBa-aBAva-mAtra-tvAt anupalabDeH
   / yad asti tad upalabdher viṣayaḥ, upalabdhyā tad astīti pratijñāyate /	/ yat asti tat upalabDeH vizayaH, upalabDyA tat asti-iti pratijQAyate /
   yan nāsti tad anupalabdher viṣayaḥ, anupalabhyamānaṃ nāstīti pratijñāyate	yat na-asti tat anupalabDeH vizayaH, anupalaByamAnam na-asti-iti pratijQAyate
   / so 'yam āvaraṇādyanupalabheḥ anupalambha upalabdhyabhāve 'nupalabdhau	/ saH ayam AvaraNa-Adi-anupalaBeH anupalamBaH upalabDi-aBAve anupalabDO
   svaviṣaye pravarttamāno na svaviṣayaṃ pratiṣedhati / apratiṣiddhā	sva-vizaye pravarttamAnaH na sva-vizayam pratizeDati / apratizidDA
   cāvaraṇādyanupalabdhi hetutvāya kalpate / āvaraṇādīni tu vidyamānatvād	ca-AvaraNa-Adi-anupalabDi hetu-tvAya kalpate / AvaraNa-AdIni tu vidyamAna-tvAt-
   upalabdher viṣayāḥ, teṣām upalabdhyā bhavitavyam / yat tāni nopalabhyante,	upalabDeH vizayAH, tezAm upalabDyA Bavitavyam / yat tAni na-upalaByante,
   tadupalabdheḥ svaviṣayapratipādikāyā abhāvād anupalambhād anupalabdher	tad-upalabDeH sva-vizaya-pratipAdikAyAH aBAvAt anupalamBAt anupalabDeH-
   viṣayo gamyate na santy āvaraṇādīni śabdasyāgrahaṇakāraṇānīti /	vizayaH gamyate na santi AvaraNa-AdIni Sabdasya-agrahaNa-kAraNAni-iti /
   anupalambhāt tv anupalabhiḥ sidhyati, viṣayaḥ sa tasyeti //	anupalamBAt tu anupalaBiH siDyati, vizayaH sa tasya-iti //
   NyS_5,1.31 jñānavikalpānāṃ ca bhāvābhāvasaṃvedanād adhyātmam //	NyH-_5,1.31 jQAna-vikalpAnAm ca BAva-aBAva-saMvedanAt aDyAtmam //
   NySBh_5,1.31 ahetur iti varttate / śarīre śarīre jñānavikalpānāṃ	Ni-H-Bh_5,1.31 ahetuH iti varttate / SarIre SarIre jQAna-vikalpAnAm
   bhāvābhāvau saṃvedanīyau / asti me saṃśayajñānaṃ nāsti me saṃśayajñānam	BAva-aBAvO saMvedanIyO / asti me saMSaya-jQAnam na-asti me saMSaya-jQAnam
   iti / evaṃ pratyakṣānumānāgamasmṛtijñāneṣu / seyam āvaraṇādyanupalabdhir	iti / evam pratyakza-anumAna-Agama-smRti-jQAnezu / sA-iyam AvaraNa-Adi-anupalabDiH-
   upalabdhyabhāvaḥ svasaṃvedyaḥ nāsti me śabdasyāvaraṇādyupalabdhir iti	upalabDi-aBAvaH sva-saMvedyaH na-asti me Sabdasya-AvaraNa-Adi-upalabDiH iti
   nopalabdhyante śabdasyāgrahaṇakāraṇāny āvaraṇādīnīti / tatra yad uktaṃ	na-upalabDi-ante Sabdasya-agrahaNa-kAraNAni AvaraNa-AdIni-iti / tatra yat uktam
   tadanupalabdher anupalambhād abhāvasiddhir iti, etan nopapadyate //	tad-anupalabDeH anupalamBAt aBAva-sidDiH iti, etat na-upapadyate //
   NyS_5,1.32 sādharmyāt tulyadharmopapatteḥ sarvānityatvaprasaṅgād	NyH-_5,1.32 sADarmyAt tulya-Darma-upapatteH sarva-anitya-tva-prasaFgAt-
   anityasamaḥ // NySBh_5,1.32 sādharmyāt tulyadharmopapatteḥ	anitya-samaH // Ni-SBh_5,1.32 sADarmyAt tulya-Darma-upapatteH
   sarvānityatvaprasaṅgād anityasamaḥ //5,1.32 anityena ghaṭena sādharmyād	sarva-anitya-tva-prasaFgAt anitya-samaH //5,1.32 anityena Gawena sADarmyAt-
   anityaḥ śabda iti bruvato 'sti ghaṭenānityena sarvabhāvānāṃ sādharmyam iti	anityaH SabdaH iti bruvataH asti Gawena-anityena sarva-BAvAnAm sADarmyam iti
   sarvasyānityatvam aniṣṭaṃ sampadyate / so 'yam anityatvena pratyavasthānād	sarvasya-anitya-tvam anizwam sampadyate / saH ayam anitya-tvena pratyavasTAnAt-
   anityasama iti // NySBh_	anitya-samaH iti // Ni-SBh_
   asyottaram	asya-uttaram
   NyS_5,1.33 sādharmyād asiddheḥ pratiṣedhāsiddhiḥ pratiṣedhyasādharmyāt //	NyH-_5,1.33 sADarmyAt asidDeH pratizeDa-asidDiH pratizeDya-sADarmyAt //
   NySBh_5,1.33 pratijñādyavayavayuktaṃ vākyaṃ pakṣanivartakaṃ	NI-SBh_5,1.33 pratijQa-Adi-avayava-yuktam vAkyam pakza-nivartakam
   pratipakṣalakṣaṇaṃ pratiṣedhaḥ / tasya pakṣeṇa pratiṣedhyena sādharmyaṃ	pratipakza-lakzaNam pratizeDaH / tasya pakzeNa pratizeDyena sADarmyam
   pratijñādiyogaḥ / tad yady anityasādharmyād anityatvasyāsiddhiḥ,	pratijQa-Adi-yogaH / tat yadi anitya-sADarmyAt anitya-tvasya-asidDiH,
   sādharmyād asiddheḥ pratiṣedhasyāpy asiddhiḥ, pratiṣedhyena sādharmyād iti	sADarmyAt asidDeH pratizeDasya-api asidDiH, pratizeDyena sADarmyAt iti
   NyS_5,1.34 dṛṣṭānte ca sādhyasādhanabhāvena prajñātasya dharmasya hetutvāt	NyH-_5,1.34 dRzwAnte ca sADya-sADana-BAvena prajQAtasya Darmasya hetu-tvAt-
   tasya cobhayathābhāvān nāviśeṣaḥ //	tasya ca-uBayaTa-aBAvAt na-aviSezaH //
   NySBh_5,1.34 dṛṣṭānte yaḥ khalu dharmaḥ sādhyasādhanabhāvena prajñāyate,	Ni-SBh_5,1.34 dRzwAnte yaH Kalu DarmaH sADya-sADana-BAvena prajQAyate,
   sa hetutvenābhidhīyate / sa cobhayathā bhavati, kenacit samānaḥ kutaścid	sa hetu-tvena-aBiDIyate / sa ca-uBayaTA Bavati, kenacid samAnaH kutaScid-
   viśiṣṭaḥ / sāmānyāt sādharmyaṃ viśeṣāc ca vaidharmyam / evaṃ	viSizwaH / sAmAnyAt sADarmyam viSezAt ca vEDarmyam / evam
   sādharmyaviśeṣo hetuḥ, nāviśeṣeṇa sādharmyamātraṃ vaidharmyamātraṃ vā /	sADarmya-viSezaH hetuH, na-aviSezeNa sADarmya-mAtram vEDarmya-mAtram vA /
   sādharmyamātraṃ vaidharmyamātraṃ cāśritya bhavān āha "sādharmyāt	sADarmya-mAtram vEDarmya-mAtram ca-ASritya BavAn Aha "sADarmyAt-
   tulyadharmopapatteḥ sarvānityatvaprasaṅgād anityasama" iti, etad ayuktam	tulya-Darma-upapatteH sarva-anitya-tva-prasaFgAt anitya-sama" iti, etat ayuktam
   iti / aviśeṣasamapratiṣedhe ca yad uktaṃ tad api veditavyam //	iti / aviSeza-sama-pratizeDe ca yat uktam tat api veditavyam //
   NyS_5,1.35 nityam anityabhāvād anitye nityatvopapatter nityasamaḥ //	NyH-_5,1.35 nityam anitya-BAvAt anitye nitya-tva-upapatteH nitya-samaH //
   NySBh_5,1.35 anityaḥ śabda iti pratijñāyate / tad anityatvaṃ kiṃ śabde	Ni-H-Bh_5,1.35 anityaH SabdaH iti pratijQAyate / tat anitya-tvam kim Sabde
   nityam athānityam ? yadi tāvat sarvadā bhavati ? dharmasya sadā bhāvād	nityam aTa-anityam ? yadi tAvat sarvadA Bavati ? Darmasya sadA BAvAt-
   dharmiṇo 'pi sadā bhāva iti nityaḥ śabda iti / atha na sarvadā bhavati ?	DarmiNaH api sadA BAvaH iti nityaH SabdaH iti / aTa na sarvadA Bavati ?
   anityatvasyābhāvān nityaḥ śabdaḥ / evaṃ nityatvena pratyavasthānān	anitya-tvasya-aBAvAt nityaH SabdaH / evam nitya-tvena pratyavasTAnAn
   nityasamaḥ //	nitya-samaH //
   asyottaram	asya-uttaram
   NyS_5,1.36 pratiṣedhye nityam anityabhāvād anitye 'nityatvopapatteḥ	NyH-_5,1.36 pratizeDye nityam anitya-BAvAt anitye anitya-tva-upapatteH
   pratiṣedhābhāvaḥ //	pratizeDa-aBAvaH //
   NySBh_5,1.36 pratiṣedhye śabde nityam anityatvasya bhāvād ity ucyamāne	Ni-SBh_5,1.36 pratizeDye Sabde nityam anitya-tvasya BAvAt iti ucyamAne
   'nujñātaṃ śabdasyānityatvam, anityatvopapatteś ca "nānityaḥ śabda" iti	anujQAtam Sabdasya-anitya-tvam, anitya-tva-upapatteH ca "nAnityaH Sabda" iti
   pratiṣedho nopapadyate / atha nābhyupagamyate, nityam anityatvasya bhāvād	pratizeDaH na-upapadyate / aTa nAByupagamyate, nityam anitya-tvasya BAvAt-
   iti hetur na bhavatīti hetvabhāvāt pratiṣedhānupapattir iti / utapannasya	iti hetuH na Bavati-iti hetu-aBAvAt pratizeDa-anupapattiH iti / utapannasya
   nirodhād abhāvaḥ śabdasyānityatvaṃ, tatra paripraśnānupapattiḥ / yo 'yaṃ	niroDAt aBAvaH Sabdasya-anitya-tvaM, tatra paripraSna-anupapattiH / yaH ayam
   paripaśnaḥ tad anityatvaṃ kiṃ śabde sarvadā bhavati atha neti, ayam	paripaSnaH tat anitya-tvam kim Sabde sarvadA Bavati aTa na-iti, ayam
   anupapannaḥ / kasmāt ? utpannasya yo nirodhād abhāvaḥ śabdasya tad	anupapannaH / kasmAt ? utpannasya yaH niroDAt aBAvaH Sabdasya tat-
   anityatvam ; evaṃ ca saty adhikaraṇādheyavibhāgo vyāghātān nāstīti /	anitya-tvam ; evam ca sati aDikaraNa-ADeya-viBAgaH vyAGAtAt na-asti-iti /
   nityānityatvavirodhāc ca / nityatvam anityatvaṃ ca ekasya dharmiṇo dharmāv	nitya-anitya-tva-viroDAt ca / nitya-tvam anitya-tvam ca ekasya DarmiNaH DarmAv
   iti virudhyete, na sambhavataḥ / tatra yad uktaṃ nityam anityatvasya	iti viruDyete, na samBavataH / tatra yat uktam nityam anitya-tvasya
   bhāvān nitya eva, tad avartamānārtham uktam iti //	BAvAn nityaH eva, tat avartamAna-arTam uktam iti //
   NyS_5,1.37 prayatnakāryānekatvāt kāryasamaḥ //	NyH-_5,1.37 prayatna-kArya-aneka-tvAt kArya-samaH //
   NySBh_5,1.37 prayatnānantarīyakatvād anityaḥ śabda iti / yasya	Ni-SBh_5,1.37 prayatna-anantarIyaka-tvAt anityaH SabdaH iti / yasya
   prayatnānantaram ātmalābhaḥ tat khalv abhūtvā bhavati, yathā ghaṭādikāryam	prayatna-anantaram Atma-lABaH tat Kalu aBUtvA Bavati, yaTA Gawa-Adi-kAryam
   ; anityam iti ca bhūtvā na bhavatīty etad vijñāyate / evam avasthite	; anityam iti ca BUtvA na Bavati-iti etat vijQAyate / evam avasTite
   prayatnakāryānekatvād iti pratiṣedha ucyate / prayatnānantaram ātmalābhaś	prayatna-kArya-anekatvAt iti pratizeDaH ucyate / prayatna-anantaram Atma-lABaH-
   ca dṛṣṭo ghaṭādīnām, vyavadhānāpohāc cābhivyaktir vyavahitānām / tat kiṃ	ca dRzwaH Gawa-AdInAm, vyavaDAna-apohAt ca-aBivyaktiH vyavahitAnAm / tat kim
   prayatnānantaram ātmalābhaḥ śabdasyāho 'bhivyaktir iti viśeṣo nāsti /	prayatna-anantaram Atma-lABaH Sabdasya-aho aBivyaktiH iti viSezaH na-asti /
   kāryāviśeṣeṇa pratyavasthānaṃ kāryasamaḥ //	kAryA-viSezeNa pratyavasTAnam kArya-samaH //
   asyottaram	asya-uttaram
   NyS_5,1.38 kāryānyatve prayatnāhetutvam anupalabdhikāraṇopapatteḥ //	NyH-_5,1.38 kArya-anya-tve prayatna-ahetu-tvam anupalabDi-kAraNa-upapatteH //
   NySBh_5,1.38 sati kāryānyatve anupalabdhikāraṇopapatteḥ	Ni-SBh_5,1.38 sati kArya-anya-tve anupalabDi-kAraNa-upapatteH
   prayatnasyāhetutvaṃ śabdasyābhivyaktau / yatra prayatnānantaram	prayatnasya-ahetu-tvam Sabdasya-aBivyaktO / yatra prayatna-anantaram
   abhivyaktis tatrānupalabdhikāraṇaṃ vyavadhānam upapadyate, vyavadhānāpohāc	aBivyaktiH tatra-anupalabDi-kAraNam vyavaDAnam upapadyate, vyavaDAna-apoha-At-
   ca prayatnānantarabhāvino 'rthasyopalabdhilakṣaṇābhivyaktir bhavatīti, na	ca prayatna-anantara-BAvinaH arTasya-upalabDi-lakzaNa-aBivyaktiH Bavati-iti, na
   tu śabdasyānupalabdhikāraṇaṃ kiṃcid upapadyate, yasya prayatnānantaram	tu Sabdasya-anupalabDi-kAraNam kiMcid upapadyate, yasya prayatna-anantaram
   apohāc chabdasyopalabhilakṣaṇābhivyaktir bhavatīti, tasmād utpadyate śabdo	apohAt Sabdasya-upalaBilakzaNa-aBivyaktiH Bavati-iti, tasmAt utpadyate SabdaH-
   nābhivyajyate iti //	na-aBivyajyate iti //
   hetoś ced anaikāntikatvam upapadyate anaikātikatvād asādhakaḥ syād iti /	hetoH ced anEkAntika-tvam upapadyate anEkAtika-tvAt asADakaH syAt iti /
   yadi cānaikāntikatvād asādhakatvam	yadi ca-anEkAntika-tvAt asADaka-tvam
   NyS_5,1.39 pratiṣedhe 'pi samāno doṣaḥ //	NyH-_5,1.39 pratizeDe api samAnaH dozaH //
   NySBh_5,1.39 pratiṣedho 'py anaikāntikaḥ, kiṃcit pratiṣedhati kiṃcin neti	NI-SBh_5,1.39 pratizeDaH api anEkAntikaH, kiMcid pratizeDati kiMcid na-iti
   anaikāntikatvād asādhaka iti / atha vā śabdasyānityatvapakṣe	anEkAntika-tvAt asADakaH iti / aTa vA Sabdasya-anitya-tva-pakze
   prayatnānantaram utpādo nābhivyaktir iti viśeṣahetvabhāvaḥ, nityatvapakṣe	prayatna-anantaram utpAdaH na-aBi-vyaktiH iti viSeza-hetu-aBAvaH, nitya-tva-pakze
   'pi prayatnānantaram abhivyaktir notpāda iti viśeṣahetvabhāvaḥ / so 'yam	api prayatna-anantaram aBivyaktiH na-utpAdaH iti viSeza-hetu-aBAvaH / saH ayam
   ubhayapakṣasamo viśeṣahetvabhāva ity ubhayam apy anaikātikam iti //	uBaya-pakza-samaH viSeza-hetu-aBAvaH iti uBayam api anEkAtikam iti //
   NyS_5,1.40 sarvatraivam //	NyH-_5,1.40 sarvatra-evam //
   NySBh_5,1.40 sarveṣu sādharmyaprabhṛtiṣu pratiṣedhahetuṣu yatra	Ni-SBh_5,1.40 sarvezu sADarmya-praBRtizu pratizeDa-hetuzu yatra
   yatrāviśeṣo dṛśyate tatrobhayoḥ pakṣayoḥ samaḥ prasajyata iti //	yatra-aviSezaH dRSyate tatra-uBayoH pakzayoH samaH prasajyate iti //
   NyS_5,1.41 pratiṣedhavipratiṣedhe pratiṣedhadoṣavad doṣaḥ //	NyH-_5,1.41 pratizeDa-vipratizeDe pratizeDa-doza-vat dozaH //
   NySBh_5,1.41 yo 'yaṃ pratiṣedhe 'pi samāno doṣo 'naikāntikatvam āpadyate	Ni-SBh_5,1.41 yaH ayam pratizeDe api samAnaH dozaH anEkAntika-tvam Apadyate
   so 'yaṃ pratiṣedhasya vipratiṣedhe 'pi samānaḥ / tatrānityaḥ śabdaḥ	saH ayam pratizeDasya vipratizeDe api samAnaH / tatra-anityaH SabdaH
   prayatnānantarīyakatvād iti sādhanavādinaḥ sthāpanā prathamaḥ pakṣaḥ /	prayatna-anantarIyaka-tvAt iti sADana-vAdinaH sTApanA praTamaH pakzaH /
   "prayatnakāryānekatvāt kāryasama" iti dūṣaṇavādinaḥ pratiṣedhahetunā	"prayatna-kArya-aneka-tvAt kArya-sama" iti dUzaNa-vAdinaH pratizeDa-hetunA
   dvitīyaḥ pakṣaḥ / sa ca pratiṣedha ity ucyate / tasyāsya pratiṣedhe 'pi	dvitIyaH pakzaH / sa ca pratizeDaH iti ucyate / tasya-asya pratizeDe api
   samāno doṣa iti tṛtīyaḥ pakṣaḥ vipratiṣedha ucyate / tasmin	samAnaH dozaH iti tRtIyaH pakzaH vipratizeDaH ucyate / tasmin
   pratiṣedhavipratiṣedhe 'pi samāno doṣo 'naikāntikatvaṃ caturthaḥ pakṣaḥ //	pratizeDa-vipratizeDe api samAnaH dozaH anEkAntika-tvam caturTaH pakzaH //
   NyS_5,1.42 pratiṣedhaṃ sadoṣam abhyupetya pratiṣedhavipratiṣedhe samāno	NyH-_5,1.42 pratizeDam sa-dozam aByupetya pratizeDa-vipratizeDe samAnaH-
   doṣaprasaṅgo matānujñā //	doza-prasaFgaH mata-anujQA //
   NySBh_5,1.42 pratiṣedhaṃ dvitīyaṃ pakṣaṃ sadoṣam abhyupetya taduddhāram	NI-SBh_5,1.42 pratizeDam dvitIyam pakzam sa-dozam aByupetya tad-udDAram
   akṛtvānujñāya pratiṣedhavipratiṣedhe tṛtīyapakṣe samānam anaikāntikatvam	akRtvA-anujQAya pratizeDa-vipratizeDe tRtIya-pakze samAnam anEkAntika-tvam
   iti samānaṃ dūṣaṇaṃ prasañjayato dūṣaṇavādino matānujñā prasajyata iti	iti samAnam dUzaNam prasaQjayataH dUzaNa-vAdinaH mata-anujQA prasajyate iti
   pañcamaḥ pakṣaḥ //	paQcamaH pakzaH //
   NyS_5,1.43 svapakṣalakṣaṇāpekṣopapattyupasaṃhāre hetunirdeśe	NyH-_5,1.43 sva-pakza-lakzaNa-apekzA-upapatti-upasaMhAre hetu-nirdeSe
   parapakṣadoṣābhyupagamāt samāno doṣaḥ //	para-pakza-doza-aByupagamAt samAnaH dozaH //
   NySBh_5,1.43 sthāpanāpakṣe prayatnakāryānekatvād iti doṣaḥ	NI-SBh_5,1.43 sTApanA-pakze prayatna-kArya-anekatvAt iti dozaH
   sthāpanāhetuvādinaḥ svapakṣalakṣaṇo bhavati / kasmāt ?	sTApanA-hetu-vAdinaH sva-pakza-lakzaNaH Bavati / kasmAt ?
   svapakṣasamutthatvāt / so 'yaṃ svapakṣalakṣaṇaṃ doṣam apekṣamāṇo	sva-pakza-samutTa-tvAt / saH ayam sva-pakza-lakzaNam dozam apekzamANaH-
   'nuddhṛtyānujñāya pratiṣedhe 'pi samāno doṣa ity upapadyamānaṃ doṣaṃ	anudDRtya-anujQAya pratizeDe api samAnaH dozaH iti upapadyamAnam dozam
   parapakṣe upasaṃharati / itthaṃ cānaikāntikaḥ pratiṣedha iti hetuṃ	para-pakze upasaMharati / itTam ca-anEkAntikaH pratizeDaH iti hetum
   nirdiśati / tatra svapakṣalakṣaṇāpekṣayopapadyamānadoṣopasaṃhāre	nirdiSati / tatra sva-pakza-lakzaNa-apekzayA-upapadyamAna-doza-upasaMhAre
   hetunirdeśe ca saty anena parapakṣadoṣo 'bhyupagato bhavati / kathaṃ kṛtvā	hetu-nirdeSe ca sati anena para-pakza-dozaH aByupagataH Bavati / kaTam kRtvA
   ? yaḥ pareṇa prayatnakāryānekatvādityādinānaikāntikadoṣa uktaḥ, tam	? yaH pareNa prayatna-kArya-aneka-tvAt-ityAdinA-anEkAntika-dozaH uktaH, tam
   anuddhṛtya pratiṣedhe 'pi samāno doṣa ity āha / evaṃ sthāpanāṃ sadoṣām	anudDRtya pratizeDe api samAnaH dozaH iti Aha / evam sTApanAm sa-dozAm
   abhyupetya pratiṣedhe 'pi samānaṃ doṣaṃ prasañjayataḥ parapakṣābhyupagamāt	aByupetya pratizeDe api samAnam dozam prasaQjayataH para-pakza-aByupagamAt
   samāno doṣo bhavati / yathā parasya pratiṣedhaṃ sadoṣam abhyupetya	samAnaH dozaH Bavati / yaTA parasya pratizeDam sa-dozam aByupetya
   pratiṣedhavipratiṣedhe 'pi samāno doṣaprasaṅgo matānujñā prasajyata iti,	pratizeDa-vipratizeDe api samAnaH doza-prasaFgaH mata-anujQA prasajyate iti,
   tathāsyāpi sthāpanāṃ sadoṣām abhyupetya pratiṣedhe 'pi samānaṃ doṣaṃ	taTA-asya-api sTApanAm sa-dozAm aByupetya pratizeDe api samAnam dozam
   prasañjayato matānujñā prasajyata iti / sa khalv ayaṃ ṣaṣṭaḥ pakṣaḥ /	prasaQjayataH mata-anujQA prasajyate iti / sa Kalu ayam zazwaH pakzaH /
   tatra khalu sthāpanāhetuvādinaḥ prathamatṛtīyapañcamapakṣāḥ,	tatra Kalu sTApanA-hetu-vAdinaH praTama-tRtIya-paQcama-pakzAH,
   pratiṣedhahetuvādinaḥ dvitīyacaturthaṣaṣṭapakṣāḥ teṣāṃ sādhvasādhutāyāṃ	pratizeDa-hetu-vAdinaH dvitIya-caturTa-zazwa-pakzAH tezAm sADu-asADutAyAm
   mīmāṃsyamānāyāṃ caturthaṣaṣṭayor arthāviśeṣāt punaruktadoṣaprasaṅgaḥ /	mImAMsyamAnAyAm caturTa-zazwayoH arTa-aviSezAt punar-ukta-doza-prasaFgaH /
   caturthapakṣe samānadoṣatvaṃ parasyocyate "pratiṣedhavipratiṣedhe	caturTa-pakze samAna-doza-tvam parasya-ucyate "pratizeDa-vipratizeDe
   pratiṣedhadoṣavad doṣa" iti / ṣaṣṭe 'pi "parapakṣadoṣābhyupagamāt samāno	pratizeDa-doza-vat doza" iti / zazwe api "para-pakza-doza-aByupagamAt samAnaH-
   doṣa" iti samānadoṣatvam evocyate, nārthaviśeṣaḥ kaścid asti / samānas	doza" iti samAna-doza-tvam eva-ucyate, na-arTa-viSezaH kaScid asti / samAna-s
   tṛṭīyapañcamayoḥ punaruktadoṣaprasaṅgaḥ, tṛṭīyapakṣe 'pi "pratiṣedhe 'pi	tRwIya-paQcamayoH punar-ukta-doza-prasaFgaH, tRwIya-pakze api "pratizeDe api
   samāno doṣa" iti samānatvam abhyupagamyate / pañcamapakṣe 'pi	samAnaH doza" iti samAna-tvam aByupagamyate / paQcama-pakze api
   "pratiṣedhavipratiṣedhe samāno doṣaprasaṅgo"+abhyupagamyate, nārthaviśeṣaḥ	"pratizeDa-vipratizeDe samAnaH doza-prasaFgaH-"+aByupagamyate, na-arTa-viSezaH
   kaścid ucyata iti / tatra pañcamaṣaṣṭapakṣayor arthāviśeṣāt	kaScid ucyate iti / tatra paQcama-zazwa-pakzayoH arTa-aviSezAt
   punaruktadoṣaprasaṅgaḥ, tṛtīyacaturthayor matānujñā, prathamadvitīyayor	punarukta-doza-prasaFgaH, tRtIya-caturTayoH mata-anujQA, praTama-dvitIyayoH-
   viśeṣahetvabhāva iti ṣaṭpakṣyām ubhayor asiddhiḥ / kadā ṣaṭpakṣī ? yadā	viSeza-hetu-aBAvaH iti zaz-pakzyAm uBayoH asidDiH / kadA zaz-pakzI ? yadA
   "pratiṣedhe 'pi samāno doṣa" ity evaṃ pravarttate / tadobhayoḥ pakṣayor	"pratizeDe api samAnaH doza" iti evam pravarttate / tad-A-uBayoH pakzayoH-
   asiddhiḥ / yadā tu "kāryānyatve prayatnāhetutvam	asidDiH / yadA tu "kArya-anya-tve prayatna-ahetu-tvam
   anupalabdhikāraṇopapatter" ity anena tṛṭīyapakṣo yajyate, tadā	anupalabDi-kAraNa-upapatter" iti anena tRwIya-pakzaH yajyate, tadA
   viśeṣahetuvacanāt "prayatnānantaram ātmalābhaḥ śabdasya, nābhivyaktir" iti	viSeza-hetu-vacanAt "prayatna-anantaram Atma-lABaH Sabdasya, na-aBi-vyaktir" iti
   siddhaḥ prathamapakṣo na ṣaṭpakṣī pravartata iti //	sidDaH praTama-pakzaH na zaz-pakzI pravartate iti //
