   (Part I)	(Part I)
   padyāvalī viracitā rasikair mukunda-	padyA-AvalI viracitA rasikEH mukunda-
   sambandha-bandhura-padā pramodormi-sindhuḥ |	sambanDa--banDura-padA pramoda-Urmi-sinDuH |
   ramyā samasta-tamasāṃ damanī krameṇa	ramyA samasta--tamasAm damanI krameNa
   saṃgṛhyate kṛti-kadambaka-kautukāya ||1||	saMgRhyate kRti-kadamba-ka-kOtukAya ||1||
   granthaprārambhe maṅgalācaraṇam |	granTa-prAramBe maFgala-AcaraNam |
   namo nalina-netrāya	namaH nalina--netrAya
   veṇu-vādya-vinodine |	veNu-vAdya-vinodine |
   rādhādhara-sudhāpāna-	rADA-Dara--suDA-pAna-
   śāline vana-māline || 2 ||	SAline vana--mAline || 2 ||
   kasyacit ||	kasyacid ||
   bhakti-prahva-vilokana-praṇayinī nīlotpala-spardhinī	Bakti--prahva--vilokana--praNayinI nIlotpala--sparDinI
   dhyānālambanatāṃ samadhi-niratair nīte hita-prāptaye |	DyAna-AlambanatAm samaDi--niratEH nIte hita--prAptaye |
   lāvaṇyaika-mahā-nidhau rasikatāṃ rādhā-dṛśos tanvatī	lAvaNya-eka--mahA-niDO rasika-tAm rADA--dRSoH tanvatI
   yuṣmākaṃ kurutāṃ bhavārti-śamanaṃ netre tanur vā hareḥ ||3||	yuzmAkam kurutAm Bava-Arti-Samanam netre tanuH vA hareH ||3||
   śrī-sāraṅgasya ||	SrI--sAraFgasya ||
   ye govardhana-mūla-kardama-rasa-vyādaṣṭa-barha-cchadā	ye govarDana--mUla-kardama--rasa-vyAdazwa-barha-cCadA
   ye vṛndāvana-kukṣiṣu vraja-vadhū-līlopadhānāni ca |	ye vRndAvana-kukzizu vraja-vaDU--lIlA-upaDAnAni ca |
   ye cābhyaṅga-sugandhayaḥ kuvalayāpīḍasya dānāmbhasā	ye ca-aByaFga--suganDayaH kuvalayApIxasya dAna-amBasA
   te vo maṅgalam ādiśantu satataṃ kaṃsa-dviṣo bāhavaḥ ||4||	te vaH maFgalam AdiSantu satatam kaMsa--dvizaH bAhavaH ||4||
   śubhāṅkasya || (SKM 1.59.3)	SuBa-aFkasya || (SKm 1.59.3)
   sāyaṃ vyāvartamānakhila-surabhi-kulāhvāna-saṃketa-nāmāny	sAyam vyAvartamAna-Kila--suraBi--kula-AhvAna--saMketa--nAmAni-
   abhīrī-vṛnda-ceto haṭha-haraṇa-kalā-siddha-mantrākṣarāṇi |	aBIrI--vRnda--cetaH haWa-haraNa-kalA--sidDa-mantra-akzarANi |
   saubhāgyaṃ vaḥ samantād dadhatu madhu-bhidaḥ keli-gopāla-mūrteḥ	sOBAgyam vaH samantAt daDatu maDu-BidaH keli--gopAla--mUrteH
   sānandakṛṣṭa-vṛndāvana-rasika-mṛga-śreṇayo veṇu-nādāḥ ||5||	sa-Ananda-kRzwa--vRndAvana-rasika-mRga--SreNayaH veNu-nAdAH ||5||
   umāpatidharasya || (SKM 1.57.3)	umApatiDarasya || (SKm 1.57.3)
   atha śrī-kṛṣṇasya mahimā |	aTa SrI--kRzNasya mahimA |
   ambhobhiḥ sthalatāṃ sthalaṃ jaladhitāṃ dhūlīlavaḥ śailatāṃ	amBoBiH sTalatAm sTalam jalaDitAm DUlIlavaH SEla-tAm
   śailī mṛt-kaṇatāṃ tṛṇaṃ kuliśatāṃ vajraṃ tṛṇa-kṣīṇatām |	SElI mRt-kaNatAm tRNam kuliSatAm vajram tRNa--kzINa-tAm |
   vahniḥ śītalatāṃ himaṃ vahanatām āyāti yasyecchayā	vahniH SItala-tAm himam vahana-tAm AyAti yasya-icCayA
   līlā-durlalitādbhuta-vyasaninaṃ kṛṣṇāya tasmai namaḥ ||6||	lIlA--durlalita-adButa--vyasaninam kRzNAya tasmE namaH ||6||
   kasyacit ||	kasyacid ||
   vātsalyād abhaya-pradāna-samayād ārtārti-nirvāpaṇād	vAtsalyAt aBaya--pradAna--samayAt Arta-Arti-nirvApaNAt-
   audāryād agha-śoṣaṇād agaṇita-śreyaḥ-pada-prāpaṇāt |	OdAryAt aGa--SozaNAt agaNita-SreyaH-pada--prApaNAt |
   sevyaḥ śrī-patir eva sarva-jagatām ete yataḥ sākṣiṇaḥ	sevyaH SrI-patiH eva sarva-jagatAm ete yatas sAkziNaH
   prahlādaś ca vibhīṣaṇaś ca karirāṭ pāñcalya-halyā dhruvaḥ ||7||	prahlAdaH ca viBIzaNaH ca kari-rAj pAQcalI-a--halyAH DruvaH ||7||
   kasyacit ||	kasyacid ||
   atha bhajana-māhātmyam |	aTa Bajana--mAhAtmyam |
   vyādhasyācaraṇaṃ dhruvasya ca vayo vidyā gajendrasya kā	vyADasya-AcaraNam Druvasya ca vayaH vidyA gaja-indrasya kA
   kubjāyāḥ kim u nāma rūpam adhikaṃ kiṃ tat sudāmno dhanam |	kubjAyAH kim u nAma rUpam aDikam kim tat sudAmnaH Danam |
   vaṃśaḥ ko vidurasya yādavapater ugrasya kiṃ pauruṣaṃ	vaMSaH kaH vidurasya yAdava-pateH ugrasya kim pOruzam
   bhaktyā tuṣyati kevalaṃ na ca guṇair bhakti-priyo mādhavaḥ || 8 ||	BaktyA tuzyati kevalam na ca guNEH Bakti-priyaH mADavaH || 8 ||
   śrī-dākṣiṇātyasya ||	SrI--dAkziNAti-asya ||
   anucitam ucitaṃ vā karma ko'yaṃ vibhāgo	anucitam ucitam vA karma kaH-ayam viBAgaH-
   bhagavati param āstāṃ bhakti-yogo draḍhīyān |	Bagavati param AstAm Bakti-yogaH draXIyAn |
   kirati viṣa-mahīndraḥ sāndra-pīyūṣam indur	kirati viza-mahIndraH sAndra-pIyUzam induH-
   dvayam api sa maheśo nirviśeṣaṃ bibharti ||9||	dvayam api sa maheSaH nirviSezam biBarti ||9||
   śrī-viṣṇupurīpādānām ||	SrI--vizNu-purI-pAdAnAm ||
   yadi madhu-mathana tvad-aṅghri-sevāṃ	yadi maDu-maTana tvad--aFGri--sevAm
   hṛdi vidadhāti jahāti vā vivekī |	hRdi vidaDAti jahAti vA vivekI |
   tad-akhilam api duṣkṛtaṃ triloke	tat--aKilam api duzkRtam triloke
   kṛtam akṛtaṃ na kṛtaṃ kṛtaṃ ca sarvam ||10||	kRtam akRtam na kRtam kRtam ca sarvam ||10||
   teṣam eva ||	tezam eva ||
   kāṣāyān na ca bhojanādi-niyamān no vā vane vāsato	kAzAyAt na ca Bojana-Adi--niyamAn naH vA vane vAsataH-
   vyākhyānād atha vā muni-vrata-bharāc cittodbhavaḥ kṣīyate |	vyAKyAnAt aTa vA muni--vrata-BarAt citta-udBavaH kzIyate |
   kintu sphīta-kalinda-śaila-tanayā-tīreṣu vikīḍato	kintu sPIta--kalinda--SEla-tanayA--tIrezu vikIxataH-
   govindasya padāravinda-bhajanārambhasya leśād api ||11||	govindasya pada-aravinda--Bajana-AramBasya leSAt api ||11||
   kasyacit ||	kasyacid ||
   alam alam iyam eva prāṇināṃ pātakānāṃ	alam alam iyam eva prANinAm pAtakAnAm
   nirasana-viṣaye yā kṛṣṇa kṛṣṇeti vāṇī |	nirasana--vizaye yA kRzNa kRzNa-iti vANI |
   yadi bhavati mukunde bhaktir ānanda-sāndrā	yadi Bavati mukunde BaktiH Ananda--sAndrA
   viluṭhati caraṇābje mokṣa-sāmrājya-lakṣmīḥ || 12 ||	viluWati caraNa-abje mokza--sAmrAjya--lakzmIH || 12 ||
   śrī-sarvajñasya ||	SrI--sarvajQasya ||
   nānopacāra-kṛta-pūjanam ārta-bandhoḥ	nAnA-upacAra-kRta--pUjanam Arta-banDoH
   premṇaiva bhakta-hṛdayaṃ sukha-vidrutaṃ syāt |	premNA-eva Bakta--hRdayam suKa-vidrutam syAt |
   yāvat kṣud asti jaṭhare jaraṭhā pipāsā	yAvat kzuD asti jaWare jaraWA pipAsA
   tāvat sukhāya bhavato nanu bhakṣya-peye ||13||	tAvat suKAya BavataH nanu Bakzya-peye ||13||
   śrī-rāmānandarāyasya | (CCMK 13.42; CC 2.8.69)	SrI-rAma-AnandarAyasya | (SCMK 13.42; CS 2.8.69)
   kṛṣṇa-bhakti-rasa-bhāvita-matiḥ	kRzNa--Bakti-rasa-BAvita-matiH
   kriyatāṃ yadi kuto'pi labhyate	kriyatAm yadi kutas-api laByate
   tatra laulyam api mūlyam ekalaṃ	tatra lOlyam api mUlyam ekalam
   janma-koṭi-sukṛtair na labhyate ||14||	janma--kowi-su-kRtEH na laByate ||14||
   tasyaiva | (CC 2.8.70)	tasya-eva | (SC 2.8.70)
   jñānam asti tulitaṃ ca tulāyāṃ	jQAnam asti tulitam ca tulAyAm
   prema naiva tulitaṃ tu tulāyām |	prema na-eva tulitam tu tulAyAm |
   siddhir eva tulitātra tulāyāṃ	sidDiH eva tulitA-atra tulAyAm
   kṛṣṇa-nāma tulitaṃ na tulāyām ||15||	kRzNa--nAma tulitam na tulAyAm ||15||
   śrī-śrī-dharasvāmipādānām ||	SrI--SrI-Dara-svAmi-pAdAnAm ||
   atha nāmamāhātmyam |	aTa nAma-mAhAtmyam |
   aṃhaḥ saṃharad akhilaṃ sakṛd	aMhar saMharat aKilam sakRt-
   udayād eva sakala-lokasya |	udayAt eva sakala--lokasya |
   taraṇir iva timira-jaladhiṃ	taraNiH iva timira--jalaDim
   jayati jagan-maṅgalaṃ harer nāma ||16||	jayati jagan-maFgalam hareH nAma ||16||
   śrī-lakṣmīdharāṇām || (Nāmakaumudī 1.2; CC 3.3.180)	SrI---lakzmIDarANAm || (NA-Ama-kOmudI 1.2; CS 3.3.180)
   caturṇāṃ vedānāṃ hṛdayam idam ākṛṣya hariṇā	caturNAm vedAnAm hRdayam idam AkRzya hariNA
   caturbhir yad varṇaiḥ sphuṭam aghaṭi nārāyaṇa-padam |	caturBiH yat varNEH sPuwam aGawi nArAyaNa--padam |
   tad etad gāyanto vayam aniśam ātmānam adhunā	tat etat gAyantaH vayam aniSam AtmAnam aDunA
   punīmo jānīmo na hari-paritoṣāya kim api ||17||	punImaH jAnImaH na hari--paritozAya kim api ||17||
   kasyacit ||	kasyacid ||
   yoga-śruty-upapatti-nirjana-vana-dhyānādhva-sambhāvita-	yoga--Sruti--upapatti--nirjana--vana--DyAna-aDva--samBAvita-
   svārājyaṃ pratipadya nirbhayam amī muktā bhavantu dvijāḥ |	svArAjyam pratipadya nirBayam amI muktAH Bavantu dvijAH |
   asmākaṃ tu kadamba-kuñja-kuhara-pronmīlad-indīvara-	asmAkam tu kadamba--kuQja--kuhara--pronmIlat--indIvara-
   śreṇī-śyāmala-dhāma-nāma juṣatāṃ janmāstu lakṣāvadhi ||18||	SreNI-SyAmala--DAma--nAma juzatAm janmAH-tu lakza-avaDi ||18||
   śrī- īśvara-purī-pādānām ||	SrI ISvara--purI--pAdAnAm ||
   kalyāṇānāṃ nidhānaṃ kali-mala-mathanaṃ pāvanaṃ pāvanānāṃ	kalyANAnAm niDAnam kali-mala-maTanam pAvanam pAvanAnAm
   pātheyaṃ yan mumukṣoḥ sapadi parapadaprāptaye procyamānam |	pATeyam yat mumukzoH sapadi para-pada-prAptaye procyamAnam |
   viśrāma-sthānam ekaṃ kavi-vara-vacasāṃ jīvanaṃ sajjanānāṃ	viSrAma--sTAnam ekam kavi-vara--vacasAm jIvanam sat-janAnAm
   bījaṃ dharma-drumasya prabhavatu bhavatāṃ bhūtaye kṛṣṇa-nāma ||19||	bIjam Darma-drumasya praBavatu BavatAm BUtaye kRzNa--nAmaH ||19||
   kasyacit ||	kasyacid ||
   vepante duritāni moha-mahimā sammoham ālambate	vepante duritAni moha--mahimA sammoham Alambate
   sātaṅkaṃ nakha-rajanīṃ kalayati śrī-citraguptaḥ kṛtī |	sa-AtaFkam naKa--rajanIm kalayati SrI--citraguptaH kRtI |
   sānandaṃ madhuparka-sambhṛti-vidhau vedhāḥ karoty udyamaṃ	sa-Anandam maDu-parka--samBRti-viDO veDAH karoti udyamam
   vaktuṃ nāmni taveśvarābhilaṣite brūmaḥ kim anyat param ||20||	vaktum nAmni tava-ISvara-aBilazite brUmaH kim anyat param ||20||
   kasyacit ||	kasyacid ||
   kaḥ pareta-nagarī-purandaraḥ	kaH pareta-nagarI--purandaraH
   ko bhaved atha tadīya-kiṅkaraḥ |	kaH Bavet aTa tadIya--kiFkaraH |
   kṛṣṇa-nāma jagad-eka-maṅgalaṃ	kRzNa--nAma jagat--eka--maFgalam
   kaṇṭha-pīṭham urarīkaroti cet ||21||	kaNWa--pIWam urarIkaroti ced ||21||
   śrī- ānandācāryasya |	SrI Ananda-AcAryasya |
   ceto-darpaṇa-mārjanaṃ bhava-mahā-dāvāgni-nirvāpaṇaṃ	cetaH--darpaNa--mArjanam Bava--mahA-dAva-agni--nirvApaNam
   śreyaḥ-kairava-candrikā-vitaraṇaṃ vidyā-vadhū-jīvanam |	SreyaH-kEH-ava--candrikA-vitaraNam vidyA-vaDU--jIvanam |
   ānandāmbudhi-vardhanaṃ prati-padaṃ pūrṇāmṛtāsvādanaṃ	Ananda-ambuDi-varDanam prati-padam pUrNa-amRta-AsvAdanam
   sarvātma-snapanaṃ paraṃ vijayate śrī-kṛṣṇa-saṅkīrtanam ||22||	sarvAtma--snapanam param vijayate SrI--kRzNa--saFkIrtanam ||22||
   śrī-śrī-bhagavataḥ || (CC 3.20.12)	SrI--SrI--BagavataH || (SC 3.20.12)
   brahmāṇḍānāṃ koṭi-saṅkhyādhikānām	brahmANxAnAm kowi--saFKyA-aDikAnAm
   aiśvaryaṃ yac cetanā vā yad aṃśaḥ |	ESvaryam yat cetanA vA yat aMSaH |
   āvirbhūtaṃ tan-mahaḥ kṛṣṇa-nāma	AvirBUtam tan-m-ahar kRzNa-nAma
   tan me sādhyaṃ sādhanaṃ jīvanaṃ ca ||23||	tat me sADyam sADanam jIvanam ca ||23||
   keṣāṃcit ||	kezAMcid ||
   viṣṇor nāmaiva puṃsāḥ śamalam apaharat puṇyam utpādayac ca	vizNoH nAma-eva puMsAH Samalam apaharat puNyam utpAdayat ca
   brahmādi-sthāna-bhogād viratim atha guroḥ śrī-pada-dvandva-bhaktim |	brahma-Adi-sTAna--BogAt viratim aTa guroH SrI--pada--dvandva--Baktim |
   Tattva-jñānaṃ ca viṣṇor iha mṛti-janana-bhrānti-bījaṃ ca dagdhvā	Tattva--jQAnam ca vizNoH iha mRti-jana-na--BrAnti--bIjam ca dagDvA
   saṃpūrṇānanda-bodhe mahati ca puruṣaṃ sthāpayitvā nivṛttam ||24||	saMpUrNa-Ananda-boDe mahati ca puruzam sTApayitvA nivRttam ||24||
   śrī-bhagavad-vyāsa-pādānām ||	SrI--Bagavat--vyAsa--pAdAnAm ||
   nāma cintāmaṇiḥ kṛṣṇaś	nAma cintAmaNiH kRzNaH-
   caitanya-rasa-vigrahaḥ |	cEtanya-rasa-vigrahaH |
   pūrṇaḥ śuddho nitya-mukto	pUrNaH SudDaH nitya-muktaH-
   'bhinnatvān nāma-nāminoḥ || 25 ||	aBinna-tvAt nAma-nAminoH || 25 ||
   teṣām eva || (Padmapurāṇa, CC 2.17.133, HBV 11.503)	tezAm eva || (Pat-ma-purANa, CS 2.17.133, HBV 11.503)
   madhura-madhuram etan maṅgalaṃ maṅgalānāṃ	maDura--maDuram etat maFgalam maFgalAnAm
   sakala-nigama-vallī-sat-phalaṃ cit-svarūpam |	sakala-nigama-vallI--sat--Palam cit--svarUpam |
   sakṛdapi parigītaṃ śraddhayā helayā vā	sakRt-api parigItam SradDayA helayA vA
   bhṛgu-vara nara-mātraṃ tārayet kṛṣṇa-nāma ||26 ||	BRgu-vara nara--mAtram tArayet kRzNa--nAma ||26 ||
   teṣām eva || (HBV 11.451; Skāndapurāṇa, Prabhāsa-khaṇḍe)	tezAm eva || (HBV 11.451; SkAndapurANa, PraBAsa---KaNxe)
   svargārthīyā vyavasitir asau dīnayaty eva lokān	svarga-arTIyAH vyavasitiH asO dInayati eva lokAn
   mokṣāpekṣā janayati janaṃ kevalaṃ kleśabhājam |	mokza-apekzA janayati janam kevalam kleSa-BAjam |
   yogābhyāsaḥ parama-virasas tādṛśaiḥ kiṃ prayāsaiḥ	yoga-aByAsaH parama--virasaH tAdRSEH kim prayAsEH
   sarvaṃ tyaktvā mama tu rasanā kṛṣṇa kṛṣṇeti rautu ||27||	sarvam tyaktvA mama tu rasanA kRzNa kRzNa-iti rOtu ||27||
   kasyacit ||	kasyacid ||
   sadā sarvatrāste nanu vimalam ādyaṃ tava padaṃ	sadA sarvatra-Aste nanu vimalam Adyam tava padam
   tathāpy ekaṃ stokaṃ na hi bhava-taroḥ patram abhinat |	taTA-api ekam stokam na hi Bava-taroH patram aBinat |
   kṣaṇaṃ jihvāgra-sthaṃ tava tu bhagavan-nāma nikhilaṃ	kzaNam jihvA-agra--sTam tava tu Bagavan-nAma niKilam
   sa-mūlaṃ sambhāraṃ kaṣati katarat sevyam anayoḥ ||28||	sa-mUlam samBAram kazati katarat sevyam anayoH ||28||
   śrī-śrī-dharasvāmipādānām ||	SrI--SrI-Dara-svAmi-pAdAnAm ||
   ākṛṣṭiḥ kṛta-cetasāṃ sumanasām uccāṃanaṃ cāṃhasām	AkRzwiH kRta-cetasAm sumanasAm uccAManam ca-aMhasAm
   ācaṇḍālam amūka-loka-sulabho vaśyaś ca mukti-śriyaḥ |	AcaNxAlam amUka-loka--sulaBaH vaSyaH ca mukti--SriyaH |
   no dīkṣāṃ na ca sat-kriyāṃ na ca puraścaryāṃ manāg īkṣate	naH dIkzAm na ca sat-kriyAm na ca puraScaryAm manAk Ikzate
   mantro 'yaṃ rasanā-spṛg eva phalati śrī-kṛṣṇa-nāmātmakaḥ ||29||	mantraH ayam rasanA--spRS eva Palati SrI-kRzNa-nAma-AtmakaH ||29||
   śrī-lakṣmīdharāṇām || (Bhagavan-nāma-kaumudī 133; CC Madhya 15.110)	SrI--lakzmIDarANAm || (Bha-gavan--nAma-kOmudI 133; CS MaDyaH 15.110)
   viceyāni vicāryāṇi	viceyAni vicAryANi
   vicintyāni punaḥ punaḥ |	vicintyAni punar punar |
   kṛpaṇasya dhanānīva	kRpaNasya DanAni-iva
   tvan-nāmāni bhavantu naḥ ||30||	tvan-nAmAni Bavantu naH ||30||
   śrī-bhavānandasya ||	SrI--Bava-Anandasya ||
   nāmnām akāri bahudhā nija-sarva-śaktis	nAmnAm akAri bahuDA nija--sarva--Sakti-s
   tatrārpitā niyamitaḥ smaraṇe na kālaḥ |	tatra-arpitA niyamitaH smaraNe na kAlaH |
   etādṛśī tava kṛpā bhagavan mamāpi	etAdRSI tava kRpA Bagavat mama-api
   durdaivam īdṛśam ihājani nānurāgaḥ ||31||	durdEvam IdRSam iha-ajani na-anurAgaH ||31||
   śrī-bhagavataḥ | (CC 3.20.16)	SrI--BagavataH | (SC 3.20.16)
   atha nāmakīrtanam |	aTa nAma-kIrtanam |
   tṛṇād api sunīcena	tRNAt api sunIcena
   taror iva sahiṣṇunā |	taroH iva sahizNunA |
   amāninā mānadena	amAninA mAnadena
   kīrtanīyaḥ sadā hariḥ ||32|| tasyaiva || (CC 3.20.21)	kIrtanIyaH sadA hariH ||32|| tasya-eva || (SC 3.20.21)
   śrī-rāmeti janārdaneti jagatāṃ nātheti nārāyaṇe-	SrI-rAma-iti janArdanA-iti jagatAm nATa-iti nArAyaNe-
   tyānandeti dayāpareti kamalākānteti kṛṣṇeti ca |	tyAnandA-iti dayA-parA-iti kamalA-kAntA-iti kRzNa-iti ca |
   śrī-man-nāma-mahāmṛtābdhi-laharī-kallolamagnaṃ muhu-	SrI-man-nAma--mahA-amRta-abDi-laharI--kallola-magnam muhur-
   rmuhyantaṃ galad-aśru-netramavaśaṃ māṃ nātha nityaṃ kuru ||33||	rmuhyantam galat--aSru-netram-avaSam mAm nATa nityam kuru ||33||
   śrī-lakṣmīdharāṇām || (DCP 2)	SrI--lakzmI-DarANAm || (DSP 2)
   śrī-kānta kṛṣṇa karuṇāmaya kañjanābha	SrI--kAnta kRzNa karuNA-maya kaQjana-ABa
   kaivalyavallabha mukunda murāntaketi |	kEvalya-vallaBa mukunda murA-antaka-iti |
   nāmāvalīṃ vimalamauktikahāralakṣmī-	nAma-AvalIm vimala-mOktika-hAra-lakzmI-
   lāvaṇya-vañcanakarīṃ karavāṇi kaṇṭhe ||34||	lAvaNya--vaQcana-karIm karavANi kaNWe ||34||
   teṣāmeva || (DCP 3)	tezAm-eva || (DSP 3)
   kṛṣṇa rāma mukunda vāmana vāsudeva jagadguro	kRzNa rAma mukunda vAmana vAsudeva jagadguro
   matsya kacchapa nārasiṃha varāha rāghava pāhi mām |	matsya kacCapa nArasiMha varAha rAGava pAhi mAm |
   devadānavanāradādimunīndravandya dayānidhe	deva-dAnava-nArada-Adi-muni-indravandya dayAniDe
   devakīsuta dehi me tava pādabhaktimacañcalām ||35||	devakIsuta dehi me tava pAda-Baktim-acaQcalAm ||35||
   kasyacit || (DCP 4)	kasyacid || (DSP 4)
   he gopālaka he kṛpā-jala-nidhe he sindhu-kanyā-pate	he gopAlaka he kRpA--jala-niDe he sinDu--kanyA--pate
   he kaṃsāntaka he gajendra-karuṇā-pārīṇa he mādhava |	he kaMsAntaka he gaja-indra--karuNA--pArINa he mADava |
   he rāmānuja he jagat-traya-guro he puṇḍarīkākṣa māṃ	he rAma-anuja he jagat--traya--guro he puNxarIkAkza mAm
   he gopījana-nātha pālaya paraṃ jānāmi na tvāṃ vinā ||36||	he gopI-jana-nATa pAlaya param jAnAmi na tvAm vinA ||36||
   śrī-vaiṣṇavasya || (KK 2.108, DCP 5)	SrI-vEzNavasya || (KK 2.108, DCP 5)
   śrī-nārāyaṇa puṇḍarīka-nayana śrī-rāma sītā-pate	SrI-nArAyaNa puNxarIka-nayana SrI-rAma sItA-pate
   govindācyuta nanda-nandana mukundānanda dāmodara |	govinda-acyuta nanda-nandana mukunda-Ananda dAmodara |
   viṣṇo rāghava vāsudeva nṛ-hare devendra-cūḍāmaṇe	vizNo rAGava vAsudeva nR-hare deva-indra-cUxAmaNe
   saṃsārārṇava-karṇa-dhāraka hare śrī-kṛṣṇa tubhyaṃ namaḥ ||37||	saMsAra-arNava-karNa--DAraka hare SrI--kRzNa tuByam namaH ||37||
   tasyaiva ||	tasya-eva ||
   bhāṇḍīreśa śikhaṇḍa-maṇḍana vara śrī-khaṇḍa-liptāṅga he	BANxIra-ISa SiKaNxa-maNxana vara SrI-KaNxa--lipta-aFga he
   vṛndārarṇya-purandara sphurad-amandendīvara-śyāmala |	vRndAra-RNya-purandara sPurat--amanda-indIvara-SyAmala |
   kālindī-priya nanda-nandana parānandāravindekṣaṇa	kAlindI--priya nanda-nandana para-Ananda-aravinda-IkzaNa
   śrī-govinda mukunda sundara-tano māṃ dīnam ānandaya ||38||	SrI---govinda mukunda sundara-tanaH mAm dInam Anandaya ||38||
   śrī-gopāla-bhaṭṭānām ||	SrI--gopAla--BawwAnAm ||
   śrī-kṛṣṇakathāmāhātmyam |	SrI--kRzNa-kaTA-mAhAtmyam |
   śrutam apy aupaniṣadaṃ	Srutam api Opanizadam
   dūre hari-kathāmṛtāt |	dUre hari--kaTA-amRtAt |
   yan na santi dravac-citta-	yat na santi drava-c-citta-
   kampāśru-pulakādayaḥ ||39||	kampa-aSru--pulaka-AdayaH ||39||
   śrī-bhagavadvyāsapādānām || [Bhakti-sandarbha 69]	SrI--Bagavat-vyAsa-pAdAnAm || [Bhakti--sandarBaH 69]
   naiva divya-sukha-bhogam arthaye	na-eva divya--suKa--Bogam arTaye
   nāpavargam api nātha kāmaye |	na-apavargam api nATa kAmaye |
   yāntu karṇa-vivara dine dine	yAntu karNa-vivara dine dine
   kṛṣṇa-keli-caritāmṛtāni me ||40||	kRzNa--keli--carita-amRtAni me ||40||
   śrī-kaviratnasya ||	SrI-ka-vi-ratnasya ||
   aho ahobhir na kaler vidūyate	aho ahoBiH na kaleH vidUyate
   sudhā-sudhārām adhuraṃ pade pade |	suDA-su-DArAm aDuram pade pade |
   dine dine candana-candra-śītalaṃ	dine dine candana-candra-SItalam
   yaśo yaśodā-tanayasya gīyate ||41||	yaSaH yaSodA-tanayasya gIyate ||41||
   tasyaiva ||	tasya-eva ||
   nanda-nandana-kaiśora-	nanda-nandana--kESora-
   līlāmṛta-mahāmbudhau |	lIlA-amRta--mahA-ambuDO |
   nimagnānāṃ kim asmākaṃ	nimagnAnAm kim asmAkam
   nirvāṇa-lavaṇāmbhasā ||42||	nirvANa--lavaNa-amBasA ||42||
   śrī-yādavendrapurīpādānām ||	SrI--yAdava-indra-purI-pAdAnAm ||
   tvat-kathāmṛta-pāthodhau	tvat--kaTA-amRta-pATa-UDO
   viharanto mahā-mudaḥ |	viharantaH mahA-mudaH |
   kurvanti kṛtinaḥ kecic	kurvanti kRtinaH kecid-
   catur-vargaṃ tṛṇopamam ||43||	catur-vargam tRNa-upamam ||43||
   śrī-śrī-dharasvāmipādānām ||	SrI--SrI-Dara-svAmi-pAdAnAm ||
   tatraiva gaṅgā yamunā ca tatra	tatra-eva gaFgA yamunA ca tatra
   tatra godāvarī tatra sarasvatī ca |	tatra godAvarI tatra sarasvatI ca |
   sarvāṇi tīrthāni vasanti tatra	sarvANi tIrTAni vasanti tatra
   yatrācyutodāra-kathā-prasaṅgaḥ ||44||	yatra-acyuta-udAra--kaTA--prasaFgaH ||44||
   kasyacit ||	kasyacid ||
   yā bhukti-lakṣmīr bhuvi kāmukānāṃ	yA Bukti-lakzmIH Buvi kAmukAnAm
   yā mukti-lakṣmīr hṛdi yogabhājām |	yA mukti-lakzmIH hRdi yoga-BAjAm |
   yānanda-lakṣmī rasikendra-mauleḥ	yAnanda-lakzmI rasika-indra-mOleH
   sā kāpi līlāvatu mādhavasya ||45||	sA kA-api lIlAvatu mADavasya ||45||
   śrī-śaṅkarasya ||	SrI--SaFkarasya ||
   atha śrī-kṛṣṇadhyānam |	aTa SrI--kRzNa-DyAnam |
   phullendīvara-kāntim indu-vadanaṃ barhāvataṃsa-priyaṃ	Pulla-indIvara--kAntim indu-vadanam barha-avataMsa--priyam
   śrī-vatsāṅkam udāra-kaustubha-dharaṃ pītāmbaraṃ sundaram |	SrI-vatsa-aFkam udAra--kOstuBa--Daram pIta-ambaram sundaram |
   gopīnāṃ nayanotpalārcita-tanuṃ go-gopa-saṅghāvṛtaṃ	gopInAm nayana-utpala-arcita--tanum go-gopa--saFGa-AvRtam
   govindaṃ kala-veṇu-vādana-paraṃ divyāṅga-bhūṣaṃ bhaje ||46 ||	govindam kala-veNu-vAdana--param divya-aFga-BUzam Baje ||46 ||
   śrī-śāradākārasya || [KK 3.82; KṛṣṇaS 106 (p49fn) attributed to	SrI--SArada-AkArasya || [KK 3.82; KRzNaH 106 (p49fn) attri-butet taH-
   Mṛtyu-sañjaya-tantra; ibid. HBV 3.114 (sāradā-tilake ca). In RKAD to	MRtyu--saQjaya-tantra; ibid. HBV 3.114 (sAradA--tilake ca). In RKAj taH-
   Svāyambhuvāgama.]	SvAyamBuvAgama.]
   aṃsālambita-vāma-kuṇḍala-dharaṃ mandonnata-bhrū-lataṃ	aMsa-Alambita--vAma--kuNxala-Daram manda-unnata--BrU--latam
   kiñcit-kuñcita-komalādhara-puṭaṃ sāci-prasārekṣaṇam |	kiQcit--kuQcita--komala-aDara--puwam sAci--prasAra-IkzaNam |
   ālolāṅguli-pallavair muralikām āpūrayantaṃ mudā	Alola-aFguli--pallavEH muralikAm ApUrayantam mudA
   mule kalpa-taros tribhaṅga-lalitaṃ dhyāyej jagan-mohanam ||47||	mule kalpa--taroH tri-BaFga-lalitam DyAyet jagan--mohanam ||47||
   kasyacit || (KK 2.102)	kasyacid || (KK 2.102)
   adhare vinihita-vaṃśaṃ	aDare vinihita--vaMSam
   campaka-kusumena kalpitottaṃsam |	campaka-kusumena kalpita-uttaMsam |
   vinataṃ dadhānam aṃsaṃ	vinatam daDAnam aMsam
   vāmaṃ satataṃ namāmi jitakaṃsam ||48||	vAmam satatam namAmi jita-kaMsam ||48||
   śrī-puruṣottama-devasya |	SrI--puruzottama-devasya |
   vyatyasta-pāda-kamalaṃ lalita-tribhaṅgī-	vyatyasta-pAda--kamalam lalita-tri-BaFgI-
   saubhāgyam aṃsa-viralīkṛta-keśa-pāśam |	sOBAgyam aMsa-viralIkRta--keSa--pASam |
   piñchāvataṃsam urarīkṛta-vaṃśa-nālam	piQCAvataMsam urarIkRta--vaMSa--nAlam
   avyāja-mohanam upaimi kṛpā-viśeṣam ||49||	avyAja--mohanam upEmi kRpA--viSezam ||49||
   śrī-nāradasya |	SrI-nAradasya |
   atha bhakta-vātsalyam |	aTa Bakta--vAtsalyam |
   atandrita-camū-pati-prahita-hastam asvīkṛta-	atandrita-camU-pati--prahita-hastam asvIkRta-
   praṇīta-maṇi-pādukaṃ kim iti vismṛtāntaḥ puram |	praNIta-maNi-pAdukam kim iti vismRta-antar puram |
   avāhana-pariṣkriyaṃ pataga-rājam ārohataḥ	avAhana--parizkriyam pataga-rAjam ArohataH
   kari-pravara-bṛṃhite bhagavatas tvarāyai namaḥ ||50||	kari--pravara--bRMhite BagavataH tvarAyE namaH ||50||
   śrī-dākṣiṇātyasya |	SrI--dAkziNAti-asya |
   śrī-draupadī-trāṇe tad-vākyam |	SrI-drOpadI-trANe tat--vAkyam |
   tamasi ravir ivodyan-majjatām aplavānāṃ	tamasi raviH iva-udyan--majjatAm aplavAnAm
   plava iva tṛṣitānāṃ svādu-vaṛsīva meghaḥ |	plavaH iva tRzitAnAm svAdu-vaRsi-iva meGaH |
   nidhir iva nidhanānāṃ tīvra-duḥkhāmayānāṃ	niDiH iva niDanAnAm tIvra--duHKa-AmayAnAm
   bhiṣag iva kuśalaṃ no dātum āyāti śauriḥ ||51||	Bizaj iva kuSalam naH dAtum AyAti SOriH ||51||
   śrī-vyāsa-pādānām |	SrI-vyAsa--pAdAnAm |
   atha tad-bhaktānāṃ māhātmyam |	aTa tad--BaktAnAm mAhAtmyam |
   prahlāda-nārada-parāśara-puṇḍarīka-	prahlAda--nArada--parASara--puNxarIka-
   vyāsāmbarīṣa-śuka-śaunaka-bhīṣma-dālbhyān |	vyAsa-ambarIza--Suka--SOnaka--BIzma--dAlByAn |
   rukmāṅgadoddhava-vibhīṣaṇa-phālgunādīn	rukma-aFgada-udDava--viBIzaNa--PAlguna-AdIn
   puṇyānimān paramabhāgavatān namāmi ||52||	puNyAn-imAn parama-BAgavatAt namAmi ||52||
   śrī-dākṣiṇātyasya ||	SrI--dAkziNAti-asya ||
   śrī-viṣṇoḥ śravaṇe parīkṣid abhavad vaiyāsakiḥ kīrtane	SrI--vizNoH SravaNe parIkzit aBavat vEyAsakiH kIrtane
   prahlādaḥ smaraṇe tad-aṅghri-bhajane lakṣmīḥ pṛthuḥ pūjane |	prahlAdaH smaraNe tad--aFGri--Bajane lakzmIH pRTuH pUjane |
   akrūras tv abhivandane kapi-patir dāsye 'tha sakhye 'rjunaḥ	akrUraH tu aBivandane kapi-patiH dAsye aTa saKye arjunaH
   sarvasvātma-nivedane balir abhūt kṛṣṇāptir eṣāṃ parā ||53||	sarva-sva-Atma--nivedane baliH aBUt kRzNa-AptiH ezAm parA ||53||
   kasyacit || (CC 2.22.136; BRS 1.2.365)	kasyacid || (SC 2.22.136; BRH 1.2.365)
   tebhyo namo'stu bhava-vāridhi-jīrṇa-paṅka-	teByaH namaH-astu Bava--vAriDi-jIrNa--paFka-
   saṃlagna-mokṣaṇa-vicakṣaṇa-pādukebhyaḥ |	saMlagna--mokzaNa--vicakzaNa--pAdukeByaH |
   kṛṣṇeti varṇa-yugala-śravaṇena yeṣām	kRzNa-iti varNa--yugala--SravaNena yezAm
   ānandathur bhavati nartita-roma-vṛndaḥ ||54||	AnandaTuH Bavati nartita-roma-vRndaH ||54||
   autkalasya ||	Otkalasya ||
   hari-smṛtyāhlāda-stimita-manaso yasya kṛtinaḥ	hari--smRti-AhlAda-stimita--manasaH yasya kRtinaH
   sa-romāñcaḥ kāyo nayanam api sānanda-salilam |	sa-romAQcaH kAyaH nayanam api sa-Ananda--salilam |
   tam evācandrārkaṃ vaha puruṣa-dhaureyam avane	tam eva-acandrArkam vaha puruza--DOreyam avane
   kim anyais tair bhārair yama-sadana-gatyāgati-paraiḥ ||55||	kim anyEH tEH BArEH yama--sadana--gatyA-gati--parEH ||55||
   śrī-sarvānandasya |	SrI--sarva-Anandasya |
   tvad-bhaktaḥ saritāṃ patiṃ culukavat khadyotavad bhāskaraṃ	tvad--BaktaH saritAm patim culuka-vat Kadyota-vat BAskaram
   meruṃ paśyati loṣṭravat kim aparaṃ bhūmeḥ patiṃ bhṛtyavat |	merum paSyati lozwra-vat kim aparam BUmeH patim BRtya-vat |
   cintāratna-cayaṃ śilā-śakalavat kalpa-drumaṃ kāṣṭhavat	cintA-ratna-cayam SilA-Sakala-vat kalpa--drumam kAzWa-vat-
   saṃsāraṃ tṛṇa-rāśivat kim aparaṃ dehaṃ nijaṃ bhāravat ||56||	saMsAram tRNa-rASi-vat kim aparam deham nijam BAra-vat ||56||
   śrī-sarvajñasya |	SrI--sarvajQasya |
   mīmāṃsā-rajasā malīmasa-dṛśāṃ tāvan na dhīr īśvare	mImAMsA--rajasA malImasa-dRSAm tAvat na DIH ISvare
   garvodarka-kutarka-karkaśa-dhiyāṃ dūre'pi vārtā hareḥ |	garva-udarka--kutarka--karkaSa--DiyAm dUre-api vArtA hareH |
   jānanto'pi na jānate śruti-sukhaṃ śrī-raṅgi-saṅgād ṛte	jAnantaH-api na jAnate Sruti-suKam SrI-raFgi-saFgAt Rte
   susvāduṃ pariveṣayanty api rasaṃ gurvī na darvī spṛśet ||57||	susvAdum parivezayanti api rasam gurvI na darvI spRSet ||57||
   śrī-mādhava-sarasvatī-pādānām |	SrI--mADava--sarasvatI--pAdAnAm |
   jñānāvalambakāḥ kecit	jQAna-avalambakAH kecid-
   kecit karmāvalambakāḥ |	kecid karma-avalambakAH |
   vayaṃ tu hari-dāsānāṃ	vayam tu hari-dAsAnAm
   pāda-trāṇāvalambakāḥ ||58||	pAda-trANa-avalambakAH ||58||
   kasyacit |	kasyacid |
   atha bhaktānāṃ dainyoktiḥ	aTa BaktAnAm dEnyoktiH
   nāmāni praṇayena te sukṛtināṃ tanvanti tuṇḍotsavaṃ	nAmAni praNayena te sukRtinAm tanvanti tuNxa-utsavam
   dhāmāni prathayanti hanta jaladaśyāmāni netrāñjanam |	DAmAni praTayanti hanta jalada-SyAmAni netrAQjanam |
   sāmāni śrutiśuṣkalīṃ muralikājātānyalaṃkurvate	sAmAni Sruti-SuzkalIm muralikA-jAtAni-alaMkurvate
   kāmānirvṛtacetasām api vibho nāśāpi naḥ śobhate ||59||	kAma-anirvRta-cetasAm api viBo nASA-api naH SoBate ||59||
   samāhartuḥ ||	samAhartuH ||
   saṃsārāmbhasi sambhṛta-bhrama-bhare gambhīra-tāpa-traya-	saMsAra-amBasi samBRta--Brama--Bare gamBIra-tApa-traya-
   grāheṇābhigṛhītam ugragatinā krośantam antar-bhayāt |	grAheNa-aBigRhItam ugra-gatinA kroSantam antar--BayAt |
   dīpreṇādya sudarśanena vibudha-klānti-cchidākāriṇā	dIpreNa-adya sudarSanena vibuDa--klAnti-=-CidAkAriNA
   cintā-santati-ruddham uddhara hare mac-citta-dantīśvaram ||60||	cintA--santati--rudDam udDara hare mac-citta-danti-ISvaram ||60||
   samāhartuḥ ||	samAhartuH ||
   vivṛta-vividha-bādhe bhrānti-vegād agādhe	vivRta-viviDa---bADe BrAnti--vegAt agADe
   balavati bhava-pūre majjato me vidūre |	balavati Bava--pUre majjataH me vidUre |
   aśaraṇa-gaṇa-bandho hā kṛpā-kaumudīndo	aSaraNa--gaNa-banDaH hA kRpA--kOmudi-indaH-
   sakṛd akṛta-vilambaṃ dehi hastāvalambam ||61||	sakRt akRta-vilambam dehi hasta-avalambam ||61||
   samāhartuḥ |	samAhartuH |
   nṛtyan vāyu-vighūrṇitaiḥ sva-viṭapair gāyann alīnāṃ rutair	nRtyan vAyu--viGUrNitEH sva--viwapEH gAyan alInAm rutEH-
   muñcann aśru maranda-bindubhir alaṃ romāñcavān aṅkuraiḥ |	muQcan aSru maranda--binduBiH alam romAQcavAn aFkurEH |
   mākando'pi mukunda mūrcchati tava smṛtyā tu vṛndāvane	mAkandaH-api mukunda mUrcCati tava smRtyA tu vRndAvane
   brūhi prāṇasamāna cetasi kathaṃ nāmāpi nāyāti te ||62||	brUhi prANa-samAna cetasi kaTam nAma-api na-AyAti te ||62||
   śrī- īśvarapurīpādānām |	SrI ISvara-purI-pAdAnAm |
   yā draupadī-paritrāṇe	yA drOpadI--paritrANe
   yā gajendrasya mokṣaṇe |	yAH gaja-indrasya mokzaNe |
   mayy ārte karuṇāmūrte	mayi Arte karuNA-mUrte
   sā tvarā kva gatā hare ||63||	sA tvarA kva gatAH hare ||63||
   śrī- autkalasya	SrI Otkalasya
   dīna-bandhur iti nāma te smaran	dIna-banDuH iti nAma te smaran
   yādavendra patito'ham utsahe |	yAdava-indra patitaH-aham utsahe |
   bhakta-vatsalatayā tvayi śrute	Bakta--vatsala-tayA tvayi Srute
   māmakaṃ hṛdayam āśu kampate ||64||	mAmakam hRdayam ASu kampate ||64||
   śrī-jagannāthasenasya |	SrI--jagannATasenasya |
   stāvakās tava caturmukhādayo	stAvakAH tava caturmuKAt-ayaH-
   bhāvakās tu bhagavan bhavādayaḥ |	BAvakAH tu Bagavan Bava-AdayaH |
   sevakāḥ śatamukhādayaḥ surā	sevakAH Sata-muKa-AdayaH surA
   vāsudeva yadi ke tadā vayam ||65||	vAsudeva yadi ke tadA vayam ||65||
   śrī-dhanañjayasya |	SrI-DanaQjayasya |
   parama-kāruṇiko na bhavat-paraḥ	parama-kAruNikaH na Bavat--paraH
   parama-śocyatamo na ca mat-paraḥ |	parama-SocyatamaH na ca mat--paraH |
   iti vicintya hareḥ mayi pāmare	iti vicintya hareH mayi pAmare
   yad ucitaṃ yadunātha tad ācara ||66||	yat ucitam yadunATa tat Acara ||66||
   kasyacit |	kasyacid |
   bhavodbhava-kleśa-kaśā-śatāhataḥ	BavodBava--kleSa--kaSA--Sata-AhataH
   paribhramann indriya-kāpathāntare |	pariBraman indriya-kA-paTa-antare |
   niyamyatāṃ mādhava me mano-hayas	niyamyatAm mADava me mano--haya-s
   tvad-aṅghri-śaṅkau dṛḍha-bhakti-bandhane ||67||	tvad--aFGri--SaFkO dRXa--Bakti--banDane ||67||
   kasyacit |	kasyacid |
   na dhyāto'si na kīrtito'si na manāg ārādhito'si prabho	na DyAtaH-asi na kIrtitaH-asi na manAk ArADitaH-asi praBo
   no janmāntara-gocare tava padāmbhoje ca bhaktiḥ kṛtā |	naH janma-antara--gocare tava padA-amBoje ca BaktiH kRtA |
   tenāhaṃ bahu-duḥkha-bhājanatayā prāpto daśām īdṛśīṃ	tena-aham bahu--duHKa--BAjana-tayA prAptaH daSAm IdRSIm
   tvaṃ kāruṇya-nidhe vidhehi karuṇāṃ śrī-kṛṣṇa dīne mayi ||68||	tvam kAruNya-niDe viDehi karuNAm SrI--kRzNa dIne mayi ||68||
   śrī-śaṅkarasya |	SrI--SaFkarasya |
   śaraṇam asi hare prabho murāre	SaraNam asi hare praBo murAre
   jaya madhusūdana vāsudeva viṣṇo	jaya maDusUdana vAsudeva vizNo
   niravadhi-kaluṣaugha-kāriṇaṃ māṃ	niravaDi-kaluza-oGa--kAriNam mAm
   gati-rahitaṃ jagadīśa rakṣa rakṣa ||69||	gati--rahitam jagadISa rakza rakzaH ||69||
   kasyacit ||	kasyacid ||
   dinādau murāre niśādau murāre	dina-AdO murAre niSA-AdO murAre
   dinārdhe murāre niśārdhe murāre |	dina-arDe murAre niSA-arDe murAre |
   dinānte murāre niśānte murāre	dina-ante murAre niSA-ante murAre
   tvam eko gatir nas tvam eko gatir naḥ ||70||	tvam ekaH gatiH naH tvam ekaH gatiH naH ||70||
   śrī-dākṣiṇātyasya ||	SrI--dAkziNAti-asya ||
   ayi nanda-tanuja kiṅkaraṃ	ayi nanda-tanuja kiFkaram
   patitaṃ māṃ viṣame bhavāmbudhau	patitam mAm vizame Bava-ambuDO
   kṛpayā tava pāda-paṅkaja-	kRpayA tava pAda-paFkaja-
   sthita-dhūlī-sadṛśaṃ vicintaya ||71||	sTita-DUlI--sadRSam vicintaya ||71||
   śrī-bhagavataḥ | (CC 3.20.32)	SrI--BagavataH | (SC 3.20.32)
   atha bhaktānāṃ niṣṭhā	aTa BaktAnAm nizWA
   na vayaṃ kavayo na tārkikā	na vayam kavayaH na tArkikA
   na ca vedāntanitāntapāragāḥ |	na ca vedAntanitAnta-pAragAH |
   na ca vādinivārakāḥ paraṃ	na ca vAdi-nivArakAH param
   kapaṭābhīrakiśorakiṅkarāḥ ||72||	kapawa-ABIra-ki-Sora-kiFkarAH ||72||
   śrī-sārvabhauma-bhaṭṭācāryāṇām ||	SrI--sArvaBOma-Bawwa-AcAryANAm ||
   parivadatu jano yathā tathā vā	parivadatu janaH yaTA taTA vA
   nanu mukharo na vayaṃ vicārayāmaḥ	nanu muKaraH na vayam vicArayAmaH
   hari-rasa-madirā madātimattā	hari-rasa--madirA mada-atimattA
   bhuvi viluṭhāma naṭāma nirviśāma ||73||	Buvi viluWAma nawAma nirviSAma ||73||
   teṣām eva || (BRS 2.2.15)	tezAm eva || (BRH 2.2.15)
   nāhaṃ vipro na ca narapatir nāpi vaiśyo na śūdro	na-aham vipraH na ca narapatiH na-api vESyaH na SUdraH-
   nāhaṃ varṇī na ca gṛhapatir no vanastho yatir vā |	na-aham varNI na ca gRhapatiH naH vana-sTaH yatiH vA |
   kintu prodyan-nikhila-paramānanda-pūrṇāmṛtābdher	kintu prodyan--niKila--parama-Ananda-pUrNa-amRta-abDeH-
   gopī-bhartuḥ pada-kamalayor dāsa-dāsānudāsaḥ ||74||	gopI-BartuH pada--kamalayoH dAsa-dAsAn-udAsaH ||74||
   śrī-bhagavataḥ | (CC 2.13.80)	SrI--BagavataH | (SC 2.13.80)
   dhanyānāṃ hṛdi bhāsatāṃ giri-vara-pratyagra-kuñjaukasāṃ	DanyAnAm hRdi BAsatAm giri-vara--pratyagra--kuQjOka-sAm
   satyānanda-rasaṃ vikāra-vibhava-vyāvṛttam antar-mahaḥ |	satya-Ananda--rasam vikAra--viBava--vyAvRttam antar-mahaH |
   asmākaṃ kila vallavī-rati-raso vṛndāṭavī-lālaso	asmAkam kila valla-vI-rati-rasaH vRndAwavI--lAlasaH-
   gopaḥ ko'pi mahendra-nīla-ruciraś citte muhuḥ krīḍatu ||75||	gopaH kaH-api mahA-indra--nIla--ruciraH citte muhur krIxatu ||75||
   śrī- īśvara-purīpādānām |	SrI ISvara--purI-pAdAnAm |
   rasaṃ praśaṃsantu kavitā-niṣṭhā	rasam praSaMsantu kavi-tA--nizWA
   brahmāmṛtaṃ veda-śiro-niviṣṭhāḥ |	brahma-amRtam veda--Siro--nivizWAH |
   vayaṃ tu guñjākalitāvataṃsaṃ	vayam tu guQjA-kalita-avataMsam
   gṛhīta-vaṃśaṃ kam api śrayāmaḥ ||76||	gRhIta--vaMSam kam api SrayAmaH ||76||
   śrī-yādavendra-purīpādānām ||	SrI--yAdava-indra--purI-pAdAnAm ||
   dhyānātītaṃ kim api paramaṃ ye tu jānanti tattvaṃ	DyAna-atItam kim api paramam ye tu jAnanti tattvam
   teṣām āstāṃ hṛdaya-kuhare śuddha-cinmātra ātmā |	tezAm AstAm hRdaya-kuhare SudDa--cit-mAtraH AtmA |
   asmākaṃ tu prakṛti-madhuraḥ smera-vaktrāravindo	asmAkam tu prakRti-maDuraH smera--vaktra-aravindaH-
   megha-śyāmaḥ kanaka-paridhiḥ paṅkajākṣo'yam ātmā ||77||	meGa-SyAmaH kanaka-pariDiH paFkaja-akzaH-ayam AtmA ||77||
   śrī-kavi-ratnasya || (BRS 3.2.28)	SrI-ka-vi-ratnasya || (BRH 3.2.28)
   jātu prārthayate na pārthiva-padaṃ nendre pade modate	jAtu prArTayate na pArTiva-padam na-indre pade modate
   sandhatte na ca yoga-siddhiṣu dhiyaṃ mokṣaṃ ca nākāṅkṣati |	sanDatte na ca yoga--sidDizu Diyam mokzam ca na-AkAFkzati |
   kālindī-vana-sīmani sthira-taḍin-megha-dūtau kevalaṃ	kAlindI-vana-sImani sTira--taxin--meGa-dUtO kevalam
   śuddhe brahmaṇi vallavī-bhuja-latā-baddhe mano dhāvati ||78||	SudDe brahmaNi valla-vI--Buja--latA--badDe manaH DAvati ||78||
   tasyaiva ||	tasya-eva ||
   sandhyā-vandana bhadram astu bhavato bhoḥ snāna tubhyaṃ namo	sanDyA--vandana Badram astu BavataH BoH snAna tuByam namaH-
   bho devāḥ pitaraś ca tarpaṇa-vidhau nāhaṃ kṣamaḥ kṣamyatām |	Bo devAH pitaraH ca tarpaNa-viDO na-aham kzamaH kzamyatAm |
   yatra kvāpi niṣadya yādava-kulottamasya kaṃsa-dviṣaḥ	yatra kvApi nizadya yAdava--kula-uttamasya kaMsa-dvizaH
   smāraṃ smāram aghaṃ harāmi tad alaṃ manye kim anyena me ||79||	smAram smAram aGam harAmi tat alam manye kim anyena me ||79||
   śrī-mādhavendra-purī-pādānām ||	SrI--mADava-indra--purI--pAdAnAm ||
   devakī-tanaya-sevakībhavan	devakI-tanaya--sevakI-Bavan
   yo bhavāni sa bhavāni kiṃ tataḥ |	yaH BavAni sa BavAni kim tatas |
   utpathe kvacana satpathe'pi vā	utpaTe kvacana sat-paTe-api vA
   mānasaṃ vrajatu daiva-deśitaṃ ||80||	mAnasam vrajatu dEva-deSitam ||80||
   kasyacit ||	kasyacid ||
   mugdhaṃ māṃ nigadantu nīti-nipuṇā bhrāntaṃ muhur vaidikāḥ	mugDam mAm nigadantu nIti--nipuNAH BrAntam muhur vEdikAH
   mandaṃ bāndhava-sañcayā jaḍa-dhiyaṃ muktādarāḥ sodarāḥ |	mandam bAnDava--saQcayAH jaxa-Diyam mukta-AdarAH sodarAH |
   unmattaṃ dhanino viveka-caturāḥ kāmaṃ mahā-dāmbhikaṃ	unmattam DaninaH viveka--caturAH kAmam mahA--dAmBikam
   moktuṃ na kṣamate manāg api mano govinda-pāda-spṛhām ||81||	moktum na kzamate manAk api manaH govinda--pAda--spRhAm ||81||
   śrī-mādhavasya ||	SrI--mADavasya ||
   śyāmam eva paraṃ rūpaṃ	SyAmam eva param rUpam
   purī madhu-purī varā |	purI maDu-purI varAH |
   vayaḥ kaiśorakaṃ dhyeyam	vayaH kESorakam Dyeyam
   ādya eva paro rasaḥ ||82||	AdyaH eva paraH rasaH ||82||
   raghupatyupādhyāyasya | (CC 2.19.106)	raGupati-upADyAyasya | (SC 2.19.106)
   purataḥ sphuratu vimuktiś	puratas sPuratu vimuktiH-
   ciram iha rājyaṃ karotu vairājyam |	ciram iha rAjyam karotu vErAjyam |
   paśupāla-bālaka-pateḥ	paSu-pAla--bAlaka-pateH
   sevām evābhivāñchāmi ||83||	sevAm eva-aBivAQCAmi ||83||
   śrī-surottamācāryasya ||	SrI--sura-uttama-AcAryasya ||
   kṣauṇī-patitvam athavaikam akiñcanatvaṃ	kzONI--pati-tvam aTavA-ekam akiQcana-tvam
   nityaṃ dadāsi bahu-mānam athāpamānam |	nityam dadAsi bahu-mAnam aTa-apamAnam |
   vaikuṇṭha-vāsam athavā narake nivāsaṃ	vEkuNWa--vAsam aTavA narake nivAsam
   hā vāsudeva mama nāsti gatis tvad-anyā ||84||	hA vAsudeva mama na-asti gatiH tvad--anyA ||84||
   śrī-garbhakavīndrasya ||	SrI--garBakavi-indrasya ||
   diśatu svārājyaṃ vā	diSatu svArAjyam vA
   vitaratu tāpa-trayaṃ vāpi |	vitaratu tApa--trayam vA-api |
   sukhitaṃ duḥkhitam api māṃ	suKitam duHKitam api mAm
   na vimuñcatu keśavaḥ || 85 ||	na vimuQcatu keSavaH || 85 ||
   śrī-kavirājamiśrasya ||	SrI-kavi-rAja-miSrasya ||
   atha bhaktānāṃ sotkaṇṭhāprārthanā |	aTa BaktAnAm sa-utkaNWA-prArTanA |
   nandanandana-padāravindayoḥ	nanda-nandana--pada-aravindayoH
   syandamāna-makaranda-bindavaḥ |	syandamAna--makaranda--bindavaH |
   sindhavaḥ parama-saukhya-sampadāṃ	sinDavaH parama--sOKya--sampadAm
   nandayantu hṛdayaṃ mamāniśam ||86||	nandayantu hRdayam mama-aniSam ||86||
   śrī-karācāryāṇām |	SrI-kara-AcAryANAm |
   iha vatsān samacārayad	iha vatsAn samacArayat-
   iha naḥ svāmī jagau vaṃśīm |	iha naH svAmI jagO vaMSIm |
   iti sāsraṃ gadato me	iti sa-asram gadataH me
   yamunātīre dinaṃ yāyāt ||87||	yamunA-tIre dinam yAyAt ||87||
   śrī-raghupatyupādhyāyasya |	SrI--raGupati-upADyAyasya |
   anuśīlana-kuñja-vāṭikāyāṃ	anuSIlana-kuQja--vAwikAyAm
   jaghanālambita-pīta-śāṭikāyām |	jaGana-Alambita--pIta--SAwikAyAm |
   muralī-kala-kūjite ratāyāṃ	muralI-kala--kUjite ratAyAm
   mama ceto'stu kadamba-devatāyām ||88||	mama cetaH-astu kadamba--devatAyAm ||88||
   śrī-govindasya |	SrI---govindasya |
   ārakta-dīrgha-nayano nayanābhirāmaḥ	Arakta--dIrGa-nayanaH nayana-aBirAmaH
   kandarpa-koṭi-lalitaṃ vapur ādadhānaḥ |	kandarpa--kowi--lalitam vapuH AdaDAnaH |
   bhūyāt sa me'dya hṛdayāmburuhādhivartī	BUyAt sa me-adya hRdaya-amburuhA-aDivartI
   vṛndāṭavī-nagara-nāgara-cakravartī ||89||	vRndAwa-vI--nagara-nAgara--cakravartI ||89||
   śrī-bhavānandasya |	SrI--Bava-Anandasya |
   lāvaṇyāmṛta-vanyā	lAvaNya-amRta--vanyA
   madhurima-laharī-parīpākaḥ |	maDurima-laharI--parIpAkaH |
   kāruṇyānāṃ hṛdayaṃ	kAruNyAnAm hRdayam
   kapaṭa-kiśoraḥ parisphuratu ||90||	kapawa-ki-SoraH parisPuratu ||90||
   śrī-sārvabhauma-bhaṭṭācāryāṇām |	SrI--sArvaBOma-Bawwa-AcAryANAm |
   bhavantu tatra janmāni	Bavantu tatra janmAni
   yatra te muralīkalaḥ |	yatra te muralI-kalaH |
   karṇapeyastvam āyāti	karNa-peyaH-tvam AyAti
   kiṃ me nirvāṇavārtayā ||91||	kim me nirvANa-vArtayA ||91||
   teṣam eva |	tezam eva |
   āsvādyaṃ pramadārada-cchadam iva śravyaṃ navaṃ jalpitaṃ	AsvAdyam pramadArada-cCadam iva Sravyam navam jalpitam
   bālāyā iva dṛśyam uttama-vadhū-lāvaṇya-lakṣmīr iva |	bAlAyAH iva dRSyam uttama-vaDU--lAvaNya--lakzmIH iva |
   prodghoṣyaṃ cira-viprayukta-vanitā-sandeśa-vāṇīva me	prodGozyam cira--viprayukta--vanitA-a-sandeSa-vANI-iva me
   naivedyaṃ caritaṃ ca rūpam aniśaṃ śrī-kṛṣṇa nāmāstu me ||92||	nEvedyam caritam ca rUpam aniSam SrI--kRzNa nAma-astu me ||92||
   keṣāṃcit |	kezAMcid |
   nayanaṃ galad-aśru-dhārayā	nayanam galat--aSru--DArayA
   vadanaṃ gadgada-ruddhayā girā |	vadanam gadgada-rudDayA girA |
   pulakair nicitaṃ vapuḥ kadā	pulakEH nicitam vapuH kadA
   tava nāma-grahaṇe bhaviṣyati ||93||	tava nAma--grahaNe Bavizyati ||93||
   śrī-bhagavataḥ | (CC 3.20.36)	SrI--BagavataH | (SC 3.20.36)
   na dhanaṃ na janaṃ na sundarīṃ	na Danam na janam na sundarIm
   kavitāṃ vā jagad-īśa kāmaye	kavi-tAm vA jagat--ISa kAmaye
   mama janmani janmanīśvare	mama janmani janmani-ISvare
   bhavatād bhaktir ahaitukī tvayi ||94||	BavatAt BaktiH ahEtukI tvayi ||94||
   tasyaiva | (CC 3.20.29)	tasya-eva | (SC 3.20.29)
   govardhana-prastha-navāmbuvāhaḥ	govarDana--prasTa-nava-ambuvAhaH
   kalinda-kanyā-nava-nīla-padmam |	kalinda--kanyA-nava--nIla--padmam |
   vṛndāvanodāra-tamāla-śākhī	vRndAvanodAra-tamAla-SAKI
   tāpa-trayasyābhinavaṃ karotu ||95||	tApa--trayasya-aBinavam karotu ||95||
   śrī-gauḍīyasya |	SrI--gOxIyasya |
   anaṅga-rasa-cāturī-capala-cāru-netrāñcalaś	anaFga--rasa--cAturI--capala--cAru--netrAQcalaH-
   calan-makara-kuṇḍala-sphurita-kānti-gaṇḍa-sthalaḥ |	calan--makara--kuNxala--sPurita--kAnti--gaNxa-sTalaH |
   vrajollasita-nāgarī-nikara-rāsa-lāsyotsukaḥ	vraja-ullasita-nAgarI--nikara--rAsa-lAsya-utsukaH
   sa me sapadi mānase sphuratu ko'pi gopālakaḥ ||96||	sa me sapadi mAnase sPuratu kaH-api gopAlakaH ||96||
   śrī-mādhavendra-purīpādānām |	SrI--mADava-indra--purI-pAdAnAm |
   atha bhaktānām utkaṇṭhā |	aTa BaktAnAm utkaNWA |
   śrutayaḥ palālakalpāḥ	SrutayaH palAla-kalpAH
   kim iha vayaṃ sāmprataṃ cinumaḥ |	kim iha vayam sAmpratam cinumaH |
   āhriyata puraiva nayanair	Ahriyata purA-eva nayanEH-
   ābhīrībhiḥ paraṃ brahma ||97||	ABIrIBiH param brahma ||97||
   śrī-raghupatyupādhyayasya ||	SrI--raGupati-upADyayasya ||
   kaṃ prati kathayitum īśe	kam prati kaTayitum ISe
   samprati ko vā pratītim āyātu	samprati kaH vA pratItim AyAtu
   go-pati-tanayā-kuñje	go-pati-tanayA--kuQje
   gopa-vadhṚṃī-viṃaṃ brahma ||98||	gopa--vaDṚMI-viMam brahma ||98||
   tasyaiva ||(CC 2.19.98)	tasya-eva ||(SS 2.19.98)
   jñātaṃ kāṇa-bhujaṃ mataṃ paricitaivānvīkṣikī śikṣitā	jQAtam kANa-Bujam matam paricitA-eva-AnvIkzikI SikzitA
   mīmāṃsā viditaiva sāṅkhya-saraṇir yoge vitīrṇā matiḥ |	mImAMsA viditA-eva sAFKya--saraNiH yoge vitIrNA matiH |
   vedāntāṃ pariśīlitāḥ sarabhasaṃ kiṃ tu sphuran-mādhurī-	vedAntAm pariSIlitAH sa-raBasam kim tu sPuran-mADurI-
   dhārā kācana nandasūnu-muralī mac-cittam ākarṣati ||99||	DArA kAcana nanda-sUnu--muralI mac--cittam Akarzati ||99||
   śrī-sārvabhauma-bhaṭṭācāryāṇām |	SrI--sArvaBOma-Bawwa-AcAryANAm |
   amarī-mukha-sīdhu-mādhurīṇāṃ	amarI--muKa--sIDu--mADurINAm
   laharī kācana cāturī kalānām |	laharI kAcana cAturI kalAnAm |
   taralīkurute mano madīyaṃ	taralIkurute manaH madIyam
   muralī-nāda-paramparā murāreḥ ||100||	muralI-nAda-paramparA murAreH ||100||
   teṣām eva |	tezAm eva |
   apaharati mano me ko'py ayaṃ kṛṣṇa-cauraḥ	apaharati manaH me kaH-api ayam kRzNa--cOraH
   praṇata-durita-coraḥ pūtanā-prāṇa-cauraḥ |	praNata-durita-coraH pUtanA--prANa--cOraH |
   valaya-vasana-cauro bāla-gopī-janānāṃ	valaya--vasana--cOraH bAla-gopI--janAnAm
   nayana-hṛdaya-cauraḥ paśyatām sajjanānām ||101||	nayana--hRdaya--cOraH paSyatAm sat-janAnAm ||101||
   kasyacit |	kasyacid |
   alaṃ tri-diva-vārtayā kim iti sārvabhauma-śriyā	alam tri-diva--vArtayA kim iti sArvaBOma--SriyA
   vidūratara-vartinī bhavatu mokṣa-lakṣmīr api |	vidUratara-vartinI Bavatu mokza--lakzmIH api |
   kalinda-giri-nandinī-taṭa-nikuñja-puñjodare	kalinda--giri-nandinI--tawa--nikuQja--puQja-udare
   mano harati kevalaṃ nava-tamāla-nīlaṃ mahaḥ ||102||	manaH harati kevalam nava-tamAla--nIlam mahaH ||102||
   śrī-hari-dāsasya |	SrI--hari-dAsasya |
   avalokitamanumoditam	avalokitam-anumoditam
   āliṅgitam aṅganābhir anurāgaiḥ |	AliFgitam aFganABiH anurAgEH |
   adhivṛndāvana-kuñjaṃ	aDivRndAvana--kuQjam
   marakata-puñjaṃ namasyāmaḥ ||103||	mara-kata-puQjam namasyAmaH ||103||
   śrī-sarva-vidyā-vinodānām |	SrI--sarva--vidyA-vinodAnAm |
   kadā drakṣyāmi nandasya	kadA drakzyAmi nandasya
   bālakaṃ nīpa-mālakam |	bAlakam nIpa-mAlakam |
   pālakaṃ sarva-sattvānāṃ	pAlakam sarva-sattvAnAm
   lasat-tilaka-bhālakam ||104||	lasat--tilaka-BAlakam ||104||
   śrī-mādhavendra-purī-pādānām |	SrI--mADava-indra--purI--pAdAnAm |
   kadā vṛndāraṇye mihira-duhituḥ saṅga-māhite	kadA vRnda-araNye mihira-duhituH saFga-mAhite
   muhur bhrāmaṃ bhrāmaṃ carita-laharīṃ gokula-pateḥ |	muhur BrAmam BrAmam carita--laharIm go-kula--pateH |
   lapann uccair uccair nayana-payasāṃ veṇibhir ahaṃ	lapan uccEs uccEs nayana--payasAm veNiBiH aham
   kariṣye sotkaṇṭhaṃ niviḍam upasekaṃ viṭapinām ||105||	karizye sa-utkaNWam nivixam upasekam viwapinAm ||105||
   samāhartuḥ |	samAhartuH |
   durārohe lakṣmīvati bhagavatīnām api padaṃ	durArohe lakzmIvati BagavatInAm api padam
   dadhānā dhammille naṭati kaṭhine yopaniṣadām |	daDAnA Dammille nawati kaWine yA-upanizadAm |
   rutir vaṃśī-janmā dhṛta-madhurimā sā madhuripor	rutiH vaMSI-janmA DRta-maDuH-imA sA maDuripa-UH-
   akasmād asmākaṃ śruti-śikharam ārokṣyati ||106||	akasmAt asmAkam Sruti-SiKaram Arokzyati ||106||
   samāhartuḥ |	samAhartuH |
   atrāsīt kila nanda-sadma śakaṭasyātrābhavad bhañjanaṃ	atra-AsIt kila nanda--sadma Sakawa-sya-atra-aBavat BaQjanam
   bandha-cchedakaro'pi dāmabhir abhūd baddho'tra dāmodaraḥ |	banDa-=-Ceda-karaH-api dAmaBiH aBUt badDaH-atra dAmodaraH |
   itthaṃ mathurā-vṛddha-vaktra-vigalat-pīyūṣa-dhārāṃ piban	itTam maTurA--vRdDa--vaktra--vigala-t-pI-yUza--DArAm piban
   ānandāśrudharaḥ kadā madhupurīṃ dhanyaś cariṣyāmy aham ||	Ananda-aSru-DaraH kadA maDupurIm DanyaH carizyAmi aham ||
   (Quoted in BRS 1.3.40 - yathā padyāvalyām, but not found in this edition)	(Quotet id BRH 1.3.40  yaTA padyAvalyAm, but not fount id TiH editiA-Un)
   utphullatā-piñcha-manorama-śrī-r	utPulla-tA-piQCa--manorama--SrI-r
   mātuḥ stana-nyasta-mukhāravindaḥ |	mAtuH stana-nyasta-muKa-aravindaH |
   sañcālayan pāda-saroruhāgraṃ	saQcAlayan pAda--saroruha-agram
   kṛṣṇaḥ kadā yāsyati dṛk-pathaṃ me ||107||	kRzNaH kadA yAsyati dRk-paTam me ||107||
   kasyacit |	kasyacid |
   atha mokṣānādaraḥ |	aTa mokza-an-AdaraH |
   bhaktiḥ sevā bhagavato	BaktiH sevA BagavataH-
   muktis tat-pada-laṅghanam |	muktiH tat-pada--laFGanam |
   ko mūḍho dāsatāṃ prāpya	kaH mUXaH dAsa-tAm prApya
   prābhavaṃ padamicchati ||110||	prABavam padam-icCati ||110||
   śrī-śiva-mauninām |	SrI-Siva--mOninAm |
   bhava-bandha-cchide tasyai	Bava--banDa-=-Cide tasyE
   spṛhayāmi na muktaye |	spRhayAmi na muktaye |
   bhavān prabhur ahaṃ dāsa	BavAn praBuH aham dAsa
   iti yatra vilupyate ||111||	iti yatra vilupyate ||111||
   śrī-hanumataḥ |	SrI--hanumataH |
   hanta citrīyate mitra	hanta citrIyate mitra
   smṛtvā tān mama mānasam |	smRtvA tAn mama mAnasam |
   vivekitno'pi ye kuryus	vivekitnaH-api ye kuryuH-
   tṛṣṇām ātyantike laye ||112||	tRzNAm Atyantike laye ||112||
   keṣāṃcit |	kezAMcid |
   kā tvaṃ muktir upāgatāsmi bhavatī kasmād akasmād iha	kA tvam muktiH upAgatA-asmi BavatI kasmAt akasmAt iha
   śrī-kṛṣṇa-smaraṇena deva bhavatī dāsī-padaṃ prāpitā |	SrI--kRzNa-smaraNena deva BavatI dAsI--padam prApitA |
   dūre tiṣṭha manāg anāgasi katha kuryād anāryaṃ mayi	dUre tizWa manAk anAgasi kaTa kuryAt anAryam mayi
   tvad-gandhān nija-nāma-candana-rasālepasya lopo bhavet ||113||	tvad--ganDAn nija--nAma--candana--rasa-Alepasya lopaH Bavet ||113||
   kasyacit |	kasyacid |
   atha śrī-bhagavaddharmatattvam |	aTa SrI--Bagavat-Darma-tattvam |
   arcye viṣṇau śilā-dhīr guruṣu nara-matir vaiṣṇave jāti-buddhir	arcye vizNO SilA-DIH guruzu nara-matiH vEzNave jAti-budDiH-
   viṣṇor vā vaiṣṇavānāṃ kali-mala-mathane pāda-tīrthe 'mbu-buddhiḥ |	vizNoH vA vEzNavAnAm kali-mala--maTane pAda-tIrTe ambu--budDiH |
   śrī-viṣṇor nāmni mantre sakala-kaluṣa-he śabda-sāmānya-buddhir	SrI--vizNoH nAmni mantre sakala--kaluza--he Sabda--sAmAnya-budDiH-
   viṣṇau sarveśvareśe tad-itara-sama-dhīr yasya vā nārakī saḥ ||114||	vizNO sarva-ISvara-ISe tad--itara--sama-DIH yasya vA nArakI saH ||114||
   śrī-dākṣiṇātyasya ||	SrI--dAkziNAti-asya ||
   hatyāṃ hanti yad-aṅghri-saṅga-tulasī steyaṃ ca toyaṃ pador	hatyAm hanti yat--aFGri-saFga-tulasI steyam ca toyam padoH-
   naivedyaṃ bahu-madya-pāna-duritaṃ gurv-aṅganā-saṅgajam |	nEvedyam bahu-madya--pAna-duritam guru--aFganA--saFga-jam |
   śrī-śādhina-matiḥ sthitir hari-janais tat-saṅgajaṃ kilbiṣaṃ	SrI-SADina-matiH sTitiH hari-janEH tat-saFga-jam kilbizam
   śālāgrāma-śilā-nṛsiṃha-mahimā ko'py eṣa lokottaraḥ ||115||	SAlAgrAma--SilA--nRsiMha--mahimA kaH-api eza loka-uttaraH ||115||
   śrī-āgamasya | (HBV 5.446)	SrI--Agamasya | (HBV 5.446)
   atha naivedyārpaṇe vijñaptiḥ |	aTa nEvedya-arpaNe vijQaptiH |
   dvija-strīṇāṃ bhakte mṛduni vidurānne vraja-gavāṃ	dvija--strINAm Bakte mRduni vidura-anne vraja--gavAM
   dadhikṣere sakhyuḥ sphuṭa-cipiṭa-mṛṣṭau muraripo |	daDikzere saKyuH sPuwa--cipiwa-mRzwO mura-ripaH |
   yaśodāyāḥ stanye vraja-yuvati-datte madhuni te	yaSodAyAH stanye vraja-yuvati-datte maDuni te
   yathāsīd āmodas tam imam upahāre'pi kurutām ||116||	yaTA-AsIt AmodaH tam imam upahAre-api kurutAm ||116||
   śrī-rāmānujasya |	SrI-rAma-anujasya |
   yā prītir vidurārpite muraripo kunty-arpite yādṛśī	yA prItiH vidura-arpite mura-ripaH kuntI--arpite yAdRSI
   yā govardhana-mūrdhni yā ca pṛthuke stane yaśodārpite |	yA govarDana--mUrDni yA ca pRTuke stane yaSoda-arpite |
   bhāradvāja-samarpite śabarikā-datte'dhare yoṣitāṃ	BAradvAja--samarpite SabarikA--datte-aDare yozitAm
   yā vā te muni-bhāminī-vinihite'nne'trāpi tām arpaye ||117||	yA vA te muni--BAminI--vinihite-anne-atra-api tAm arpaye ||117||
   kasyacit |	kasyacid |
   kṣīre śyāmalayārpite kamalayā viśrāṇite phāṇite	kzIre SyAma-laya-arpite kamalayA viSrANite PANite
   datte laḍḍūni bhadrayā madhurase sobhābhayā lambhite |	datte laxxUni BadrayA maDu-rase soBA-aBayA lamBite |
   tuṣṭiryā bhavatas tataḥ śataguṇāṃ rādhā-nideśān mayā	tuzwiH-yA BavataH tatas SataguNAm rADA--nideSAt mayA
   naste'smin puratas tvam arpaya hare ramyopahāre ratim ||118||	naH-te-asmin puratas tvam arpaya hare ramya-upahAre ratim ||118||
   samāhartuḥ ||	samAhartuH ||
   atha śrī-mathurāmahimā |	aTa SrI-m-aTu-rA-mahimA |
   he mātur mathure tvam eva niyataṃ dhanyāsi bhūmī-tale	he mAtuH maTure tvam eva niyatam DanyA-asi BUmI--tale
   nirvyājaṃ natayaḥ śataṃ savidhayas tubhyaṃ sadā santu naḥ |	nirvyAjam natayaH Satam sa-viDayaH tuByam sadA santu naH |
   hitvā hanta nitāntam adbhuta-guṇaṃ vaikuṇṭham utkaṇṭhayā	hitvA hanta nitAntam adButa-guNam vEkuNWam utkaNWayA
   tvayy ambhoja-vilocanaḥ sa bhagavān yenāvatīrṇo hariḥ ||119||	tvayi amBoja--vilocanaH sa BagavAn yena-avatIrNaH hariH ||119||
   kasyacit |	kasyacid |
   atrāsīt kila nanda-sadma śakaṭasyātrābhavad bhañjanaṃ	atra-AsIt kila nanda--sadma Sakawa-sya-atra-aBavat BaQjanam
   bandha-ccheda-karo'pi dāmabhir abhūd baddho'tra dāmodaraḥ |	banDa--=-Ceda-karaH-api dAmaBiH aBUt badDaH-atra dAmodaraH |
   itthaṃ mathurā-vṛddha-vaktra-vigalat-pīyūṣa-dhārāṃ piban	itTam maTurA--vRdDa--vaktra--vigala-t-pI-yUza--DArAm piban
   nāndāśru-dharaḥ kadā madhu-purīṃ dhanyaś cariṣyāmy aham ||120||	nAnda-aSru--DaraH kadA maDu--purIm DanyaH carizyAmi aham ||120||
   śrī-kavi-śekharasya | (BRS 1.3.40)	SrI-kavi-SeKarasya | (BRH 1.3.40)
   yatrākhilādi-gurur ambuja-sambhavo'pi	yatra-aKila-Adi-guruH ambuja--samBavaH-api
   stambātmanā janur anuspṛhayāmbabhūva |	stamba-AtmanA januH anuspRhaya-ambaBUva |
   cakradhvajāṅkuśa-lasat-pada-rāji-ramyā	cakra-Dvaja-aFkuSa-lasat-pada--rAji--ramyA
   sā rājate'dya mathurā hari-rāja-dhānī ||121||	sA rAjate-adya maTurA hari-rAja-DAnI ||121||
   kasyacit ||	kasyacid ||
   bījaṃ mukti-taror anartha-paṭalī-nistārakaṃ tārakaṃ	bIjam mukti-taroH anarTa--pawalI--nistArakam tArakam
   dhāma prema-rasasya vāñchita-dhurā-sampārakaṃ pārakam |	DAma prema--rasasya vAQCita-DurA--sampArakam pArakam |
   etad yatra nivāsinām udayate cic-chakti-vṛtti-dvayaṃ	etat yatra nivAsinAm udayate cic--Sakti--vRtti-dvayam
   mathnātu vyasanāni māthura-purī sā vaḥ śriyaṃ ca kriyāt ||122||	maTnAtu vyasanAni mATura--purI sA vaH Sriyam ca kriyAt ||122||
   samāhartuḥ ||	samAhartuH ||
   vitarati mura-mardanaḥ prabhuste	vitarati mura-mardanaH praBuH-te
   na hi bhajamāna-janāya yaṃ kadāpi |	na hi BajamAna-janAya yam kadApi |
   vitarasi bata bhakti-yogam etaṃ	vitarasi bata Bakti--yogam etam
   tava mathure mahimā girām abhūmiḥ ||123||	tava maTure mahimA girAm aBUmiH ||123||
   tasyaiva ||	tasya-eva ||
   śravaṇe mathurā nayane mathurā	SravaNe maTurA nayane maTurA
   vadane mathurā hṛdaye mathurā |	vadane maTurA hRdaye maTurA |
   purato mathurā parato mathurā	puratas maTurA paratas maTurA
   madhurā madhurā mathurā mathurā ||124||	maDurA maDurA maTurA maTurA ||124||
   śrī-govinda-miśrāṇām |	SrI---govinda--miSrANAm |
   atha śrī-vṛndāṭavī-vandanam |	aTa SrI--vRndAwavI--vandanam |
   tvaṃ bhaja hiraṇyagarbhaṃ	tvam Baja hiraNyagarBam
   tvam api haraṃ tvaṃ ca tat-paraṃ brahma |	tvam api haram tvam ca tat--param brahma |
   vinihita-kṛṣṇānandām	vinihita--kRzNa-AnandAm
   ahaṃ tu vṛndāṭavīṃ vande ||125||	aham tu vRnda-awavIm vande ||125||
   kasyacit |	kasyacid |
   atha śrī-nandapraṇāmaḥ |	aTa SrI-nanda-praNAmaH |
   śrutim apare smṛtim itare	Srutim apare smRtim itare
   bhāratam anye bhajantu bhava-bhītāḥ	BAratam anye Bajantu Bava-BItAH
   aham iha nandaṃ vande	aham iha nandam vande
   yasyālinde paraṃ brahma ||126||	yasya-alinde param brahma ||126||
   raghupatyupādhyāyasya | (CC 2.19.96)	raGupati-upADyAyasya | (SC 2.19.96)
   bandhūkāruṇa-vasanaṃ	banDUka-aruNa--vasanam
   sundara-kūrcaṃ mukunda-hṛta-nayanam |	sundara--kUrcam mukunda--hRta-nayanam |
   nandaṃ tundila-vapuṣaṃ	nandam tundila--vapuzam
   candana-gaura-tviṣaṃ vande ||127||	candana-gOra-tvizam vande ||127||
   samāhartuḥ |	samAhartuH |
   atha śrī-yaśodāvandanam |	aTa SrI--yaSa-udA-vandanam |
   aṅkaga-paṅkaja-nābhāṃ	aFka-ga-paFkaja-nABAm
   nava-ghanābhāṃ vicitra-ruci-sicayām |	nava-Gana-ABAm vicitra--ruci--sicayAm |
   viracita-jagat-pramodāṃ	viracita--jagat--pramodAm
   muhur yaśodāṃ namasyāmi ||128||	muhur yaSodAm namasyAmi ||128||
   samāhartuḥ |	samAhartuH |
   atha śrī-kṛṣṇaśaiśavam |	aTa SrI--kRzNa-SESavam |
   atilohita-kara-caraṇaṃ	ati-lohita-kara--caraNam
   mañjula-gorocanā-tilakam |	maQjula--gorocanA--tilakam |
   haṭha-parivartita-śakaṭaṃ	haWa--parivartita--Sakawam
   muraripum uttāna-śāyinaṃ vande ||129||	mura-ripum uttAna--SAyinam vande ||129||
   kasyacit |	kasyacid |
   ardhonmīlita-locanasya pibataḥ paryāptam ekaṃ stanaṃ	arDa-unmIlita--locanasya pibataH paryAptam ekam stanam
   sadyaḥ prastuta-dugdha-digdham aparaṃ hastena sammārjataḥ |	sadyas prastuta-dugDa--digDam aparam hastena sammArjataH |
   mātrā cāṅguli-lāsitasya vadane smerāyamāne muhur	mAtrA ca-aFguli-lAsitasya vadane smerAyamAne muhur-
   viṣṇoḥ kṣīra-kaṇoru-dhāma-dhavalā danta-dyutiḥ pātu vaḥ ||130||	vizNoH kzIra-kaNA-Uru--DAma--DavalA danta--dyutiH pAtu vaH ||130||
   śrī-maṅgalasya | (BRK 5.1736)	SrI--maFgalasya | (BRS 5.1736)
   gopeśvarī-vadana-phūt-kṛti-lola-netraṃ	gopeSvarI--vadana--PUt--kRti--lola--netram
   jānu-dvayena dharaṇīm anu sañcarantam |	jAnu--dvayena DaraNIm anu saQcarantam |
   kañcin nava-smita-sudhā-madhurādharābhaṃ	kaQcid nava-smita-suDA--maDura-aDara-ABam
   bālaṃ tamāla-dala-nīlam ahaṃ bhajāmi ||131||	bAlam tamAla--dala--nIlam aham BajAmi ||131||
   śrī-raghunātha-dāsasya | (BRK 5.1738)	SrI--raGu-nATa-dAsasya | (BRS 5.1738)
   kvānanaṃ kva nayanaṃ kva nāsikā	kva-Ananam kva nayanam kva nAsikA
   kva śrutiḥ kva śikheti deśitaḥ |	kva SrutiH kva SiKA-iti deSitaH |
   tatra tatra nihitāṅgulī-dalo	tatra tatra nihita-aFgulI-dalaH-
   vallavī-kulam anandayat prabhuḥ ||132||	vallavI--kulam anandayat praBuH ||132||
   kavi-sārvabhaumasya || (BRK 5.1740)	kavi--sArvaBOmasya || (BRS 5.1740)
   idānīm aṅgam akṣāli	idAnIm aFgam akzAli
   racitaṃ cānulepanam |	racitam ca-anulepanam |
   idānīm eva te kṛṣṇa	idAnIm eva te kRzNa
   dhūli-dhūsaritaṃ vapuḥ ||133||	DUli-DU-saritam vapuH ||133||
   sārvabhauma-bhaṭṭācāryāṇām | (BRK 5.1742)	sArvaBOma--Bawwa-AcAryANAm | (BRS 5.1742)
   pañca-varṣam atilolam aṅgane	paQca-varzam ati-lolam aFgane
   dhāvamānam alakākulekṣaṇam |	DAvamAnam alaka-Akula-IkzaNam |
   kiñkiṇī-valaya-hāra-nūpuraṃ	kiQkiNI-valaya--hAra--nUpuram
   rañjitaṃ namata nanda-nandanam ||134||	raQjitam namata nanda-nandanam ||134||
   āgamasya | (BRK 5.1749)	Agamasya | (BRS 5.1749)
   atha śaiśave tāruṇyam	aTa SESave tAruNyam
   adhara-madhure kaṇṭhaṃ kaṇṭhe sacāṭu dṛśau dṛśor	aDara--maDure kaNWam kaNWe sa-cAwu dRSO dRSoH-
   alikam alike kṛtvā gopījanena sa-sambhramam |	alikam alike kRtvA gopI-janena sa--samBramam |
   śiśur iti rudan kṛṣṇo vakṣaḥ-sthale nihitaś cirān	SiSuH iti rudan kRzNaH vakzaH-sTale nihitaH cirAn
   nibhṛta-pulakaḥ smeraḥ pāyāt smarālasa-vigrahaḥ ||135||	niBRta-pulakaH smeraH pAyAt smarAla-sa-vigrahaH ||135||
   divākarasya | (SKM 1.51.4; BRK 5.1751)	divAkarasya | (SKm 1.51.4; BRS 5.1751)
   brūmas tvac-caritaṃ tavādhijanani cchadmātibālyākṛte	brUmaH tvac--caritam tava-aDijanani cCadmAti-bAlya-akRte
   tvaṃ yādṛg giri-kandareṣu nayanānandaḥ kuraṅgī-dṛśām |	tvam yAdRS giri--kandarezu nayana-AnandaH kuraFgI--dRSAm |
   ity uktaḥ parilehana-cchalatayā nyastāṅguliḥ svānane	iti uktaH parilehana-=-Cala-tayA nyasta-aFguliH sva-Anane
   gopībhiḥ purataḥ punātu jagatīm uttāna-supto hariḥ ||136||	gopIBiH puratas punAtu jagatIm uttAna--suptaH hariH ||136||
   vanamālinaḥ || (SKM 1.51.5)	vanamAlinaH || (SKm 1.51.5)
   vanamālini pitur aṅke	vanamAlini pituH aFke
   racayati bālyocitaṃ caritam |	racayati bAlya-ucitam caritam |
   navanava-gopa-vadhūṭī-	nava-nava-gopa-vaDUwI-
   smita-paripāṭī parisphurati ||137||	smita--paripAwI parisPurati ||137||
   śrī-mukunda-bhaṭṭācāryasya | (BRK 5.1752)	SrI--mukunda--Bawwa-AcAryasya | (BRS 5.1752)
   nītaṃ navanavanītaṃ kiyad	nItam nava-navanItam kiyat-
   iti kṛṣṇao yaśodayā pṛṣṭaḥ |	iti kRzNaaH yaSodayA pRzwaH |
   iyad iti guru-jana-savidhe	iyat iti guru-jana--saviDe
   vidhṛta-dhaniṣṭhā-payodharaḥ ||138||	viDRta-DanizWA--payoDaraH ||138||
   kasyacit || (rāṅgasya) (BRK 5.1753)	kasyacid || (ra-aFgasya) (BRS 5.1753)
   kva yāsi nanu caurike pramuṣitaṃ sphuṭaṃ dṛśyate	kva yAsi nanu cOrike pramuzitam sPuwam dRSyate
   dvitīyam iha māmakaṃ vahasi kañcuke kandukam |	dvitIyam iha mAmakam vahasi kaQcuke kandukam |
   tyajeti nava-gopikā-kuca-yugaṃ nimathnan balāl	tyaja-iti nava--gopi-kA--kuca--yugam nimaTnan balAl
   lasat-pulaka-maṇḍalo jayati gokule keśavaḥ ||139||	lasat--pulaka-maNxalaH jayati gokule keSavaH ||139||
   dīpakasya || (Spd 74, Smv; BRK 5.1754)	dIpakasya || (Spd 74, Smv; BRS 5.1754)
   atha gavya-haraṇam	aTa gavya-haraNam
   dūra-dṛṣṭa-nava-nīta-bhājanaṃ	dUra-dRzwa--nava-nIta--BAjanam
   jānu-caṅkramaṇa-jāta-sambhramam |	jAnu--caFkramaNa-jAta--samBramam |
   mātṛ-bhīti-parivartitānanaṃ	mAtR-BIti--parivartita-Ananam
   keśavaṃ kim api śaiśavaṃ bhaje ||140||	keSavam kim api SESavam Baje ||140||
   kasyacit || (BRK 5.1756)	kasyacid || (BRS 5.1756)
   sammuṣṇan navanītam antika-maṇi-stambhe sva-bimbodgamaṃ	sammuzNan navanItam antika-maNi--stamBe sva--bimba-udgamam
   dṛṣṭvā mugdhatayā kumāram aparaṃ sañcintayan śaṅkayā |	dRzwvA mugDa-tayA kumAram aparam saQcintayan SaFkayA |
   man-mitraṃ hi bhavān mayātra bhavato bhāgaḥ samaḥ kalpito	man-mitram hi BavAn mayA-atra BavataH BAgaH samaH kalpitaH-
   mā māṃ sūcaya sūcayety anunayan bālo hariḥ pātu vaḥ ||141||	mA mAm sUcaya sUcayA-iti anunayan bAlaH hariH pAtu vaH ||141||
   keṣāṃcit ||	kezAMcid ||
   dadhimathananinādaistyaktanidraḥ prabhāte	daDi-maTana-ninAdEH-tyakta-nidraH praBAte
   nibhṛtapadamagāraṃ vallavīnāṃ praviṣṭaḥ |	niBRta-padam-agAram vallavInAm pravizwaH |
   mukhakamalasamīrairāśu nirvāpya dīpān	muKa-kamala-samIrEH-ASu nirvApya dIpAn
   kavalitanavanītaḥ pātu māṃ bālakṛṣṇaḥ || 142 ||	kavalita-navanItaH pAtu mAm bAla-kRzNaH || 142 ||
   kasyacit ||	kasyacid ||
   savye pāṇau niyamita-ravaṃ kiñkiṇī-dāma dhṛtvā	savye pANO niyamita--ravam kiQkiNI-dAma DRtvA
   kubjībhūya prapada-gatibhir manda-mandaṃ vihasya |	kubjIBUya prapada--gatiBiH manda-mandam vihasya |
   akṣṇor bhaṅgyā vihasita-mukhīr vārayan sammukhīnā	akzNoH BaFgyAH vihasita--muKIH vArayan sammuKInA
   mātuḥ paścād aharata harir jātu haiyaṅgavīnam || 143 ||	mAtuH paScAt aharata hariH jAtu hEyaFgavInam || 143 ||
   śrī-śrīmataḥ ||	SrI--SrImataH ||
   pada-nyāsān dvārāñcala-bhuvi vidhāya tri-caturān	pada-nyAsAn dvAra-aQcala--Buvi viDAya tri-caturAn
   samantād ālolaṃ nayana-yugalaṃ dikṣu vikiran |	samantAt Alolam nayana--yugalam dikzu vikiran |
   smitaṃ bibhrad vyaktaṃ dadhi-haraṇa-līlā-caṭula-dhīḥ	smitam biBrat vyaktam daDi-haraNa--lIlA--cawula-DIH
   saśaṅkaṃ gopīnāṃ madhuripur agāraṃ praviśati || 144 ||	sa-SaFkam gopInAm maDuripuH agAram praviSati || 144 ||
   samāhartuḥ ||	samAhartuH ||
   mṛdnan kṣīrādi-cauryān masṛṇa-surabhiṇī sṛkvaṇī pāṇi-dharṣair	mRdnan kzIra-Adi--cOryAt masRNa--suraBiNI sRkvaNI pANi-DarzEH-
   āghrāyāghrāya hastaṃ sapadi paruṣayan kiṅkiṇī-mekhalāyām |	AGrAya-AGrAya hastam sapadi paruzayan kiFkiNI--meKalAyAm |
   vāraṃ vāraṃ viśāle diśi diśi vikiran locane lolatāre	vAram vAram viSAle diSi diSi vikiran locane lola-tAre
   mandaṃ mandaṃ jananyāḥ parisaram ayate kūṭa-gopāla-bālaḥ || 145 ||	mandam mandam jananyAH parisaram ayate kUwa-gopAla--bAlaH || 145 ||
   kasyacit ||	kasyacid ||
   atha hareḥ svapnāyitam	aTa hareH svapnAyitam
   śambho svāgatam āsyatām ita ito vāmena padmodbhava	SamBo svAgatam AsyatAm itas itas vAmena padmodBava
   krauñcāre kuśalaṃ sukhaṃ surapate vitteśa no dṛśyate |	krOQcAre kuSalam suKam surapate vitteSa naH dRSyate |
   itthaṃ svapna-gatasya kaiṭabha-ripoḥ śrutvā jananyā giraḥ	itTam svapna--gatasya kEwaBa-ripoH SrutvA jananyAH giraH
   kiṃ kiṃ bālaka jalpasīty anucitaṃ thūthūt-kṛtaṃ pātu vaḥ ||146||	kim kim bAlaka jalpasi-iti anucitam TUTUt--kRtam pAtu vaH ||146||
   mayūrasya || (SKM 1.53.1; BRK 5.1758)	mayUrasya || (SKm 1.53.1; BRS 5.1758)
   dhīrā dharitri bhāva bhāram avehi śāntaṃ	DIrAH Daritri BAva BAram avehi SAntam
   nanv eṣa kaṃsa-hatakaṃ vinipātayāmi |	nanu eza kaMsa-hatakam vinipAtayAmi |
   ity adbhuta-stimita-gopa-vadhū-śrutāni	iti adButa-H-timita-gopa-vaDU-SrutAni
   svapnāyitāni vasudeva-śiśor jayanti ||147||	svapnAyitAni vasudeva--SiSoH jayanti ||147||
   sudevasya || (SKM 1.53.2)	sudevasya || (SKm 1.53.2)
   atha pitror vismāpana-śikṣaṇādi	aTa pitroH vismApana--SikzaNa-Adi
   kālindī-puline mayā na na mayā śīlopaśalye na na	kAlindI--puline mayA na na mayA SIla-upaSalye na na
   nyagrodhasya tale mayā na na mayā rādhā-pituḥ prāṅgane |	nyagroDasya tale mayA na na mayA rADA-pituH prAFgane |
   dṛṣṭaḥ kṛṣṇa itīrite saniyamaṃ gopair yaśodā-pater	dRzwaH kRzNaH iti-Irite sa-niyamam gopEH yaSodA--pateH-
   vismerasya puro hasan nija-gṛhān niryan hariḥ pātu vaḥ ||148||	vismerasya puras hasan nija--gRhAt niryan hariH pAtu vaH ||148||
   umāpatidharasya || (SKM 1.52.4)	umApatiDarasya || (SKm 1.52.4)
   vatsa sthavara-kandareṣu vicaran dūra-pracāre gavāṃ	vatsa sTavara--kandarezu vicaran dUra--pracAre gavAm
   hiṃsrān vīkṣya puraḥ purāṇa-puruṣaṃ nārāyaṇaṃ dhyāsyasi |	hiMsrAn vIkzya puras purANa-puruzam nArAyaNam DyAsyasi |
   ity uktasya yaśodayā murāripor avyāj jaganti sphurad-	iti uktasya yaSodayA murA-ripoH avyAt jaganti sPurat--
   bimboṣṭha-dvaya-gāḍha-pīḍana-vaśād avyakta-bhāvaṃ smitam ||149||	bimba-uzWa--dvaya-gAXa---pIxana--vaSAt avyakta-BAvam smitam ||149||
   abhinandasya || (SKM 1.52.1)	aBinandasya || (SKm 1.52.1)
   rāmo nāma babhūva huṃ tad abalā sīteti huṃ tāṃ pitur	rAmaH nAma baBUva hum tat abalA sItA-iti hum tAm pituH-
   vācā pañcavaṭī-vane nivasatas tasyāharad rāvaṇaḥ |	vAcA paQcavawI--vane nivasataH tasya-aharat rAvaNaH |
   kṛṣṇasyeti purātanīṃ nija-kathām ākarṇya mātreritāṃ	kRzNasya-iti purAtanIm nija--kaTAm AkarNya mAtrA-IritAm
   saumitre kva dhanur dhanur dhanur iti vyagrā giraḥ pāntu vaḥ ||150||	sOmitre kva DanuH DanuH DanuH iti vyagrAH giraH pAntu vaH ||150||
   kasyacit | (RSAK; KK 2.72; BRK 5.1760)	kasyacid | (RSAK; KK 2.72; BRS 5.1760)
   śyāmoccandrā svapiti na śiśo naiti mām amba nidrā	SyAma-uccandrA svapiti na SiSaH na-eti mAm amba nidrA
   nidrāhetoḥ śṛṇu kathāṃ kām apūrvāṃ kuruṣva |	nidrA-hetoH SRNu kaTAm kAm apUrvAm kuruzva |
   vyaktaḥ stambhān naraharir abhūd dānavaṃ dārayiṣyann	vyaktaH stamBAt narahariH aBUt dAnavam dArayizyan=-
   ity uktasya smitam udayate devakī-nandanasya ||151||	iti uktasya smitam udayate devakI-nandanasya ||151||
   sarvānandasya | (SRK 123; SKM 1.52.2; śatānandasya; BRK 5.1761)	sarva-Anandasya | (SRj 123; SKm 1.52.2; SatAnandasya; BRS 5.1761)
   atha gorakṣādilīlā	aTa gorakza-Adi-lIlA
   devas tvām eka-jaṅghāvalayita-guḍī-mūrdhni vinyasta-bāhu-	devaH tvAm eka--jaFGA-valayita-guxI--mUrDni vinyasta-bAhu-
   rgāyan goyuddhagītir uparacita-śiraḥśekharaḥ pragraheṇa |	rgAyan go-yudDa-gItiH uparacita-SiraH-SeKaraH pragraheNa |
   darpa-sphūrjan mahokṣa-dvaya-samara-kalā-baddha-dīrghānubandhaḥ	darpa--sPUrjan mahA-ukza--dvaya--samara-kalA--badDa--dIrGa-anubanDaH
   krīḍā-gopāla-mūrtir muraripur avatād ātta-gorakṣa-līlaḥ ||152||	krIxA--gopAla--mUrtiH muraripuH avatAt Atta-gorakza--lIlaH ||152||
   yogeśvarasya | (SKM 1.58.3)	yogeSvarasya | (SKm 1.58.3)
   yāvad gopā madhura-muralī-nāda-mattā mukundaṃ	yAvat gopAH maDura--muralI-nAda--mattA mukundam
   manda-spandair ahaha sakalair locanair āpibanti |	manda--spandEH ahaha sakalEH locanEH Apibanti |
   gāvas tāvan masṛṇa-yavasa-grāsa-lubdhā vidūraṃ	gAvaH tAvat masRNa-yavasa--grAsa-lubDA vidUram
   yātā govardhana-giri-darī-droṇikābhyantareṣu ||153||	yAtAH govarDana--giri-darI--droNikA-aByantarezu ||153||
   śrī-keśava-cchatriṇaḥ |	SrI-keSava-=-CatriNaH |
   atha gopīnāṃ premotkarṣaḥ |	aTa gopInAm prema-utkarzaH |
   dhairyaṃ nāma-parigrahe'pi jaghane yady aṃśukālambanaṃ	DEryam nAma--parigrahe-api jaGane yadi aMSuka-Alambanam
   gopīnāṃ ca vivecanaṃ nidhuvanārambhe raho-mārgaṇam |	gopInAm ca vivecanam niDuvana-AramBe raho-mArgaNam |
   sādhvī-sac-caritaṃ vilāsa-viratau patyur gṛhānveṣaṇaṃ	sADvI--sac--caritam vilAsa--viratO patyuH gRha-anvezaNam
   tat tad raurava-rakṣaṇaṃ muraripor vaṃśī-ravāpekṣaṇam ||154||	tat tat rOrava-rakzaNam muraripoH vaMSI-rava-apekzaNam ||154||
   sarva-vidyāvinodānām |	sarva-vidyA-vinodAnAm |
   vilokya kṛṣṇaṃ vraja-vāma-netrāḥ	vilokya kRzNam vraja-vAma--netrAH
   sarvendriyāṇāṃ nayanatvam eva |	sarva-indriyANAm nayana-tvam eva |
   ākarṇya tad-veṇu-nināda-bhaṅgīm	AkarNya tad--veNu--ninAda--BaFgIm
   aicchan punas tāḥ śravaṇatvam eva ||155||	EcCan punar tAH SravaNa-tvam eva ||155||
   kasyacit |	kasyacid |
   atha gopībhiḥ saha līlā	aTa gopIBiH saha lIlA
   kālindī-jala-keli-lola-taruṇīr āvīta-cīnāṃśukā	kAlindI--jala--keli--lola--taruNIH AvIta--cIna-aMSukA
   nirgatyāṅga-jalāni sāritavatīr ālokya sarvā diśaḥ |	nirgatya-aFga-jalAni sAritavatIH Alokya sarvAH diSaH |
   tīropānta-milan-nikuñja-bhavane gūḍhaṃ cirāt paśyataḥ	tIra-upAnta--milan--nikuQja--Bavane gUXam cirAt paSyataH
   śaureḥ sambhramayann imā vijayate sākūta-veṇur dhvaniḥ ||156||	SOreH samBramayan imAH vijayate sa-AkUta-veNuH DvaniH ||156||
   puruṣottamadevasya |	puruzottama-devasya |
   tāsu kṛṣṇasya bhāvaḥ |	tAsu kRzNasya BAvaH |
   svedāplāvita-pāṇi-padma-mukula-prakrānta-kampodayād	sveda-AplAvita-pANi--padma--mukula--prakrAnta--kampa-udayAt-
   visrastām avijānato muralikāṃ pādāravindopari |	visrastAm avijAnataH muralikAm pAda-aravinda-upari |
   līlā-vellita-vallavī-kavalita-svāntasya vṛndāvane	lIlA--vellita-valla-vI--kavalita--svAntasya vRndAvane
   jīyāt kaṃsaripos tribhaṅga-vapuṣaḥ śūnyodayaḥ phūtkṛtiḥ ||157||	jIyAt kaMsa-ripoH tri-BaFga-vapuzaH SUnya-udayaH PUtkRtiH ||157||
   cirañjīvasya |	ciraQjIvasya |
   śrī-kṛṣṇasya prathama-darśane rādhā-praśnaḥ	SrI--kRzNasya praTama--darSane rADA--praSnaH
   bhrūvalli-tāṇḍava-kalā-madhurānana-śrī-ḥ	BrU-valli-tANxava-kalA--maDura-Anana--SrI-H
   kaṅkelli-koraka-karambita-karṇa-pūraḥ |	kaFkelli-kora-ka-karambita-karNa--pUraH |
   ko'yaṃ navīna-nikaṣopala-tulya-veṣo	kaH-ayam navIna--nikaza-upala--tulya--vezaH-
   vaṃśīraveṇa sakhi mām avaśīkaroti ||158||	vaMSIraveNa saKi mAm avaSIkaroti ||158||
   kasyacit | (BRS 3.5.20)	kasyacid | (BRH 3.5.20)
   indīvarodara-sahodara-medura-śrī-r	indIvara-udara--sahodara--medura--SrI-r
   vāso dravat-kanaka-vṛnda-nibhaṃ dadhānaḥ |	vAsaH dravat--kanaka-vRnda--niBam daDAnaH |
   āmukta-mauktika-manohara-hāra-vakṣāḥ	Amukta-mOktika--manohara--hAra-vakzAH
   ko'yaṃ yuvā jagad-anaṅga-mayaṃ karoti ||159||	kaH-ayam yuvA jagat--anaFga-mayam karoti ||159||
   sarva-vidyā-vinodānām || (UN 15.7)	sarva--vidyA-vinodAnAm || (Uj 15.7)
   sakhyā uttaram	saKyAH uttaram
   asti ko'pi timira-stanandhayaḥ	asti kaH-api timira-stananDayaH
   kiñcid añcita-padaṃ sa gāyati |	kiQcid aQcita-padam sa gAyati |
   yan manāg api niśamya kā vadhūr	yat manAk api niSamya kA vaDUH-
   nāvadhūta-hṛdayopajāyate || 160 ||	na-avaDUta--hRdaya-upajAyate || 160 ||
   kasyacit |	kasyacid |
   śrī-rādhāyāḥ pūrva-rāgaḥ	SrI--rADAyAH pUrva-rAgaH
   manogatāṃ manmatha-bāṇa-bādhām	manogatAm manmaTa--bANa--bADAm
   āvedayantīva tanor vikāraiḥ |	Avedayanti-iva tanoH vikArEH |
   dīnānanā vācam uvāca rādhā	dIna-AnanA vAcam uvAca rADA
   tadā tadālī-jana-sammukhe sā ||161||	tadA tad-AlI--jana--sammuKe sA ||161||
   śrī-puruṣottama-devasya |	SrI--puruzottama-devasya |
   yadavadhi yāmuna-kuñje	yat-avaDi yAmuna--kuQje
   ghana-rucir avalokitaḥ ko'pi |	Gana-ruciH avalokitaH kaH-api |
   nalinī-dala iva salilaṃ	nalinI--dalaH iva salilam
   tadavadhi taralāyate ||162||	tat-avaDi taralAyate ||162||
   kavicandrasya ||	kavi-candrasya ||
   akasmād ekasmin pathi sakhi mayā yāmuna-taṭaṃ	akasmAt ekasmin paTi saKi mayA yAmuna--tawam
   vrajantyā dṛṣṭo yo nava-jaladhara-śyāmala-tanuḥ |	vrajantyA dRzwaH yaH nava--jalaDara--SyAmala-tanuH |
   sa dṛg-bhaṅgyā kiṃ vākuruta na hi jāne tata idaṃ	sa dRS--BaFgyA kim vAkuruta na hi jAne tatas idam
   mano me vyālolaṃ kvacana gṛhakṛtyo na lagate ||163||	manaH me vyAlolam kvacana gRha-kRtyaH na lagate ||163||
   jayantasya | (Bhakti-rasāyana; BRS 3.5.27)	jayantasya | (Bhakti--rasAyana; BRH 3.5.27)
   puro nīla-jyotsnā tad anu mṛganābhī-parimalas	puras nIla-jyotsnA tat anu mRganABI--parimala-s
   tato līlā-veṇu-kvaṇitam anu kāṇcī-kala-ravaḥ |	tatas lIlA--veNu--kvaNitam anu kANcI--kala-ravaH |
   tato vidyud-vallī-valayita-camatkāra-laharī-	tatas vidyut--vallI--valayita--camatkAra--laharI-
   taraṅgāl lāvaṇyaṃ tad anu sahajānanda udagāt ||164||	taraFgAt lAvaNyam tat anu sahaja-AnandaH udagAt ||164||
   kasyacit |	kasyacid |
   adya sundari kalinda-nandinī-	adya sundari kalinda-nandinI-
   tīra-kuñja-bhuvi keli-lampaṭaḥ |	tIra-kuQja--Buvi keli-lampawaH |
   vādayan muralikāṃ muhur muhur	vAdayan muralikAm muhur muhur-
   mādhavo harati māmakaṃ manaḥ ||165||	mADavaH harati mAmakam manaH ||165||
   kasyacit | (similar Premāmṛta 4.13)	kasyacid | (similar Prema-amRtaH 4.13)
   yadavadhi yamunāyās tīra-vānīra-kuñje	yat-avaDi yamunAyAH tIra--vAnIra--kuQje
   muraripu-pada-līlā locanābhyām aloki |	murari-pu-pada--lIlA locanAByAm aloki |
   tadavadhi mama cittaṃ kutracit kārya-mātre	tat-avaDi mama cittam kutracid kArya--mAtre
   na hi lagati muhūrtaṃ kiṃ vidheyaṃ na jāne ||166||	na hi lagati muhUrtam kim viDeyam na jAne ||166||
   kavicandrasya |	kavi-candrasya |
   yadavadhi yadunandanānanenduḥ	yat-avaDi yadunandana-Anana-induH
   sahacari locana-gocarībabhūva |	sahacari loca-na--gocarI-baBUva |
   tadavadhi malayānile'nale vā	tat-avaDi malaya-anile-anale vA
   sahaja-vicāra-parāṅmukhaṃ mano me ||167||	sahaja--vicAra--parAFmuKam manaH me ||167||
   sañjaya-kaviśekharasya |	saQjaya-ka-viSeKarasya |
   asamañjasam asamañjasam	asamaQjasam asamaQjasam
   asamañjasam etad āpatitam |	asamaQjasam etat Apatitam |
   vallava-kumāra-buddhyā	vallava-kumAra--budDyA
   hari hari harir īkṣitaḥ kutukāt ||168||	hari hari hariH IkzitaH kutukAt ||168||
   śaraṇasya ||	SaraNasya ||
   śuṣyati mukham ūru-yugaṃ puṣyati	Suzyati muKam Uru--yugam puzyati
   jaḍatāṃ pravepate hṛdayam |	jaxa-tAm pravepate hRdayam |
   svidyati kapolapālī sakhi	svidyati kapola-pAlI saKi
   vanamālī kim āloki ||169||	vanamAlI kim Aloki ||169||
   mukunda-bhaṭṭācāryasya |	mukunda--Bawwa-AcAryasya |
   upari tamāla-taroḥ sakhi	upari tamAla--taroH saKi
   pariṇata-śarad-indu-maṇḍalaḥ ko'pi |	pariNata--Sarad--indu--maNxalaH kaH-api |
   tatra ca muralī-khuralī	tatra ca muralI--KuralI
   kula-maryādām adho nayati ||170||	kula-maryAdAm aDas nayati ||170||
   sañjaya-kaviśekharasya |	saQjaya-ka-viSeKarasya |
   hanta kāntam api taṃ didṛkṣate	hanta kAntam api tam didRkzate
   mānasaṃ mama na sādhu yat-kṛte |	mAnasam mama na sADu yat-kRte |
   indur indumukhi manda-mārutaś	induH indu-muKi manda--mAruta-S
   candanaṃ ca vitanoti vedanāṃ ||171||	candanam ca vitanoti vedanAm ||171||
   kasyacit |	kasyacid |
   guru-jana-gañjanam ayaśo	guru--jana--gaQjanam ayaSaH-
   gṛhapaticaritaṃ ca dāruṇaṃ kim api |	gRhapati-caritam ca dAruNam kim api |
   vismārayati samastaṃ	vismArayati samastam
   śiva śiva muralī murārāteḥ || 172 ||	Siva Siva muralI murA-rAteH || 172 ||
   sarva-vidyā-vinodānām | (BRS 3.5.12)	sarva--vidyA--vinodAnAm | (BRH 3.5.12)
   draviṇaṃ bhavanam apatyaṃ tāvan	draviNam Bavanam apatyam tAvan
   mitraṃ tathābhijātyaṃ ca |	mitram taTA-aBijAtyam ca |
   upayamunaṃ vanamālī	upayamunam vanamAlI
   yāvan netre na nartayati ||173||	yAvat netre na nartayati ||173||
   teṣām eva	tezAm eva
   tṛpyantu me chidram avāpya śatravaḥ	tRpyantu me Cidram avApya SatravaH
   karotu me śāsti-bharaṃ gṛheśvaraḥ |	karotu me SAsti-Baram gRheSvaraH |
   maṇis tu vakṣoruha-madhya-bhūṣaṇaṃ	maNiH tu vakzoruha--maDya--BUzaNam
   mamāstu vṛndāvana-kṛṣṇa-candramā || 174 || kasyacit |	mama-astu vRndAvana--kRzNa--candramAH || 174 || kasyacid |
   svāmī nihantu vihasantu puraḥ sapatnyo	svAmI nihantu vihasantu puras sapatnyaH-
   bhartur bhajantu guravaḥ pitaraś ca lajjām |	BartuH Bajantu guravaH pitaraH ca lajjAm |
   etāvatā yadi kalaṅki kulaṃ tathāstu	etAvatA yadi kalaFki kulam taTA-astu
   rāmānuje mama tanotu mano'nurāgam ||175|| kasyacit |	rAma-anuje mama tanotu manaH-anurAgam ||175|| kasyacid |
   svāmī kupyati kupyatāṃ parijanā nindanti nindantu mām,	svAmI kupyati kupyatAm parijanAH nindanti nindantu mAm,
   anyat kiṃ prathatām ayaṃ ca jagati prauḍho mamopadravaḥ |	anyat kim praTatAm ayam ca jagati prOXaH mama-upadravaH |
   āśāsyaṃ punar etad eva yad idaṃ cakṣuś ciraṃ vardhatāṃ	ASAsyam punar etat eva yat idam cakzuH ciram varDatAm
   yenedaṃ paripīyate muraripoḥ saundarya-sāraṃ vapuḥ ||176 ||	yena-idam paripIyate muraripoH sOndarya--sAram vapuH ||176 ||
   puṣkarākṣasya |	puzkarAkzasya |
   kiṃ durmilena mama dūti manorathena	kim durmilena mama dUti manoraTena
   tāvanti hanta sukṛtāni kayā kṛtāni |	tAvanti hanta sukRtAni kayA kRtAni |
   etāvad eva mama janma-phalaṃ murārir	etAvat eva mama janma--Palam murAriH-
   yan netrayoḥ pathi bibharti gatāgatāni ||177||	yat netrayoH paTi biBarti gatAgatAni ||177||
   kasyacit ||	kasyacid ||
   sakhi mama niyati-hatāyās	saKi mama niyati-hatAya-as
   tad-darśana-bhāgyam astu vā mā vā |	tad--darSana-BAgyam astu vA mA vA |
   punar api sa veṇu-nādo	punar api sa veNu-nAdaH-
   yadi karṇapathe patet tad evālam ||178||	yadi karNa-paTe patet tat eva-alam ||178||
   kasyacit |	kasyacid |
   tārābhisāraka caturtha-niśā-śaśāṅka	tArABisAraka caturTa--niSA-Sa-SAFka
   kāmāmbu-rāśi-parivardhana deva tubhyam |	kAma-ambu-rASi--parivarDana deva tuByam |
   argho namo bhavatu me saha tena yūnā	arGaH namaH Bavatu me saha tena yUnA
   mithyāpavāda-vacasāpy abhimāna-siddhiḥ ||179||	miTyA-apavAda--vacasA-api aBimAna--sidDiH ||179||
   kasyacit | (UN 14.128)	kasyacid | (Uj 14.128)
   athānya-catura-sakhī-vitarkaḥ	aTa-anya--catura-saKI-vitarkaH
   siddhāntayati na kiñcid	sidDAntayati na kiQcid-
   bhramayati dṛśām eva kevalaṃ rādhā |	Bramayati dRSAm eva kevalam rADA |
   tad avagataṃ sakhi lagnaṃ	tat avagatam saKi lagnam
   kadamba-taru-devatāmarutā ||180||	kadamba--taru--devatA-marutA ||180||
   rāṅgasya |	rAFgasya |
   atha rādhāṃ prati praśnaḥ |	aTa rADAm prati praSnaH |
   kāmaṃ vapuḥ pulakitaṃ nayane dhṛtāsre	kAmam vapuH pulakitam nayane DRta-asre
   vācaḥ sagadgadapadāḥ sakhi kampi vakṣaḥ |	vAcaH sa-gadgada-padAH saKi kampi vakzaH |
   jñātaṃ Mukunda-muralī-rava-mādhurī te	jQAtam Mukunda--muralI-rava-mADurI te
   cetaḥ sudhāṃśu-vadane taralīkaroti ||181||	cetaH suDAMSu--vadane taralIkaroti ||181||
   tasyaiva | (BRS 3.5.15)	tasya-eva | (BRH 3.5.15)
   gataṃ kula-vadhū-vrataṃ viditam eva tat-tad-vacas	gatam kula--vaDU-vratam viditam eva tat--tad--vacas
   tathāpi taralāśaye na vimatāsi ko durgrahaḥ |	taTA-api tarala-ASaye na vimatA-asi kaH durgrahaH |
   karomi sakhi kiṃ śrute danuja-vairi-vaṃśī-rave	karomi saKi kim Srute danuja-vEri-vaMSI--rave
   manāg api mano na me sumukhi dhairyam ālambate ||182||	manAk api manaH na me su-muKi DEryam Alambate ||182||
   kasyacit |	kasyacid |
   āstāṃ tāvad akīrtir me	AstAm tAvat akIrtiH me
   tvayā tathyaṃ tu kathyatām |	tvayA taTyam tu kaTyatAm |
   cittaṃ katham ivāsīt te	cittam kaTam iva-AsIt te
   harir vaṃśī-rava-śrutau ||183||	hariH vaMSI-rava--SrutO ||183||
   kasyacit |	kasyacid |
   satyaṃ jalpasi duḥsahāḥ khala-giraḥ satyaṃ kulaṃ nirmalaṃ	satyam jalpasi duHsahAH Kala--giraH satyam kulam nirmalam
   satyaṃ niṣkaruṇo'py ayaṃ sahacaraḥ satyaṃ sudūre sarit |	satyam nizkaruNaH-api ayam sahacaraH satyam sudUre sarit |
   tat sarvaṃ sakhi vismarāmi jhaṭiti śrotrātithir jāyate	tat sarvam saKi vismarAmi Jawiti Srotra-atiTiH jAyate
   ced unmāda-mukunda-mañju-muralī-nisvāna-rāgodgatiḥ || 184 ||	ced unmAda--mukunda--maQju--muralI--nisvAna---rAga-udgatiH || 184 ||
   govinda-bhaṭṭasya |	govinda-Bawwasya |
   atha rādhāṃ prati sakhī-narmāśvāsaḥ |	aTa rADAm prati saKI--narma-ASvAsaH |
   niśā jalada-saṅkulā timira-garbha-līnaṃ jagad-	niSA jalada-saFkulA timira-garBa--lInam jagat--
   dvayas tava navaṃ navaṃ vapur apūrva-līlāmayam |	dvayaH tava navam navam vapuH apUrva--lIlA-mayam |
   alaṃ sumukhi nidrayā vraja gṛhe'pi naktaṃ carī	alam su-muKi nidrayA vraja gRhe-api naktam carI
   kadamba-vana-devatā nava-tamāla-nīla-dyutiḥ ||185||	kadamba-vana--devatA nava--tamAla--nIla--dyutiH ||185||
   sarvavidyāvinodānām |	sarva-vidyA-vinodAnAm |
   kṛṣṇaṃ prati rādhānurāga-kathanam |	kRzNam prati rADa-anurAga--kaTanam |
   tvām añjanīyati phalāsu vilokayantī	tvAm aQjanIyati PalAsu vilokayantI
   tvāṃ śṛṇvatī kuvalayīyati karṇapūram |	tvAm SRNvatI kuvalayIyati karNapUram |
   tvāṃ pūrṇimā-vidhu-mukhī hṛdi bhāvayantī	tvAm pUrNimA--viDu-muKI hRdi BAvayantI
   vakṣonilīna-nava-nīlamaṇiṃ karoti ||186||	vakzaH-nilIna-nava--nIla-maNim karoti ||186||
   kasyacit | (MSN 5.12)	kasyacid | (MSN 5.12)
   gṛhītaṃ tāmbūlaṃ parijana-vacobhir na sumukhī	gRhItam tAmbUlam parijana--vacoBiH na sumuKI
   smaraty antaḥśūnyā murahara gatāyām api niśi |	smarati antar-SUnyAH mura-hara gatAyAm api niSi |
   tatevāste hastaḥ kalita-phaṇi-vallī-kisalayas	tata-iva-Aste hastaH kalita--PaNi--vallI--kisalayas
   tathavāsyaṃ tasyāḥ kramuka-phala-phālī-paricitam ||187||	taTavAsyam tasyAH kramuka-Pala-PAlI--paricitam ||187||
   hariharasya | (UN 13.59)	hari-harasya | (Uj 13.59)
   prema-pāvaka-līḍhāṅgī	prema--pAvaka-lIXa-aFgI
   rādhā tava jagat-pate |	rADA tava jagat-pate |
   śayyāyāḥ skhalitā bhūmau	SayyAyAH sKalitA BUmO
   punas tāṃ gantum akṣamā ||188||	punar tAm gantum akzamA ||188||
   murahara sāhasa-garimā	mura-hara sAhasa--garimA
   katham iva vācyaḥ kuraṅga-śāvākṣyāḥ |	kaTam iva vAcyaH kuraFga-SAvAkzyAH |
   khedārṇava-patitāpi	Keda-arNava-patitA-api
   prema-madhurāṃ te na sā tyajati ||189||	prema--maDurAm te na sA tyajati ||189||
   kavicandrasyemau | (UN 8.100)	kavi-candrasya-imO | (Uj 8.100)
   gāyati gīte śaṃsati vaṃśe	gAyati gIte SaMsati vaMSe
   vādayati sā vipañcīṣu	vAdayati sA vipaQcIzu
   pāṭhayati pañjara-śukaṃ tava	pAWayati paQjara--Sukam tava
   sandeśākṣaraṃ rādhā ||190||	sandeSa-akzaram rADA ||190||
   govardhanācāryasya | (Ārya-śataka 211/265)	govarDana-AcAryasya | (Ārya-SatakaH 211/265)
   rādhāṃ prati kṛṣṇānurāga-kathanam	rADAm prati kRzNa-anurAga--kaTanam
   kelikalāsu kuśalā nagare murārer	keli-kalAsu kuSalAH nagare murAreH-
   ābhīra-nīraja-dṛśaḥ kati vā na santi |	ABIra--nIraja--dRSaH kati vA na santi |
   rādhe tvayā mahad akāri tapo yad eṣa	rADe tvayA mahat akAri tapaH yat eza
   dāmodaras tvayi paraṃ paramānurāgaḥ ||191||	dAmodaraH tvayi param parama-anurAgaH ||191||
   kasyacit || (UN 8.101)	kasyacid || (Uj 8.101)
   vatsān na cārayati vādayate na veṇum	vatsAt na cArayati vAdayate na veNum
   āmodate na yamunā-vana-mārutena |	Amodate na yamunA--vana--mArutena |
   kuñje nilīya śithilaṃ valitottamāṅgam	kuQje nilIya SiTilam valita-uttamAFgam
   antas tvayā śvasiti sundari nanda-sūnuḥ ||192||	antar tvayA Svasiti sundari nanda-sUnuH ||192||
   daityāri-paṇḍitasya ||	dEtya-ari--paNxitasya ||
   sarvādhikaḥ sakala-keli-kalā-vidagdhaḥ	sarva-aDikaH sakala--keli-kalA--vidagDaH
   snigdhaḥ sa eṣa mura-śatrur anargha-rūpaḥ |	snigDaH saH eza mura--SatruH anarGa--rUpaH |
   tvāṃ yācate yadi bhaja vraja-nāgari tvaṃ	tvAm yAcate yadi Baja vraja--nAgari tvam
   sādhyaṃ kim anyad adhikaṃ bhuvane bhavatyāḥ ||193|| rāṅgasya ||	sADyam kim anyat aDikam Buvane BavatyAH ||193|| rAFgasya ||
   atha rādhābhisāraḥ |	aTa rADABisAraH |
   mandaṃ nidhehi caraṇau paridhehi nīlaṃ	mandam niDehi caraNO pariDehi nIlam
   vāsaḥ pidhehi valayāvalim añcalena |	vAsaH piDehi valaya-Avalim aQcalena |
   mā jalpa sāhasini śārada-candra-kānti-	mA jalpa sAhasini SArada--candra--kAnti-
   dantāṃśavas tava tamāṃsi samāpayanti || 194 ||	danta-aMSavaH tava tamAMsi samApayanti || 194 ||
   ṣāṇmāsikasya || (SKM 2.61.2 nālasya, Spd 3620, Smv 71.8 hariharasya)	zANmAsikasya || (SKm 2.61.2 na-Alasya, SpD 3620, Smu 71.8 hari-harasya)
   kim uttīrṇaḥ panthāḥ kupita-bhujagī-bhoga-viṣamo	kim uttIrNaH panTAH kupita--Buja-gI--Boga--vizamaH-
   viṣoḍhā bhūyasyaḥ kim iti kulapālī-kaṭu-giraḥ |	viza-UXA BUyasyaH kim iti kula-pAlI--kawu-giraH |
   iti smāraṃ smāraṃ daradalita-śīta-dyuti-rucau	iti smAram smAram daradalita-SIta-dyuti--rucO
   sarojākṣī śoṇaṃ diśi nayana-koṇaṃ vikirati ||195||	sarojAkzI SoNam diSi nayana--koNam vikirati ||195||
   sarvavidyāvinodānām ||	sarva-vidyA-vinodAnAm ||
   citrotkīrṇād api viṣadharād bhītibhājo rajanyāṃ	citra-utkIrNAt api vizaDarAt BIti-BAjaH rajanyAm
   kiṃ vā brūmas tvad-abhisaraṇe sāhasaṃ mādhavāsyāḥ |	kim vA brUmaH tvad--aBisaraNe sAhasam mADava-asyAH |
   dhvānte yāntyā yad atinibhṛtaṃ rādhayātma-prakāśa-	DvAnte yAntyA yat ati-niBRtam rADaya-Atma--prakASa-
   trāsāt pāṇiḥ pathi phaṇi-phaṇāratna-rodhī vyadhāyī ||196||	trAsAt pANiH paTi PaNi--PaNA-ratna-roDI vyaDAyI ||196||
   kasyacit || (Spd 3494 hariharasya)	kasyacid || (Spd 3494 hari-harasya)
   rādhāṃ prati sakhī-vākyam	rADAm prati saKI--vAkyam
   manmathonmathitam acyutaṃ prati	manmaTa-unmaTitam acyutam prati
   brūhi kiñcana samullasat-smitam |	brUhi kiQcana samullasat--smitam |
   kiṃ ca siñca mṛga-śāva-locane	kim ca siQca mRga-SAva--locane
   locaneṅgita-sudhaugha-nirjharaiḥ ||197||	locana-iFgita-suDA-oGa--nirJarEH ||197||
   kasyacit ||	kasyacid ||
   govinde svayam akaroḥ sarojanetre	govinde svayam akaroH saroja-netre
   premāndhā varavapur arpaṇaṃ sakhi |	prema-anDAH vara-vapuH arpaNam saKi |
   kārpaṇyaṃ na kuru darāvaloka-dāne	kArpaNyam na kuru dara-avaloka-dAne
   vikrīte kariṇi kim añkuśe vivādaḥ ||198||	vikrIte kariNi kim aQkuSe vivAdaH ||198||
   kasyacit | (BRS 2.4.114, Bhaktirasāyana; DKK; MSN 5.15)	kasyacid | (BRH 2.4.114, Bhakti-rasAyana; DKK; MSN 5.15)
   atha krīḍā |	aTa krIxA |
   paramānurāga-parayātha rādhayā	parama-anurAga-parayA-aTa rADayA
   parirambha-kauśala-vikāśi-bhāvayā |	pariramBa--kOSala-vikASi--BAvayA |
   sa tayā saha smara-sabhājanotsavaṃ	sa tayA saha smara--saBA-jana-utsavam
   niravāhayac chikhi-śikhaṇḍa-śekharaḥ ||199||	niravAhayat SiKi-SiKaNxa--SeKaraH ||199||
   kavirāja-miśrasya | (BRS 3.5.35)	kavi-rAja--miSrasya | (BRH 3.5.35)
   asmin kuñje vināpi pracalati pavanaṃ vartate ko'pi nūnaṃ	asmin kuQje vinA-api pracalati pavanam vartate kaH-api nUnam
   paśyāmaḥ kiṃ na gatvety anusarati gaṇe bhīta-bhīte'rbhakāṇām |	paSyAmaH kim na gatvA-iti anusarati gaNe BIta--BIte-arBakANAm |
   tasmin rādhāsakho vaḥ sukhayatu vilasan krīḍayā kaiṭabhārir	tasmin rADA-saKaH vaH suKayatu vilasan krIxayA kEwaBAriH-
   vyātanvāno mṛgāri-pravala-ghuraghurārāva-raudroccanādān || 200 ||	vyAtanvAnaH mRga-ari--pravala--Gura-Gura-ArAva--rOdra-uccana-AdAn || 200 ||
   kasyacit || (Spd 116)	kasyacid || (Spd 116)
   atha krīḍānantaraṃ tatra jānatīnāṃ sakhīnāṃ narmoktiḥ	aTa krIxA-anantaram tatra jAnatInAm saKInAm narma-uktiH
   iha nicula-nikuñje madhya-madhyāsya rantur	iha nicula--nikuQje maDya-m-aDyAsya rantuH-
   vijanam ajani śayyā kasya bāla-pravālaiḥ |	vijanam ajani SayyA kasya bAla--pravAlEH |
   iti nigadati vṛnde yoṣitāṃ pāntu yuṣmān	iti nigadati vRnde yozitAm pAntu yuzmAn
   smita-śavalita-rādhā-mādhavālokitāni || 201 ||	smita-Savalita--rADA--mADava-AlokitAni || 201 ||
   rūpa-devasya || (SKM 1.55.1)	rUpa-devasya || (SKm 1.55.1)
   atha mugdha-bāla-vākyam	aTa mugDa--bAla--vAkyam
   kṛṣṇa tvad-vanamālayā saha kṛtaṃ kenāpi kuñjāntare	kRzNa tvad--vanamAlayA saha kRtam kena-api kuQja-antare
   gopī-kuntala-barha-dāma tad idaṃ prāptaṃ mayā gṛhyatām |	gopI--kuntala-barha-dAma tat idam prAptam mayA gRhyatAm |
   itthaṃ dugdha-mukhena gopa-śiśunākhyāne trapānamrayo	itTam dugDa--muKena gopa--SiSunA-AKyAne trapAn-amra-yaH-
   rādhā-mādhavayor jayanti balita-smerālasā dṛṣṭayaḥ ||202||	rADA--mADavayoH jayanti balita--smera-alasA dRzwayaH ||202||
   lakṣmaṇa-sena-devasya || (SKM 1.55.2)	lakzmaNa-sena--devasya || (SKm 1.55.2)
   atha rādhayā saha dināntare keliḥ tatra sakhī-vākyam	aTa rADayA saha dina-antare keliH tatra saKI--vAkyam
   adhunā dadhi-manthanānubandhaṃ	aDunA daDi-manTana-anubanDam
   kuruṣe kiṃ guru-vibhramālasāṅgi |	kuruze kim guru-viBrama-alasa-aFgi |
   kalasa-stani lālasīti kuñje	kalasa--stani lAlasi-iti kuQje
   muralī-komala-kākalī murāreḥ ||203||	muralI--komala-kAkalI murAreH ||203||
   samāhartuḥ ||	samAhartuH ||
   atha tasyāḥ sākūta-vākyam |	aTa tasyAH sa-AkUta--vAkyam |
   śvaśrūr iṅgita-daivataṃ nayanayor īhāliho yātaraḥ	SvaSrUH iFgita-dEvatam nayanayoH Iha-alihaH yAtaraH
   svāmī niḥśvasite'py asūyati manojighraḥ sapatnī-janaḥ |	svAmI niHSvasite-api asUyati manaH-jiGraH sapatnI--janaH |
   tad-dūrād ayam añjaliḥ kim adhunā dṛgbhaṅgi-bhāvena te	tad--dUrAt ayam aQjaliH kim aDunA dRS-BaFgi-BAvena te
   vaidagdhī-vividha-prabandha-rasika vyartho'yam atra śramaḥ ||204||	vEdagDI--viviDa--prabanDa--rasika vyarTaH-ayam atra SramaH ||204||
   kasyacit ||	kasyacid ||
   saṅketīkṛta-kokilādi-ninadaṃ kaṃsa-dviṣaḥ kurvato	saFketIkRta-kokila-Adi-ninadam kaMsa-dvizaH kurvataH-
   dvāronmocana-lola-śaṅkha-valaya-kvāṇaṃ muhuḥ śṛṇvataḥ |	dvAra-unmocana--lola--SaFKa-valaya--kvANam muhur SRNvataH |
   keyaṃ keyam iti pragalbha-jaratī-vākyena dūnātmano	kA-iyam kA-iyam iti pragalBa--jaratI--vAkyena dUna-AtmanaH-
   rādhā-prāṅgaṇa-koṇa-koli-viṭapi-kroḍe gatā śarvarī ||205||	rADA--prAFgaNa--koNa--koli--viwapi-kroxe gatA SarvarI ||205||
   harasya | (SKM 1.55.5 ācārya gopīkasya; BRK 5.1159)	harasya | (SKm 1.55.5 AcArya gopIkasya; BRS 5.1159)
   āhūtādya mayotsave niśi gṛhaṃ śūnyaṃ vimucyāgatā	AhUta-adya mayA-utsave niSi gRham SUnyam vimucya-AgatA
   kṣīvaḥ preṣyajanaḥ kathaṃ kulavadhūr ekākinī yāsyati |	kzIvaH prezya-janaH kaTam kula-vaDUH ekAkinI yAsyati |
   vatsa tvaṃ tad imāṃ nayālayam iti śrutvā yaśodā-giro	vatsa tvam tat imAm naya-Alayam iti SrutvA yaSodA--giraH-
   rādhā-mādhavayor jayanti madhura-smerālasā dṛṣṭayaḥ ||206||	rADA--mADavayoH jayanti maDura--smera-alasAH dRzwayaH ||206||
   śrī-mat-keśava-sena-devasya || (SKM 1.54.5)	SrI--mat-keSava-sena--devasya || (SKm 1.54.5)
   gacchāmy acyuta darśanena bhavataḥ kiṃ tṛptir utpadyate	gacCAmi acyuta darSanena BavataH kim tRptiH utpadyate
   kiṃ tv evaṃ vijana-sthayor hata-janaḥ sambhāvayaty anyathā |	kim tu evam vijana--sTayoH hata-janaH samBAvayati anyaTA |
   ity āmantraṇa-bhaṅgi-sūcita-vṛthāvasthāna-khedāsalām	iti AmantraNa--BaFgi--sUcita-vRTA-avasTAna--Keda-asalAm
   āśliṣyan pulakotkarāñcita-tanur gopīṃ hariḥ pātu vaḥ ||207||	ASlizyan pulaka-utkara-AQcita-tanuH gopIm hariH pAtu vaH ||207||
   kasyacit dākṣiṇātyasya | (Nāṭaka-candrikā 624 (260); RASK)	kasyacid dAkziNAti-asya | (NAwaka-candrikA 624 (260); RAH-K)
   atha sakhī-narma |	aTa saKI--narma |
   sakhi pulakinī sakampā	saKi pulakinI sa-kampA
   bahiḥ-sthalītas tvam ālayaṃ prāptā |	bahis--sTa-lItaH tvam Alayam prAptA |
   vikṣobhitāsi nūnaṃ	vikzoBitA-asi nUnam
   kṛṣṇa-bhujaṅgena kalyāṇi ||208||	kRzNa---BujaFgena kalyANi ||208||
   samāhartuḥ ||	samAhartuH ||
   atha punar anyedyur abhisārikā tatra sakhī-vākyam |	aTa punar anyedyus aBisArikA tatra saKI--vAkyam |
   aklānta-dyutibhir vasanta-kusumair uttaṃsayan kuntalā-	aklAnta--dyutiBiH vasanta--kusumEH uttaMsayan kuntalA-
   nantaḥ khelati khañjarīṭa-nayane kuñjeṣu kuñjekṣaṇaḥ |	nantaH Kelati KaQjarIwa--nayane kuQjezu kuQja-IkzaNaH |
   asmān mandira-karmatas tava karau nādyāpi viśrāmyataḥ	asmAn mandira-karmataH tava karO na-adya-api viSrAmyataH
   kiṃ brūmo rasaikāgraṇīr asi ghaṭī neyaṃ vilamba-kṣamā ||209 ||	kim brUmaH rasa-ekAgraNIH asi GawI na-iyam vilamba--kzamA ||209 ||
   tasyaiva | (MSN 5.16)	tasya-eva | (MSN 5.16)
   parīkṣaṇa-kāriṇīṃ sakhīṃ prati rādhā-vākyam |	parIkzaNa--kAriNIm saKIm prati rADA--vAkyam |
   lajjaivodghaṭitā kim atra kulśodbaddhā kapāṭa-sthitir	lajjA-eva-udGawitA kim atra kulSa-udbadDA kapAwa--sTitiH-
   maryādaiva vilaṅghitā pathi punaḥ keyaṃ kalindātmajā |	maryAdA-eva vilaFGitA paTi punar kA-iyam kalinda-AtmajA |
   ākṣiptā khala-dṛṣṭir eva sahasā vyālāvalī kīdṛśī	AkziptA Kala-dRzwiH eva sahasA vyAlAvalI kIdRSI
   prāṇā eva samarpitāḥ sakhi ciraṃ tasmai kim eṣā tanuḥ ||210||	prANAH eva samarpitAH saKi ciram tasmE kim ezA tanuH ||210||
   kasyacit |	kasyacid |
   dvitraiḥ keli-saroruhaṃ tri-caturair dhammilla-mallī-srajaṃ	dvitrEH keli--saroruham tri-caturEH Dammilla-mallI--srajam
   kaṇṭhān mauktika-mālikāṃ tad anu ca tyaktvā padaiḥ pañcamaiḥ |	kaNWAt mOktika-mAlikAm tat anu ca tyaktvA padEH paQcamEH |
   kṛṣṇa-prema-vighūrṇitāntaratayā dūrābhisārāturā	kRzNa--prema--viGUrNita-antara-tayA dUra-aBisAra-AturA
   tanvaṅgī nirupāyam adhvani paraṃ śreṇībharaṃ nindati || 211 ||	tanvaFgI nirupAyam aDvani param SreNI-Baram nindati || 211 ||
   kasyacit | (UN 13.19)	kasyacid | (Uj 13.19)
   atha vāsaka-sajjā |	aTa vAsaka--sajjA |
   talpaṃ kalpaya dūti pallava-kuler antarlatā-maṇḍape	talpam kalpaya dUti pallava-kuleH antar-latA--maNxape
   nirbandhaṃ mama puṣpa-maṇḍana-vidhau nādyāpi kiṃ muñcati |	nirbanDam mama puzpa-maNxana-viDO na-adya-api kim muQcati |
   paśya krīḍad-amandam andha-tamasaṃ vṛndāṭavīṃ tastare	paSya krIxad-a-mandam anDa-tamasam vRnda-awavIm tastare
   tad gopendra-kumāram atra milita-prāyaṃ manaḥ śaṅkate ||212||	tat gopendra-kumAram atra milita--prAyam manaH SaFkate ||212||
   śrī-raghunāthasya ||	SrI-raGu-nATasya ||
   athotkaṇṭhitā |	aTa-utkaNWitA |
   sakhi sa vijito vīṇā-vādyaiḥ kayāpy apara-striyā	saKi sa vijitaH vINA-a-vAdyEH kayA-api apara--striyA
   paṇitam abhavat tābhyāṃ tava kṣapā-lalitaṃ dhruvam |	paNitam aBavat tAByAm tava kzapA-a-lalitam Druvam |
   katham itarathā śephālīṣu skhalat-kusumāsv api	kaTam itaraTA SePAlIzu sKalat--kusumAsu api
   prasarati nabho-madhye'pīndau priyeṇa vilambyae ||213||	prasarati naBo--maDye-api-indO priyeNa vilambyae ||213||
   kasyacit | (SKM 2.39.3 rudraṭasya; Daśarūpaka 2.23; ST 1.78ad)	kasyacid | (SKm 2.39.3 rudra-wasya; DaSa-rUpakaH 2.23; ST 1.78ad)
   aratir iyam upaiti māṃ na nidrā	aratiH iyam upEti mAm na nidrA
   gaṇayati tasya guṇān mano na doṣān |	gaNayati tasya guNAn manaH na dozAn |
   viramati rajanī na saṅgam āśā	viramati rajanI na saFgam ASA
   vrajati tanus tanutāṃ na cānurāgaḥ ||214||	vrajati tanuH tanu-tAm na ca-anurAgaH ||214||
   kaṅkasya || (SKM 2.37.5 pravarasenasya, Spd 3427 bilhaṇasya, Srk 723)	kaFkasya || (SKm 2.37.5 pravara-senasya, SpD 3427 bilhaNasya, Src 723)
   atha vipralabdhā |	aTa vipralabDAH |
   uttiṣṭha dūti yāmo yāmo	uttizWa dUti yAmaH yAmaH-
   yātas tathāpi nāyātaḥ |	yAtaH taTA-api na-AyAtaH |
   yā'taḥ param api jīvej	yA-atas param api jIvet-
   jīvitanātho bhavet tasyāḥ ||215 ||	jIvita-nATaH Bavet tasyAH ||215 ||
   tasyaiva | (SD 3.83, Daś 2.26f)	tasya-eva | (SD 3.83, Das 2.26f)
   atha khaṇḍitā |	aTa KaNxitAH |
   lākṣā-lakṣma-lalāṭa-paṭṭam abhitaḥ keyūra-mudrā gale	lAkzA-a-lakzma--lalAwa--pawwam aBitas keyUra-mudrA gale
   vaktre kajjala-kālimā nayanayors tāmbūla-rāgo ghanaḥ |	vaktre kajjala-kAlimAH nayanayoH-H tAmbUla-rAgaH GanaH |
   dṛṣṭā kopa-vidhāyi maṇḍanam idaṃ prātaś ciraṃ preyaso	dRzwA kopa-viDAyi maNxanam idam prAtar ciram preyasaH-
   līlā-tāmarasodare mṛgadṛśaḥ śvāsāḥ samāptiṃ gatāḥ ||216||	lIlA-tAmarasodare mRga-dRSaH SvAsAH samAptim gatAH ||216||
   autkalasya || (Amaru 71/60; SKM 2.24.4; Spd 3740, Sbhv 2215; Smv 82.17;	Otkalasya || (Amaru 71/60; SKm 2.24.4; SpD 3740, SBu 2215; Smu 82.17;
   Daśarūpaka 2.6)	DaSa-rUpakaH 2.6)
   tasyā vākyam	tasyAH vAkyam
   kṛtaṃ mithyā-jalpair virama viditaṃ kāmuka cirāt	kRtam miTyA-jalpEH virama viditam kAmuka cirAt-
   priyāṃ tām evoccair abhisara yadīyair nakha-padaiḥ |	priyAm tAm eva-uccEs aBisara yadIyEH naKa-padEH |
   vilāsaiś ca prāptaṃ tava hṛdi padaṃ raga-bahulair	vilAsEH ca prAptam tava hRdi padam raga--bahulEH-
   mayā kiṃ te kṛtyaṃ dhruvam akuṭilācāra-parayā ||217||	mayA kim te kRtyam Druvam akuwila-AcAra-parayA ||217||
   rudraṭasya || (ST 1.80; Smv 58.8)	rudrawasya || (ST 1.80; Smu 58.8)
   sārdhaṃ manoratha-śatais tava dhūrta kāntā	sArDam manoraTa--SatEH tava DUrta kAntA
   saiva sthitā manasi kṛtrima-bhāva-ramyā |	sA-eva sTitA manasi kRtrima--BAva--ramyA |
   asmākam asti na hi kaścid ihāvakāśas	asmAkam asti na hi kaScid iha-AvakASa-s
   tasmāt kṛtaṃ caraṇa-pāta-viḍambanābhiḥ ||218||	tasmAt kRtam caraNa-pAta--vixambanABiH ||218||
   tasyaiva || (ST 1.41d; SKM 2.23.2; Spd 3563; Smv 57.16)	tasya-eva || (ST 1.41d; SKm 2.23.2; SpD 3563; Smu 57.16)
   analaṅkṛto'pi mādhava	analaFkRtaH-api mADava
   harasi mano me sadā prasabham |	harasi manaH me sadA prasaBam |
   kiṃ nālaṅkṛtas tvaṃ	kim na-alaFkRtaH tvam
   samprati nakha-kṣatais tasyāḥ ||219||	samprati naKa--kzatEH tasyAH ||219||
   viśvanāthasya | (SD 3.63)	viSvanATasya | (SD 3.63)
   khaṇḍanāpta-nirvedāyās tasyā vākyam |	KaNxanApta--nirvedAyAH tasyAH vAkyam |
   vaytītāḥ prārambhāḥ praṇaya-bahumāno vigalito	vaytItAH prAramBAH praNaya--bahu-mAnaH vigalitaH-
   durāśā yātā me pariṇatir iyaṃ prāṇitum api |	durASA yAtA me pariNatiH iyam prANitum api |
   yatheṣṭhaṃ ceṣṭantāṃ virahi-vadha-vihyāta-yaśaso	yaTezWam cezwantAm virahi--vaDa--vihyAta--yaSaso
   vibhāvā mayy ete pika-madhu-sudhāṃśu-prabhṛtayaḥ ||220||	viBAvAH mayi ete pika--maDu--suDAMSu--praBRtayaH ||220||
   puruṣottamadevasya ||	puruzottama-devasya ||
   mā muñca pañcaśara pañcaśarīṃ śarīre	mA muQca paQcaSara paQcaSarIm SarIre
   mā siñca sāndra-makaranda-rasena vāyo |	mA siQca sAndra-maka-randa--rasena vAyo |
   aṅgāni tat-praṇaya-bhaṅga-vigarhitāni	aFgAni tat--praNaya--BaFga--vigarhitAni
   nālambituṃ katham api kṣamate'dya jīvaḥ ||221 ||	na-Alambitum kaTam api kzamate-adya jIvaH ||221 ||
   tasyaiva | (BRS 3.5.17)	tasya-eva | (BRH 3.5.17)
   punaḥ sāyam āyāti mādhave	punar sAyam AyAti mADave
   kañcana vañcana-cature	kaQcana vaQcana--cature
   prapañcaya tvaṃ murāntake mānam |	prapaQcaya tvam murA-antake mAnam |
   bahu-vallabhe hi puruṣe	bahu--vallaBe hi puruze
   dākṣiṇyaṃ duḥkham udvahati ||222||	dAkziNyam duHKam udvahati ||222||
   samāhartuḥ || (UN 8.33)	samAhartuH || (Uj 8.33)
   atha māninī	aTa mAninI
   bhavatu viditaṃ chadmālāpair alaṃ priya gamyatāṃ	Bavatu viditam Cadma-AlApEH alam priya gamyatAm
   tanur api na te doṣo'smākaṃ vidhis tu parāṅmukhaḥ |	tanuH api na te dozaH-asmAkam viDiH tu parAFmuKaH |
   tava yathā tathābhūtaṃ prema prapannam imāṃ daśāṃ	tava yaTA taTABUtam prema prapannam imAm daSAm
   prakṛti-capale kā naḥ pīḍā gate hata-jīvite || 223 ||	prakRti-capale kA naH pIxA gate hata--jIvite || 223 ||
   amaroḥ || (Amaru 28/30; SKM 2.47.3)	amaroH || (Amaru 28/30; SKm 2.47.3)
   kas tvaṃ tāsu yadṛcchayā kitava yās tiṣṭhanti gopāṅganāḥ	kaH tvam tAsu yadRcCayA kitava yAH tizWanti gopa-aFganAH
   premāṇaṃ na vidanti yās tava hare kiṃ tāsu te kaitavam |	premANam na vidanti yAH tava hare kim tAsu te kEtavam |
   eṣā hanta hatāśayā yad abhavaṃ tvayy ekatānā paraṃ	ezA hanta hata-ASayAH yat aBavam tvayi eka-tAnA param
   tenāsyāḥ praṇayo'dhunā khalu mama prāṇaiḥ samaṃ yāsyati || 224 ||	tena-asyAH praNayaH-aDunA Kalu mama prANEH samam yAsyati || 224 ||
   puruṣottamadevasya |	puruzottama-devasya |
   niṣkrāmati kṛṣṇe sakhī-vākyam	nizkrAmati kRzNe saKI--vAkyam
   sāci-kandharam amuṃ kim īkṣase	sAci--kanDaram amum kim Ikzase
   yātu yātu sakhi pūtanārdanaḥ |	yAtu yAtu saKi pUtanA-ardanaH |
   vāmarīticaturāṃ hi pāmrīṃ	vAmarIti-caturAm hi pAmrIm
   sevatāṃ parama-devatām iva || 225 ||	sevatAm parama-devatAm iva || 225 ||
   samāhartuḥ |	samAhartuH |
   kṛṣṇa-dūtī-vākyam	kRzNa-dUtI--vAkyam
   premāvagāhana-kṛte mānaṃ mā kuru cirāya karabhoru |	prema-avagAhana-kRte mAnam mA kuru cirAya karaBa-Uru |
   nākarṇi kiṃ nu mugdhe jātaṃ pīyūṣa-manthane garalam ||226||	nAkarNi kim nu mugDe jAtam pIyUza-manTane garalam ||226||
   vidhumukhi vimukhībhāvaṃ bhāvini mad-bhāṣaṇe mā gāḥ |	viDu-muKi vimuKIBAvam BAvini mad--BAzaNe mA gAH |
   mūḍhe nigama-nigūḍhaḥ katipaya-kalyāṇato milati ||227||	mUXe nigama-nigUXaH katipaya--kalyANataH milati ||227||
   rāṅgasyaitau ||	rAFgasya-etO ||
   dūtīṃ prati rādhā-vākyam	dUtIm prati rADA--vAkyam
   alam alam aghṛṇasya tasya nāmnā	alam alam aGRNasya tasya nAmnA
   punar api saiva katha gataḥ sa kālaḥ |	punar api sA-eva kaTa gataH sa kAlaH |
   kathaya kathaya vā tathāpi dūti	kaTaya kaTaya vA taTA-api dUti
   prativacanaṃ dviṣato'pi mānanīyam ||228||	prativacanam dvizataH-api mAnanIyam ||228||
   aṅgadasya || (Sbhv 1418; Spd 3513; Smv 47.3)	aFgadasya || (SBu 1418; SpD 3513; Smu 47.3)
   atha kalahāntaritā |	aTa kalaha-antaritA |
   tāṃ prati dakṣiṇa-sakhī-vākyam	tAm prati dakziNa--saKI--vAkyam
   anālocya premṇaḥ pariṇatim anādṛtya suhṛdas	anAlocya premNaH pariNatim anAdRtya suhRdas
   tvayākāṇḍe mānaḥ kim iti sarale preyasi kṛtaḥ |	tvayA-akANxe mAnaH kim iti sarale preyasi kRtaH |
   samākṛṣṭā hy ete viraha-dahanodbhāsura-śikhāḥ	samAkRzwAH hi ete viraha--dahana-udBAsura--SiKAH
   sva-hastenāñgārās tad alam adhunāraṇya-ruditaiḥ ||229||	sva-hastena-aQgArAH tat alam aDunA-araNya-ruditEH ||229||
   amaroḥ || (Amaru 112/80; Sbhv 1170; SKM 2.42.1, Smv 56.9, Srk 659	amaroH || (Amaru 112/80; SBu 1170; SKm 2.42.1, Smu 56.9, Srk 659
   Vikaṭanitambā)	Vikawa-nitambA)
   atha karkaśa-sakhī-vākyam	aTa karkaSa--saKI--vAkyam
   māna-bandham abhitaḥ ślathayantī	mAna-banDam aBitas SlaTayantI
   gauravaṃ na khalu hāraya gauri |	gOravam na Kalu hAraya gOri |
   ārjavaṃ na bhajate danujārir	Arjavam na Bajate danujAriH-
   vañcake saralatā na hi sādhvī || 230 ||	vaQcake saralatA na hi sADvI || 230 ||
   samāhartuḥ ||	samAhartuH ||
   tāṃ prati rādhā-vākyam	tAm prati rADA--vAkyam
   bhrū-bhaṅgo guṇitaś ciraṃ nayanayor abhyastam āmīlanaṃ	BrU-BaFgaH guNitaH ciram nayanayoH aByastam AmIlanam
   roddhuṃ śikṣitam ādareṇa hasitaṃ maune'bhiyogaḥ kṛtaḥ |	rodDum Sikzitam AdareNa hasitam mOne-aBiyogaH kRtaH |
   dhairyaṃ kartum api sthirīkṛtam idaṃ cetaḥ kathañcin mayā	DEryam kartum api sTirIkRtam idam cetaH kaTaQcid mayA
   baddho māna-parigrahe parikaraḥ siddhis tu daive sthitā || 231 ||	badDaH mAna--parigrahe parikaraH sidDiH tu dEve sTitAH || 231 ||
   amaroḥ ||(Amaru 118/97)	amaroH ||(Amaru 118/97)
   jānāmi maunam alasāñgi vaco-vibhaṅgīr	jAnAmi mOnam alasAQgi vaco-viBaFgIH-
   bhañgī-śataṃ nayanayor api cāturīṃ ca |	BaQgI--Satam nayanayoH api ca-AturIm ca |
   ābhīra-nandana-mukhāmbuja-saṅga-śaṃsī	ABIra--nandana--muKa-ambuja--saFga-SaMsI
   vaṃśīravo yadi na mām avaśīkaroti ||232|| kasyacit ||	vaMSIravaH yadi na mAm avaSIkaroti ||232|| kasyacid ||
   satyaṃ śṛṇomi sakhi nitya-nava-priyo'sau	satyam SRNomi saKi nitya-nava--priyaH-asO
   gopas tathāpi hṛdayaṃ madano dunoti |	gopaH taTA-api hRdayam madanaH dunoti |
   yuktyā kathañcana samaṃ gamite'pi tasmin	yuktyA kaTaQcana samam gamite-api tasmin
   māṃ tasya kāla-muralī kavalīkaroti ||233||	mAm tasya kAla-muralI kavalIkaroti ||233||
   śrī-mat-prabhūnām |	SrI--mat--praBUnAm |
   na jāne sammukhāyāte	na jAne sammuKa-AyAte
   priyāṇi vadati priye |	priyANi vadati priye |
   prayānti mama gātrāṇi	prayAnti mama gAtrANi
   śrotratāṃ kim u netratām ||234||	Srotra-tAm kim u netra-tAm ||234||
   kasyacit || (Amaru 63/64)	kasyacid || (Amaru 63/64)
   murāriṃ paśyantyāḥ sakhi sakalam aṅgaṃ na nayanaṃ	murArim paSyantyAH saKi sakalam aFgam na nayanam
   kṛtaṃ yac chṛṇvantyāḥ hari-guṇa-gaṇaṃ śrotra-nicitam |	kRtam yat SRNvantyAH hari--guNa--gaNam Srotra--nicitam |
   samaṃ tenālāpaṃ sapadi racayantyā mukham ayaṃ	samam tena-AlApam sapadi racayantyA muKam ayam
   vidhātur naivāyaṃ ghaṭan-paripāṭī-madhurimā ||235||	viDAtuH na-eva-ayam Gawan--paripAwI--maDuH-imAH ||235||
   śaraṇasya |	SaraNasya |
   atha sakhyāḥ sābhyusūyā-vākyam |	aTa saKyAH sa-aByusUyA--vAkyam |
   tvam asi viśuddhā sarale	tvam asi viSudDA sarale
   muralī-vaktras tridhā vakraḥ |	muralI-vaktraH triDA vakraH |
   bhaṅgurayā khalu sulabhaa	BaFgurayA Kalu sulaBaa
   tad uraḥ sakhi vejayanty eva || 236 ||	tat uraH saKi vejayanti eva || 236 ||
   samāhartuḥ |	samAhartuH |
   atha kṣubhita-rādhikoktiḥ |	aTa kzuBita--rADika-uktiH |
   niḥśvāsā vadanaṃ dahanti hṛdayaṃ nirmūlam unmathyate	niHSvAsAH vadanam dahanti hRdayam nirmUlam unmaTyate
   nidrā neti na dṛśyate priyamukhaṃ rātrindivaṃ rudyate |	nidrA na-iti na dRSyate priya-muKam rAtrindivam rudyate |
   aṅgaṃ śoṣam upaiti pāda-patitaḥ preyāṃs tathopekṣitaḥ	aFgam Sozam upEti pAda--patitaH preyAn taTA-upekzitaH
   sakhyaḥ kaṃ guṇam ākalayya dayite mānaṃ vayaṃ kāritāḥ ||237||	saKyaH kam guNam Akalayya dayite mAnam vayam kAritAH ||237||
   amaroḥ | (Amaru 98/92; SKM 2.41.2)	amaroH | (Amaru 98/92; SKm 2.41.2)
   mānaja-viraheṇa dhyāyantīṃ tāṃ prati kasyāścid vākyam |	mAna-ja--viraheNa DyAyantIm tAm prati kasyAScid vAkyam |
   āhāre viratiḥ samasta-viṣaya-grāme nivṛttiḥ parā	AhAre viratiH samasta--vizaya--grAme nivRttiH parA
   nāsāgre nayanaṃ yad etad aparaṃ yac caikatānaṃ manaḥ |	nAsA-agre nayanam yat etat aparam yat ca-EkatAnam manaH |
   maunaṃ cedam idaṃ ca śūnyam akhilaṃ yad viśvam ābhāti te	mOnam ca-idam idam ca SUnyam aKilam yat viSvam ABAti te
   tad brūyāḥ sakhi yoginī kim asi bhoḥ kiṃ viyoginy api ||238||	tat brUyAH saKi yoginI kim asi BoH kim viyogini api ||238||
   (SKM 2.25.2, Srk 703 Rajasekhara, UN 13.75)	(SKm 2.25.2, Src 703 Raja-seKara, UN 13.75)
   taṃ prati rādhā-vākyam |	tam prati rADA--vAkyam |
   saṅgama-viraha-vikalpe	saFgama--viraha--vikalpe
   varam iha viraho na tu saṅgamas tasya |	varam iha virahaH na tu saFgamaH tasya |
   ekaḥ sa eva saṅge	ekaH saH eva saFge
   tribhuvanam api tanmayaṃ virahe ||239||	triBuvanam api tad-mayam virahe ||239||
   kasyacit | (SKM 2.99.4)	kasyacid | (SKm 2.99.4)
   atha kṛṣṇa-virahaḥ |	aTa kRzNa-virahaH |
   sañjāte virahe kayāpi hṛdaye sandānite cintayā	san-jAte virahe kayA-api hRdaye sandAnite cintayA
   kālindī-taṭa-vetasī-vana-ghana-cchāyā-niṣaṇṇātmanaḥ |	kAlindI--tawa-vetasI--vana-Gana--=-CAyA-nizaNNa-AtmanaH |
   pāyāsuḥ kalakaṇṭha-kūjita-kalā gopasya kaṃsa-dviṣo	pAyAsuH kala-kaNWa--kUjita-kalA gopasya kaMsa--dvizaH-
   jihvā-varjita-tālu-mūrcchita-marud-visphāritā gītayaḥ ||240||	jihvA--varjita--tAlu--mUrcCita-marut--visPAritAH gItayaH ||240||
   kasyacit || (SKM 1.58.1)	kasyacid || (SKm 1.58.1)
   atha rādhā-prasādanam |	aTa rADA--prasAdanam |
   śiraś chāyāṃ kṛṣṇaḥ svayam akṛta rādhā-caraṇayor	SiraH CAyAm kRzNaH svayam akRta rADA--caraNayoH-
   bhujāvallī-cchāyām iyam api tadīya-pratikṛtau |	Buja-AvallI-=-CAyAm iyam api tadIya--pratikRtO |
   iti krīḍā-kope nibhṛtam ubhayor apy anunaya-	iti krIxA--kope niBRtam uBayoH api anunaya-
   prasādau jīyās tām api guru-samakṣaṃ sthitavatoḥ ||241||	prasAdO jIyAH tAm api guru--samakzam sTitavatoH ||241||
   harasya |	harasya |
   kṛṣṇaṃ prati rādhā-sakhī-vākyam |	kRzNam prati rADA--saKI--vAkyam |
   sā sarvathaiva raktā rāgaṃ	sA sarvaTA-eva raktA rAgam
   guñjeva na tu mukhe vahati |	guQjA-iva na tu muKe vahati |
   vacana-paṭos tava rāgaḥ	vacana--pawoH tava rAgaH
   kevalam āsye śukasyeva ||242||	kevalam Asye Sukasya-iva ||242||
   govardhanācāryasya | (Aryas 649/703)	govarDana-AcAryasya | (AryaH 649/703)
   subhaga bhavatā hṛdye tasyā jvalat-smara-pāvake'py	suBaga BavatA hRdye tasyAH jvalat-smara--pAvake-api-
   abhiniveśatā premādhikyaṃ cirāt prakaṭīkṛtam |	aBiniveSa-tA prema-ADikyam cirAt prakawIkRtam |
   tava tu hṛdaye śīte'py evaṃ sadaiva sukhāptaye	tava tu hRdaye SIte-api evam sadA-eva suKa-Aptaye
   mama sahacarī sā niḥsnehā manāg api na sthitā ||243||	mama sahacarI sA niHsnehA manAk api na sTitAH ||243||
   rudrasya | (Śṛṅgāra-tilaka 2.108)	rudrasya | (ŚRFgAra-tilakaH 2.108)
   atha dināntara-vārtā |	aTa dina-antara--vArtA |
   āgatya praṇipāta-sāntvita-sakhī-dattāntaraṃ sāgasi	Agatya praNipAta--sAntvita--saKI--datta-antaram sa-Agasi
   svairaṃ kurvati talpa-pārśva-nibhṛte dhūrte'ṅga-saṃvāhanam |	svEram kurvati talpa--pArSva--niBRte DUrte-aFga--saMvAhanam |
   jñātvā sparśa-vaśāt tayā kila sakhī-bhrānty eva vakṣaḥ śanaiḥ	jQAtvA sparSa--vaSAt tayA kila saKI-BrAnti eva vakzaH SanEs-
   khinnāsīty abhidhāya mīlita-dṛśā sānandam āropitaḥ ||244||	KinnAsi-iti aBiDAya mIlita-dRSA sa-Anandam AropitaH ||244||
   kasyacit | (Spd 3576; Sbhv 2083; Smv 58.5)	kasyacid | (Spd 3576; SBu 2083; Smu 58.5)
   vastutas tu guru-bhītayā tayā	vastutas tu guru-BItayA tayA
   vyañjite kapaṭamāna-kuṭmale |	vyaQjite kapawamAna--kuwmale |
   peśala-priya-sakhī-dṛśā harir	peSala--priya--saKI-dRSA hariH-
   bodhitas taṭa-latā-gṛhaṃ yayau ||245||	boDitaH tawa-latA--gRham yayO ||245||
   mādhavo madhura-mādhavī-latā-	mADavaH maDura--mADavI--latA-
   maṇḍape paṭu-raṭan-madhuvrate |	maNxape pawu-rawan--maDuvrate |
   saṃjagau śravaṇa-cāru gopikā-	saMjagO SravaNa-cAru gopikA-
   māna-mīna-vaḍiśena veṇunā ||246||	mAna--mIna--vaxiSena veNunA ||246||
   kayościd imau | (UN 10.64, RSAK 1.100f)	kayoH-cit imO | (Uj 10.64, RSAK 1.100f)
   puṣpa-cchalena kṛṣṇam anveṣayantīṃ rādhāṃ prati kasyāścid uktiḥ |	puzpa--cCalena kRzNam anvezayantIm rADAm prati kasyAScid uktiH |
   panthāḥ kṣemamayo'stu te parihara pratyūha-sambhāvanām	panTAH kzema-mayaH-astu te parihara pratyUha--samBAvanAm
   etan-mātram adhāri sundari mayā netra-praṇālī-pathe |	etan--mAtram aDAri sundari mayA netra--praNAlI--paTe |
   nīre nīla-sarojam ujjvala-guṇaṃ tīre tamālālaṅkāraḥ	nIre nIla--sarojam ujjvala-guNam tIre tamAla-alaFkAraH
   kuñje ko'pi kalinda-śaila-duhituḥ puṃskokilaḥ khelati ||247||	kuQje kaH-api kalinda--SEla-duhituH puMskokilaH Kelati ||247||
   sarva-vidyāvinodānām |	sarva-vidyA-vinodAnAm |
   tatra yamunā-tīre gatayā rādhayā saha saṃkathā |	tatra yamunA--tIre gatayA rADayA saha saMkaTA |
   kā tvaṃ mādhava-dūtikā vadasi kiṃ mānaṃ jahīti priye	kA tvam mADava-dUtikA vadasi kim mAnam jahi-iti priye
   dhūrtaḥ so'nyamanā manāg api sakhi tvayy ādaraṃ nojjhati |	DUrtaH saH-anya-manAH manAk api saKi tvayi Adaram na-ujJati |
   ity anyonya-kathā-rasaiḥ pramuditāṃ rādhāṃ sakhī-veśavān	iti anyonya--kaTA--rasEH pramuditAm rADAm saKI-veSavAn
   nītvā kuñja-gṛhaṃ prakāśitatanuḥ smero hariḥ pātu vaḥ ||248||	nItvA kuQja--gRham prakASita-tanuH smeraH hariH pAtu vaH ||248||
   vāsavasya ||	vAsavasya ||
   vasantaḥ sannaddho vipinam ajanaṃ tvaṃ ca taruṇī	vasantaH sannadDaH vipinam ajanam tvam ca taruNI
   sphurat-kāmāveśe vayasi vayam apy āhita-padāḥ |	sPurat---kAma-AveSe vayasi vayam api Ahita-padAH |
   vraja tvaṃ vā rādhe kṣaṇam atha vilambasva yadi vā	vraja tvam vA rADe kzaNam aTa vilambasva yadi vA
   sphuṭaṃ jātas tāvac catura-vacanānām avasaraḥ ||249|| kasyacit ||	sPuwam jAtaH tAvat catura-vacanAnAm avasaraH ||249|| kasyacid ||
   tatra rādhā-vākyam	tatra rADA--vAkyam
   svāmī mugdhataro vanaṃ ghanam idaṃ bālāham ekākinī	svAmI mugDataraH vanam Ganam idam bAlA-aham ekAkinI
   kṣauṇīm āvṛṇute tamāla-malina-cchāyā-tamaḥ-santatiḥ |	kzONIm AvRNute tamAla--malina--=-CAyA-a-tamaH--santatiH |
   tan me sundara kṛṣṇa muñca sahasā vartmeti rādhā-giraḥ	tat me sundara kRzNa muQca sahasA vartma-iti rADA-giraH
   śrutvā tāṃ parirabhya manmatha-kalāsakto hariḥ pātu vaḥ || 250 ||	SrutvA tAm pariraBya manmaTa-kalA-saktaH hariH pAtu vaH || 250 ||
   kasyacit ||	kasyacid ||
   atha svādhīna-bhartṛkā |	aTa svADIna--BartRkA |
   makarī-viracana-bhaṅgyā	makarI--viracana--BaFgyA
   rādhā-kuca-kalasa-mardana-vyasanī |	rADA-kuca-kalasa--mardana--vyasanI |
   ṛjum api rekhāṃ lumpan	Rjum api reKAm lumpan
   vallava-veśo harir jayati ||251|	vallava-veSaH hariH jayati ||251|
   kasyacit || (Spd 77 hariharasya)	kasyacid || (Spd 77 hari-harasya)
   krīḍānantaraṃ kṛṣṇasya svapnāyitam |	krIxA-anantaram kRzNasya svapnAyitam |
   ete lakṣmaṇa jānakī-virahiṇaṃ māṃ khedayanty ambudā	ete lakzmaNa jAnakI--virahiNam mAm Kedayanti ambudA
   marmāṇīva ca ghaṭṭayanty alam amī krūrāḥ kadambānilāḥ |	marmANi-iva ca Gawwayanti alam amI krUrAH kadamba-anilAH |
   itthaṃ vyāhṛta-pūrva-janma-viraho yo rādhayā vīkṣitaḥ	itTam vyAhRta--pUrva--janma-virahaH yaH rADayA vIkzitaH
   serṣyaṃ śaṅkitayā sa vaḥ sukhayatu svapnāyamāno hariḥ ||252||	sa-Irzyam SaFkitayA sa vaH suKayatu svapnAyamAnaH hariH ||252||
   śubhāṅkasya | (KK 2.69(70); Srk 131)	SuBa-aFkasya | (KK 2.69(70); Src 131)
   atha vaṃśī-cauryam |	aTa vaMSI--cOryam |
   nīcair nyāsād atha caraṇayor nūpura mūkayantī	nIcEs nyAsAt aTa caraNayoH nUpura mUkayantI
   dhṛtvā dhṛtvā kataka-valayāny utkṣipantī bhujānte |	DRtvA DRtvA kataka--valayAni utkzipantI Buja-ante |
   mudrām akṣṇoś cakitaṃ śaśvad ālokayantī	mudrAm akzNoH cakitam SaSvat AlokayantI
   smitvā smitvā harati muralīm aṅkato mādhavasya ||253||	smitvA smitvA harati muralIm aFkataH mADavasya ||253||
   daityāri-paṇḍitasya | (UN 15.238)	dEtya-ari--paNxitasya | (Uj 15.238)
   tāṃ prati rādhā-vākyam |	tAm prati rADA--vAkyam |
   acchidram astu hṛdayaṃ paripūrṇam astu	acCidram astu hRdayam paripUrNam astu
   maukharyam astamitam astu gurutvam astu |	mOKaryam astamitam astu guru-tvam astu |
   kṛṣṇa-priye sakhi diśāmi sadāśiṣas te	kRzNa--priye saKi diSAmi sadASizaH te
   yad vāsare murali me karuṇāṃ karoṣi ||254||	yat vAsare murali me karuNAm karozi ||254||
   śrī-govinda-miśrāṇām ||	SrI---govinda--miSrANAm ||
   śūnyatvaṃ hṛdaye salāghavam idaṃ śuṣkatvam aṅgeṣu me	SUnya-tvam hRdaye sa-lAGavam idam Suzka-tvam aFgezu me
   maukharyaṃ vraja-nātha-nāma-kathane dattaṃ bhavatyā nijam |	mOKaryam vraja-nATa--nAma--kaTane dattam BavatyA nijam |
   tat kiṃ no murali prayaccasi pnar govinda-vaktrāsavaṃ	tat kim naH murali prayaccasi pnar govinda--vaktra-Asavam
   yaṃ pītvā bhuvanaṃ vaśe vidadhatī nirlajjam udgāyasi ||255||	yam pItvA Buvanam vaSe vidaDatI nirlajjam udgAyasi ||255||
   teṣām eva ||	tezAm eva ||
   atha sāyaṃ harer vrajāgamanam |	aTa sAyam hareH vraja-Agamanam |
   mandra-kvāṇita-veṇur ahni śithile vyāvartayan gokulaṃ	mandra-kvANita-veNuH ahni SiTile vyAvartayan go-kulam
   barhāpīḍakam uttamāṅga-racitaṃ godhūli-dhumraṃ dadhat |	barha-ApIxakam uttamAFga--racitam goDUli-Dumram daDat |
   mlāyantyā vana-mālayā parigataḥ śrānto'pi ramyākṛtir	mlAyantyA vana-mAlayA parigataH SrAntaH-api ramya-AkRtiH-
   gopa-strī-nayanotsavo vitaratu śreyāṃsi vaḥ keśavaḥ ||256||	gopa--strI--nayana-utsavaH vitaratu SreyAMsi vaH keSavaH ||256||
   kasyacit || (Kvs 22, SKM 1.57.4, Srk 110)	kasyacid || (KvH 22, SKm 1.57.4, Src 110)
   tatra kasyāścid uktiḥ |	tatra kasyAScid uktiH |
   dṛṣṭyā keśava gopa-rāga-hatayā kiñcin na dṛṣṭaṃ mayā	dRzwyA keSava gopa-rAga-hatayA kiQcid na dRzwam mayA
   tenādya skhalitāsmi nātha patitāṃ kiṃ nāma nālambase |	tena-adya sKalitA-asmi nATa patitAm kim nAma na-Alambase |
   ekas tvaṃ viṣameṣu khinna-manasāṃ sarvābalānāṃ gatir	ekaH tvam vizamezu Kinna--manasAm sarva-abalAnAm gatiH-
   gopyaivaṃ gaditaḥ saleśam avatād goṣṭhe harir vaś ciram || 257 ||	gopya-evam gaditaH sa-leSam avatAt gozWe hariH vaH ciram || 257 ||
   kasyacit || (Dhvan, Vakro, SD 4.14; Smv 2.93; different kinds of vyaṅgya)	kasyacid || (Dhvan, Vakro, SD 4.14; Smu 2.93; different kindH of vyaFgya)
   nābhi-deśa-viniveśita-veṇur	nABi-deSa--viniveSita-veNuH-
   dhenu-puccha-nihitaika-karābjaḥ |	Denu--pucCa--nihita-eka-kara-abjaH |
   anya-pāṇi-parimaṇḍita-daṇḍaḥ	anya--pANi--parimaNxita-daNxaH
   puṇḍarīka-nayano vrajam āpa ||258||	puNxarIka-nayanaH vrajam ApaH ||258||
   kasyacit ||	kasyacid ||
   tatraiva rādhāyāḥ saubhāgyam |	tatra-eva rADAyAH sOBAgyam |
   bhrūvallī-calanaiḥ kayāpi nayanonmeṣaiḥ kayāpi smita-	BrU-vallI--calanEH kayA-api nayana-unmezEH kayA-api smita-
   jyotsnāvicchuritaiḥ kayāpi nibhṛtaṃ sambhāvitasyādhvani |	jyotsnA-vicCuritEH kayA-api niBRtam samBAvitasya-aDvani |
   garvād bheda-kṛtāvahela-vinaya-śrī-bhāji rādhānane	garvAt Beda-kRta-avahela--vinaya--SrI--BAji rADAnane
   sātaṅkānunayaṃ jayanti patitāḥ kaṃsadviṣaḥ dṛṣṭayaḥ ||259||	sa-AtaFka-anunayam jayanti patitAH kaMsadvizaH dRzwayaH ||259||
   umāpatidharasya || (SKM 1.55.3, RKAD 129)	umApatiDarasya || (SKm 1.55.3, RKAD 129)
   tiryak-kandharam aṃsadeśa-milita-śrotrāvataṃsaṃ sphurad-	tiryak--kanDaram aMsa-deSa--milita--Srotra-avataMsam sPurat--
   barhottambhita-keśa-pāśam anṛju-bhrū-vallarī-vibhramam |	barha-uttamBita-keSa--pASam anRju--BrU--vallarI--viBramam |
   guñjad-veṇu-niveśitādhara-puṭaṃ sākūta-rādhānana-	guQjad-veNu--niveSita-aDara--puwam sa-AkUta-rADa-Anana-
   nyastāmīlita-dṛṣṭi gopa-vapuṣo viṣṇor mukhaṃ pātu vaḥ ||260||	nyasta-AmIlita-dRzwi gopa--vapuzaH vizNoH muKam pAtu vaH ||260||
   lakṣmaṇa-sena-devasya || (SKM 1.55.2)	lakzmaNa-sena--devasya || (SKm 1.55.2)
   aṃsāsakta-kapola-vaṃśa-vadana-vyāsakta-bimbādhara-	aMsa-Asakta--kapola--vaMSa--vadana--vyAsakta--bimba-aDara-
   dvandvodīrita-manda-manda-pavana-prārabdha-mugdha-dhvaniḥ |	dvandva-udIrita-manda--manda--pavana--prArabDa--mugDa--DvaniH |
   īṣad-vakrima-lola-hāra-nikaraḥ pratyekarokānana-	Izat--vakrima--lola--hAra--nikaraH pratyekaroka-Anana-
   nyañcac-cañcad-udañcad-aṅguli-cayas tvāṃ pātu rādhā-dhavaḥ ||261||	nyaQca-c-caQcat--u-daQcat--aFguli-cayaH tvAm pAtu rADA-DavaH ||261||
   nāthokasya || (SKM 1.57.5 keśara-kīlīya-nāthokasya)	nATokasya || (SKm 1.57.5 keSara-kIlIya--nATokasya)
   aṅguṣṭhāgrima-yantritāṅgulir asau pādārtha-nīruddha-bhūr	aFguzWa-agri-ma-yantrita-aFguliH asO pAda-arTa-nIrudDa-BUH-
   ārdrīkṛtya payodharāñcalam alaṃ sadyaḥ payo-bindubhiḥ |	ArdrIkRtya payoDara-aQcalam alam sadyas payo-binduBiH |
   nyag-jānu-dvaya-madhya-yantrita-gahṭī-vaktrāntarāla-skhalad-	nyag-ja-anu-dvaya--maDya-yantrita--gahwI--vaktra-antarAla--sKala-t--
   dhārādhvāna-manoharaṃ sakhi payo gāṃ dogdhi dāmodaraḥ || 262 ||	DArADvAna--manoharam saKi payaH gAm dogDi dAmodaraH || 262 ||
   śaraṇasya || (SKM 5.1.1; Srk 1157, Upādhyāya Dāmarasya; UN 10.50)	SaraNasya || (SKm 5.1.1; Src 1157, UpADyAya DAmarasya; UN 10.50)
   śāṭhān yasyāḥ kāñcī-maṇi-raṇitam ākarṇya sahasā	SAWAn yasyAH kAQcI-maNi--raNitam AkarNya sahasA
   yad āśliṣyann eva praśithila-bhuja-granthir abhavaḥ |	yat ASlizyan eva praSiTila--Buja--granTiH aBavaH |
   tad etat kvācakṣe ghṛtamadhumaya tvad-bahu-vaco-	tat etat kva-Acakze GRta-maDu-maya tvad--bahu--vacaH--
   viṣeṇāghūrṇantī kim api na sakhī me gaṇayati ||263||	vizeNa-AGUrNantI kim api na saKI me gaNayati ||263||
   kasyacit || (Amaru 73/109, SD 3.37) śaṭha-nāyaka	kasyacid || (Amaru 73/109, SD 3.37) SaWa-nAyaka
   atha govardhanoddharaṇam |	aTa govarDana-udDaraNam |
   satrāsarti yaśodayā priya-guṇa-prītekṣaṇaṃ rādhayā	satrAsarti yaSodayA priya-guNa--prIta-IkzaNam rADayA
   lagnair vallava-sūnubhiḥ sarabhasaṃ sambhāvitātmorjitaiḥ |	lagnEH vallava--sUnuBiH sa-raBasam samBAvita-Atma-UrjitEH |
   bhītānandita-vismitena viṣamaṃ nandena cālokitaḥ	BIta-Anandita--vismitena vizamam nandena ca-AlokitaH
   pāyād vaḥ kara-padma-susthita-mahā-śailaḥ salīlo hariḥ ||264||	pAyAt vaH kara-padma--su-sTita--mahA-SElaH sa-lIlaH hariH ||264||
   sohnokasya | (SKM 1.60.1 sollokasya; Srk 140 sonnokasya)	sohnokasya | (SKm 1.60.1 sa-ullokasya; Src 140 sa-unnokasya)
   ekenaiva cirāya kṛṣṇa bhavatā govardhano'yaṃ dhṛtaḥ	ekena-eva cirAya kRzNa BavatA govarDanaH-ayam DRtaH
   śrānto'si kṣaṇam āssva sāmpratam amī sarve vayaṃ dadhmahe |	SrAntaH-asi kzaNam Assva sAmpratam amI sarve vayam daDmahe |
   ity ullāsita-doṣṇi gopa-nivahe kiñcid bhujākuñcana-	iti ullAsita-dozNi gopa--nivahe kiQcid Buja-AkuQcana-
   nyañcac-chaila-bharārdite viruvati smero hariḥ pātu vaḥ ||265||	nyaQca-c-SEla--Bara-ardite viruvati smeraH hariH pAtu vaH ||265||
   śaraṇasya || (SM 1.60.2)	SaraNasya || (Sm 1.60.2)
   khinno'si muñca śailaṃ	KinnaH-asi muQca SElam
   bibhṛmo vayam iti vadatsu śithila-bhujaḥ |	biBRmaH vayam iti vadatsu SiTila-BujaH |
   bhara-bhugna-vitata-	Bara-Buj-na-vitata-
   bāhuṣu gopeṣu hasan harir jayati || 266 ||	bAhuzu gopezu hasan hariH jayati || 266 ||
   subandhoḥ || (Vāsavadatta, 2; Spd 78; Smv 1.41 hariharasya)	subanDoH || (VAsavadatta, 2; SpD 78; Smu 1.41 hari-harasya)
   dūraṃ dṛṣṭi-pathāt tirobhava harer govardhanaṃ vibhratas	dUram dRzwi-paTAt tiroBava hareH govarDanam viBrataH-
   tvayy āsakta-dṛśaḥ kṛśodari kara-srasto'sya mā bhūd ayam |	tvayi Asakta-dRSaH kRSa-udari kara-srastaH-asya mA BUt ayam |
   gopīnām iti jalpitaṃ kalayato rādhā-nirodhāśrayaṃ	gopInAm iti jalpitam kalayataH rADA--niroDa-ASrayam
   śvāsāḥ śaila-bhara-śrama-bhrama-karāḥ kaṃsa-dviṣaḥ pāntu vaḥ || 267 ||	SvAsAH SEla-Bara--Srama--Brama-karAH kaMsa-dvizaH pAntu vaH || 267 ||
   śubhāṅkasya | (SKM 1.60.4)	SuBa-aFkasya | (SKm 1.60.4)
   atha nau-krīḍā |	aTa nO-krIxA |
   kuru pāraṃ yamunāyā	kuru pAram yamunAyAH-
   muhur iti gopībhir utkarāhūtaḥ |	muhur iti gopIBiH utkara-AhUtaH |
   tari-taṭa-kapaṭa-śayālur	tari-tawa-ka-pawa-SayAluH-
   dviguṇālasyo harir jayati ||268||	dviguNa-AlasyaH hariH jayati ||268||
   sañjaya-kaviśekharasya | (BRK 5.1706)	saQjaya-ka-viSeKarasya | (BRS 5.1706)
   uttiṣṭhārāt tarau me taruṇi mama taroḥ śaktir ārohaṇe kā	uttizWArAt tarO me taruNi mama taroH SaktiH ArohaNe kA
   sākṣād ākhyāmi mugdhe taraṇim iha raver ākhyayā kā ratir me |	sAkzAt AKyAmi mugDe taraNim iha raveH AKyayA kA ratiH me |
   vārteyaṃ nau-prasaṅge katham api bhavitā nāvayoḥ saṅgamārthā	vArteyam nO-prasaFge kaTam api BavitA na-AvayoH saFgama-arTA
   vārtāpīti smitāsyaṃ jita-girim ajitaṃ rādhayārādhayāmi ||269||	vArtApi-iti smita-Asyam jita-girim ajitam rADaya-ArADayAmi ||269||
   (UN 11.86)	(UN 11.86)
   muktā taraṅga-nivahena pataṅga-putrī	muktA taraFga--nivahena pataFga--putrI
   navyā ca naur iti vacas tava tathyam eva |	navyA ca nOH iti vacaH tava taTyam eva |
   śaṅkā-nidānam idam eva mamātimātraṃ	SaFkA-nidAnam idam eva mama-atimAtram
   tvaṃ cañcalo yad iha mādhava nāviko'si ||270||	tvam caQcalaH yat iha mADava nAvikaH-asi ||270||
   samāhartur imau | (UN 15.236)	samAhartuH imO | (Uj 15.236)
   jīrṇā tariḥ sarid atīva-gabhīra-nīrā	jIrNA tariH sarit atIva-gaBIra--nIrA
   bālā vayaṃ sakalam ittham anartha-hetuḥ |	bAlAH vayam sakalam itTam anarTa--hetuH |
   nistāra-bījam idam eva kṛśodarāṇāṃ	nistAra--bIjam idam eva kRSa-udarANAm
   yan mādhava tvam asi samprati karṇadhāraḥ ||271||	yat mADava tvam asi samprati karNaDAraH ||271||
   jagadānanada-rāyasya | (BRK 5.1709)	jagat-Ananada-rAyasya | (BRS 5.1709)
   ambhasi taraṇi-sutāyāḥ	amBasi taraNi-sutAyAH
   stambhita-taraṇiḥ sa devakī-sutaḥ |	stamBita--taraNiH sa devakI-sutaH |
   ātara-virahita-gopyāḥ	Atara--virahita--gopyAH
   kātara-mukham īkṣate smeraḥ || 272 ||	kAtara--muKam Ikzate smeraH || 272 ||
   sūryadāsasya |	sUrya-dAsasya |
   vācā tavaiva yadunandana gavya-bhāro	vAcA tava-eva yadunandana gavya-BAraH-
   hāro'pi vāriṇi mayā sahasā vikīrṇaḥ |	hAraH-api vAriNi mayA sahasA vikIrNaH |
   dūrīkṛtaṃ ca kucayor anayor dukūlaṃ	dUrIkRtam ca kucayoH anayoH dukUlam
   kūlaṃ kalinda-duhitur na tathāpy adūram ||273||	kUlam kalinda--duhituH na taTA-api adUram ||273||
   kasyacit | (Premāmṛta 3.18; BRK 5.1710)	kasyacid | (Prema-amRtaH 3.18; BRS 5.1710)
   payaḥ-pūraiḥ pūrṇā sapadi gataghūrṇā ca pavanair	payaH-pUrEH pUrNA sapadi gata-GUrNA ca pavanEH-
   gabhīre kālindī-payasi tarir eṣā praviśati |	gaBIre kAlindI--payasi tariH ezA praviSati |
   aho me durdaivaṃ parama-kutukākrānta-hṛdayo	aho me durdEvam parama--kutuka-AkrAnta--hRdayaH-
   harir vāraṃ vāraṃ tad api karatāliṃ racayati ||274||	hariH vAram vAram tat api karatAlim racayati ||274||
   manoharasya | (Premāmṛta 3.19; BRK 5.1711)	manoharasya | (Prema-amRtaH 3.19; BRS 5.1711)
   pānīya-secana-vidhau mama naiva pāṇī	pAnIya--secana-viDO mama na-eva pANI
   viśrāmyatas tad api te parihāsa-vāṇī |	viSrAmyataH tat api te parihAsa-vANI |
   jīvāmi cet punar ahaṃ na tadā kadāpi	jIvAmi ced punar aham na tadA kadApi
   kṛṣṇa tvadīya-taraṇau caraṇau dadāmi ||275||	kRzNa tvadIya-taraNO caraNO dadAmi ||275||
   tasyaiva | (Premāmṛta 3.12; BRK 5.1712)	tasya-eva | (Prema-amRtaH 3.12; BRS 5.1712)
   idam uddiśya vayasyāḥ	idam uddiSya vayasyAH
   sva-samīhita-daivataṃ namata |	sva--samIhita--dEvatam namata |
   yamunaiva jānu-dadhnī	yamunA-eva jAnu-daDnI
   bhavatu na vā nāviko'stv aparaḥ ||276||	Bavatu na vA nAvikaH-astu aparaH ||276||
   mukunda-bhaṭṭācāryasya |	mukunda--Bawwa-AcAryasya |
   tarir uttaralā sarid gabhīrā	tariH uttaralA sarit gaBIrA
   taralo nanda-sutaś ca karṇa-dhāraḥ |	taralaH nanda-sutaH ca karNa-DAraH |
   abalāham upaiti bhānur astaṃ	abalA-aham upEti BAnuH astam
   sakhi dūre nagarīha kiṃ karomi ||277||	saKi dUre nagarI-iha kim karomi ||277||
   kascyacit ||	kascyacid ||
   nāpekṣate stuti-kathāṃ na śṛṇoti kākuṃ	na-apekzate stuti--kaTAm na SRNoti kAkuM
   śaśvat kṛtaṃ na manute praṇipāta-jātam |	SaSvat kRtam na manute praNipAta--jAtam |
   hā kiṃ vidheyam adhunā sakhi nanda-sūnur	hA kim viDeyam aDunA saKi nanda--sUnuH-
   madhye-taraṅgiṇi tariṃ taralo dhunoti ||278||	maDye-taraFgiNi tarim taralaH Dunoti ||278||
   tasyaiva |	tasya-eva |
   Extra verse found in only one edition.	Extra verse fount id onlI one edition.
   ātara-lāghava-hetor	Atara--lAGava--hetoH-
   murahara tariṃ tavāvalambe |	mura-hara tarim tava-avalambe |
   apaṇaṃ paṇam iha kuruṣe	apaNam paNam iha kuruze
   nāvika-puruṣe na viśvāsaḥ ||	nAvika-puruze na viSvAsaH ||
   kasyacit |	kasyacid |
   eṣottuṅga-taraṅga-laṅghita-taṭotsaṅgā pataṅgātmajā	ezA-uttuFga-taraFga--laFGita--tawa-utsaFgA pataFga-AtmajA
   pūrṇeyaṃ tarir ambubhir na hi hareḥ śaṅkā kalaṅkād api |	pUrNA-iyam tariH ambuBiH na hi hareH SaFkA kalaFkAt api |
   kāṭhiṇyaṃ bhaja nādya sundari vayaṃ rādhe prasādena te	kAWiNyam Baja na-adya sundari vayam rADe prasAdena te
   jīvāmaḥ sphuṭam ātarīkuru giri-droṇī-vinodotsavam ||279||	jIvAmaH sPuwam AtarIkuru giri-droNI--vinoda-utsavam ||279||
   kākuṃ karoṣi gṛha-koṇa-karīṣa-puñja-	kAkum karozi gRha-koNa--karIza--puQja-
   gūḍhāṅga kiṃ nanu vṛthā kitava prayāhi |	gUXa-aFga kim nanu vRTA kitava prayAhi |
   kutrādya jīrṇa-taraṇi-bhramaṇātibhīta-	kutra-adya jIrNa-taraNi--BramaNA-atiBIta-
   gopāṅganā-gaṇa-viḍambana-cāturī ||280||	gopa-aFganA--gaNa--vixambana--cAturI ||280||
   trayaḥ samāhartuḥ | (UN 5.49)	trayaH samAhartuH | (Uj 5.49)
   atha rādhayā saha harer vākovākyam |	aTa rADayA saha hareH vAkovAkyam |
   aṅgulyā kaḥ kavāṭaṃ praharati kuṭile mādhavaḥ kiṃ vasanto	aFgulyA kaH kavAwam praharati kuwile mADavaH kim vasantaH-
   no cakrī kiṃ kulālo na hi dharaṇī-dharaḥ kiṃ dvijihvaḥ phaṇīndraḥ |	no cakrI kim kulAlaH na hi DaraNI--DaraH kim dvijihvaH PaNIndraH |
   nāhaṃ ghorāhi-mardī kim asi khaga-patir no hariḥ kiṃ kapīśo	na-aham Gora-ahi-mardI kim asi Kaga-patiH naH hariH kim kapi-ISaH-
   rādhā-vāṇībhir itthaṃ prahasita-vadanaḥ pātu vaś cakra-pāṇiḥ ||281||	rADA--vANIBiH itTam prahasita-vadanaH pAtu vaH cakra-pANiH ||281||
   kasyacit || (Sbhv 130; KK 3.105; Srk 7.19)	kasyacid || (SBu 130; KK 3.105; Src 7.19)
   kas tvaṃ bho niśi keśavaḥ śirasijai :y kiṃ nāma garvāyase	kaH tvam Bo niSi keSavaH SirasijEH :y kim nAma garvAyase
   bhadre śaurir ahaṃ guṇaiḥ pitṛ-gataiḥ putrasya kiṃ syād iha |	Badre SOriH aham guNEH pitR-gatEH putrasya kim syAt iha |
   cakrī candramukhi prayacchasi na me kuṇḍīṃ ghaṭīṃ dohanīm	cakrI candra-muKi prayacCasi na me kuNxIm GawIm dohanIm
   itthaṃ gopa-vadhū-jitottaratayā hrīṇo hariḥ pātu vaḥ ||282||	itTam gopa--vaDU-jita-uttara-tayA hrINaH hariH pAtu vaH ||282||
   cakrapāṇeḥ || (SKM 1.56.3)	cakrapANeH || (SKm 1.56.3)
   vāsaḥ samprati keśava kva bhavato mugdhekṣaṇe nanv idaṃ	vAsaH samprati keSava kva BavataH mugDa-IkzaNe nanu idam
   vāsaṃ brūhi śaṭha prakāma-subhage tvad-gātra-saṃsargataḥ |	vAsam brUhi SaWa prakAma--suBage tvad--gAtra--saMsargataH |
   yāminyām uṣitaḥ kva dhūrta vitanur muṣṇāti kiṃ yāminī	yAminyAm uzitaH kva DUrta vitanuH muzNAti kim yAminI
   śaurir gopavadhūṃ chalaiḥ parihasann evaṃvidhaiḥ pātu vaḥ ||283||	SOriH gopa-vaDUm CalEH parihasan evaMviDEH pAtu vaH ||283||
   kasyacit || (SKM 1.56.4; BRS 2.1.83)	kasyacid || (SKm 1.56.4; BRH 2.1.83)
   rādhe tvaṃ kupitā tvam eva kupitā ruṣṭāsi bhūmer yato	rADe tvam kupitA tvam eva kupitA ruzwA-asi BUmeH yatas-
   mātā tvaṃ jagatāṃ tvam eva jagatāṃ mātā na vijño'paraḥ |	mAtA tvam jagatAm tvam eva jagatAm mAtA na vijQaH-aparaH |
   devi tvaṃ parihāsa-keli-kalahe'nantā tvam evety asau	devi tvam parihAsa--keli--kalahe-anantA tvam eva-iti asO
   smero vallava-sundarīm avanamac chauriḥ śriyaḥ vaḥ kriyāt ||284||	smeraH vallava-sundarIm avanamat SOriH SriyaH vaH kriyAt ||284||
   hariharasya || (SKM 1.56.1 vākpateḥ; Srk 108)	hari-harasya || (SKm 1.56.1 vAkpateH; Src 108)
   atha rāsaḥ |	aTa rAsaH |
   vṛndāraṇye pramada-sadane mallikā-puṣpa-mode	vRnda-araNye pramada--sadane mallikA--puzpa-mode
   śrī-śubhrāṃśoḥ kiraṇa-rucire kokilādyair manojñe |	SrI--SuBra-aMSoH kiraNa-rucire kokila-AdyEH manojQe |
   rātrau citre paśupa-vanitā-citta-dehāpahārī	rAtrO citre paSupa--vanitA--citta-deha-apahArI
   kaṃsārāter madhura-muralī-vādya-rājo rarāja ||285||	kaMsArAteH maDura--muralI-vAdya--rAjaH rarAja ||285||
   kasyacit |	kasyacid |
   adharāmṛta-mādhurī-dhurīṇo	aDara-amRta--mADurI--DurINaH-
   hari-līlā-muralī-nināda eṣaḥ |	hari--lIlA--muralI--ninAdaH ezaH |
   pratatāna manaḥpramodam uccair	pratatAna manaH-pramodam uccEs-
   hariṇīnāṃ hariṇī-dṛśāṃ munīnām ||286||	hariNInAm hariNI-dRSAm munInAm ||286||
   śrī-mādhavendrapurīpādānām |	SrI--mADava-indra-purI-pAdAnAm |
   līlā-mukharita-muralī-	lIlA--muKarita--muralI-
   kṛta-gopa-bhāvinī-nivahaḥ |	kRta-gopa-BAvinI--nivahaH |
   tad-adhara-madhuni satṛṣṇaḥ	tad--aDara-maDuni sa-tRzNaH
   kṛṣṇaḥ pāyād apāyato bhavataḥ || 287||	kRzNaH pAyAt apAyataH BavataH || 287||
   mādhava-cakravartinaḥ ||	mADava--cakravartinaH ||
   kāraya nāmba vilambaṃ	kAraya na-amba vilambam
   muñca karaṃ me hariṃ yāmi |	muQca karam me harim yAmi |
   na sahe sthātuṃ yad asau	na sahe sTAtum yat asO
   garjati muralī pragalbha-dūtīva ||288||	garjati muralI pragalBa-dUtI-ivaH ||288||
   samāhartuḥ ||	samAhartuH ||
   cūḍā-cumbita-cāru-candra-kacayaṃ cāmīkarābhāmbaraṃ	cUxA--cumbita--cAru-candra-ka-cayam cAmIkarABa-ambaram
   karṇottaṃsita-karṇikāra-kusumaṃ kandarpa-kallolitam |	karNa-uttaMsita-karNikAra--kusumam kandarpa--kat-lolitam |
   vaṃśī-vādana-vāvadūka-vadanaṃ vakrī-bhavad-vīkṣaṇaṃ	vaMSI-vAdana--vAvadUka-vadanam vakrI--Bavat--vIkzaNam
   bhāgyaṃ bhaṅgura-madhyamāḥ pariṇataṃ kuñjāntaraṃ bjejire || 289 ||	BAgyam BaFgura-maDyamAH pariNatam kuQja-antaram bjejire || 289 ||
   jīva-dāsa-vāhinī-pateḥ |	jIva-dAsa--vAhinI--pateH |
   śrī-kṛṣṇa-vākyam |	SrI-kRzNa--vAkyam |
   duṣṭaḥ ko'pi karoti vaḥ paribhavaṃ śaṅke muhur gokule	duzwaH kaH-api karoti vaH pariBavam SaFke muhur go-kule
   dhāvantyaḥ skhalad-ambaraṃ niśi vane yūyaṃ yad-abhyāgatāḥ |	DAvantyaH sKalat--ambaram niSi vane yUyam yat--aByAgatAH |
   āḥ kā bhītir amanda-dānava-vadhū-sindūra-mudrāhare	AH kA BItiH amanda-dAnava-vaDU--sindUra-mudrA-hare
   dordaṇḍe mama bhāti dīvyata pati-kroḍe kuraṅgī-dṛśaḥ ||290||	dos-daNxe mama BAti dIvyata pati-kroxe kuraFgI-dRSaH ||290||
   dhūtottāpe vahati gahane dharma-pūre vrajāntaḥ	DUta-uttApe vahati gahane Darma--pUre vraja-antaH
   kā vas tṛṣṇā valati hṛdaye durmadeyaṃ satīnām |	kA vaH tRzNA valati hRdaye durmadeyam satInAm |
   sīmantinyaḥ spṛhayata gṛhān mā viruddhaṃ kurudhvaṃ	sImantinyaH spRhayata gRhAt mA virudDam kuruDvam
   nāyaṃ dṛṣṭau mama vighaṭate hanta puṇyasya panthāḥ || 291 ||	na-ayam dRzwO mama viGawate hanta puNyasya panTAH || 291 ||
   atha vrajadevīnām uttaram |	aTa vraja-devInAm uttaram |
   kathaṃ vīthīm asmān upadiśasi dharma-praṇayinīṃ	kaTam vITIm asmAn upadiSasi Darma--praNayinIm
   prasīda svāṃ śiṣyām atikhilamukhīṃ śādhi muralīm |	prasIda svAm SizyAm atiKila-muKIm SADi muralIm |
   harantī maryādāṃ śiva śiva pare puṃsi hṛdayaṃ	harantI maryAdAm Siva Siva pare puMsi hRdayam
   nayantī dhṛṣṭeyaṃ yaduvara yathā nāhvayati naḥ ||292 ||	nayantI DRzwA-iyam yadu-vara yaTA na-Ahvayati naH ||292 ||
   trayaḥ samāhartuḥ ||	trayaH samAhartuH ||
   gopījanāliṅgita-madhya-bhāgaṃ	gopI-jana-AliFgita-maDya--BAgam
   veṇuṃ dhamantaṃ bhṛśa-lola-netram |	veNum Damantam BRSa--lola--netram |
   kalevare prasphuṭa-roma-vṛndaṃ	kalevare prasPuwa--roma--vRndam
   namāmi kṛṣṇaṃ jagad-eka-kandam ||293||	namAmi kRzNam jagat--eka-kandam ||293||
   śrī-puruṣottamadevasya ||	SrI--puruzottama-devasya ||
   kālindyāḥ pulineṣu keli-kupitām utsṛjya rāse rasaṃ	kAlindyAH pulinezu keli-kupitAm utsRjya rAse rasam
   gacchantīm anugacchato'śrukaluṣāṃ kaṃsadviṣo rādhikām |	gacCantIm anugacCataH-aSru-kaluzAm kaMsa-dvizaH rADikAm |
   tat-pāda-pratimāniveśita-padasyodbhūtaromodgater	tat-pAda--pratimA-niveSita-padasya-udBUta-roma-udgateH-
   akṣuṇṇo'nunayaḥ prasanna-dayitā-dṛṣṭasya puṣṇātu vaḥ || 294 ||	akzuNNaH-anunayaH prasanna--dayitA--dRzwasya puzNAtu vaH || 294 ||
   bhaṭṭa-nārāyaṇasya || (Veṇisaṃhāra 1.2)	Bawwa--nArAyaNasya || (VeNi-saMhAraH 1.2)
   kṛṣṇāntardhāne tāsāṃ praśnaḥ |	kRzNa-antarDAne tAsAm praSnaH |
   tulasi vilasasi tvaṃ malli jātāsi phullā	tulasi vilasasi tvam malli jAtA-asi PullA
   sthala-kamalini bhṛṅge saṅgatāṅgī vibhāsi |	sTala--kamalini BRFge saFgata-aFgI viBAsi |
   kathayata bata sakhyaḥ kṣipram asmāsu kasmin	kaTayata bata saKyaH kzipram asmAsu kasmin
   vasati kapaṭa-kandaḥ kandare nanda-sūnuḥ ||295||	vasati kapawa--kandaH kandare nanda-sUnuH ||295||
   samāhartuḥ | (UN 10.94)	samAhartuH | (Uj 10.94)
   dṛṣṭaḥ kvāpi sa mādhavo vraja-vadhūm ādāya kāñcid gataḥ	dRzwaH kvApi sa mADavaH vraja-vaDUm AdAya kAQcid gataH
   sarvā eva hi vañcitāḥ sakhi vayaṃ so'nveṣaṇīyo yadi |	sarvAH eva hi vaQcitAH saKi vayam saH-anvezaNIyaH yadi |
   dve dve gacchatam ity udīrya sahasā rādhāṃ gṛhītvā kare	dve dve gacCatam iti udIrya sahasA rADAm gRhItvA kare
   gopī-veśa-dharo nikuñja-kuharaṃ prāpto hariḥ pātu vaḥ ||296||	gopI--veSa--DaraH nikuQja-kuharam prAptaH hariH pAtu vaH ||296||
   kasyacit || (Sbhv 100)	kasyacid || (SBu 100)
   rādhā-sakhī-vākyam |	rADA-saKI--vAkyam |
   adoṣād doṣād vā tyajati vipine tāṃ yadi bhavān	adozAt dozAt vA tyajati vipine tAm yadi BavAn
   abhadraṃ bhadraṃ vā tribhuvana-pate tvāṃ vadatu kaḥ |	aBadram Badram vA triBuvana-pate tvAm vadatu kaH |
   idaṃ tu krūraṃ me smarati hṛdayaṃ yat kila tayā	idam tu krUram me smarati hRdayam yat kila tayA
   tvad-arthaṃ kāntāre kula-tilaka nātmāpi gaṇitaḥ ||297||	tvad--arTam kAntAre kula-tilaka na-AtmA-api gaNitaH ||297||
   rāmacandradāsasya | (UN 8.40)	rAma-candra-dAsasya | (Uj 8.40)
   lakṣmīṃ madhya-gatena rāsa-valaye vistārayann ātmanā	lakzmIm maDya--gatena rAsa-valaye vistArayan AtmanA
   kastūrī-surabhir vilāsa-muralī-vinyasta-vaktrendunā |	kastUrI--suraBiH vilAsa--muralI--vinyasta-vaktra-indunA |
   krīḍā-tāṇḍava-maṇḍalena parito dṛṣṭena tuṣyad dṛśā	krIxA-tANxava--maNxalena paritas dRzwena tuzyat dRSA
   tvāṃ hallīśaka-śaṅku-saṅkula-padā pāyād vihārī hariḥ ||298||	tvAm hallISaka--SaFku-saFkula--padA pAyAt vihArI hariH ||298||
   kasyacit |	kasyacid |
   tatra khecarāṇām uktiḥ |	tatra KecarANAm uktiH |
   mukta-munīnāṃ mṛgyaṃ	mukta-munInAm mRgyam
   kim api phalaṃ devakī phalati |	kim api Palam devakI Palati |
   tat pālayati yaśodā	tat pAlayati yaSodA
   nikāmam upabhuñjate gopyaḥ ||299||	nikAmam upaBuQjate gopyaH ||299||
   dākṣiṇātyasya ||	dAkziNAti-asya ||
   taptaṃ tapobhir anyaiḥ	taptam tapoBiH anyEH
   phalitaṃ tad gopa-bālānām |	Palitam tat gopa-bAlAnAm |
   āsāṃ yat kuca-kumbhe	AsAm yat kuca-kumBe
   nīla-nicolayati brahma ||300||	nIla--nicolayati brahma ||300||
   śrī-raghupatyupādhyāyasya ||	SrI--raGupati-upADyAyasya ||
   atha jala-krīḍā |	aTa jala-krIxA |
   jala-keli-tarala-karatala-	jala-keli-tarala-kara-tala-
   mukta-punaḥ-pihita-rādhikā-vadanaḥ |	mukta--punaH--pihita-rADikA--vadanaH |
   jagad avatu koka-yūnor	jagat avatu koka-yUnoH-
   vighaṭana-saṅghaṭana-kautukī kṛṣṇaḥ ||301||	viGawana--saFGawana--kOtukI kRzNaH ||301||
   kasyacit | (UN 15.235)	kasyacid | (Uj 15.235)
   rādhāsakhīṃ prati candrāvalī-sakhyāḥ sāsūya-vākyam	rADA-saKIm prati candra-AvalI--saKyAH sa-asUya-vAkyam
   mā garvam udvaha kapola-tale cakāsti	mA garvam udvaha kapola-tale cakAsti
   kṛṣṇa-svahasta-likhitā nava-mañjarīti |	kRzNa-sva-hasta-liKitA nava-maQjarI-iti |
   anyāpi kiṃ na sakhi bhājanam īdṛśīnāṃ	anyA-api kim na saKi BAjanam IdRSInAm
   vairī na ced bhavati vepathur antarāyaḥ ||302||	vErI na ced Bavati vepaTuH antarAyaH ||302||
   dāmodarasya | (Amaru 55; SKM 2.140.5 keśaṭasya; Smv 86.14; SD 3.105 mada;	dAmodarasya | (Amaru 55; SKm 2.140.5 keSawasya; Smu 86.14; SD 3.105 mada;
   Daśa 2.22, etc.; BRS 2.4.165)	DaSa 2.22, ed-c.; BRH 2.4.165)
   rādhā-sakhyāḥ sākūta-vākyam |	rADA--saKyAH sa-AkUta--vAkyam |
   yadavadhi gokulam abhitaḥ	yat-avaDi gokulam aBitas-
   samajani kusumācitāsana-śreṇī |	samajani kusuma-Acita-Asana--SreNI |
   pītāṃśuka-priyeyaṃ	pIta-aMSuka-priyA-iyam
   tadavadhi candrāvalī jātā ||303||	tat-avaDi candrAvalI jAtAH ||303||
   govardhanācāryasya | (Aryas 436/531)	govarDana-AcAryasya | (AryaH 436/531)
   candrāvalīṃ prati sakhī-vākyam	candra-AvalIm prati saKI--vAkyam
   saujanyena vaśīkṛtā vayam atas tvāṃ kiñcid ācakṣmahe	sOjanyena vaSIkRtAH vayam atas tvAm kiQcid Acakzmahe
   kālindīṃ yadi yāsi sundari punar mā gāḥ kadambāṭvaīm |	kAlindIm yadi yAsi sundari punar mA gAH kadamba-awvaIm |
   kaścit tatra nitānta-nirmala-tamaḥ-stomo'sti yasmin manāg	kaScid tatra nitAnta--nirmala-tamaH-stomaH-asti yasmin manAg
   lagne locanasīmni notpaladṛśaḥ paśyantī patyur gṛham ||304||	lagne locana-sImni na-utpala-dRSaH paSyantI patyuH gRham ||304||
   govinda-bhaṭṭasya ||	govinda-Bawwasya ||
   śyāmo'yaṃ divasaḥ payoda-paṭalaiḥ sāyaṃ tathāpy utsukā	SyAmaH-ayam divasaH payoda--pawalEH sAyam taTA-api utsukA
   puṣpārthaṃ sakhi yāsi yāmuna-taṭaṃ yāhi vyathā kā mama |	puzpa-arTam saKi yAsi yAmuna--tawam yAhi vyaTA kA mama |
   kintv ekaṃ khara-kaṇṭaka-kakṣatam urasy ālokya sadyo'nyathā	kintu ekam Kara--kaNwaka-ka-kzatam urasi Alokya sadyas-anyaTA
   śaṅkāṃ yat kuṭilaḥ kariṣyati jano jātāsmi tenākulā || 305 ||	SaFkAm yat kuwilaH karizyati janaH jAtA-asmi tena-AkulAH || 305 ||
   karṇapūrasya ||	karNapUrasya ||
   gantavyā te manasi yamunā vartate cet tadānīṃ	gantavyA te manasi yamunA vartate ced tadAnIm
   kuñjaṃ mā gāḥ sahaja-sarale vāñjulaṃ mad-vacobhiḥ |	kuQjam mA gAH sahaja--sarale vAQjulam mad---vacoBiH |
   gacches tatrāpy ahaha yadi vā mā murārer udāre	gacCeH tatra-api ahaha yadi vA mA murAreH udAre
   kutrāpy ekā rahasi muralī-nādam ākarṇayethāḥ ||306||	kutra-api ekA rahasi muralI-nAdam AkarNayeTAH ||306||
   tairabhukta-kaveḥ |	tEH-aBukta--kaveH |
   tarale na kuru vilambaṃ	tarale na kuru vilambam
   kumbhaṃ saṃsmṛtya mandiraṃ yāhi |	kumBam saMsmRtya mandiram yAhi |
   yāvan na mohana-mantraṃ	yAvat na mohana-mantram
   śaṃsati kaṃsadviṣo vaṃśī ||307||	SaMsati kaMsa-dvizaH vaMSI ||307||
   samāhartuḥ ||	samAhartuH ||
   pṛṣṭhena nīpam avalambya kalindajāyāḥ	pRzWena nIpam avalambya kalinda-jAyAH
   kūle vilāsa-muralīṃ kvaṇayan mukundaḥ |	kUle vilAsa--muralIm kvaNayan mukundaH |
   prāk pūraṇāt kalasam ambhasi lolayantyā	prAk pUraNAt kalasam amBasi lolayantyA
   vaktraṃ vivartayati gopakulāṅganāyāḥ ||308||	vaktram vivartayati gopa-kula-aFganAyAH ||308||
   kasyacit ||	kasyacid ||
   sakhyo yayr gṛham ahaṃ kalasīṃ vahantī	saKyaH yayH gRham aham kalasIm vahantI
   pūrṇām atīva-mahatīm anulambitāsmi |	pUrNAm atIva--mahatIm anulambitA-asmi |
   ekākinīṃ spṛśasi māṃ yadi nandasūno	ekAkinIm spRSasi mAm yadi nanda-sUno
   mokṣyāmi jīvanam idaṃ sahasā puras te ||309||	mokzyAmi jIvanam idam sahasA puras te ||309||
   samāhartuḥ ||	samAhartuH ||
   tāṃ prati kasyāścid uktiḥ |	tAm prati kasyAScid uktiH |
   valgantyā vana-mālayā tava hṛtaṃ vakṣojayoś candanaṃ	valgantyA vana-mAlayA tava hRtam vakzaH-jayoH candanam
   gaṇḍasthā makarīghaṭā ca makarāndolena vidhvaṃsitā |	gaNxa-sTA makarI-GawA ca maka-rAn-dolena viDvaMsitAH |
   klāntā svaira-taraṅga-kelibhir iyaṃ tanvī ca dhūrte tanuḥ	klAntA svEra-taraFga--keliBiH iyam tanvI ca DUrte tanuH
   satyaṃ jalpasi bhānujām abhi rase magnādya harṣād abhūḥ ||310||	satyam jalpasi BAnu-jAm aBi rase magna-adya harzAt aBUH ||310||
   samāhartuḥ ||	samAhartuH ||
   tad-bhartāraṃ prati sakhī-vākhyam |	tad--BartAram prati saKI-va-AKyam |
   subhaga mama priya-sakhyāḥ	suBaga mama priya--saKyAH
   kim iva saśaṅkaṃ muhur vilokayasi |	kim iva sa-SaFkam muhur vilokayasi |
   yāmuna-pavana-vikīrṇa-	yAmuna--pavana--vikIrNa-
   priya-karajaḥ-piñjaraṃ pṛṣṭham ||311||	priya-ka-rajaH-piQjaram pRzWam ||311||
   samāhartuḥ ||	samAhartuH ||
   candrāvalīṃ prati tasyā vākyam	candra-AvalIm prati tasyAH vAkyam
   kātyāyanī-kusuma-kāmanayā kim arthaṃ	kAtyAyanI--kusuma-kAmanayA kim arTam
   kāntāra-kukṣi-kuharaṃ kutukād gatāsi |	kAntAra--kukzi-kuharam kutukAt gatA-asi |
   paśya stana-stavakayos tava kaṇṭakāṅkaṃ	paSya stana-H-tavakayoH tava kaNwaka-aFkam
   gopaḥ sukaṇṭhi bata paśyasi jāta-kopaḥ ||312||	gopaH su-kaNWi bata paSyasi jAta-kopaH ||312||
   samāhartur ime | (UN 3.38)	samAhartuH ime | (Uj 3.38)
   atha nitya-līlā	aTa nitya--lIlA
   vṛndāvane mukundasya nitya-līlā virājate |	vRndAvane mukundasya nitya--lIlA virAjate |
   spaṣṭam eṣā rahasyatvāj jānadbhir api nocyate ||	spazwam ezA rahasya-tvAt jAnadBiH api na-ucyate ||
   tābhir nitya-vihāram eva tanute vṛndāvane mādhavo	tABiH nitya-vihAram eva tanute vRndAvane mADavaH-
   goṣṭhāmbhojamukhībhir itya bhi manāk proce priyāyai haraḥ |	gozWa-amBoja-muKIBiH itya Bi manAk proce priyAyE haraH |
   līlāratna-rahasyatā vrajapater bhūyasy aho paśya yat	lIlA-ratna--rahasya-tA vrajapateH BUyasi aho paSya yat-
   tattvajño'pi purāntare ca gamanaṃ vyācaṣṭa vaiyāsakiḥ ||	tattva-jQaH-api purA-antare ca gamanam vyAcazwa vEyAsakiH ||
   tathā hi pādme pārvatyai vyājahāra haro rahaḥ |	taTA hi pAdme pArvatyE vyAjahAra haraH rahaH |
   gogopagopikāsaṅge yatra krīḍati kaṃsahā ||	go-gopa-gopikA-saFge yatra krIxati kaMsa-hA ||
   atha bhāvini harer mathurā-prasthāne rādhā-sakhī-vākyam	aTa BAvini hareH maTurA--prasTAne rADA-saKI--vAkyam
   adyaiva yat pratipad-udgata-candra-lekhā-	adya-eva yat pratipad--udgata--candra--leKA-
   sakhyaṃ tvayā vapur idaṃ gamitaṃ varākyāḥ |	saKyam tvayA vapuH idam gamitam varAkyAH |
   kṛṣṇe gate kusuma-sāyaka tat prabhāte	kRzNe gate kusuma--sAyaka tat praBAte
   bāṇāvaliṃ kathaya kutra vimokṣyasi tvam ||313||	bANa-Avalim kaTaya kutra vimokzyasi tvam ||313||
   rudrasya || (ST 2.87)	rudrasya || (ST 2.87)
   prasthānaṃ valayaiḥ kṛtaṃ priyasakhair ajasraṃ gataṃ	prasTAnam valayEH kRtam priya-saKEH ajasram gatam
   dhṛtyā na kṣaṇam āsitaṃ vyavasitaṃ cittena gantuṃ puraḥ |	DRtyA na kzaNam Asitam vyavasitam cittena gantum puras |
   gantuṃ niścita-cetasi priyatame sarve samaṃ prasthitā	gantum niScita--cetasi priyatame sarve samam prasTitA
   gantavye sati jīvita-priya-suhṛt-sārthaḥ kim u tyajyate || 314 ||	gantavye sati jIvita--priya--suhRt--sArTaH kim u tyajyate || 314 ||
   amaroḥ | (Amaru 31/36; Sbhv 1151; Spd 3424; SKM 2.54.1; Smv 37.19)	amaroH | (Amaru 31/36; SBu 1151; SpD 3424; SKm 2.54.1; Smu 37.19)
   harer mathurā-praveśe	hareH maTurA--praveSe
   chāyāpi locana-pathaṃ na jagāma yasyāḥ	CAyA-api locana--paTam na jagAma yasyAH
   seyaṃ vadhūr nagara-madhyam alaṅkaroti |	sA-iyam vaDUH nagara--maDyam alaFkaroti |
   kiṃ cāpakalayya mathurā-nagare mukundam	kim ca-apakalayya maTurA--nagare mukundam
   andho'pi bandhukaradattakaraḥ prayāti ||315||	anDaH-api banDu-karadatta-karaH prayAti ||315||
   vāṇīvilāsasya |	vANI-vilAsasya |
   tatra pura-strī-vākyam |	tatra pura--strI-vAkyam |
   asram ajasraṃ moktuṃ	asram ajasram moktum
   dhiṅ naḥ karṇāyate nayane |	Dik naH karNAyate nayane |
   draṣṭavyaṃ paridṛṣṭaṃ	drazwavyam paridRzwam
   tat kaiśoraṃ vraja-strībhiḥ ||316||	tat kESoram vraja--strIBiH ||316||
   tairabhuktasya ||	tEH-aBuktasya ||
   sāndrānandam anantam avyayam ajaṃ yad yogino'pi kṣaṇaṃ	sAndra-Anandam anantam avyayam ajam yat yoginaH-api kzaNam
   sākṣāt kartum upāsate pratidinaṃ dhyānaikatānāḥ param |	sAkzAt kartum upAsate pratidinam DyAna-eka-tAnAH param |
   dhanyās tā vrajavāsināṃ yuvatayas tad brahma yāḥ kautukād	DanyAH tAH vraja-vAsinAm yuvatayaH tat brahma yAH kOtukAt-
   āliṅganti samālapanti śatadhākarṣanti cumbanti ca ||317||	AliFganti samAlapanti SataDA-Akarzanti cumbanti ca ||317||
   vāhinīpateḥ || (SD 6.314a)	vAhinIpateH || (SD 6.314a)
   Extra verse :	Extra verse :
   ānanda-kandam akhila-śruti-sāram ekam	Ananda--kandam aKila--Sruti--sAram ekam
   adhyātma-dīpam atidustaram añjanābham |	aDyAtma-dIpam ati-dustaram aQjana-ABam |
   ākṛṣya sāndra-kucayoḥ parirabhya kāmaṃ	AkRzya sAndra-kucayoH pariraBya kAmam
   samprāpya gopavanitā bata puṇya-puñjāḥ ||	samprApya gopa-vanitAH bata puNya-puQjAH ||
   priyasakhi na jagāma vāmaśīlaḥ	priya-saKi na jagAma vAma-SIlaH
   sphuṭam amunā nāgareṇa nandasūnuḥ |	sPuwam amunA nAgareNa nanda-sUnuH |
   adalita-nalinī-dalaiva vāpī	adalita-nalinI-dalA-eva vApI
   yad ahata-pallava eva kānanāntaḥ ||318||	yat ahata--pallavaH eva kAnana-antaH ||318||
   kumārasya ||	kumArasya ||
   yāsyāmīti samudyatasya vacanaṃ visrabdham ākarṇitaṃ	yAsyAmi-iti samudyatasya vacanam visrabDam AkarNitam
   gacchan dūram apekṣito muhur asau vyāvṛtya paśyann api |	gacCan dUram apekzitaH muhur asO vyAvRtya paSyan api |
   tac chūnye punar āgatāsmi bhavane prāṇās ta eva sthitāḥ	tat SUnye punar AgatA-asmi Bavane prANAH te eva sTitAH
   sakhyaḥ paśyata jīvita-praṇayinī dambhād ahaṃ rodimi ||319|| rudraṭasya |	saKyaH paSyata jIvita--praNayinI damBAt aham rodimi ||319|| rudrawasya |
   gato yāmo gatau yāmau	gataH yAmaH gatO yAmO
   gatā yāmā gataṃ dinam |	gatA yAmAH gatam dinam |
   hā hanta kiṃ kariṣyāmi	hA hanta kim karizyAmi
   na paśyāmi harer mukham ||320||	na paSyAmi hareH muKam ||320||
   śaṅkarasya ||	SaFkarasya ||
   yamunā-puline samutkṣipan	yamunA--puline samutkzipan
   naṭaveśaḥ kusumasya kandukam |	nawa-veSaH kusumasya kandukam |
   na punaḥ sakhi lokayiṣyate	na punar saKi lokayizyate
   kapaṭābhīra-kiśora-candramāḥ ||321 ||	kapawa-ABIra-ki-Sora--candramAH ||321 ||
   ṣaṣṭhī-dāsasya ||	zazWI-dAsasya ||
   yāḥ paśyanti priyaṃ svapne	yAH paSyanti priyam svapne
   dhanyāstāḥ sakhi yoṣitaḥ	DanyAH-tAH saKi yozitaH
   asmākaṃ tu gate kṛṣṇe	asmAkam tu gate kRzNe
   gatā nidrāpi vairiṇī ||322||	gatA nidrA-api vEriNI ||322||
   dhanyasya | (UN 15.169)	Danyasya | (Uj 15.169)
   so'yaṃ vasanta-samayo vipinaṃ tad etat	saH-ayam vasanta--samayaH vipinam tat etat-
   so'yaṃ nikuñja-viṭapī nikhilaṃ tadāste	saH-ayam nikuQja--viwapI niKilam tat-A-Aste
   hā hanta kiṃ tu nava-nīrada-komalāṅgo	hA hanta kim tu nava--nIrada--komala-aFgaH-
   naloki puṣpa-dhanuṣaḥ prathamāvatāraḥ ||323||	naloki puzpa--DanuzaH praTama-avatAraH ||323||
   sañjaya-kaviśekharasya ||	saQjaya-ka-viSeKarasya ||
   yugāyitaṃ nimeṣeṇa	yugAyitam nimezeNa
   cakṣuṣā prāvṛṣāyitam |	cakzuzA prAvRzAyitam |
   śūnyāyitaṃ jagat sarvaṃ	SUnyAyitam jagat sarvam
   govinda-viraheṇa me ||324||	govinda--viraheNa me ||324||
   śrī-bhagavataḥ || (Śikṣāṣṭaka, 7)	SrI--BagavataH || (ŚikzA-azwaka, 7)
   dalati hṛdayaṃ gāḍhodvegaṃ dvidhā na tu bhidyate	dalati hRdayam gAXa-udvegam dviDA na tu Bidyate
   vahati vikalaḥ kāyo mūrcchāṃ na muñcati cetanām |	vahati vikalaH kAyaH mUrcCAm na muQcati cetanAm |
   jvalayati tanūm antardāhaḥ karoti na bhasmasāt	jvalayati tanUm antardAhaH karoti na BasmasAt-
   praharati vidhir marmacchedī na kṛntati jīvitam ||325||	praharati viDiH marma=-CedI na kRntati jIvitam ||325||
   (Mālatīmādhava 9.11, Uttararāmacarita 3.31, Brk; Smv 43.39)	(MAlatI-mADava 9.11, u-uttara-rAma-caritaH 3.31, Brk; Smu 43.39)
   bhramaya jaladān ambhogarbhān pramodaya cātakān	Bramaya jaladAn amBaH-garBAn pramodaya cAtakAn
   kalaya śikhinaḥ kekotkaṇṭhān kaṭhoraya ketakān |	kalaya SiKinaH keka-utkaNWAn kaWoraya ketakAn |
   virahiṇi jane mūrcchāṃ labdhvā vinodayati vyathā-	virahiNi jane mUrcCAm labDvA vinodayati vyaTA-
   makaruṇa punaḥ saṃjñā-vyādhiṃ vidhāya kim īhase || 326 ||	makaruNa punar saMjQA--vyADim viDAya kim Ihase || 326 ||
   etau bhavabhūteḥ | (Mālatīmādhava 9.42, Spd 3453; Smv 43.34)	etO Bava-BUteH | (MAlatI-mADava 9.42, SpD 3453; Smu 43.34)
   dṛṣṭaṃ ketaka-dhūli-dhūsaram idaṃ vyoma kramād vīkṣitāḥ	dRzwam ketaka-DUli--DUsaram idam vyoma kramAt vIkzitAH
   kaccāntāś ca śilīndhra-kandala-bhṛtaḥ soḍhāḥ kadambānilāḥ |	kacca-antAH ca SilInDra--kandala-BRtaH soXAH kadamba-anilAH |
   sakhyaḥ saṃvṛṇutāśru muñcata bhayaṃ kasmān mudevākulā	saKyaH saMvRNuta-aSru muQcata Bayam kasmAt mudA-iva-AkulA
   etān apy adhunāsmi vajraghaṭitā nūnaṃ sahiṣye dhanān ||327||	etAn api aDunA-asmi vajra-GawitAH nUnam sahizye DanAn ||327||
   rudrasya || (SKM 2.55.3, ST 2.60a)	rudrasya || (SKm 2.55.3, ST 2.60a)
   seyaṃ nadī kumuda-badnhukarās ta eva	sA-iyam nadI kumuda--badnhu-karAH te eva
   tad yāmunaṃ taṭam idaṃ vipinaṃ tad etat |	tat yAmunam tawam idam vipinam tat etat |
   te mallikā-surabhayo marutas tvam eva	te mallikA--suraBayaH marutaH tvam eva
   hā prāṇa-vallabha sudurlabhatāṃ gato'si ||328||	hA prANa--vallaBa su-durlaBa-tAm gataH-asi ||328||
   haribhaṭṭasya ||	hari-Bawwasya ||
   yadunātha bhavantam āgataṃ	yadunA-aTa Bavantam Agatam
   kathayiṣyanti kadā madālayaḥ |	kaTayizyanti kadA mad-AlayaH |
   yugapat paritaḥ pradhāvitaḥ	yugapad paritas praDAvitaH
   vikasadbhir vadanendu-maṇḍalaiḥ ||329 ||	vikasadBiH vadana-indu--maNxalEH ||329 ||
   tairabhuktakaveḥ ||	tEH-aBukta-kaveH ||
   ayi dīnadayārdra nātha he,	ayi dIna-dayA-Ardra nATa he,
   mathurānātha kadāvalokyase |	maTurA-nATa kadA-avalokyase |
   hṛdayaṃ tvad-aloka-kātaraṃ	hRdayam tvad--aloka--kAtaram
   dayita bhrāmyati kiṃ karomy aham ||330||	dayita BrAmyati kim karomi aham ||330||
   śrī-mādhavendra-purī-pādānām | (CC 2.4.197, 3.8.32)	SrI--mADava-indra--purI--pAdAnAm | (CC 2.4.197, 3.8.32)
   prathayati na tathā mamārtim uccaiḥ	praTayati na taTA mama-Artim uccEs-
   sahacari vallava-candra-viprayogaḥ |	sahacari vallava--candra--viprayogaH |
   kaṭubhir asura-maṇḍalaiḥ parīte	kawuBiH asura--maNxalEH parIte
   danujapater nagare yathāsya vāsaḥ ||331||	danuja-pateH nagare yaTA-asya vAsaH ||331||
   śrī-raghunātha-dāsasya | (BRS 2.4.52)	SrI--raGu-nATa-dAsasya | (BRH 2.4.52)
   cūtāṅkure sphurati hanta nave nave'smin	cUta-aFkure sPurati hanta nave nave-asmin
   jīvo'pi yāsyatitarāṃ tarala-svabhāvaḥ |	jIvaH-api yAsi-atitarAm tarala--svaBAvaH |
   kiṃ tv ekam eva mama duḥkham abhūd analpaṃ	kim tu ekam eva mama duHKam aBUt analpam
   prāṇeśvareṇa sahito yad ayaṃ na yātaḥ ||332|||	prANeSvareNa sahitaH yat ayam na yAtaH ||332|||
   rāṅgasya |	rAFgasya |
   āśaika-tantum avalambya vilamamānā	ASA-eka-tantum avalambya vilamamAnA
   rakṣāmi jīvam avadhir niyato yadi syāt |	rakzAmi jIvam avaDiH niyataH yadi syAt |
   no ced vidhiḥ sakala-loka-hitaikakārī	no ced viDiH sakala--loka--hita-eka-kArI
   yat kāla-kūṭam asṛjat tad idaṃ kim artham ||333||	yat kAla-kUwam asRjat tat idam kim arTam ||333||
   hareḥ |	hareH |
   prasara śiśirāmodaṃ kaundaṃ samīra samīraya	prasara SiSira-Amodam kOndam samIra samIraya
   prakaṭaya śaśinn āśāḥ kāmaṃ manoja samullasa |	prakawaya SaSin ASAH kAmam manoja samullasa |
   avadhi-divasaḥ pūrṇaḥ sakhyo vimuñcata tat-kathāṃ	avaDi-divasaH pUrNaH saKyaH vimuQcata tat-kaTAm
   hṛdayam adhunā kiñcit kartuṃ mamānyad ihecchati ||334 ||	hRdayam aDunA kiQcid kartum mama-anyat iha-icCati ||334 ||
   rudrasya || (SKM 2.55.5; ST 2.58e, Smv 40.18)	rudrasya || (SKm 2.55.5; ST 2.58e, Smu 40.18)
   nāyāti ced yadupatiḥ sakhi naitu kāmaṃ	na-AyAti ced yadu-patiH saKi na-etu kAmam
   prāṇās tadīya-virahād yadi yānti yāntu |	prANAH tadIya--virahAt yadi yAnti yAntu |
   ekaḥ paraṃ hṛdi mahān mama vajra-pāto	ekaH param hRdi mahAn mama vajra-pAtaH-
   bhūyo yad induvadanaṃ na vilokitaṃ tat || 335 ||	BUyas yat indu-vadanam na vilokitam tat || 335 ||
   hari-bhaṭṭasya ||	hari-Bawwasya ||
   pañcatvaṃ tanur etu bhūta-nivahāu svāṃśe viśantu sphuṭaṃ	paQcatvam tanuH etu BUta--nivahAu sva-aMSe viSantu sPuwam
   dhātāraṃ praṇipatya hanta śirasā tatrāpi yāce varam |	DAtAram praNipatya hanta SirasA tatra-api yAce varam |
   tad-vāpīṣu payas tadīya-mukure jyotis tadīyāṅgana-	tad--vApIzu payaH tadIya--mukure jyotiH tadIya-aFgana-
   vyomni vyoma tadīya-vartmani dharā tat-tāla-vṛnte'nilaḥ || 336 ||	vyomni vyoma tadIya-vartmani DarA tat-tAla-vRnte-anilaH || 336 ||
   ṣaṇmāsikasya | (Spd 3428; Smv 43.32; Sbhv 1355; UN 14.189)	zaz-mAsikasya | (Spd 3428; Smu 43.32; SBu 1355; UN 14.189)
   āśliṣya vā pāda-ratāṃ pinaṣṭu mām	ASlizya vA pAda-ratAm pinazwu mAm
   adarśanān marma-hatāṃ karotu vā |	adarSanAt marma-hatAm karotu vA |
   yathā tathā vā vidadhātu lampaṭo	yaTA taTA vA vidaDAtu lampawaH-
   mat-prāṇa-nāthas tu sa eva nāparaḥ ||337||	mat--prANa-nATaH tu saH eva na-aparaH ||337||
   śrī-bhagavataḥ || (CC 3.20.47, UN 13.79)	SrI--BagavataH || (SC 3.20.47, UN 13.79)
   mathurāyāṃ yaśodā-smṛtyā kṛṣṇa-vākyam |	maTurAyAm yaSodA--smRtyA kRzNa--vAkyam |
   tāmbūlaṃ sva-mukhārdhaṃ carvitam itaḥ ko me mukhe nikṣiped	tAmbUlam sva--muKa-arDam carvitam itas kaH me muKe nikzipet-
   unmārga-prasṛtaṃ ca cāṭu-vacanaiḥ ko māṃ vaśe sthāpayet |	unmArga--prasRtam ca cAwu-vacanEH kaH mAm vaSe sTApayet |
   ehy ehīti vidūra-sārita-bhujaḥ svāṅke nidyāyādhunā	ehi ehi-iti vidUra-sArita-BujaH sva-aFke nidyAya-aDunA
   keli-srasta-śikhaṇḍakaṃ mama punar vyādhūya badhnātu kaḥ ||338||	keli-sraH-ta-SiKaNxakam mama punar vyADUya baDnAtu kaH ||338||
   tairabhuktasya ||	tEH-aBuktasya ||
   atha śrī-rādhā-smṛtyā harer vākyam |	aTa SrI--rADA--smRtyA hareH vAkyam |
   yadi nibhṛtam araṇyaṃ prāntaraṃ vāpy apānthaṃ	yadi niBRtam araNyam prAntaram vA-api apAnTam
   katham api cirakālaṃ puṇyapākena lapsye |	kaTam api cira-kAlam puNya-pAkena lapsye |
   avirala-galad-asrair ghaghara-dhvāna-miśraiḥ	avirala--galat--asrEH GaGara--DvAna--miSrEH
   śaśimukhi tava śokaiḥ plāvayiṣye jaganti ||339||	SaSi-muKi tava SokEH plAvayizye jaganti ||339||
   tairabhuktakaveḥ ||	tEH-aBukta-kaveH ||
   uddhavaṃ prati harer vākyam |	udDavam prati hareH vAkyam |
   viṣayeṣu tāvad abalās	vizayezu tAvat abalAs
   tāsv api gopyaḥ svabhāva-mṛdu-vācaḥ |	tAsu api gopyaH svaBAva--mRdu-vAcaH |
   madhye tāsām api sā	maDye tAsAm api sA
   tasyām api sācivīkṣitaṃ kim api || 340 ||	tasyAm api sAcivIkzitam kim api || 340 ||
   kasyacit ||	kasyacid ||
   uddhavena rādhāyāṃ hareḥ sandeśaḥ |	udDavena rADAyAm hareH sandeSaH |
   āvirbhāva-dine na yena gaṇito hetus tanīyān api	AvirBAva-dine na yena gaNitaH hetuH tanIyAn api
   kṣīyetāpi na cāparādha-vidhinā natyā nayo vardhate |	kzIyeta-api na ca-aparADa--viDinA natyAH nayaH varDate |
   pīyūṣa-prativedinas trijagatī-duḥkha-druhaṃ sāmprataṃ	pIyUza--prativedinaH trijagatI--duHKa-druham sAmpratam
   premṇas tasya guroḥ kathaṃ nu karavai vāṅ-niṣṭhatā-lāghavam ||341||	premNaH tasya guroH kaTam nu karavEH vAc--nizWatA--lAGavam ||341||
   keṣāṃcit ||	kezAMcid ||
   āstāṃ tāvad vacana-racanā-bhājanatvaṃ vidūre	AstAm tAvat vacana--racanA--BAjana-tvam vidUre
   dūre cāstāṃ tava tanu-parīrambha-sambhāvanāpi |	dUre ca-AstAm tava tanu--parIramBa--samBAvanA-api |
   bhūyo bhūyaḥ praṇatibhir idaṃ kiṃ tu yāce vidheyā	BUyas BUyas praNatiBiH idam kim tu yAce viDeyA
   smāraṃ smāraṃ svajana-gaṇane kvāpi rekhā mamāpi ||342||	smAram smAram sva-jana--gaNane kvApi reKA mama-api ||342||
   keśava-bhaṭṭācāryāṇām ||	keSava--Bawwa-AcAryANAm ||
   vṛndāvanaṃ gacchata uddhavasya vākyam |	vRndAvanam gacCataH udDavasya vAkyam |
   iyaṃ sā kālindī kuvalaya-dala-snigdha-madhurā	iyam sA kAlindI kuvalaya-dala--snigDa--maDurA
   madāndha-vyākūja-tarala-jala-raṅku-praṇayinī |	mada-anDa--vyAkUja--tarala--jala-H-aFku--praNayinI |
   purā yasyās tīre sarabhasa-satṛṣṇaṃ murabhido	purA yasyAH tIre saraBasa--sa-tRzNam muraBidaH-
   gatāḥ prāyo gopī-nidhuvana-vinodena divasāḥ ||343 ||	gatAH prAyas gopI-niDuvana-vinodena divasAH ||343 ||
   daśarathasya | (SKM 5.11.4 śaraṇasya)	daSaraTasya | (SKm 5.11.4 SaraNasya)
   pureyaṃ kāllindī vraja-jana-vadhūnāṃ stana-taṭī-	purA-iyam kAllindI vraja--jana-vaDUnAm stana-tawI-
   tanūrāgair bhinnā cabala-salilābhūd anudinam |	tanU-rAgEH BinnA cabala--salilA-aBUt anudinam |
   aho tāsāṃ nityaṃ rudita-galitaiḥ kajjala-jalair	aho tAsAm nityam rudita-galitEH kajjala--jalEH-
   idānīṃ yāte'smin dviguṇa-mallinābhūn muraripau || 344 ||	idAnIm yAte-asmin dviguNa--mallinA-aBUt muraripO || 344 ||
   sarvānandasya ||	sarva-Anandasya ||
   idaṃ tat kālindī-pulinam iha kaṃsāsurabhido	idam tat kAlindI--pulinam iha kaMsa-asuraBidaH-
   yaśaḥ śṛṇvad vaktra-skhalita-kavalaṃ gokulam abhūt |	yaSaH SRNvat vaktra--sKalita--kavalam gokulam aBUt |
   bhramad-veṇu-kvāṇa-śravaṇa-masṛṇottāra-madhura-	Bramat--veNu--kvANa--SravaNa--masRNA-uttAra--maDura-
   svarābhir gopībhir diśi diśi samudghūrṇam aniśam ||345 ||	svarABiH gopIBiH diSi diSi samudGUrNam aniSam ||345 ||
   moṭakasya || (SKM 5.11.5 keśaṭasya)	mowakasya || (SKm 5.11.5 keSawasya)
   tābhyo namo vallava-vallabhābhyo	tAByaH namaH vallava-vallaBa-aByaH-
   yāsāṃ guṇais tair abhicintyamānaiḥ |	yAsAm guNEH tEH aBicintyamAnEH |
   vakṣaḥsthale niḥśvasitaiḥ kaduṣṇair	vakzaH-sTale niHSvasitEH kaduzNEH-
   lakṣmīpater mlāyati vaijayantī || 346 || kasyacit ||	lakzmIpateH mlAyati vEjayantI || 346 || kasyacid ||
   vrajadevīkulaṃ praty uddhava-vākyam |	vraja-devI-kulam prati udDava--vAkyam |
   viyoginīnām api paddhatiṃ vo	viyoginInAm api padDatim vaH-
   na yogino gantum api kṣamante |	na yoginaH gantum api kzamante |
   yad dhyeyarūpasya parasya puṃso	yat Dyeya-rUpasya parasya puMso
   yūyaṃ gatā dhyeya-padaṃ durāpam ||347||	yUyam gatAH Dyeya--padam durApam ||347||
   kasyacit ||	kasyacid ||
   uddhave dṛṣṭe sakhīṃ prati rādhā-vākyam |	udDave dRzwe saKIm prati rADA--vAkyam |
   kalyāṇaṃ kathayāmi kiṃ sahacari svaireṣu śaśvat purā	kalyANam kaTayAmi kim sahacari svErezu SaSvat purA
   yasyā nāma samīritaṃ muraripoḥ prāṇeśvaīti tvayā |	yasyAH nAma samIritam muraripoH prANeSvaI-iti tvayA |
   sāhaṃ premabhidābhayāt priyatamaṃ dṛṣṭvāpi dūtaṃ prabhoḥ	sA-aham prema-BidA-BayAt priyatamam dRzwvA-api dUtam praBoH
   sandiṣṭāsmi na veti saṃśayavatī pṛcchāmi no kiñcana ||348||	sandizwA-asmi na vA-iti saMSayavatI pRcCAmi no kiQcana ||348||
   rāmacandra-dāsasya ||	rAmacandra-dAsasya ||
   śrī-rādhāṃ prati uddhava-vākyam |	SrI--rADAm prati udDava--vAkyam |
   malinaṃ nayanāñjanāmbubhir	malinam nayana-aQjana-ambuBiH-
   mukhacandraṃ karabhoru mā kuru |	muKa-candram karaBa-Uru mA kuru |
   karuṇāvaruṇālayo haris	karuNA-varuNa-AlayaH haris
   tvayi bhūyaḥ karuṇāṃ vidhāsyati ||349||	tvayi BUyas karuNAm viDAsyati ||349||
   ṣaṣṭhī-dāsasya || (UN 12.30)	zazWI-dAsasya || (Uj 12.30)
   uddhavaṃ prati rādhā-sakhī-vākyam |	udDavam prati rADA--saKI--vAkyam |
   hastodare vinihitaikakapolapāler	hasta-udare vinihita-eka-kapola-pAleH-
   aśrāntalocanajalasnapitānanāyāḥ |	aSrAnta-locana-jala-snapita-AnanAyAH |
   prasthānamaṅgaladināvadhi mādhavasya	prasTAna-maFgala-dina-avaDi mADavasya
   nidrālavo'pi kuta eva saroruhākṣyāḥ ||350||	nidrA-lavaH-api kutas eva saroruha-akzyAH ||350||
   hariharasya || (BRS 3.5.32)	hari-harasya || (BRH 3.5.32)
   rādhā-sakhyā eva kṛṣṇe sandeśaḥ |	rADA--saKyAH eva kRzNe sandeSaH |
   niścandanāni vaṇijām api mandirāṇi	niScandanAni vaNijAm api mandirANi
   niṣpallavāni ca digantara-kānanāni |	nizpallavAni ca diS-antara--kAnanAni |
   niṣpaṅkajāny api sarit-sarasīkulāni	nizpaFkajAni api sarit--sarasI-kulAni
   jātāni tad-viraha-vedanayā na śāntam ||351 ||	jAtAni tat--viraha--vedanayA na SAntam ||351 ||
   tasyaiva ||	tasya-eva ||
   prāṇas tvaṃ jagatāṃ harer api purā saṅketa-veṇu-svanān	prANaH tvam jagatAm hareH api purA saFketa--veNu--svanAn
   ādāya vraja-subhruvām iha bhavān mārgopadeśe guru |	AdAya vraja--suBruvAm iha BavAn mArga-upadeSe guru |
   haṃho mathurā-niṣkuṭānila sakhe sampraty api śrī-pater	haMho maTurA--nizkuwa-anila saKe samprati api SrI-pateH-
   aṅga-sparśa-pavitra-śītila-tanus trātā tvam eko'si naḥ ||352||	aFga--sparSa-pavitra--SItila-tanuH trAtA tvam ekaH-asi naH ||352||
   rāmacandra-dāsasya ||	rAmacandra-dAsasya ||
   rādhāsakhyā eva kṛṣṇe sandeśaḥ |	rADA-saKyAH eva kRzNe sandeSaH |
   tvad-deśāgata-mārutena mṛdunā sañjāta-romāñcayā	tvad--deSa-Agata-mArutena mRdunA saQjAta--romAQcayA
   tvad-rūpāṅkita-cāru-citra-phalake santarpayantyā dṛśam |	tvad--rUpa-aFkita--cAru--citra--Palake santarpayantyAH dRSam |
   tvan-nāmāmṛta-sikta-karṇa-puṭayā tvan-mārga-vātāyane	tvan-nAma-amRta-sikta-karNa--puwayA tu-an--mArga-vAtAyane
   tanvyā pañcama-gīta-garbhita-girā rātrindivaṃ sthīyate ||353||	tanvyA paQcama--gIta--garBita-girA rAtrindivam sTIyate ||353||
   trivikramasya || (Nalacampū 6.23; Smv 44.5)	trivikramasya || (Nala-campU 6.23; Smu 44.5)
   aṅge'naṅga-jvara-huta-vahaś cakṣuṣi dhyāna-mudrā	aFge-anaFga--jvara--huta-vahaH cakzuzi DyAna-mudrA
   kaṇḍhe jīvaḥ karakiśalaye dīrgha-śāyī kapolaḥ |	kaNXe jIvaH kara-kiSalaye dIrGa-SAyI kapolaH |
   aṃse veṇī kuca-parisare candanaṃ vāci maunaṃ	aMse veNI kuca--parisare candanam vAci mOnam
   tasyāḥ sarvaṃ sthitam iti na ca tvāṃ vinā kvāpi cetaḥ ||354||	tasyAH sarvam sTitam iti na ca tvAm vinA kvApi cetaH ||354||
   kṣemendrasya || (Spd 3474; Smv 44.6; Kavikaṇṭhābharaṇa 3.2)	kzemendrasya || (Spd 3474; Smu 44.6; Ka-vikaNWa-ABaraNaH 3.2)
   dṛṣṭe candramasi pralupta-tamasi vyomāṅgana-stheyasi	dRzwe candramasi pralupta-tamasi vyoma-aFgana--sTeyasi
   sphūrjan-nirmala-tejasi tvayi gate dūraṃ nija-preyasi |	sPUrjan--nirmala--tejasi tvayi gate dUram nija--preyasi |
   śvāsaḥ kairava-korakīyati mukhaṃ tasyāḥ sarojīyati	SvAsaH kEH-ava-korakIyati muKam tasyAH sarojIyati
   kṣīrodīyati manmatho dṛgapi ca drāk candrakāntīyati ||355||	kzIrodIyati manmaTaH dRS-api ca drAk candrakAntIyati ||355||
   bhīmabhaṭṭasya || (Spd 3480, Smv 44.10; SKM 2.36.1 first two lines	BIma-Bawwasya || (Spd 3480, Smu 44.10; SKm 2.36.1 firsd twaH lineH-
   somewhat different)	somewhat different)
   asyās tāpam ahaṃ mukunda kathayāmy eṇīdṛśas te kathaṃ	asyAH tApam aham mukunda kaTayAmi eNi-IdRSaH te kaTam
   padminyāḥ sarasaṃ dalaṃ vinihitaṃ yasyāḥ satāpe hṛdi |	padminyAH sarasam dalam vinihitam yasyAH sa-tApe hRdi |
   ādau śuṣyati saṅkucaty anu tataś cūrṇatvam āpadyate	AdO Suzyati saFkucati anu tatas cUrNa-tvam Apadyate
   paścān murmuratāṃ dadhad dahati ca śvāsāvadhūtaḥ śikhī ||356||	paScAt murmura-tAm daDat dahati ca SvAsa-avaDUtaH SiKI ||356||
   śāntikarasya | (Smv 44.25; SKM 2.31.1; Srk 553 kasyacit; utpalarāja)	SAnti-karasya | (Smu 44.25; SKm 2.31.1; Src 553 kasyacit; utpala-rAja)
   uddhūyeta tanū-lateti nalinī-patreṇa no bījyate	udDUyeta tanU-latA-iti nalinI--patreNa naH bIjyate
   sphoṭaḥ syād iti nāṅgakaṃ malayaja-kṣodāmbhasā sicyate |	sPowaH syAt iti na-aFgakam mala-yaja-kzoda-amBasA sicyate |
   syād asyātibharāt parābhava iti prāyo na vā pallavā-	syAt asya-ati-BarAt parABavaH iti prAyas na vA pallavA-
   ropo vakṣasi tat katha kṛśatanor adhiḥ samādhīyatām || 358 ||	ropaH vakzasi tat kaTaH kRSa-tanoH aDiH samADIyatAm || 358 ||
   ānandasya ||	Anandasya ||
   nivasasi yadi tava hṛdaye	nivasasi yadi tava hRdaye
   sā rādhā vajra-ghaṭite'smin	sA rADA vajra--Gawite-asmin
   tat khalu kuśalaṃ tasyāḥ	tat Kalu kuSalam tasyAH
   smara-viśikhais tāḍyam ānayoḥ ||359 ||	smara--viSiKEH tAxyam AnayoH ||359 ||
   kasyacit || (Smv 44.11)	kasyacid || (Smu 44.11)
   unmīlanti nakhair lunīhi vahati kṣaumāñcalenāvṛṇu	unmIlanti naKEH lunIhi vahati kzOma-aQcalena-AvRNu
   krīḍā-kānanam āviśanti valaya-kvāṇaiḥ samutrāsaya |	krIxA-kAnanam AviSanti valaya--kvANEH samutrAsayaH |
   itthaṃ pallava-dakṣiṇānila-kuhū-kaṇṭhīṣu sāṅketika-	itTam pallava--dakziNa-anila--kuhU--kaNWIzu sa-aFketika-
   vyāhārāḥ subhaga tvadīya-virahe rādhā-sakhīnāṃ mithaḥ ||360||	vyAhArAH suBaga tvadIya--virahe rADA--saKInAm miTas ||360||
   śambhoḥ || (SKM 2.30.4 amaroḥ; Spd 3489 satkavicandrasya; Smv 44.13; SD	SamBoH || (SKm 2.30.4 amaroH; SpD 3489 sat-kavi-candrasya; Smu 44.13; SD
   galaty ekā mūrcchā bhavati punar anyā yad anayoḥ	galati ekA mUrcCA Bavati punar anyA yat anayoH
   kim apy āsīn madhyaṃ subhaga nikhilāyām api niśi |	kim api AsIt maDyam suBaga niKilAyAm api niSi |
   likhantyās tatrāsyāḥ kusuma-śara-lekhaṃ tava kṛte	liKantyAH tatra-asyAH kusuma--Sara--leKam tava kRte
   samāptiṃ svastīti prathama-pada-bhāgo'pi na gataḥ || 361 ||	samAptim svasti-iti praTama--pada--BAgaH-api na gataH || 361 ||
   śacīpateḥ || (Spd 3477; Smv 44.20)	SacIpateH || (Spd 3477; Smu 44.20)
   citrāya tvayi cintite tanubhuvā cakre tatajyaṃ dhanur-	citrAya tvayi cintite tanuBuvA cakre tata-jyam DanuH--
   vartiṃ dhartum upāgate'ṅguli-yuge bāṇo guṇe yojitaḥ |	vartim Dartum upAgate-aFguli--yuge bANaH guNe yojitaH |
   prārabdhe tava citra-karmaṇi dhanur muktāstra-bhinnā bhṛśaṃ	prArabDe tava citra-karmaNi DanuH mukta-astra-BinnA BRSam
   bhittiṃ drag avalambya keśava ciraṃ sā tatra citrāyate ||362||	Bittim drak avalambya keSava ciram sA tatra citrAyate ||362||
   bāṇasya || (Smv 44.21 siṃhalapateḥ)	bANasya || (Smu 44.21 siMhala-pateH)
   tvām antaḥsthirabhāvanā-pariṇataṃ matvā puro'vasthitaṃ	tvAm antar-sTira-BAvanA--pariNatam matvA puras-avasTitam
   yāvad dorvalayaṃ karoti rabhasād agre samāliṅgitum |	yAvat dos-valayam karoti raBasAt agre samAliFgitum |
   tāvat taṃ nijam eva deham acirād aliṅgya romāñcitāṃ	tAvat tam nijam eva deham acirAt aliFgya romAQcitAm
   dṛṣṭvā vṛṣṭijalacchalena ruditaṃ manye payodair api ||363||	dRzwvA vRzwi-jala=-Calena ruditam manye payodEH api ||363||
   kasyacit || (Smv 44.22)	kasyacid || (Smu 44.22)
   acchinnaṃ nayanāmbu bandhuṣu kṛtaṃ tāpaḥ sakhīṣv āhito	acCinnam nayana-ambu banDuzu kRtam tApaH saKIzu Ahito
   dainyaṃ nyastam aśeṣataḥ parijane cintā gurubhyo'rpitā |	dEnyam nyastam aSezatas parijane cintA guruByaH-arpitA |
   adya śvaḥ kila nirvṛtiṃ vrajati sā śvāsaiḥ paraiḥ khidyate	adya Svas kila nirvRtim vrajati sA SvAsEH parEH Kidyate
   visrabdho bhava viprayoga-janitaṃ duḥkhaṃ vibhaktaṃ tayā ||364||	visrabDaH Bava viprayoga--janitam duHKam viBaktam tayA ||364||
   (Amaru 78/110; Sbhv 1407; Smv 44.20; Spd 3486; SKM 2.32.2; Daśa 4.27)	(Amaru 78/110; SBu 1407; Smu 44.20; SpD 3486; SKm 2.32.2; DaSa 4.27)
   athāsyā eva spraṇayerṣyaṃ jalpitam |	aTa-asyAH eva spraNaya-Irzyam jalpitam |
   mukha-mādhurya-samṛddhyā	muKa--mADurya--samRdDyA
   parahṛdayasya grahītari prasabham |	para-hRdayasya grahItari prasaBam |
   kṛṣṇātmani para-puruṣe	kRzNa-Atmani para-puruze
   sauhṛdakāmasya kā śarīrāśā ||365||	sOhRda-kAmasya kA SarIra-ASA ||365||
   jagannātha-senasya |	jagannATa-senasya |
   atha vrajadevīnāṃ sotprāsaḥ sandeśaḥ |	aTa vraja-devInAm sa-utprAsaH sandeSaH |
   vācā tṛtīya-jana-saṅkaṭa-duḥsthayā kiṃ	vAcA tRtIya--jana--saFkawa-duHsTayA kim
   kiṃ vā nimeṣa-virasena vilokitena |	kim vA nimeza--virasena vilokitena |
   he nātha nanda-suta gokula-sundarīṇām	he nATa nanda-suta go-kula--sundarINAm
   antaścarī sahacarī tvayi bhaktir eva || 366 ||	antar-carI sahacarI tvayi BaktiH eva || 366 ||
   kasyacit |	kasyacid |
   atha yathārtha-sandeśaḥ |	aTa yaTA-arTa--sandeSaH |
   muralī-kala-nikvaṇair yā	muralI--kala--nikvaNEH yA
   guru-lajjā-bharam apy ajīgaṇat |	guru-lajjA-Baram api ajIgaNat |
   virahe tava gopikāḥ kathaṃ	virahe tava gopikAH kaTam
   samayaṃ tā gamayantu mādhava || 367 ||	samayam tAH gamayantu mADava || 367 ||
   ṣaṣṭhīdāsasya ||	zazWI-dAsasya ||
   mathurā-pathika murārer	maTurA-paTika murAreH-
   upageyaṃ dvāri vallavī-vacanam |	upageyam dvAri vallavI--vacanam |
   punar api yamunā-salile	punar api yamunA--salile
   kāliya-garalānalo jvalati || 368 ||	kAliya-garala-analaH jvalati || 368 ||
   vīrasarasvatyāḥ || (SKM 1.62,5; UN 10.98)	vIra-sarasvatyAH || (SKm 1.62,5; UN 10.98)
   atha dvāravatīsthasya harer virahaḥ |	aTa dvAravatI-sTasya hareH virahaH |
   kalindīm anukūla-komala-rayām indīvara-śyāmalāḥ	kalindIm anukUla--komala--rayAm indIvara-SyAmalAH
   śailopāntabhuvaḥ kadamba-kusumair āmodinaḥ kandarāt |	SEla-upAnta-BuvaH kadamba--kusumEH AmodinaH kandarAt |
   rādhāṃ ca prathamābhisāra-madhurāṃ jātānutāāḥ smarann	rADAm ca praTama-aBisAra--maDurAm jAta-anutAAH smaran=-
   astu dvāravatī-patis tribhuvanāmodāya dāmodaraḥ ||369 ||	astu dvAravatI--patiH triBuvanAmodAya dAmodaraH ||369 ||
   śaraṇasya || (SKM 1.61.2)	SaraNasya || (SKm 1.61.2)
   kāmaṃ kāmayate na keli-nalinīṃ nāmodate kaumudī-	kAmam kAmayate na keli-nalinIm nAma-udate kOmudI-
   nisyandair na samīhate mṛga-dṛśām ālāpa-līlām api |	nisyandEH na samIhate mRga-dRSAm AlApa--lIlAm api |
   sīdann eṣa niśāsu niḥsaha-tanur bhogābhilāṣālasair	sIdan eza niSAsu niHsaha--tanuH Boga-aBilAza-alasEH-
   aṅgais tāmyati cetasi vrajavadhūm ādhāya mugdho hariḥ || 370 ||	aFgEH tAmyati cetasi vraja-vaDUm ADAya mugDaH hariH || 370 ||
   tasyaiva || (SKM 1.61.3)	tasya-eva || (SKm 1.61.3)
   ratna-cchāyā-cchurita-jaladhau mandire dvārakāyā	ratna-=-CAyA--cCurita--jalaDO mandire dvArakAyAH-
   rukmiṇyāpi prabala-pulakodbhedam āliṅgitasya |	rukmiNyA-api prabala--pulaka-udBedam AliFgitasya |
   viśvaṃ pāyān masṛṇa-yamunā-tīra-vānīra-kuñje	viSvam pAyAt masRNa--yamunA--tIra--vAnIra--kuQje
   rādhā-kelī-parimala-bhara-dhyāna-mūrcchā murāreḥ ||371||	rADA--kelI--parimala--Bara--DyAna--mUrcCA murAreH ||371||
   umāpatidharasya || (SKM 1.61.1; UN 14.184; Jīva and VCT to BRS 2.4.178)	umApatiDarasya || (SKm 1.61.1; UN 14.184; JIva and VCT taH BRH 2.4.178)
   nirmagnena mayāmbhasi praṇayataḥ pālī samāliṅgitā	nirmagnena mayA-amBasi praNayataH pAlI samAliFgitA
   kenālīkam idaṃ tavādya kathitaṃ rādhe mudhā tāmyasi |	kena-alIkam idam tava-adya kaTitam rADe muDA tAmyasi |
   ity utsavapna-paramparāsu śayane śrutvā giraṃ śārṅgiṇo	iti utsavapna--paramparAsu Sayane SrutvA giram SArFgiNaH-
   rukmiṇyā śithilīkṛtaḥ sakapataṃ kaṇṭha-grahaḥ pātu vaḥ ||372||	rukmiNyA SiTilIkRtaH sa-kapatam kaNWa--grahaH pAtu vaH ||372||
   umāpatidharasya || (SKM 1.53.5,kasyacit)	umApatiDarasya || (SKm 1.53.5,kasya-cit)
   SKM version:	SKm versiA-Un:
   nirmagnena mayāmbhasi smara-bhayād ālī samāliṅgitā	nirmagnena mayA-amBasi smara--BayAt AlI samAliFgitA
   kenālīkam idaṃ tavādya kathitaṃ rādhe mudhā tāmyasi |	kena-alIkam idam tava-adya kaTitam rADe muDA tAmyasi |
   itthaṃ svapna-paramparāsu śayane śrutvā giraṃ śārṅgiṇaḥ	itTam svapna--paramparAsu Sayane SrutvA giram SArFgiNaH
   savyājaṃ śithilīkṛtaḥ kamalayā kaṇṭha-grahaḥ pātu vaḥ || kasyacit ||	sa-vyAjam SiTilIkRtaH kamalayA kaNWa--grahaH pAtu vaH || kasyacid ||
   atha vṛndāvanādhīśvarī-viraha-gītam |	aTa vRndAvana-aDISvarI--viraha--gItam |
   yāte dvāravatī-puraṃ muraripau tad-vastra-saṃvyānayā	yAte dvAravatI--puram muraripO tad--vastra--saMvyAnayA
   kālindī-taṭa-kuñja-vañjula-latām ālāmbya sotkaṇṭhayā |	kAlindI--tawa--kuQja--vaQjula-latAm AlAmbya sa-utkaNWayA |
   udgītaṃ guru-bāṣpa-gadgada-galat-tārasvaraṃ rādhayā	udgItam guru--bAzpa--gadgada-galat--tAra-svaram rADayA
   yenāntarjalacāribhir jalacarair apy utkam utkūjitam ||373||	yena-antar-jala-cAriBiH jalacarEH api utkam utkUjitam ||373||
   aparājitasya || (SKM 1.58.4 kasyacit; Dhv, Vak 2.59; etc.; UN 14.188)	aparAjitasya || (SKm 1.58.4 kasyacit; Dhv, Vaj 2.59; ed-c.; UN 14.188)
   atha vrajadevīnāṃ sandeśaḥ |	aTa vraja-devInAm sandeSaH |
   pāntha dvāravatīṃ prayāsi yadi he tad devakīnandano	pAnTa dvAravatIm prayAsi yadi he tat devakI-nandanaH-
   vaktavyaḥ smara-mohamantra-vivaśo gopyo'pi nāmojjhitāḥ |	vaktavyaH smara--moha-mantra--vivaSaH gopyaH-api nAma-ujJitAH |
   etāḥ keli-kadamba-dhūli-paṭalair āloka-śūnyā diśaḥ	etAH keli--kadamba--DUli--pawalEH Aloka--SUnyAH diSaH
   kālindī-taṭa-bhūmayo bhavato nāyānti cittāspadam ||374||	kAlindI--tawa--BUmayaH BavataH na-AyAnti citta-Aspadam ||374||
   govardhanācāryasya || (SKM 1.62.2; Śṛṅgāra-prakāśa, check Srk)	govarDana-AcAryasya || (SKm 1.62.2; ŚRFgAra--prakASa, Ceck Srk)
   te govardhana-kandarāḥ sa yamunā-kacchaḥ sa ceṣṭāraso	te govarDana--kandarAH sa yamunA-kacCaH sa cezwA-rasaH-
   bhāṇḍīraḥ sa vamaspatiḥ sahacarās te tac ca goṣṭhāṅganam |	BANxIraH sa vamaspatiH sahacarAH te tat ca gozWa-aFganam |
   kiṃ dvāravatī-bhujaṅga hṛdayaṃ nāyāti doṣair apīty	kim dvAravatI--BujaFga hRdayam na-AyAti dozEH api-iti-
   avyād vo hṛdi duḥsahaṃ vraja-vadhū-sandeśa-śalyaṃ hareḥ ||375 ||	avyAt vaH hRdi duHsaham vraja-vaDU--sandeSa--Salyam hareH ||375 ||
   nīlasya || (SKM 1.62.1)	nIlasya || (SKm 1.62.1)
   kālindyāḥ pulinaṃ pradoṣa-maruto ramyāḥ śaśaṅkāṃśavaḥ	kAlindyAH pulinam pradoza--marutaH ramyAH SaSaFkA-aMSavaH
   santāpaṃ na harantu nāma nitarāṃ kurvanti kasmāt punaḥ |	santApam na harantu nAma nitarAm kurvanti kasmAt punar |
   sandiṣṭaṃ vraja-yoṣitām iti hareḥ saṃśṛṇvato'ntaḥpure	sandizwam vraja--yozitAm iti hareH saMSRNvataH-antaHpure
   niḥśvāsāḥ prasṛtā jayanti ramaṇī-saubhāgya-garva-cchidaḥ ||376||	niHSvAsAH prasRtAH jayanti ramaNI--sOBAgya--garva-cCidaH ||376||
   pañcatantra-kṛtaḥ || (SKM 1.62.4, UN 15.164)	paQcatantra-kRtaH || (SKm 1.62.4, UN 15.164)
   mudāmānaṃ prati śrī-dvārakeśvara-vacanam	mudAmAnam prati SrI--dvArakeSvara-vacanam
   mā gā ity apamaṅgalaṃ vraja sakhe snehena śūnyaṃ vacaḥ	mA gAH iti apamaFgalam vraja saKe snehena SUnyam vacaH
   tiṣṭheti prabhutā yathābhilapitaṃ kurv ity udāsīnatā |	tizWA-iti praBu-tA yaTA-aBilapitam kuru iti udAsIna-tA |
   brūmo hanta mudāma mitra vacanaṃ naivopacārād idaṃ	brUmaH hanta mudAma mitra vacanam na-eva-upacArAt idam
   smartavyā vayam ādareṇa bhavatā yāvad bhavad-darśanam ||377||	smartavyAH vayam AdareNa BavatA yAvat Bavat--darSanam ||377||
   hareḥ ||	hareH ||
   sva-gṛhādikaṃ dṛṣṭvā tasya vacanam |	sva--gRha-Adikam dRzwvA tasya vacanam |
   tad-gehaṃ nata-bhitti mandiram idaṃ labdhāvakāśaṃ divaḥ	tat--geham nata-Bitti mandiram idam labDa-avakASam divaH
   sā dhenur jaratī caranti kariṇām etā ghanābhā ghaṭāḥ |	sA DenuH jaratI caranti kariNAm etAH Gana-ABAH GawAH |
   sa kṣudro muṣala-dhvaniḥ kalam idaṃ saṅgītakaṃ yoṣitāṃ	sa kzudraH muzala--DvaniH kalam idam saFgItakam yozitAm
   citraṃ hanta kathaṃ dvijo'yam iyatīṃ bhūmiṃ samāropitaḥ ||378|| kasyacit	citram hanta kaTam dvijaH-ayam iyatIm BUmim samAropitaH ||378|| kasyacid-
   atha kurukṣetre śrī-vṛndāvanādhīśvara-ceṣṭitam	aTa kurukzetre SrI--vRndAvana-aDISvara--cezwitam
   yenaiva sūcita-navābhyudaya-prasaṅgā	yena-eva sUcita-nava-aByudaya--prasaFgA
   mīnāhati-sphurita-tāmarasopamena |	mIna-Ahati--sPurita-tAmarasa-upamena |
   anyan nimīlya nayanaṃ muditaiva rādhā	anyat nimIlya nayanam muditA-eva rADA
   vāmena tena nayanena dadarśa kṛṣṇam || 379 ||	vAmena tena nayanena dadarSa kRzNam || 379 ||
   harasya || (Smv 54.8 utprekṣāvallabhasya)	harasya || (Smu 54.8 utprekzA-vallaBasya)
   ānandodgata-bāṣpa-pūra-pihitaṃ cakṣuḥ kṣamaṃ nekṣituṃ	Ananda-udgata--bAzpa--pUra--pihitam cakzuH kzamam na-Ikzitum
   bāhū sīdata eva kampa-vidhurau śaktau na kaṇṭha-grahe |	bAhU sIdate eva kampa--viDurO SaktO na kaNWa--grahe |
   vāṇī sambhram-gadgadākṣara-padā saṃkṣobha-lolaṃ manaḥ	vANI samBram--gadgada-akzara-padA saMkzoBa--lolam manaH
   satyaṃ vallabha-saṅgamo'pi sucirāj jāto viyogāyate ||380||	satyam vallaBa--saFgamaH-api sucirAt jAtaH viyogAyate ||380||
   śubhrasya || (SKM 2.132.1 kasyacit; Sbhv 2065 śrī-ḍāmarasya; Smv 54.10	SuBrasya || (SKm 2.132.1 kasyacit; SBu 2065 SrI-xAmarasya; Smu 54.10
   kasyāpi)	kasya-api)
   atha rahasy anunayantaṃ kṛṣṇaṃ prati |	aTa rahasi anunayantam kRzNam prati |
   kiṃ pādānte luṭhasi vimanāḥ svāmino hi svatantrāḥ	kim pAda-ante luWasi vimanAH svAminaH hi svatantrAH
   kañcit kālaṃ kvacid abhiratas tatra kas te'parādhaḥ |	kaQcid kAlam kvacid aBirataH tatra kaH te-aparADaH |
   āgaskāriṇy aham iha yayā jīvitaṃ tad-viyoge	AgaskAriNi aham iha yayA jIvitam tad--viyoge
   bhartṛ-prāṇāḥ striya iti nanu tvaṃ mamaivānuneyaḥ ||381||	BartR-prANAH striyaH iti nanu tvam mama-eva-anuneyaH ||381||
   kasyacit || (SKM 2.47.1 bhāvadevyāḥ; Srk 643 vākkūṭasya; Smv 57.14)	kasyacid || (SKm 2.47.1 BAva-devyAH; Src 643 vAc-kUwasya; Smu 57.14)
   yaḥ kaumāra-haraḥ sa eva hi varas tā eva caitra-kṣapās	yaH kOmAra--haraH saH eva hi varaH tAH eva cEtra-kzapA-H-
   te conmīlita-mālatī-surabhayaḥ prauéhāḥ kadambānilāḥ	te ca-unmIlita--mAlatI--sura-BayaH prOéhAH kadamba-anilAH
   sā caivāsmi tathāpi tatra surata-vyāpāra-līlā-vidhau	sA ca-eva-asmi taTA-api tatra surata--vyApAra--lIlA--viDO
   revā-rodhasi vetasī-taru-tale cetaḥ samutkaṇṃhate ||382||	revA-roDasi vetasI-taru--tale cetaH samutkaNMhate ||382||
   kasyacit (SKM 2.12.3; Spd 3768; Smv 87.9; SD 1.2, CC 2.1.58, 2.13.121,	kasyacid (SKm 2.12.3; SpD 3768; Smu 87.9; SD 1.2, CS 2.1.58, 2.13.121,
   priyaḥ so'yaṃ kṛṣṇaḥ sahacari kurukṣetra-militas	priyaH saH-ayam kRzNaH sahacari kurukzetra--milita-H-
   tathāhaṃ sā rādhā tad idam ubhayoḥ saṅgama-sukham |	taTA-aham sA rADA tat idam uBayoH saFgama--suKam |
   tathāpy antaḥ-khelan-madhura-muralī-pañcama-juṣe	taTA-api antaH--Kelan--maDura--muralI--paQcama--juze
   mano me kālindī-pulina-vipināya spṛhayati ||383||	manaH me kAlindI--pulina--vipinAya spRhayati ||383||
   samāhartuḥ || (Caitanya-caritāmṛta, 2.1.76)	samAhartuH || (SEtanya--carita-amRta, 2.1.76)
   samāptau maṅgalācaraṇam |	samAptO maFgala-AcaraNam |
   mugdhe muñca viṣādam atra balabhit kampo gurus tyajyatāṃ	mugDe muQca vizAdam atra balaBid kampaH guruH tyajyatAm
   sad-bhāvaṃ bhaja puṇḍarīka-nayane mānyān imān mānaya |	sad-BAvam Baja puNxarIka--nayane mAnyAn imAn mAnaya |
   lakṣmīṃ śikṣayataḥ svayaṃvara-vidhau dhanvantarer vākchalād	lakzmIm SikzayataH svayaMvara--viDO DanvantareH vAc-CalAt-
   ity anya-pratiṣedham ātmani vidhiṃ śṛṇvan hariḥ pātu vaḥ ||384||	iti anya-pratizeDam Atmani viDim SRNvan hariH pAtu vaH ||384||
   kasyacit || (Sbhv 84 dākṣiṇātyasya kasyāpi, SKM 1.67.5 puṇḍarīkasya)	kasyacid || (SBu 84 dAkziNAti-asya kasya-api, SKm 1.67.5 puNxarIkasya)
   yaduvaṃśāvataṃsāya	yadu-vaMSa-avataMsAya
   vṛndāvana-vihāriṇe |	vRndAvana--vihAriNe |
   saṃsāra-sāgarottāra-	saMsAra--sAgara-uttAra-
   tāraye haraye namaḥ || 385 ||	tAraye haraye namaH || 385 ||
   avilamba-sarasvatyāḥ ||	avilamba--sarasvatyAH ||
   bhrāmyad-bhāsvara-mandarādri-śikhara-vyāghaṭṭanād visphurat	BrAmyat--BAsvara-mandara-adri--SiKara--vyAGawwanAt visPurat-
   keyūrāḥ puruhūta-kuñjara-kara-prāg-bhāra-saṃvardhinaḥ |	keyUrAH puruhUta--kuQjara--kara--prAc--BAra--saMvarDinaH |
   daityendra-pramadā-kapola-vilasat-patrāṅkura-cchedino	dEtya-indra--pramadA--kapola--vilasat--patra-aFkura--=-CedinaH-
   dor-daṇḍāḥ kalil-kāla-kalmaṣa-muṣaḥ kaṃsa-dviṣo pātu vaḥ ||386||	dor-daNxAH kalil--kAla--kalmaza-muzaH kaMsa--dvizaH pAtu vaH ||386||
   yogeśvarasya|| (SKM 1.59.1 kasyacit)	yogeSvarasya|| (SKm 1.59.1 kasyacid-)
   jayadeva-bilvamaṅgala-mukhaiḥ	jayadeva--bilva-maFgala--muKEH
   kṛtā ye'tra santi sandarbhāḥ |	kRtAH ye-atra santi sandarBAH |
   teṣāṃ padyāni vinā	tezAm padyAni vinA
   samāhṛtānītarāṇy atra ||387||	samAhRtAni-itarANi atra ||387||
   lasad-ujjvala-rasastamanā	lasat--ujjvala---rasaH-tamanA
   gokula-kula-pālikālinī-valitaḥ |	go-kula--kula--pAlikAli-nI-valitaH |
   yad abhīpsitam abhidadyāt	yat aBIpsitam aBidadyAt-
   taruṇa-tamāla-kalpa-pādapaḥ ko'pi ||388||	taruNa--tamAla--kalpa-pAdapaH kaH-api ||388||
   iti śrī-mad-rūpa-gosvāmi-samāhṛtā padyāvalī samāptā |	iti SrI--mad--rUpa-go-svAmi--samAhRtA padyAvalI samAptA |
   Extra verses:	Extra verses:
   kṛtaṃ na sukṛtaṃ mayā kṛtam aho mahā-duṣkṛtaṃ	kRtam na sukRtam mayA kRtam aho mahA-duzkRtam
   kṛtānta-nagare gatir bhavatu me tatra kīdṛśī |	kRtAnta--nagare gatiH Bavatu me tatra kIdRSI |
   na bho na dinabhoga-dig-bhramaṇam asmāt paraṃ punas	na Bo na dina-Boga-diS--BramaNam asmAt param punar-
   tathā kuru yathā taṭe tava ghaṭeta vāso mama ||	taTA kuru yaTA tawe tava Gaweta vAsaH mama ||
   rādhādhara-sudhādhāra-	rADA-Dara--suDA-ADAra-
   dharāyādya-rasa-śriye	DarAyAt-ya--rasa--Sriye
   gopāla-pura-rājñāya	gopAla-pura-rAjQAya
   namaḥ pītāmbarāya te ||	namaH pIta-ambarAya te ||
