   [GBM 571.5 = LPG(Ch) 202r5]	[GBm 571.5  LPG(Sh) 202r5]
   evam ukte āyuṣmāṃ subhūtir bhagavantam etad avocat* mahāguṇasamanvāgato	evam ukte AyuzmAm suBUtiH Bagavantam etat avocat* mahA-guNa-samanvAgataH-
   bhagavaṃn avaivartiko bodhisatvo manāsatvaḥ	Bagavan avEvartikaH boDisatvaH manAsa-tvaH
   aprameyāsaṃkhyeyāparimāṇaguṇasamanvāgato	aprameya-asaMKyeya-aparimANa-guNa-samanvAgataH-
   6 bhagavann avaivartiko bodhisatvo mahāsatvaḥ aparimitaguṇasamanvāgato	6 Bagavan avEvartikaH boDisatvaH mahAsatvaH aparimita-guNa-samanvAgataH-
   bhagavann avaivartiko bodhisatvo mahāsatvaḥ bhagavān āha* evam	Bagavan avEvartikaH boDisatvaH mahAsatvaH BagavAn Aha* evam
   7 etat subhūte evam etat* mahāguṇasamanvāgataḥ subhūte avaivartiko	7 etat suBUte evam etat* mahA-guNa-samanvAgataH suBUte avEvartikaH-
   bodhisatvo mahāsatvaḥ aprameyāsaṃkhyeyāparimāṇaguṇasamanvāgataḥ subhūte	boDisatvaH mahAsatvaH aprameya-asaMKyeya-aparimANa-guNa-samanvAgataH suBUte
   avaivartiko bodhisatvo mahāsatvaḥ	avEvartikaH boDisatvaH mahAsatvaH
   8 aparimitaguṇasamanvāgataḥ subhūte avaivartiko bodhisatvo mahāsatvaḥ tat	8 aparimita-guNa-samanvAgataH suBUte avEvartikaH boDisatvaH mahAsatvaH tat-
   kasya hetoḥ tathā hy anenānantāparyantaṃ jñānaṃ pratilabdhaḥ asādhāraṇaṃ	kasya hetoH taTA hi anena-anantA-paryantam jQAnam pratilabDaH asADAraNam
   sarvaśrāvakapratyekabuddhaiḥ	sarva-SrAvaka-pratyekabudDEH
   9 tatra ca jñāne sthitvā avaivartiko bodhisatvo mahāsatvaḥ pratisaṃvido	9 tatra ca jQAne sTitvA avEvartikaH boDisatvaH mahAsatvaH pratisaMvidaH-
   'bhinirharati / yābhiḥ pratisaṃvidbhiḥ sadevamānuṣāsureṇa lokena pṛṣṭaḥ	aBinirharati / yABiH pratisaMvidBiH sa-deva-mAnuza-asureNa lokena pRzwaH
   prativacanair na śakyaṃ paryādātuṃ subhūtir āha /	prativacanEH na Sakyam paryAdAtum suBUtiH Aha /
   10 pratibalo bhagavaṃs tathāgato 'rhaṃ samyaksaṃbuddho	10 pratibalaH Bagavan taTAgataH arham samyaksaMbudDaH-
   gaṃgānadīvālukopamān kalpān avaivartikasya bodhisatvasya	gaMgA-nadI-vAlukA-upamAn kalpAn avEvartikasya boDisatvasya
   mahāsatvasyākāraliṃganimittāni nirdeṣṭuṃ / yair ākārair yair liṅgair yair	mahA-satvasya-AkAra-liMga-nimittAni nirdezwum / yEH AkArEH yEH liFgEH yEH-
   nimittair avaivartiko bodhisatvo	nimittEH avEvartikaH boDisatvaH-
   11 mahāsatvaḥ prabhāvyate / sādhu bhagavan gaṃbhīragaṃbhīrasthānāni	11 mahAsatvaH praBAvyate / sADu Bagavan gaMBIra-gaMBIra-sTAnAni
   nirdeṣṭavyāni / yatra sthitvā bodhisatvo mahāsatvaḥ ṣaṭsu pāramitāsu	nirdezwavyAni / yatra sTitvA boDisatvaH mahAsatvaH zawsu pAramitAsu
   caraṃś catvāri smṛtyupasthānāni paripūrayati / yāvat sarvākārajñatāṃ	caran catvAri smRti-upasTAnAni paripUrayati / yAvat sarva-AkAra-jQa-tAm
   12 paripūrayati bhagavān āha / sādhu sādhu subhūte sādhu khalu punas tvaṃ	12 paripUrayati BagavAn Aha / sADu sADu suBUte sADu Kalu punar tvam
   subhūte yas tvam avaivartikānāṃ bodhisatvānāṃ mahāsatvānām arthāya	suBUte yaH tvam avEvartikAnAm boDisatvAnAm mahAsatvAnAm arTAya
   tathāgataṃ gaṃbhīragaṃbhīrāṇi sthānāni yāny adhivacanaṃ	taTAgatam gaMBIra-gaMBIrANi sTAnAni yAni aDivacanam
   13 yad uta nirvāṇasya / āha / nirvāṇasyaivaitad bhagavann adhivacanan na	13 yat uta nirvANasya / Aha / nirvANasya-eva-etat Bagavan aDivacanan na
   punaḥ sarvadharmāṇāṃ / bhagavān āha / sarvadharmāṇām apy etat subhūte	punar sarva-DarmANAm / BagavAn Aha / sarva-DarmANAm api etat suBUte
   adhivacanaṃ gaṃbhīram iti / tat kasya hetoḥ / rūpaṃ subhūte gaṃbhīran	aDivacanam gaMBIram iti / tat kasya hetoH / rUpam suBUte gaMBIran
   vedanā	vedanA
   [GBM 572.1 = LPG(Ch) 202v] saṃjñā saṃskārā vijñānaṃ subhūte gaṃbhīraṃ	[GBm 572.1  LPG(Sh) 202v] saMjQA saMskArAH vijQAnam suBUte gaMBIram
   cakṣur api subhūte gaṃbhīraṃ yāvan mano 'pi subhūte gaṃbhīraṃ yāvad bodhir	cakzuH api suBUte gaMBIram yAvat manaH api suBUte gaMBIram yAvat boDiH-
   api subhūte gaṃbhīrā kathaṃ ca subhūte rūpaṃ gaṃbhīraṃ / yathā rūpasya	api suBUte gaMBIrA kaTam ca suBUte rUpam gaMBIram / yaTA rUpasya
   tathatā tathā gaṃbhīraṃ / yathā vedanāyā	taTatA taTA gaMBIram / yaTA vedanAyAH-
   2 saṃjñāyā saṃskārāṇāṃ yathā vijñānasya tathatā tathā gaṃbhīraṃ yāvad	2 saMjQAyA saMskArANAm yaTA vijQAnasya taTatA taTA gaMBIram yAvat-
   yathā bodhes tathatā tathā gaṃbhīraṃ / āha / kathaṃ bhagavaṃ rūpasya	yaTA boDeH taTatA taTA gaMBIram / Aha / kaTam Bagavam rUpasya
   tathatā yāvat kathaṃ bodhes tathatā / bhagavān āha / yatra subhūte	taTatA yAvat kaTam boDeH taTatA / BagavAn Aha / yatra suBUte
   rūpatathatāyāṃ na	rUpa-taTatAyAm na
   3 rūpaṃ nānyatra rūpāt tathatā yāvad yatra subhūte vijñānatathatāyāṃ na	3 rUpam na-anyatra rUpAt taTatA yAvat yatra suBUte vijQAna-taTatAyAm na
   vijñānaṃ nānyatra vijñānāt tathatā yāvad yatra bodhitathatāyāṃ na bodhir	vijQAnam na-anyatra vijQAnAt taTatA yAvat yatra boDitaTatAyAm na boDiH-
   nānyatra bodhes tathatā / āha / āścaryaṃ bhagavan yāvac cedaṃ	na-anyatra boDeH taTatA / Aha / AScaryam Bagavan yAvat ca-idam
   sūkṣmeṇopāyenāvaivartiko	sUkzmeNa-upAyena-avEvartiko
   4 bodhisatvo mahāsatvo rūpāc ca nivārito nirvāṇaṃ ca sūcitaḥ vedanāyāḥ	4 boDisatvaH mahAsatvaH rUpAt ca nivAritaH nirvANam ca sUcitaH vedanAyAH
   saṃjñāyāḥ saṃskārebhyo vijñānāc ca nivārito nirvāṇaṃ ca sūcita	saMjQAyAH saMskAreByaH vijQAnAt ca nivAritaH nirvANam ca sUcita
   sarvagrahebhyaś ca laukikalokottarebhyaḥ sādhāraṇāsādhāraṇebhyaḥ	sarva-graheByaH ca lOkika-lokottareByaH sADAraNAsADAraNeByaH
   5 sāsravānāsravebhyo nivārito nirvāṇaṃ ca sūcitaḥ bhagavān āha / yaḥ	5 sa-Asrava-anAsraveByaH nivAritaH nirvANam ca sUcitaH BagavAn Aha / yaH
   subhūte bodhisatvo mahāsatva imāni gaṃbhīragaṃbhīrāṇi sthānāni	suBUte boDisatvaH mahAsatvaH imAni gaMBIra-gaMBIrANi sTAnAni
   prajñāpāramitāpratisaṃyuktāni cintayiṣyati /	prajQApAramitA-pratisaMyuktAni cintayizyati /
   6 tulayiṣyaty upanidhyāsyati / evaṃ mayā sthātavyaṃ / yathā	6 tulayizyati upaniDyAsyati / evam mayA sTAtavyam / yaTA
   prajñāpāramitāyām ājñaptam evaṃ mayā śikṣitavyam* yathā prajñāpāramitāyām	prajQApAramitAyAm AjQaptam evam mayA Sikzitavyam* yaTA prajQApAramitAyAm
   upadiṣṭam* ayaṃ subhūte bodhisatvo mahāsatvaḥ tathaiva	upadizwam* ayam suBUte boDisatvaH mahAsatvaH taTA-eva
   7 saṃpādayan yathā prajñāpāramitāyām ākhyātaṃ tathopanidhyāyaṃs	7 saMpAdayan yaTA prajQApAramitAyAm AKyAtam taTA-upaniDyAyaM=-
   tathopaparīkṣamāṇas tathā yujyamānas tathā ghaṭhamānas tathā vyāyacchamāno	taTA-upaparIkzamANaH taTA yujyamAnaH taTA GaWamAnaH taTA vyAyacCamAnaH-
   yathā prajñāpāramitāyām upadiṣṭaṃ / ekena cittotpādenāsaṃkhyeyāprameyāny	yaTA prajQApAramitAyAm upadizwam / ekena citta-utpAdena-asaMKyeya-aprameyAni-
   8 aparimāṇāni kuśalamūlāni parigrahīṣyati / so 'parimāṇāṃ kalpāṃ saṃsārāc	8 aparimANAni kuSala-mUlAni parigrahIzyati / saH aparimANAm kalpAm saMsArAt-
   chorayiṣyati / kaḥ panar vādo yaḥ avyavakīrṇaḥ prajñāpāramitāyāṃ caraṃ	Corayizyati / kaH panar vAdaH yaH avyavakIrNaH prajQApAramitAyAm caram
   bodhipratisaṃyuktair	boDi-pratisaMyuktEH-
   9 manasikārair vihariṣyati / tadyathāpi nāma syāt subhūte puruṣo	9 manasikArEH viharizyati / tat-yaTA-api nAma syAt suBUte puruzaH-
   rāgacarito vitarkacaritas tenānyatarayā striyā sārdham abhirūpayā	rAga-caritaH vitarka-caritaH tena-anyatarayA striyA sArDam aBirUpayA
   prāsādikayā darśanīyayā saṃketaḥ kṛto bhavet*	prAsAdikayA darSanIyayA saMketaH kRtaH Bavet-*
   10 sā ca strī paraparigṛhītā na śaknuyād gṛhān niṣkrāntuṃ / tat kiṃ	10 sA ca strI para-parigRhItAH na SaknuyAt gRhAt nizkrAntum / tat kim
   manyase subhūte kiṃpratisaṃyuktās tasya puruṣasya vitarkā bhaveyuḥ / āha /	manyase suBUte kiMpratisaMyuktAH tasya puruzasya vitarkAH BaveyuH / Aha /
   strīpratisaṃyuktā eva bhagavaṃs tasya puruṣasya vitarkā bhaveyuḥ	strI-pratisaMyuktAH eva Bagavan tasya puruzasya vitarkAH BaveyuH
   11 imam eti iyam āgatā etayā sārdhaṃ niṣatsyāmi paricārayiṣyāmi bhagavān	11 imam eti iyam AgatAH etayA sArDam nizatsyAmi paricArayizyAmi BagavAn
   āha tat kiṃ manyase subhūte rātrer atyayād divasasyātyayāt kiyantas tasya	Aha tat kim manyase suBUte rAtreH atyayAt divasasya-atyayAt kiyantaH tasya
   puruṣasya vitarkā varteran* āha bahavo bhagavaṃ bahavas	puruzasya vitarkAH varteran* Aha bahavaH Bagavam bahavaH-
   12 sugata tasya puruṣasya rātrer atyayād divasasya cātyayād vitarkā	12 sugata tasya puruzasya rAtreH atyayAt divasasya ca-atyayAt vitarkA
   varteran* / bhagavān āha / yāvantaḥ subhūte tasya puruṣasya rātreś ca	varteran* / BagavAn Aha / yAvantaH suBUte tasya puruzasya rAtreH ca
   divasasya cātyayād vitarkā varterann iyantaḥ kalpān bodhisatvo mahāsatvaḥ	divasasya ca-atyayAt vitarkAH varteran iyantaH kalpAn boDisatvaH mahAsatvaH
   13 saṃsārāc chorayati vipṛṣṭhīkaroti ya iha gaṃbhīrāyāṃ prajñāpāramitāyāṃ	13 saMsArAt Sorayati vipRzWIkaroti yaH iha gaMBIrAyAm prajQApAramitAyAm
   yathopadiṣṭāyāṃ śikṣeta / upaparīkṣeta upanidhyāyati / tathā ca yogam	yaTA-upadizwAyAm Sikzeta / upaparIkzeta upaniDyAyati / taTA ca yogam
   āpadyate / yathā tāṃ doṣān vivarjayati	Apadyate / yaTA tAm dozAn vivarjayati
   14 yair doṣair bodhisatvo mahāsatvo vivartate 'nuttarasyāḥ samyaksaṃbodheḥ	14 yEH dozEH boDisatvaH mahAsatvaH vivartate anuttarasyAH samyaksaMboDeH
   evaṃ yogam anuyuktaḥ subhūte bodhisatvo mahāsatvo 'nena vihāreṇa viharan	evam yogam anuyuktaH suBUte boDisatvaH mahAsatvaH anena vihAreNa viharan
   yathā prajñāpāramitāyām upadiṣṭam ekadivasena	yaTA prajQApAramitAyAm upadizwam eka-divasena
   [GBM 573.1 = LPG(Ch) 203r] yat kuśalamūlaṃ parigṛhṇāti tena	[GBm 573.1  LPG(Sh) 203r] yat kuSala-mUlam parigRhNAti tena
   gaṃgānadīvālukopamāl lokadhātavaḥ paripūrṇā bhaveyur na tat tasya	gaMgA-nadI-vAlukA-upamAt lokaDAtavaH paripUrNA BaveyuH na tat tasya
   kuśalamūlasya śatatamīm api kalān nopaiti / sahasratamīm api	kuSala-mUlasya SatatamIm api kalAn na-upEti / sahasratamIm api
   śatasahasratamīm	Sata-sahasratamIm
   2 api yāvat saṃkhyām api kalām api gaṇanām apy upamām apy upaniśām api	2 api yAvat saMKyAm api kalAm api gaNanAm api upamAm api upaniSAm api
   nopaiti // punar aparaṃ subhūte bodhisatvo mahāsatvaḥ prajñāpāramitāyāṃ	na-upEti // punar aparam suBUte boDisatvaH mahAsatvaH prajQApAramitAyAm
   caraṃ / gaṃgānadīvālukopamān kalpān dānan dadyāt	caram / gaMgA-nadI-vAlukA-upamAn kalpAn dAnan dadyAt-
   3 triṣu ratneṣu / buddharatne dharmaratne saṃgharatne tat kiṃ manyase	3 trizu ratnezu / budDa-ratne Darma-ratne saMGa-ratne tat kim manyase
   subhūte api nu sa bodhisatvo mahāsatvas tatonidānaṃ bahu puṇyaṃ prasavet*	suBUte api nu sa boDisatvaH mahAsatvaH tatonidAnam bahu puNyam prasavet-*
   āha / bahu bhagavaṃ bahu sugata aprameyam asaṃkhyeyam	Aha / bahu Bagavam bahu sugata aprameyam asaMKyeyam
   4 aparimāṇam atulyaṃ bhagavān āha / ayam eva tataḥ subhūte bodhisatvo	4 aparimANam atulyam BagavAn Aha / ayam eva tatas suBUte boDisatvaH-
   mahāsatvo bahutaraṃ punyaṃ prasaved ya iha gaṃbhīrāyāṃ prajñāpāramitāyāṃ	mahAsatvaH bahutaram punyam prasavet yaH iha gaMBIrAyAm prajQApAramitAyAm
   yathānirdiṣṭāyāṃ yogam āpadyate / tat kasya	yaTA-nirdizwAyAm yogam Apadyate / tat kasya
   5 hetoḥ eṣo hi bodhisatvānāṃ mahāsatvānāṃ nayo yena nayenānuttarāṃ	5 hetoH ezaH hi boDisatvAnAm mahAsatvAnAm nayaH yena nayena-anuttarAm
   samyaksaṃbodhim abhisaṃbudhyate / tat kiṃ manyase subhūte yo bodhisatvo	samyaksaMboDim aBisaMbuDyate / tat kim manyase suBUte yaH boDisatvaH-
   mahāsatvaḥ prajñāpāramitayā virahito gaṃganadīvālukopamāṃ	mahAsatvaH prajQApAramitayA virahitaH gaMganadI-vAlukA-upamAm
   6 kalpāṃs tiṣṭhan* śrotaāpanneṣu dakṣiṇāṃ pratiṣṭhāpayet sakṛdāgāmiṣv	6 kalpAn tizWan* SrotaApannezu dakziNAm pratizWApayet sakRdAgAmizv
   anāgāmiṣv arhatsu pratyekabuddheṣu tathāgateṣv arhatsu samyaksaṃbuddheṣu	anAgAmizu arhatsu pratyekabudDezu taTAgatezu arhatsu samyaksaMbudDezu
   dakṣiṇāṃ pratiṣṭhāpaye tat kiṃ manyase subhūte	dakziNAm pratizWApaye tat kim manyase suBUte
   7 api nu sa bodhisatvo mahāsatvaḥ tatonidanaṃ bahu puṇyaṃ prasavet* āha /	7 api nu sa boDisatvaH mahAsatvaH tatonidanam bahu puNyam prasavet* Aha /
   bahu bhagavaṃ bahu sugata / bhagavān āha / ayam eva subhūte kulaputro vā	bahu Bagavam bahu sugataH / BagavAn Aha / ayam eva suBUte kula-putraH vA
   kuladuhitā vā tatonidānaṃ bahu puṇyaṃ prasavet*	kula-duhitA vA tatonidAnam bahu puNyam prasavet-*
   8 ya iha gaṃbhīrāyāṃ prajñāpāramitāyāṃ yathopadiṣṭāyāṃ yogam āpadyeta /	8 yaH iha gaMBIrAyAm prajQApAramitAyAm yaTA-upadizwAyAm yogam Apadyeta /
   tat kasya hetoḥ atra hi prajñāpāramitāyāṃ caraṃ bodhisatvo mahāsatvaḥ	tat kasya hetoH atra hi prajQApAramitAyAm caram boDisatvaH mahAsatvaH
   śrāvakapratyekabuddhabhūmīm atikramya	SrAvaka-pratyekabudDa-BUmIm atikramya
   9 bodhisatvanyāmam avakrāmati / yāvad anuttarāṃ samyaksaṃbodhim	9 boDisatvan-yAmam avakrAmati / yAvat anuttarAm samyaksaMboDim
   abhisaṃbuddhyate / tat kiṃ manyase subhūte yo bodhisatvo mahāsatvaḥ	aBisaMbudDyate / tat kim manyase suBUte yaH boDisatvaH mahAsatvaH
   prajñāpāramitayā virahito gaṃgānadīvālukopamāṃ kalpāṃs tiṣṭhaṃ yāpayaṃ	prajQApAramitayA virahitaH gaMgA-nadI-vAlukA-upamAm kalpAn tizWam yApayam
   10 dānaṃ dadyāc chīlaṃ rakṣe kṣāntyā saṃpādayed vīryam ārabheta dhyānāni	10 dAnam dadyAt SIlam rakze kzAntyA saMpAdayet vIryam AraBeta DyAnAni
   samāpadyeta prajñāṃ bhāvayet* api nu sa tatonidānaṃ bahu puṇyaṃ prasavet*	samApadyeta prajQAm BAvayet* api nu sa tatonidAnam bahu puNyam prasavet-*
   āha / bahu bhagavaṃ bahu sugata bhagavān āha / ataḥ sa	Aha / bahu Bagavam bahu sugata BagavAn Aha / atas sa
   11 subhūte kulaputro vā kuladuhitā vā bahutaraṃ puṇyaṃ prasaved ya iha	11 suBUte kula-putraH vA kula-duhitA vA bahutaram puNyam prasavet yaH iha
   gaṃbhīrāyāṃ prajñāpāramitāyāṃ yathopadiṣṭāyāṃ sthitvā ekadivasam api dānaṃ	gaMBIrAyAm prajQApAramitAyAm yaTA-upadizwAyAm sTitvA eka-divasam api dAnam
   dadyāc chīlaṃ rakṣet* kṣāntyā saṃpādayed vīryam ārabheta	dadyAt SIlam rakzet* kzAntyA saMpAdayet vIryam AraBeta
   12 dhyānāni samāpadyeta prajñāṃ bhāvaye tat kasya hetoḥ tathā hi subhūte	12 DyAnAni samApadyeta prajQAm BAvaye tat kasya hetoH taTA hi suBUte
   mātaiṣā bodhisatvānāṃ mahāsatvānāṃ yad uta prajñāpāramitā janayitryaiṣā	mAtA-ezA boDisatvAnAm mahAsatvAnAm yat uta prajQApAramitA janayitryA-ezA
   bodhisatvāṇāṃ mahāsatvāṇāṃ yad uta prajñāpāramitā / atra subhūte	boDisatvANAm mahAsatvANAm yat uta prajQApAramitA / atra suBUte
   13 prajñāpāramitāyāṃ sthitvā bodhisatvā mahāsatvāḥ sarvadharmāṃ	13 prajQApAramitAyAm sTitvA boDisatvAH mahAsatvAH sarva-DarmAm
   paripūrayaṃti / yāvad anuttarāṃ samyaksaṃbodhim abhisaṃbuddhyante / tat	paripUrayaMti / yAvat anuttarAm samyaksaMboDim aBisaMbudDi-ante / tat-
   kiṃ manyase subhūte yo bodhisatvo mahāsatvaḥ prajñāpāramitayā virahito	kim manyase suBUte yaH boDisatvaH mahAsatvaH prajQApAramitayA virahitaH-
   14 gaṃgānadīvālukopamāṃ kalpāṃs tiṣṭhan* dharmadānaṃ dadyāt* api sa	14 gaMgA-nadI-vAlukA-upamAm kalpAn tizWan* Darma-dAnam dadyAt* api sa
   kulaputro vā kuladuhitā vā tatonidānaṃ bahu puṇyaṃ prasavet* āha / bahu	kula-putraH vA kula-duhitA vA tatonidAnam bahu puNyam prasavet* Aha / bahu
   bhagavaṃ bahu sugata bhagavān āha / ataḥ sa subhūte	Bagavam bahu sugata BagavAn Aha / atas sa suBUte
   [GBM 574.1 = LPG(Ch) 203v] kulaputro vā kuladuhitā vā bahutaraṃ puṇyaṃ	[GBm 574.1  LPG(Sh) 203v] kula-putraH vA kula-duhitA vA bahutaram puNyam
   prasaved ya iha gaṃbhīrāyāṃ prajñāpāramitāyāṃ yathopadiṣṭāyāṃ sthitvā	prasavet yaH iha gaMBIrAyAm prajQApAramitAyAm yaTA-upadizwAyAm sTitvA
   ekadivasam api dharmadānaṃ dadyāt* tat kasya hetoḥ tathā hi subhūte	eka-divasam api Darma-dAnam dadyAt* tat kasya hetoH taTA hi suBUte
   bodhisatvo mahāsatvaḥ	boDisatvaH mahAsatvaH
   2 prajñāpāramitāyā virahitaḥ sa sarvākārajñatayā virahito yaḥ punaḥ	2 prajQApAramitAyAH virahitaH sa sarva-AkAra-jQa-tayA virahitaH yaH punar-
   subhūte bodhisatvo mahāsatvaḥ avirahitaḥ sarvākārajñatayā avirahitaḥ	suBUte boDisatvaH mahAsatvaH avirahitaH sarva-AkAra-jQa-tayA avirahitaH
   tasmāt tarhi subhūte bodhisatvena mahāsatvenānuttarāṃ	tasmAt tarhi suBUte boDisatvena mahAsatvena-anuttarAm
   3 samyaksaṃbodhim abhisaṃboddhukāmena prajñāpāramitayā avirahitena	3 samyaksaMboDim aBisaMbodDu-kAmena prajQApAramitayA avirahitena
   bhavitavyaṃ / tat kiṃ manyase subhūte yo bodhisatvo mahāsatvaḥ	Bavitavyam / tat kim manyase suBUte yaH boDisatvaH mahAsatvaH
   prajñāpāramitayā virahito gaṃgānadībālukopamān kalpāṃs tiṣṭhan	prajQApAramitayA virahitaH gaMgA-nadI-bAlukA-upamAn kalpAn tizWan
   4 yogam āpadyeta caturṣu smṛtyupasthāneṣu yāva śunyatānimittāpraṇihiteṣu	4 yogam Apadyeta caturzu smRti-upasTAnezu yAva SunyatA-nimitta-apraNihitezu
   yāvad yogam āpadyeta sarvasamādhiṣu / tat kiṃ manyase subhūte api nu sa	yAvat yogam Apadyeta sarva-samADizu / tat kim manyase suBUte api nu sa
   kulaputro vā kuladuhitā vā tatonidānaṃ bahu	kula-putraH vA kula-duhitA vA tatonidAnam bahu
   5 puṇyaṃ prasavet* āha / bahu bhagavaṃ bahu sugata bhagavān āha / ayam eva	5 puNyam prasavet* Aha / bahu Bagavam bahu sugata BagavAn Aha / ayam eva
   sa subhūte kulaputro vā kuladuhitā vā bahutaraṃ puṇyaṃ prasaved ya iha	sa suBUte kula-putraH vA kula-duhitA vA bahutaram puNyam prasavet yaH iha
   gaṃbhīrāyāṃ prajñāpāramitāyāṃ yathopadiṣṭāyām	gaMBIrAyAm prajQApAramitAyAm yaTA-upadizwAyAm
   6 ekadivasam api yogam āpadyeta caturṣu smṛtyupasthāneṣu yāvad aṣṭādaśaṣv	6 eka-divasam api yogam Apadyeta caturzu smRti-upasTAnezu yAvat azwAdaSazu-
   āveṇikeṣu buddhadharmeṣu / tat kasya hetoḥ / asthānaṃ subhūte anavakāśaḥ	AveNikezu budDa-Darmezu / tat kasya hetoH / asTAnam suBUte anavakASaH
   yad bodhisatvo mahāsatvaḥ	yat boDisatvaH mahAsatvaH
   7 prajñāpāramitayā avirahitaḥ sarvākārajñatayā vivartate / nedaṃ sthānaṃ	7 prajQApAramitayA avirahitaH sarva-AkAra-jQa-tayA vivartate / na-idam sTAnam
   vidyate / sthānaṃ khalu punaḥ subhūte vidyate yad bodhisatvo mahāsatvaḥ	vidyate / sTAnam Kalu punar suBUte vidyate yat boDisatvaH mahAsatvaH
   prajñāpāramitayā virahitaḥ sarvākārajñatayā nvivarteta	prajQApAramitayA virahitaH sarva-AkAra-jQa-tayA nvivarteta
   8 sthānām etad vidyate / tasmāt tarhi subhūte bodhisatvena mahāsatvena	8 sTAnAm etat vidyate / tasmAt tarhi suBUte boDisatvena mahAsatvena
   prajñāpāramitayā avirahitena bhavitavyaṃ / tat kiṃ manyase subhūte yo	prajQApAramitayA avirahitena Bavitavyam / tat kim manyase suBUte yaH-
   bodhisatvo mahāsatvaḥ prajñāpāramitayā virahito gaṃgānadīvālukopamāṃ	boDisatvaH mahAsatvaH prajQApAramitayA virahitaH gaMgA-nadI-vAlukA-upamAm
   9 kalpāṃs tiṣṭhaṃs tac cāmiṣadānaṃ tac ca dharmadānaṃ tāṃś ca	9 kalpAn tizWan tat ca-Amiza-dAnam tat ca Darma-dAnam tAn ca
   pratisaṃlayanapratisaṃyuktāṃ manasikārān anuttarasyai samyaksaṃbodhaye	pratisaMlayana-pratisaMyuktAm manasikArAn anuttarasyE samyaksaMboDaye
   pariṇāmayed api nu sa kulaputro vā kuladuhitā vā tatonidānaṃ	pariNAmayet api nu sa kula-putraH vA kula-duhitA vA tatonidAnam
   10 bahu puṇyaṃ prasavet* āha / bahu bhagavaṃ bahu sugata / bhagavān āha /	10 bahu puNyam prasavet* Aha / bahu Bagavam bahu sugataH / BagavAn Aha /
   ataḥ sa subhūte kulaputro vā kuladuhitā vā bahutaraṃ puṇyaṃ prasaved ya	atas sa suBUte kula-putraH vA kula-duhitA vA bahutaram puNyam prasavet ya
   iha gaṃbhīrāyāṃ prajñāpāramitāyāṃ	iha gaMBIrAyAm prajQApAramitAyAm
   11 yathopadiṣṭāyāṃ sthitvā ekadaivasikaṃ cāmiṣadānaṃ tac ca dharmadānaṃ	11 yaTA-upadizwAyAm sTitvA eka-dEvasikam ca-Amiza-dAnam tat ca Darma-dAnam
   tāṃś ca pratisaṃlayanapratisaṃyuktān ananasikārān anuttarasyāṃ	tAn ca pratisaMlayana-pratisaMyuktAn ananasikArAn anuttarasyAm
   samyaksaṃbodhau pariṇamayet* tat kasya hetoḥ eṣa hi paramaḥ pariṇāmo	samyaksaMboDO pariNamayet* tat kasya hetoH eza hi paramaH pariNAmaH-
   12 yad uta prajñāpāramitāpariṇāmaḥ yaḥ punaḥ prajñāpāramitayā vinā	12 yat uta prajQApAramitA-pariNAmaH yaH punar prajQApAramitayA vinA
   pariṇāmo nāsau pariṇāmaḥ / tasmāt tarhi subhūte bodhisatvena	pariNAmaH na-asO pariNAmaH / tasmAt tarhi suBUte boDisatvena
   mahāsatvenānuttarāṃ samyaksaṃbodhim abhisaṃboddhukāmena	mahAsatvena-anuttarAm samyaksaMboDim aBisaMbodDu-kAmena
   13 prajñāpāramitāpariṇamanākuśalamūlena bhavitavyaṃ / tat kiṃ manyase	13 prajQApAramitA-pariNamanA-kuSala-mUlena Bavitavyam / tat kim manyase
   subhūte / yo hi kaścit kulaputro vā kuladuhitā vā prajñāpāramitayā	suBUte / yaH hi kaScid kula-putraH vA kula-duhitA vA prajQApAramitayA
   virahito gaṃgānadīvālukopamāṃ kalpāṃs tiṣṭhann	virahitaH gaMgA-nadI-vAlukA-upamAm kalpAn tizWan=-
   [GBM 575.l = LPG(Ch) 204r] atītānāgatapratyutpannānāṃ buddhānāṃ bhagavatāṃ	[GBm 575.t  LPG(Sh) 204r] atIta-anAgata-pratyutpannAnAm budDAnAm BagavatAm
   saśrāvakasaṃghānām yat kuśalamūlaṃ tat sarvam anuttarasyāṃ samyaksaṃbodhau	sa-SrAvaka-saMGAnAm yat kuSala-mUlam tat sarvam anuttarasyAm samyaksaMboDO
   pariṇāmayed api nu sa kulaputro vā kuladuhitā vā tatonidānaṃ bahu puṇyaṃ	pariNAmayet api nu sa kula-putraH vA kula-duhitA vA tatonidAnam bahu puNyam
   prasavet*	prasavet-*
   2 āha bahu bhagavaṃ bahu sugata bhagavān āha / atas sa subhūte kulaputro	2 Aha bahu Bagavam bahu sugata BagavAn Aha / atas sa suBUte kula-putraH-
   vā kuladuhitā vā bahutaraṃ puṇyaṃ prasaved ya iha gaṃbhīrāyāṃ	vA kula-duhitA vA bahutaram puNyam prasavet yaH iha gaMBIrAyAm
   prajñāpāramitāyāṃ yathopadiṣṭāyāṃ sthitvā ekadaivasikam	prajQApAramitAyAm yaTA-upadizwAyAm sTitvA eka-dEvasikam
   3 api kusalamūlam anuttarasyāṃ samyaksaṃbodhau pariṇamayet* tat kasya	3 api kusala-mUlam anuttarasyAm samyaksaMboDO pariNamayet* tat kasya
   hetoḥ prajñāpāramitā pūrvaṃgatā hi subhūte sarvapariṇamanāt tasmāt tarhi	hetoH prajQApAramitA pUrvaMgatA hi suBUte sarva-pariNamanAt tasmAt tarhi
   subhūte bodhisatvena mahāsatvenānuttarāṃ	suBUte boDisatvena mahAsatvena-anuttarAm
   4 samyaksaṃbodhim abhisaṃboddhukāmena prajñāpāramitāpariṇamanākuśalena	4 samyaksaMboDim aBisaMbodDu-kAmena prajQApAramitA-pariNamanA-kuSalena
   bhavitavyaṃ / āha / yat punar bhagavaṃn abhisaṃskāraḥ kalpita ukto	Bavitavyam / Aha / yat punar Bagavan aBisaMskAraH kalpitaH uktaH-
   bhagavatā tat kathaṃ sa kulaputro vā kuladuhitā	BagavatA tat kaTam sa kula-putraH vA kula-duhitA
   5 vā bahutaraṃ puṇyaṃ prasavet* sa ca bhagavaṃn anabhisaṃskāreṇa śakyaṃ	5 vA bahutaram puNyam prasavet* sa ca Bagavan anaBisaMskAreNa Sakyam
   samyagdṛṣṭiṃ cotpādayituṃ nyāmaṃ cāvakramitum* śrotaāpattiphalaṃ	samyak-dRzwim ca-utpAdayitum nyAmam ca-avakramitum* SrotaA-patti-Palam
   cānuprāptum* yāvad anuttarāṃ samyaksaṃbodhim abhisaṃboddhum*	ca-anuprAptum* yAvat anuttarAm samyaksaMboDim aBisaMbodDum*
   6 bhagavān āha / evam etat subhūte evam etat* na hy anabhisaṃskāreṇa	6 BagavAn Aha / evam etat suBUte evam etat* na hi anaBisaMskAreNa
   śakyaṃ samyagdṛṣṭiṃ cotpādayituṃ nyāmaṃ cāvakramitum* śrotaāpattiphalaṃ	Sakyam samyak-dRzwim ca-utpAdayitum nyAmam ca-avakramitum* SrotaA-patti-Palam
   cānuprāptum* yāvad anuttarāṃ samyaksaṃbodhim abhisaṃboddhum*	ca-anuprAptum* yAvat anuttarAm samyaksaMboDim aBisaMbodDum*
   7 api tu khalu punaḥ subhūte tad api dānam anabhisaṃskāro bodhisatvasya	7 api tu Kalu punar suBUte tat api dAnam anaBisaMskAraH boDisatvasya
   mahāsatvasya prajñāpāramitāyāṃ carataḥ śunyakam evākhyāti riktakam eva	mahAsatvasya prajQApAramitAyAm carataH Sunyakam eva-AKyAti riktakam eva
   tucchakam evāsārakam evākhyāti	tucCakam eva-asArakam eva-AKyAti
   8 tat kasya hetoḥ tathā hi subhūte bodhisatvo mahāsatvo adhyātmaśunyatāyāṃ	8 tat kasya hetoH taTA hi suBUte boDisatvaH mahAsatvaH aDyAtma-SunyatAyAm
   suśikṣito bahirdhāśunyatāyām adhyātmabahirdhāśunyatāyāṃ suśikṣitaḥ	su-SikzitaH bahirDASunyatAyAm aDyAtma-bahirDASunyatAyAm su-SikzitaH
   śunyatāśunyatāyāṃ mahāśunyatāyāṃ paramārthaśunyatāyāṃ	Sunyata-ASunyatAyAm mahA-SunyatAyAm parama-arTa-SunyatAyAm
   9 saṃskṛtaśunyatāyām asaṃskṛtaśunyatāyām atyaṃtaśunyatāyām	9 saMskRta-SunyatAyAm asaMskRta-SunyatAyAm atyaMta-SunyatAyAm
   anavarāgraśunyatāyām anavakāraśunyatāyāṃ prakṛtiśunyatāyāṃ	anavara-agra-SunyatAyAm anavakAra-SunyatAyAm prakRti-SunyatAyAm
   sarvadharmaśunyatāyāṃ svalakṣaṇaśunyatāyām	sarva-Darma-SunyatAyAm sva-lakzaNa-SunyatAyAm
   10 anupalaṃbhaśunyatāyām abhāvaśunyatāyāṃ svabhāvaśunyatāyām	10 anupalaMBa-SunyatAyAm aBAva-SunyatAyAm svaBAva-SunyatAyAm
   abhāvasvabhāvaśunyatāyāṃ suśikṣitaḥ sa khalu punaḥ subhūte bodhisatvo	aBAva-svaBAva-SunyatAyAm su-SikzitaH sa Kalu punar suBUte boDisatvaH-
   mahāsatvaḥ āsu śunyatāsu sthitvā yathā yathā	mahAsatvaH Asu SunyatAsu sTitvA yaTA yaTA
   11 tān saṃskārāṃ pratyavekṣate / tathā tathā bodhisatvo mahāsatvaḥ	11 tAn saMskArAm pratyavekzate / taTA taTA boDisatvaH mahAsatvaH
   prajñāpāramitayā avirahito bhavati / yathā yathā bodhisatvo mahāsatvaḥ	prajQApAramitayA avirahitaH Bavati / yaTA yaTA boDisatvaH mahAsatvaH
   prajñāpāramitayā avirahito bhavati / tathā tathā	prajQApAramitayA avirahitaH Bavati / taTA taTA
   12 asaṃkhyeyam aprameyam aparimāṇaṃ puṇyaṃ prasavati āha / asaṃkhyeyasya	12 asaMKyeyam aprameyam aparimANam puNyam prasavati Aha / asaMKyeyasya
   ca bhagavaṃn aprameyasya cāparimāṇasya ca ko viśeṣaḥ bhagavān āha /	ca Bagavan aprameyasya ca-aparimANasya ca kaH viSezaH BagavAn Aha /
   asaṃkhyeyam api195 subhūte yat saṃkhyāṃ nopaiti	asaMKyeyam api195 suBUte yat saMKyAm na-upEti
   13 saṃskṛte vā dhātav asaṃskṛte va dhātau aprameyam iti subhūte yasya	13 saMskRte vA DAtav asaMskRte va DAtO aprameyam iti suBUte yasya
   pramāṇaṃ nopalabhyate atītānāgatapratyutpanneṣu dharmeṣu / aparimāṇam iti	pramANam na-upalaByate atIta-anAgata-pratyutpannezu Darmezu / aparimANam iti
   subhūte yan na śakyaṃ pramātuṃ /	suBUte yat na Sakyam pramAtum /
   [GBM 576.l = LPG(Ch) 204v] āha / syād bhagavaṃ paiyāyo yad rūpam apy	[GBm 576.t  LPG(Sh) 204v] Aha / syAt Bagavam pEyAyaH yat rUpam api-
   asaṃkhyeyam aprameyam aparimāṇaṃ bhavet* vedanā saṃjñā saṃskāra vijñānam	asaMKyeyam aprameyam aparimANam Bavet* vedanA saMjQA saMskAra vijQAnam
   asaṃkhyeyam aprameyam aparimāṇaṃ bhavet* bhagavān āha / syāt subhūte	asaMKyeyam aprameyam aparimANam Bavet* BagavAn Aha / syAt suBUte
   paryāyo	paryAyaH-
   2 yena paryāyeṇa rūpam apy asaṃkhyeyam aprameyam aparimāṇaṃ bhavet* vedanā	2 yena paryAyeNa rUpam api asaMKyeyam aprameyam aparimANam Bavet* vedanA
   saṃjñā saṃskārā vijñānam apy asaṃkhyeyam aprameyam aparimāṇaṃ bhavet* āha	saMjQA saMskArAH vijQAnam api asaMKyeyam aprameyam aparimANam Bavet* Aha
   / katamena bhagavan paryāyeṇa rūpam apy	/ katamena Bagavan paryAyeNa rUpam api-
   3 asaṃkhyeyam aprameyam aparimāṇaṃ bhaved vedanā saṃjñā saṃskārā vijñānam	3 asaMKyeyam aprameyam aparimANam Bavet vedanA saMjQA saMskArAH vijQAnam
   apy asaṃkhyeyam aprameyam bhavet* bhagavān āha / rūpam api subhūte śunyam	api asaMKyeyam aprameyam Bavet* BagavAn Aha / rUpam api suBUte Sunyam
   asaṃkhyeyam aprameyam	asaMKyeyam aprameyam
   4 aparimāṇaṃ / vedanā saṃjñā saṃskārā vijñānam api subhūte śunyam	4 aparimANam / vedanA saMjQA saMskArAH vijQAnam api suBUte Sunyam
   asaṃkhyeyam aprameyam aparimāṇaṃ āha / kiṃ punar bhagavaṃn rūpam eva	asaMKyeyam aprameyam aparimANam Aha / kim punar Bagavan rUpam eva
   śunyaṃ vedanā saṃjñā saṃskārā vijñānam eva śunyaṃ / na punaḥ	Sunyam vedanA saMjQA saMskArAH vijQAnam eva Sunyam / na punar-
   5 sarvadharmāḥ śunyāḥ bhagavān āha / tat kiṃ manyase subhūte nanu mayā	5 sarva-DarmAH SunyAH BagavAn Aha / tat kim manyase suBUte nanu mayA
   sarvadharmāḥ śunyā ity ākhyātāḥ āha / śunyā bhagavan sarvadharmā iti	sarva-DarmAH SunyAH iti AKyAtAH Aha / SunyA Bagavan sarva-DarmAH iti
   tathāgatenākhyātā yā ca bhagavaṃn śunyatā / akṣayāpi	taTAgatena-AKyAtA yA ca Bagavan SunyatA / akzayA-api
   6 sā / aprameyāpi sā aparimāṇāpi sā na hi bhagavaṃ śunyatāyāḥ	6 sA / aprameyA-api sA aparimANA-api sA na hi Bagavam SunyatAyAH
   saṃkhyopalabhyate na pramāṇaṃ na parimāṇam upalabhyate / tasmāt tarhi	saMKyA-upalaByate na pramANam na parimANam upalaByate / tasmAt tarhi
   bhagavaṃ naiṣān dharmāṇām arthato	Bagavam na-ezAn DarmANAm arTataH-
   7 vā vyaṃjanato vā nānākaraṇam upalabhyate / bhagavān āha / evam etat	7 vA vyaMjanataH vA nAnA-karaNam upalaByate / BagavAn Aha / evam etat-
   subhūte evam etat* naiṣān dharmāṇām arthato vā vyaṃjanato vā nānākaraṇam	suBUte evam etat* na-ezAn DarmANAm arTataH vA vyaMjanataH vA nAnA-karaNam
   upalabhyate / anabhilāpyam etat subhūte tathāgatenābhilaptam	upalaByate / anaBilApyam etat suBUte taTAgatena-aBilaptam
   8 akṣayam iti vā aprameyam iti vā / śunyam iti vā ānimittam iti vā	8 akzayam iti vA aprameyam iti vA / Sunyam iti vA Animittam iti vA
   apraṇihitam iti vā anabhisaṃskāram iti vā anutpāda iti vā virāga iti vā	apraNihitam iti vA anaBisaMskAram iti vA anutpAdaH iti vA virAgaH iti vA
   nirodha iti vā nirvāṇam	niroDaH iti vA nirvANam
   9 iti vā / deśanābhinirhāranirdeśa eṣa tathāgatasyākṣayam iti vā yāvan	9 iti vA / deSanA-aBinirhAra-nirdeSaH eza taTAgatasya-akzayam iti vA yAvat-
   nirvāṇam iti vā / āha / āścaryaṃ bhagavan yāvac cedaṃ dharmāṇāṃ dharmatā	nirvANam iti vA / Aha / AScaryam Bagavan yAvat ca-idam DarmANAm DarmatA
   tathāgatena deśitā anabhilāpyā / yathāham bhagavato	taTAgatena deSitAH anaBilApyAH / yaTA-aham BagavataH-
   10 bhāṣitasyārtham ājānāmi / sarvadharmā eva bhagavann anabhilāpyāḥ /	10 BAzitasya-arTam AjAnAmi / sarva-DarmAH eva Bagavan anaBilApyAH /
   bhagavān āha / evam etat subhūte evam etat* sarvadharmā subhūte	BagavAn Aha / evam etat suBUte evam etat* sarva-DarmA suBUte
   anabhilāpyāḥ yā subhūte dharmāṇām anabhilāpyatā sā	anaBilApyAH yA suBUte DarmANAm anaBilApyatA sA
   11 śunyatā na ca śunyatāyāṃ kiṃ cid abhilapitaṃ nāpi śunyatā śakyā	11 SunyatA na ca SunyatAyAm kim cit aBilapitam na-api SunyatA SakyA
   abhilapituṃ āha / kaccit punar bhagavaṃn anabhilāpyasyārthasya vṛddhir vā	aBilapitum Aha / kaccit punar Bagavan anaBilApyasya-arTasya vRdDiH vA
   parihāṇir vā / bhagavān āha / no hīdaṃ subhūte na subhūte	parihANiH vA / BagavAn Aha / no hi-idam suBUte na suBUte
   12 anabhilāpyasyārthasya vṛddhir vā parihāṇir vā / āha / sacet punar	12 anaBilApyasya-arTasya vRdDiH vA parihANiH vA / Aha / saced punar-
   bhagavaṃn anabhilāpyasyārthasya naiva vṛddhir na parihāṇis tad	Bagavan anaBilApyasya-arTasya na-eva vRdDiH na parihANiH tat-
   dānapāramitayā api bhagavaṃ na vṛddhir na parihāṇir bhaviṣyati / evaṃ	dAna-pAramitayA api Bagavam na vRdDiH na parihANiH Bavizyati / evam
   13 śīlapāramitayāḥ kṣāntipāramitayāḥ vīryapāramitayāḥ dhyānapāramitayāḥ	13 SIla-pAramitayAH kzAnti-pAramitayAH vIrya-pAramitayAH DyAna-pAramitayAH
   prajñāpāramitayāḥ api na vṛddhir na parihāṇir bhaviṣyati / caturṇāṃ	prajQApAramitayAH api na vRdDiH na parihANiH Bavizyati / caturNAm
   smṛtyupasthānānāṃ yāvad āryāṣṭāṃgasya	smRti-upasTAnAnAm yAvat Arya-azwa-aMgasya
   [GBM 577.1 = LPG(Ch) 205r] mārgasya aṣṭānāṃ vimokṣāṇāṃ navānām	[GBm 577.1  LPG(Sh) 205r] mArgasya azwAnAm vimokzANAm navAnAm
   anupūrvasamāpattīnāṃ daśānāṃ tathāgatabalāṇāṃ caturṇāṃ vaiśāradyānāṃ	anupUrva-samApattInAm daSAnAm taTAgata-balANAm caturNAm vESAradyAnAm
   catasṛṇāṃ pratisaṃvidāṃ mahāmaitryā mahākaruṇāyā aṣṭādaśānām āveṇikānāṃ	catasRNAm pratisaMvidAm mahAmEtryAH mahA-karuNAyAH azwAdaSAnAm AveNikAnAm
   buddhadharmāṇāṃ	budDa-DarmANAm
   2 na vṛddhir na parihāṇir bhaviṣyati / ṣaṇṇāṃ pāramitānām abhāvo	2 na vRdDiH na parihANiH Bavizyati / zaNNAm pAramitAnAm aBAvaH-
   bhaviṣyati / yāvad aṣṭādaśānām āveṇikānāṃ buddhadharmāṇām abhāvo	Bavizyati / yAvat azwAdaSAnAm AveNikAnAm budDa-DarmANAm aBAvaH-
   bhaviṣyati / eṣāṃ ca dharmāṇām abhāvāt sarvākārajñatāyā apy abhāvo	Bavizyati / ezAm ca DarmANAm aBAvAt sarva-AkAra-jQa-tAyAH api aBAvaH-
   3 bhaviṣyati / sarvākārajñatāyā abhāvāt ko hy anuttarāṃ samyaksaṃbodhim	3 Bavizyati / sarva-AkAra-jQa-tAyAH aBAvAt kaH hi anuttarAm samyaksaMboDim
   abhisaṃbuddhyate / abhisaṃbhotsyate vā / bhagavān āha / evam etat subhūte	aBisaMbudDyate / aBisaMBotsyate vA / BagavAn Aha / evam etat suBUte
   evam etat* nānabhilāpyasyārthasya vṛddhir vā parihāṇir vā / sa	evam etat* na-anaBilApyasya-arTasya vRdDiH vA parihANiH vA / sa
   4 cet punaḥ subhūte bodhisatvasya mahāsatvasya prajñāpāramitāyāñ carataḥ	4 ced punar suBUte boDisatvasya mahAsatvasya prajQApAramitAyAn carataH
   prajñāpāramitāṃ bhāvayataḥ prajñāpāramitāyāṃ yogam	prajQApAramitAm BAvayataH prajQApAramitAyAm yogam
   āpadyamānasyopāyakuśalasya naivaṃ bhavaty ahaṃ prajñāpāramitāyāṃ	ApadyamAnasya-upAya-kuSalasya na-evam Bavati aham prajQApAramitAyAm
   5 vivardhe evaṃ yāvad dānapāramitāyāṃ vivardhe / atha ca punar asyaivaṃ	5 vivarDe evam yAvat dAna-pAramitAyAm vivarDe / aTa ca punar asya-evam
   bhavati nāmadheyamātram etad yad uta dānapāramitā / sa dānapāramitāyāṃ	Bavati nAmaDeya-mAtram etat yat uta dAna-pAramitA / sa dAna-pAramitAyAm
   caraṃs tāṃ manasikārāṃs tāṃś cittotpādāṃs	caran tAm manasikArAn tAn citta-utpAdAn=-
   6 tāni ca kuśalamūlāni anuttarasyāṃ samyaksaṃbodhau pariṇamayati tathā ca	6 tAni ca kuSala-mUlAni anuttarasyAm samyaksaMboDO pariNamayati taTA ca
   pariṇamayati / yathā sānuttarā samyaksaṃbodhiḥ evaṃ śīlapāramitāyāṃ	pariNamayati / yaTA sA-anuttarA samyaksaMboDiH evam SIla-pAramitAyAm
   kṣāntipāramitāyāṃ vīryapāramitāyāṃ	kzAnti-pAramitAyAm vIrya-pAramitAyAm
   7 dhyānapāramitāyāṃ prajñāpāramitāyāṃ caraṃs tāṃ manasikārāṃs tāṃś	7 DyAna-pAramitAyAm prajQApAramitAyAm caran tAm manasikArAn tAnS
   cittotpādāṃs tāni kuśalamūlāni anuttarasyāṃ samyaksaṃbodhau pariṇamayati /	citta-utpAdAn tAni kuSala-mUlAni anuttarasyAm samyaksaMboDO pariNamayati /
   tathā ca pariṇamayati / yathānuttarā	taTA ca pariNamayati / yaTA-anuttarA
   8 samyaksaṃbodhiḥ āha kathaṃ bhagavaṃn anuttarā samyaksaṃbodhiḥ / bhagavān	8 samyaksaMboDiH Aha kaTam Bagavan anuttarA samyaksaMboDiH / BagavAn
   āha / yā subhūte sarvadharmāṇāṃ tathatā sānuttarā samyaksaṃbodhiḥ / āha /	Aha / yA suBUte sarva-DarmANAm taTatA sA-anuttarA samyaksaMboDiH / Aha /
   katameṣāṃ bhagavaṃ sarvadharmāṇāṃ tathatānuttarā	katamezAm Bagavam sarva-DarmANAm taTatA-anuttarA
   9 samyaksaṃbodhiḥ / bhagavān āha / yā subhūte rūpasya tathatā yāvad yā	9 samyaksaMboDiH / BagavAn Aha / yA suBUte rUpasya taTatA yAvat yA
   nirvāṇasya tathatā sānuttarā samyaksaṃbodhiḥ sā naiva vardhate na	nirvANasya taTatA sA-anuttarA samyaksaMboDiH sA na-eva varDate na
   parihīyate tat subhūte bodhisatvo mahāsatvaḥ	parihIyate tat suBUte boDisatvaH mahAsatvaH
   10 prajñāpāramitayā avirahito bhīkṣṇaṃ bahulaṃ viharati na kasya cid	10 prajQApAramitayA avirahitaH BIkzNam bahulam viharati na kasya cit-
   dharmasya vṛddhir vā parihāṇiṃ vā samanupaśyati / evaṃ khalu subhūte	Darmasya vRdDiH vA parihANim vA samanupaSyati / evam Kalu suBUte
   anabhilāpyasyārthasya naiva vṛddhir na	anaBilApyasya-arTasya na-eva vRdDiH na
   11 parihāṇi / evaṃ khalu subhūte dānapāramitāyā śīlapāramitāyā	11 parihANi / evam Kalu suBUte dAna-pAramitAyA SIla-pAramitAyAH-
   kṣāntipāramitāyā vīryapāramitāyā dhyānapāramitāyā prajñāpāramitāyā naiva	kzAnti-pAramitAyAH vIrya-pAramitAyAH DyAna-pAramitAyAH prajQApAramitAyAH na-eva
   vṛddhir na parihāṇiḥ / evaṃ	vRdDiH na parihANiH / evam
   12 yāvat pratisaṃvidāṃ na vṛddhir na parihāṇiḥ / evaṃ khalu subhūte	12 yAvat pratisaMvidAm na vRdDiH na parihANiH / evam Kalu suBUte
   bodhisatvena mahāsatvena prajñāpāramitāyāṃ caritavyaṃ /	boDisatvena mahAsatvena prajQApAramitAyAm caritavyam /
   avṛddhyaparihāṇiyogena /	avRdDi-aparihANi-yogena /
