   oṃ	om
   śrīmatprabhākaragurutantradhurandhareṇa	SrImat-praBA-kara-guru-tantra-DuranDareNa
   mahāmahopādhyāya-śālikanāthamiśreṇa praṇītā prakaraṇapañcikā	mahA-mahA-upADyAya--SAlika-nATa-miSreNa praNItA prakaraNa-paQcikA
   nyāyasiddhyākhyayā vyākhyayā viṣamasthalaṭipparāyā	nyAya-sidDi-AKyayA vyAKyayA vizama-sTalawipparAyA
   ca samalaṅkṛtā	ca samalaFkRtA
   mīmāṃsājīvarakṣā nāma	mImAMsA-jIva-rakzA nAma
   daśamaṃ prakaraṇam /	daSamam prakaraNam /
   1007prabhākaragurorbhāvaṃ paribhāvyābhidhīyate /	1007-praBAkara-guroH-BAvam pariBAvya-aBiDIyate /
   mīmāṃsājīvarakṣeyaṃ kṣaṇikatvanirākriyā // 1 //	mImAMsA-jIva-rakzeyam kzaNika-tva-nirAkriyA // 1 //
   atra sugatamatānusāriṇaḥ-kṣaṇabhaṅginassarvāneva bhāvānabhidadhati /	atra sugata-mata-anusAriNaH--kzaNa-BaFginassarvAn-eva BAvAn-aBidaDati /
   kiṃ punasteṣāṃ tatra pramāṇam ? na1008 tāvat pratyakṣaṃ kṣaṇikatāmīkṣituṃ	kim punar-tezAm tatra pramANam ? na1008 tAvat pratyakzam kzaNikatAm-Ikzitum
   1009kṣamate, stambhādibhāvaṃ1010 nipuṇataraṃ nirīkṣamāṇasya	1009kza-mate, stamBa-Adi-BAvaM1010 nipuNataram nirIkzamANasya
   kṣaṇikatvādhyavasāyābhāvāt /	kzaNikatva-aDyavasAya-aBAvAt /
   syādeṣā manīṣā---na kṣaṇikatā nāma bhāvasvabhāvabahirbhāvinī, tena	syAt-ezA manIzA---na kzaNikatA nAma BAva-svaBAva-bahis-BAvinI, tena
   bhāvānubhavādeva pratyakṣaṃ kṣaṇikatāmapi sākṣātkarotīti /	BAva-anuBavAt-eva pratyakzam kzaNikatAm-api sAkzAtkaroti-iti /
   tadidaṃ manorathamātraṃ manyante matimantaḥ /	tat-idam manoraTa-mAtram manyante matimantaH /
   tathāhi---"saṃvinniṣṭhā viṣayavyavasthitayaḥ" iti sthitiriyamavivādā	taTA-hi---"-saMvid-nizWA vizaya-vyavasTitayaH" iti sTitiH-iyam-avivAdA
   sarvavādinām /	sarva-vAdinAm /
   tadiyamapi kṣaṇikatā bhāvasya svabhāvabhūta satī saṃvittimadhirohantī	tat-iyam-api kzaNikatA BAvasya svaBAva-BUta satI saMvittim-aDirohantI
   tadavyatirekeṇavyavatiṣṭhate, nānyathā /	tat-avyatirekeNa-vyavatizWate, na-anyaTA /
   na ca tathā saṃvidamudīyamānāmudīkṣāmāha iti, kutastasyā	na ca taTA saMvidam-udIyamAnAm-udIkzAm-Aha iti, kutas-tasya-a
   bhāvasvabhāvāntarbhāvitā ? kutastarāñca tadavabodhenāvabodhaḥ /	BAva-svaBAva-antar-BAvitAH ? kutas-tarAQca tad-avaboDena-avaboDaH /
   atha manvīran---kṣaṇikatā pratyakṣamīkṣyamāṇāpi1011 na	aTa manvIran---kzaNika-tA pratyakzam-IkzyamANA-api1011 na
   niścayapathamavatīrṇā tenāgṛhītevāvabhāti, tathāpi na 1012tasyāṃ	niScaya-paTam-avatIrNA tena-agRhItA-iva-avaBAti, taTA-api na 1012tasyAm
   pratyakṣaṃ pramāṇam /	pratyakzam pramANam /
   yatra hi pratyakṣasya svabhāvato vikalpavihariṇastat--1013pṛṣṭhabhāvinā	yatra hi pratyakzasya svaBAvataH vikalpa-vihariNaH-tat--1013-pRzWa-BAvinA
   savikalpakapratyayena vyāpāro 'nugamyate, tatra pratyakṣaṃ pramāṇamiti	sa-vikalpaka-pratyayena vyApAraH anugamyate, tatra pratyakzam pramANam-iti
   saugatāḥ /	sOgatAH /
   yatra ca dṛṣṭametaditi pratyayo nodīyate, na	yatra ca dRzwam-etat-iti pratyayaH na-udIyate, na
   1014tatpratyakṣasamadhigatamiti siddhāntadhvāntākrāntāśayānāṃ	1014-tad-pratyakza-samaDigatam-iti sidDAnta-DvAnta-AkrAnta-ASayAnAm
   vāṅmātravilasitamidam1015 /	vAc-mAtra-vilasitam-idam-1015 /
   yadapi kecidūcire---pratyakṣaṃ jñānaṃ kṣaṇikaṃ,	yat-api kecid-Ucire----pratyakzam jQAnam kzaNikaM,
   svakālākalitavastuviṣayatayā kṣaṇikatāmavagamayatīti /	sva-kAla-Akalita-vastu-vizaya-tayA kzaNika-tAm-avagamayati-iti /
   tadapi bāliśabhāṣitam /	tat-api bAliSa-BAzitam /
   ekakṣaṇamātravarttitā hi kṣaṇikatā /	eka-kzaNa-mAtra-varttitAH hi kzaNika-tA /
   na tat pratyakṣeṇedānīmevedaṃ 1016vastviti pratipadyate1017, kālāntaraṃ	na tat pratyakzeNa-idAnIm-eva-idam 1016vastu-iti pratipadyate1017, kAla-antaram
   pratyaudāsīnyāt1018 pratyakṣasya /	pratyOdAsIt-yAt1018 pratyakzasya /
   pratyuta pratyabhijñālakṣaṇaṃ pratyakṣameva kṣaṇikatāṃ dūramupakṣipati,	pratyuta pratyaBijQA-lakzaNam pratyakzam-eva kzaNika-tAm dUram-upakzipati,
   pūrvā-parakālākalitabhāvāvakalpanāt /	pUrvA--para-kAla-Akalita-BAva-avakalpanAt /
   anumānamapi sambandhānusandhānanibandhanaṃ kṣaṇikatāṃ na pakṣīkartuṃ	anumAnam-api sambanDa-anusanDAna-nibanDanam kzaNika-tAm na pakzIkartum
   kṣamate, tayā saha kasyacilliṅgasya sambandhabodhavirahāt /	kzamate, tayA saha kasyacid-liFgasya sambanDa-boDa-virahAt /
   na khalvapratīte sambandhinisambandhabuddhirāvirbhavati /	na Kalva-pratIte sambanDi-nisambanDa-budDiH-AvirBavati /
   na 1019cetadubhayātireki pramāṇaṃ sugatamatānusāriṇo manyante /	na 1019cetad-uBaya-atireki pramANam sugata-mata-anusAriNaH manyante /
   tadidamākāśabhrāntamityapahasanti saugatāḥ /	tat-idam-AkASa-BrAntam-iti-apahasanti sOgatAH /
   te 1020hi svabhāvahetukānumānasamadhigamanīyāṃ kṣaṇikatāmācakṣate /	te 1020hi svaBAva-hetuka-anumAna-samaDigamanIyAm kzaNikatAm-Acakzate /
   kiṃ punastadanumānam /	kim punar-tad-anumAnam /
   yat sat, tat kṣaṇikam, santaśca sarve bhāvā iti bhāvamātrānubandhini	yat sat, tat kzaNikam, santaH-ca sarve BAvAH iti BAva-mAtra-anubanDini
   sādhye svabhāvaheturbhavati /	sADye svaBAva-hetuH-Bavati /
   yathā---śiṃśapātvaṃ vṛkṣatve /	yaTA---SiMSapA-tvam vRkza-tve /
   śiṃśapāmātrānubandhi hi vṛkṣatvam /	SiMSapA-mAtra-anubanDi hi vRkza-tvam /
   tathehāpi sattāmātrānubandhinī 1021 kṣaṇikatā /	taTA-iha-api sattA-mAtra-anubanDinI 1021 kzaNika-tA /
   kathaṃ punastanmātrānubandhasiddhiḥ ? vipakṣe bādhakapramāṇapravṛtteḥ /	kaTam punar-tanmAtra-anubanDa-sidDiH ? vipakze bADaka-pramANa-pravRtteH /
   akṣaṇikatve hi vyāpakānupalabdhissattāṃ bādhate /	akzaNika-tve hi vyApakAn-upalabDiH-sattAm bADate /
   arthakriyākāritā hi sattā, nāparā kācidasti /	arTa-kriyA-kAritA hi sattA, na-aparA kAcid-asti /
   sā ca krama-yaugapadyābhyāṃ vyāptā, tṛtīyakoṭivirahāt1022 /	sA ca krama-yOgapadyAByAm vyAptA, tRtIya-kowi-virahAt1022 /
   anayoḥ parasparapratipakṣatayaikapratiṣedhasyetaravidhināntarīyakatvāt /	anayoH paraspara-pratipakzatayA-eka-pratizeDasya-itara-viDinA-antarIyaka-tvAt /
   na ca krama-yaugapadye 'kṣaṇikeṣu sambhavataḥ /	na ca krama-yOgapadye akzaNikezu samBavataH /
   te tu nivartamāne sattāmapi nivartayataḥ, vṛkṣatvaṃ śiṃśapātvamiva /	te tu nivartamAne sattAm-api nivartayataH, vRkza-tvam SiMSapA-tvam-iva /
   kathamakṣaṇikeṣu krama-yaugapadyābhyāmarthakriyāvirahaḥ ? atrā'huḥ---	kaTam-akzaNikezu krama-yOgapadyAByAm-arTa-kriyA-virahaH ? atrA-ahuH---
   1023akṣaṇiko hi bhāvor'thakriyājananasvabhāvo vā bhavet ? atatsvabhāvo vā?	1023akzaNikaH hi BAvoH-aTa-kriyA-janana-svaBAvaH vA Bavet ? atad-svaBAvaH vA?
   nāparaḥ prakāro 'sti /	na-aparaH prakAraH asti /
   tatrāgrimapakṣaparigrahe sarvāsāmarthakriyāṇāmekasminneva kṣaṇe kṛtatvāt,	tatra-agrima-pakza-parigrahe sarva-asAm-arTa-kriyANAm-ekasmin=-eva kzaNe kRta-tvAt,
   kṛtasya ca punaḥ karaṇānupapatteḥ,	kRtasya ca punar karaNa-anupapatteH,
   anantarakṣaṇer'thakriyāsāmarthyaśūnyatvāt,	ananta-rakzaNer-aTa-kriyA-sAmarTya-SUnya-tvAt,
   asallakṣaṇatvāpatterakṣaṇikatvahāniḥ /	asat-lakzaNa-tva-ApatteH-akzaNika-tva-hAniH /
   dvitīyavikalpāvalambane tu 1024kadācidapi tator'thakriyā nodīyata iti,	dvitIya-vikalpa-avalambane tu 1024kadAcid-api tator-aTa-kriyA na-udIyate iti,
   asallakṣaṇatvāpattireva /	asat-lakzaNa-tva-ApattiH-eva /
   syānmatam---samartho 'pi svabhāvato bhāvassahakārisamavadhānavaśena	syAt-matam----samarTaH api svaBAvataH BAva-ssahakAri-samavaDAna-vaSena
   kadācitkaroti, tadabhāvāccānyadā neti /	kadAcid-karoti, tad-aBAvAt-ca-anyadA na-iti /
   tadapi vimardaṃ na kṣamate /	tat-api vimardam na kzamate /
   sa hi sahakārī kiñcidārabhate, na vā ?	sa hi sahakArI kiQcid-AraBate, na vA ?
   tenā'rabhyamāṇamapyarthakriyāsādhanatvābhimatabhāvasvabhāvabhūtam,	tenA-araByamANam-api-arTa-kriyA-sADana-tva-aBimata-BAva-svaBAva-BUta-m,
   uta--atatsvabhāvabhūtaṃ veti vikalpanīyam /	uta--a-tad-svaBAva-BUtam vA-iti vikalpanIyam /
   anārambhapakṣe 'pekṣārtho 'bhidhātavyaḥ /	anAramBa-pakze apekzA-arTaH aBiDAtavyaH /
   na khalvanupakārakaṃ pratyapekṣār'thavatī /	na Kalu-anupakArakam pratyapekzAr-aTavatI /
   arthakriyāsādhanatvābhimatabhāvasvabhāvabhūtasyā'rambhe ca	arTa-kriyA-sADana-tva-aBimata-BAva-svaBAva-BUtasya-AaramBe ca
   bhāvasyāpyutpattirāpatati /	BAvasya-api-utpattiH-Apatati /
   1025na hyanutpadyamāna utpadyamānasvabhāvo bhavati,	1025na hi-anutpadyamAnaH utpadyamAna-svaBAvaH Bavati,
   viruddhadharmādhyāsasya bhedādādakatvāt1026 /	virudDa-Darma-aDyAsasya BedAt-Adaka-tva-at1026 /
   bhāvodayāṅgīkāre cākṣaṇikatvapakṣaparikṣayaḥ1027 /	BAva-udaya-aFgIkAre ca-akzaNika-tva-pakza-parikzayaH1027 /
   atatsvabhāvabhūtasya''rambhābhyupagame bhāvasya prāgasādhakatvāt,	atad-svaBAva-BUtasya-aaramBa-aByupagame BAvasya prAc-asADaka-tvAt,
   nākṣaṇikātkrameṇār'thakriyāsiddhiḥ /	na-akzaNikAt-krameNa-Ar-aTa-kriyA-sidDiH /
   tata eva bāhyādāgantorarthakriyodeyaḥ, tadbhāve bhāvāt, tadabhāve cābhāvāt	tatas eva bAhyAt-AgantoH-arTa-kriyaH-deyaH, tad-BAve BAvAt, tad-aBAve ca-aBAvAt-
   na ca tadvyatirekā---vyatirekābhyāmanyaḥ prakāro 'sti /	na ca tad-vyatireka-a----vyatirekAByAm-anyaH prakAraH asti /
   parasparaviruddhayorekatra samavāyapratītivirahāt /	paraspara-virudDayoH-ekatra samavAya-pratIti-virahAt /
   nanu kṣaṇiko 'pi bhāvaḥ---kikarmakriyājananasamarthasvabhāvaḥ,	nanu kzaNikaH api BAvaH----ki-karma-kriyA-janana-samarTa-svaBAvaH,
   atatsvabhāvo ? veti 1028prācīṃ kalpanāṃ 1020nātivartate /	atad-svaBAvaH ? vA-iti 1028prAcIm kalpanAm 1020na-ativartate /
   tatrār'thakriyājananasamarthasvabhāvasya sahakārivyapekṣā na syāt /	tatra-Ar-aTa-kriyA-janana-samarTa-svaBAvasya sahakAri-vyapekzA na syAt /
   na hyasamarthādarthādarthakriyodīyate /	na hi-asamarTAt-arTAt-arTa-kriyA-udIyate /
   śrūyatāṃ paramarahasyaṃ saugatānām--- 1030antyakṣaṇaṃ	SrUyatAm parama-rahasyam sOgatAnAm--- 1030antya-kzaNam
   prāptor'thakriyājananasamarthasvabhāva eva bhāvaḥ	prAptoH-aTa-kriyA-janana-samarTa-svaBAvaH eva BAvaH
   1031kāryamapyekamevā'rabhate /	1031kAryam-api-ekam-eva-aaraBate /
   kimiti tarhi sahakāribhirvināpi na karoti /	kim-iti tarhi sahakAriBiH-vinA-api na karoti /
   nirapekṣasya janakatve, sahakāritāpi tasya kīdṛśīti na karoti /	nirapekzasya janaka-tve, sahakAritA-api tasya kIdRSI-iti na karoti /
   nirapekṣasya janakatve, sahakāritāpi tasya kīdṛśīti vaktavyam /	nirapekzasya janaka-tve, sahakAritA-api tasya kIdRSI-iti vaktavyam /
   atra vadāmaḥ---yattāvadidamuktam---vināpi sahakāribhiḥ kimiti na karotīti	atra vadAmaH---yat-tAvat-idam-uktam----vinA-api saha-kAriBiH kim-iti na karoti-iti
   tattāvat sugatamatakauśalavirahavijambhitam /	tat-tAvat sugata-mata-kOSala-viraha-vijamBitam /
   kṣaṇiko hi bhāvo na sahakāribhivrināsti /	kzaNikaH hi BAvaH na sahakAri-BivrinA-asti /
   kathamasan 1032kariṣyati /	kaTam-asan 1032karizyati /
   yastvasti, nāsau sa iti, na kiñcit kṣīṇam /	yaH-tu-asti, na-asO saH iti, na kiQcid kzINam /
   sahakāribhirvinā kimiti na bhavatyeveti paryanuyoge, hetusvabhāvairuttaraṃ	sahakAriBiH-vinA kim-iti na Bavati-eva-iti paryanuyoge, hetu-svaBAvEH-uttaram
   vācyam---te1033 tathā bhavanti, bhāvayanti ceti /	vAcyam---te1033 taTA Bavanti, BAvayanti ca-iti /
   ekakāryakāritā cāntyakṣaṇavartināṃ sahakāritā /	eka-kArya-kAritA ca-antyakzaNa-vartinAm sahakAritA /
   nanu te 'pyanyanirapekṣā eva janakāḥ kimiti na kāryāntaramārabhante /	nanu te api-anya-nirapekzAH eva janakAH kim-iti na kArya-antaram-AraBante /
   atrāpi vayamanīśāḥ---bhāvāstu yadārabhante, tadārabhantāmityanumantumeva	atra-api vayam-anISAH----BAvAH-tu yat-A-AraBante, tad-A-AraBantAm-iti-anumantum-eva
   vayaṃ prabhavāmaḥ /	vayam praBavAmaH /
   te cāmī janakā api 1034santastadeva janayantīti, paśyatāmasmākaṃ	te ca-amI janakAH api 1034santaH-tat-eva janayanti-iti, paSyatAm-asmAkam
   tāvatyevābhyupagamaḥ /	tAvatI-eva-aByupagamaH /
   nanvekena kṛte, aparaḥ kiṃ karotīti ? bhavedetadevaṃ	nanu-ekena kRte, aparaH kim karoti-iti ? Bavet-etat-evam
   paryāyeṇār'thakriyāyām, sahakriyāyāntu kṛta ityeva nāsti /	paryAyeNa-Ar-aTa-kriyAyAm, sahakriyA-AyAntu kRtaH iti-eva na-asti /
   nanvevamekasmādapi tatsiddheḥ, kimapare kṛrvanti /	nanu-evam-ekasmAt-api tad-sidDeH, kim-apare kRrvanti /
   naitadevam /	na-etat-evam /
   na te prekṣāpūrvakāriṇaḥ, yenaivaṃ paryālocayeyuḥ /	na te prekzA-pUrva-kAriNaH, yena-evam paryAlocayeyuH /
   anyo 'pīdaṃ kartumasmābhirapi vinā samarthaḥ, vayamiha na prabhavāma iti /	anyaH api-idam kartum-asmABiH-api vinA samarTaH, vayam-iha na praBavAmaH iti /
   te tu hetvadhīnasannidhānā na bhavituṃ na kṣamanta iti kānupapattiḥ /	te tu hetu-aDIna-sanniDAnAH na Bavitum na kzamantaH iti kA-anupapattiH /
   nanu kathamekaṃ kāryamanekasmādutpadyate /	nanu kaTam-ekam kAryam-anekasmAt-utpadyate /
   kāraṇabheda eva hi kāryasya bhede hetuḥ, anyathā'kasimakatvāpatteḥ /	kAraNa-BedaH eva hi kAryasya Bede hetuH, anyaTA-akasimaka-tva-ApatteH /
   ucyate, na sahakārikāraṇabhedād bhedaḥ kāryasya, kintu sāmāgrībhedāditi,	ucyate, na sahakAri-kAraNa-BedAt BedaH kAryasya, kintu sAma-agrI-BedAt-iti,
   1035hetubindau kṛtapariśramāṇāmanāyāsasamadhigamyam /	1035hetu-bindO kRta-pariSramANAm-anAyAsa-samaDigamyam /
   tasmānna kṣaṇikatve 'pyakṣaṇikatvapakṣasadṛkṣaparyanuyogāvakāśaḥ /	tasmAt-na kzaNika-tve api-akzaNika-tva-pakza-sadRkza-paryanuyoga-avakASaH /
   bījādīnāṃ hi kṣaṇaparamparāpariṇāmena 1036tādṛśaḥ kṣaṇassañjāyate /	bIja-AdInAm hi kzaNa-paramparA-pariNAmena 1036tAdRSaH kzaNassaQjAyate /
   yato 'napekṣitahetvantarapravṛtteranantaramaṅkuraṃ prādurbhavati /	yatas anapekzita-hetu-antara-pravRtteH-anantaram-aFkuram prAdurBavati /
   nanvevamapi parā-pareṣu bījādikṣaṇeṣu"tadevedami"ti pratyabhijñā	nanu-evam-api parA--parezu bIja-Adi-kzaNa-izu"-tat-eva-idam-i"ti pratyaBijQA
   nopapadyate /	na-upapadyate /
   api ca pratyabhijñāpratyakṣavirodhe kathamanumānamātmānaṃ labhata ityapi	api ca pratyaBijQA-pratyakza-viroDe kaTam-anumAnam-AtmAnam laBate iti-api
   na vācyam /	na vAcyam /
   1037ātmalābhe vā bahnāvapi śaityānumānaprasaṅgaḥ /	1037Atma-lABe vA bahnO=-api SEtya-anumAna-prasaFgaH /
   samādhirabhidhīyate---ye te kṣaṇāḥ, teṣāmātyantikaṃ bhedaṃ susadṛśatayā	samADiH-aBiDIyate---ye te kzaNAH, tezAm-Atyantikam Bedam su-sadRSa-tayA
   dṛṣṭamapi pratyākalāyitumanīśasya bhedagrahaṇanibandhano	dRzwam-api pratyAkalAyitum-anISasya Beda-grahaNa-nibanDanaH-
   'bhedavyavahāraḥ1038 pravartate, śuktikāyāmiva rajatavyavahāraḥ /	aBeda-vyavahAraH1038 pravartate, SuktikAyAm-iva rajatavyavahAraH /
   na cānumānodayivirodhaḥ, arthakriyāyā anyathānupapatteḥ /	na ca-anumAna-udayi-viroDaH, arTa-kriyAyAH anyaTA-anupapatteH /
   pratyabhijñā tu bhedāgrahaṇenāpyupapadyata iti niravadyam /	pratyaBijQA tu Beda-agrahaNena-api-upapadyate iti niravadyam /
   ata eva ca vṛddhā vadanti---"bhavati ca pratyakṣādapyanumānaṃ balīya" iti	atas eva ca vRdDA vadanti---"Bavati ca pratyakzAt-api-anumAnam balIya" iti
   yuktañcedameva paśyāmaḥ /	yuktaQca-idam-eva paSyAmaH /
   "tadevedami"tyekavijñānodaye1039 kāraṇābhāvāt1040, indriyaṃ sannihite	"tad-eva-idam-i"ti-eka-vijQAna-udaye1039 kAraNa-aBAva-at1040, indriyam sannihite
   vyāpriyate, na punaḥ pūrvakālasambandhitā-1041rūpāṃ tattamupaspṛśati,	vyApriyate, na punar pUrva-kAla-sambanDi-tA-1041-rUpAm tat-tam-upaspRSati,
   pūrvānubhavabhāvitā ca bhāvanā nedantāmaparakālayogātmikām---iti /	pUrva-anuBava-BAvitA ca BAvanA nedantAm-apara-kAla-yoga-Atmi-kAm----iti /
   tadidaṃ jvālāpratyabhijñānena vyākhyātam /	tat-idam jvAlA-pratyaBijQAnena vyAKyAtam /
   api ca kṛtakānāṃ bhāvānāmavaśyambhāvī vināśaḥ pratīyate /	api ca kRtakAnAm BAvAnAm-avaSyamBAvI vinASaH pratIyate /
   ato 'pi śakyā kṣaṇabhaṅgitānumātum /	atas api SakyA kzaNa-BaFgitA-anumAtum /
   tathāhi---yadyeṣāṃ dhruvabhāvinī, tatra teṣāṃ hetvantarāpekṣā nāsti /	taTA-hi---yadi-ezAm Druva-BAvinI, tatra tezAm hetu-antara-apekzA na-asti /
   dhruvabhāvī ca kṛtakānāṃ vināśa iti,	Druva-BAvI ca kRtakAnAm vinASaH iti,
   viruddhavyāptopalabdhaliṅgakamanumānaṃ vināśasya hetvantarāpekṣitāṃ	virudDa-vyApta-upalabDa-liFgakam-anumAnam vinASasya hetu-antara-apekzitAm
   pratikṣipita /	pratikzipita /
   dhruvabhāvitā hi	Druva-BAvitAH hi
   niṣidhyamānahetvantarāpekṣitvaviruddhanirapekṣatvavyāptopalabdhā1042	niziDyamAna-hetu-antarA-apekzi-tva-virudDa-nirapekza-tva-vyApta-upalabDa-a1-042
   vināśasya hetvantarānapekṣitāmupasthāpayati /	vinASasya hetu-antara-anapekzitAm-upasTApayati /
   sā ca svaviruddhaṃ hetvanatarāpekṣitvaṃ nirākaroti /	sA ca sva-virudDam hetu-anatara-apekzi-tvam nirAkaroti /
   ye hi hetvantarapekṣāḥ, te dhruvabhāvino na bhavanti /	ye hi hetu-antar-apekzAH, te Druva-BAvinaH na Bavanti /
   yathā--- vāsasi rāgādayaḥ /	yaTA-- vAsasi rAga-AdayaH /
   ato hetvantaropakṣitvaviruddhatannirapekṣatvavyāptadhruvabhāvitvasya	atas hetu-antara-upakzi-tva-virudDa-tad-nirapekza-tva-vyApta-Druva-BAvi-tvasya
   yopalabdhiḥ, saivādhruvabhāvitvasyānupalabdhiḥ /	yA-upalabDiH, sA-eva-aDruva-BAvi-tvasya-anupalabDiH /
   adhruvabhāvitvasyānupalabdheḥ, vināśasya hetvantarāpekṣā nāsti /	aDruva-BAvi-tvasya-anupalabDeH, vinASasya hetu-antara-apekzA na-asti /
   tathā yadi bhāvā api svahetubhyo hetvantaraṃ vināśaṃ pratyapekṣeran,	taTA yadi BAvAH api sva-hetuByaH hetu-antaram vinASam pratyapekzeran,
   tatastasya hetvantarasya sannidhānaniyame pramāṇābhāvāt, kaścitkṛtako 'pi	tatas-tasya hetu-antarasya sanniDAna-niyame pramANa-aBAvAt, kaScid-kRtakaH api
   na vinaśyet /	na vinaSyet /
   svahetostu vinaśvarasyodaye 'nantaramevāpavarga iti,	sva-hetoH-tu vinaSvarasya-udaye anantaram-eva-apavargaH iti,
   kṣaṇabhaṅguratvasiddhiḥ /	kzaNa-BaFgura-tva-sidDiH /
   api cedaṃ cintanīyam, kiṃ kṛtakā bhāvāssvahetubhyassamupajāyamānā	api ca-idam cintanIyam, kim kRtakAH BAva-assu-ahetuByassamupajAyamAnA
   vinaśvarasvabhāvā eva jāyante ? avināśvarasvabhāvā1043--- vā ?	vinaSvara-svaBAvAH eva jAyante ? avinA-aSvara-svaBAvA1043-- vA ?
   vinaśvara---svabhāvā udayānantarameva līyanta iti kṣaṇabhaṅginaḥ /	vinaSvara----svaBAvAH udaya-anantaram-eva lIyante iti kzaNa-BaFginaH /
   avinaśvarasvabhāvāstu na kadācidvinaśyeyuḥ /	avinaSvara-svaBAvAH-tu na kadAcid-vinaSyeyuH /
   na ca hetvantarātteṣāṃ 1044vināśaḥ, vikalpāsahatvāt /	na ca hetu-antarAt-tezAm 1044vinASaH, vikalpa-asaha-tvAt /
   sa hi jāyamāno vanāśo bhāvādavyatirekī ? vyatirekī vā /	sa hi jAyamAnaH vanASaH BAvAt-avyatirekI ? vyatirekI vA /
   na tāvadavyatirekī, hetubhedāt /	na tAvat-avyatirekI, hetu-BedAt /
   vyatirekiṇi tu jāte, bhāvasya prāgvadupalabdhyādiprasaṅgaḥ /	vyatirekiNi tu jAte, BAvasya prAgvat-upalabDi-Adi-prasaFgaH /
   tena tirodhīyata iti kalpanāyāmapi, tirodhānaṃ pratyeṣaṃ vikalpo vācya1045	tena tiroDIyate iti kalpanAyAm-api, tiroDAnam pratyezam vikalpaH vAcya1045
   ityalamatiprasaṅgena /	iti-alam-ati-prasaFgena /
   ekadeśimatena kṣaṇikatvavādanirāsaḥ /	eka-deSi-matena kzaNika-tva-vAda-nirAsaH /
   atra1046 kecidevaṃ samādadhati---"tadevedami"ti tattedante parasparaṃ	atra1046 kecid-evam samAdaDati----"tat-evedam-i"ti tat-tedante parasparam
   saṃvalite samākalayadekaṃ pratyabhijñāsamākhyātaṃ pratyakṣavijñānaṃ	saMvalite samAkalayat-ekam pratyaBijQA-samAKyAtam pratyakza-vijQAnam
   kṣaṇabhaṅgānumānaṃ niruṇaddhi---iti /	kzaNa-BaFga-anumAnam niruNadDi---iti /
   1047na cedaṃ samīcīnam /	1047na ca-idam samIcInam /
   dve ete vijñāne grahaṇa-smaraṇarūpe yathāyathaṃ tattāmātre, idantāmātre ca	dve ete vijQAne grahaNa-smaraNa-rUpe yaTAyaTam tad-tAmAtre, idantA-mAtre ca
   vyāpriyamāṇe nālamubhayānubhavasambhavasamayavartitāmarthasyāvabhāsayitum,	vyApriyamANe na-alam-uBaya-anuBava-samBava-samaya-varti-tAm-arTasya-avaBAsayitum,
   pratītivirodhāt /	pratIti-viroDAt /
   yarthaiva khalvabhinnadeśakālaṃ vastvekatayā cakāsti, tathā	yarTa-eva Kalu-aBinna-deSa-kAlam vastu-ekatayA cakAsti, taTA
   bhinnadeśakālamapyekatayaiva parisphuratīti, tathāvidhasaṃvedanodayaśca	Binna-deSa-kAlam-api-ekatayA-eva parisPurati-iti, taTAviDa-saMvedana-udayaH-ca
   naikavijñānamantareṇeti, ekamevedaṃ vijñānamurarīkaraṇīyam /	na-eka-vijQAnam-antareNa-iti, ekam-eva-idam vijQAnam-urarIkaraNIyam /
   kāryasadbhāvopapādanāyāpratītamapi kāraṇaṃ parikalpanīyam, na punaḥ	kArya-sadBAva-upapAdanAya-apratItam-api kAraNam parikalpanIyam, na punar-
   kāraṇamukhanirīkṣaṇena spaṣṭadṛṣṭakāryaviparyayaḥ paryālocanīyaḥ /	kAraNa-muKa-nirIkzaNena spazwa-dRzwa-kArya-viparyayaH paryAlocanIyaH /
   tena yadyapi kavalādindriyāt, kevalāt pūrvānubhavasamāsāditajanmano	tena yadi-api kavalAt-indriyAt, kevalAt pUrva-anuBava-samAsAdita-janmanaH-
   bhāvanābhidhānāt saṃskārādvā naivaṃvighamidaṃ vijñānumudetumarhati /	BAvanA-aBiDAnAt saMskArAt-vA na-evaMviGam-idam vijQAnum-udetum-arhati /
   tathāpi tayoranyonyasamavadhānasamāsāditadaśāntarayoridaṃ	taTA-api tayoH-anyonya-samavaDAna-samAsAdita-daSa-antarayoH-idam
   kāryamityācāryā1048 menire //	kAryam-iti-AcAryA1048 menire //
   na cedamapyucitam /	na ca-idam-api-ucitam /
   pratyakṣamevevedaṃ na bhavatīti, satyapi saṃskāropayoge,	pratyakzam-eva-iva-idam na Bavati-iti, sati-api saMskAra-upayoge,
   indriyavyāpārādhīnajanmatayāsya	indriya-vyApAra-aDIna-janma-tayA-asya
   prathamasamāgamasamayabhāvinassakalavādināmapahastitavivādānāṃ	praTama-samAgama-samaya-BAvina-ssakala-vAdinAm-apahastita-vivAdAnAm
   pratyakṣasammatādaviśeṣāt /	pratyakza-sammatAt-aviSezAt /
   na cedaṃ pramāṇābhāsamityatra kiñcana pramāṇamasti,	na ca-idam pramANa-ABAsam-iti-atra kiQcana pramANam-asti,
   bādha-kāraṇadoṣaviṣayasaṃvedanāntaravirahāt /	bADa--kAraNa-doza-vizaya-saMvedana-antara-virahAt /
   na cedamevānumānaṃ bādhakamiti cittamanurajyate,	na ca-idam-eva-anumAnam bADakam-iti cittam-anurajyate,
   parasparāśrayadoṣasamāsakteḥ /	paraspara-ASraya-doza-samAsakteH /
   yāvatkhalvetadvijñānamabādhitam, tāvadanumānameva nodetuṃ prabhavati,	yAvat-Kalu-etat-vijQAnam-abADitam, tAvat-anumAnam-eva na-udetum praBavati,
   sañjāte cānumāne bādhitāmidaṃ bhavatīti, viśadataramitaretarāśrayatvam1049	san-jAte ca-anumAne bADitAm-idam Bavati-iti, viSadataram-itaretara-ASraya-tvam-1049
   abādhitaviṣayatā1050 cāpi kāraṇamanumānodaye, anyathā hutavahe śītatā	abADita-vizaya-tA1050 ca-api kAraNam-anumAna-udaye, anyaTA hutavahe SIta-tA
   kimiti nānumīyate /	kim-iti na-anumIyate /
   nanvevaṃ tarhi kathaṃ jvālādīnāmekatvenāvadhāritānāmanumānato bhedasiddhiḥ	nanu-evam tarhi kaTam jvAlA-AdInAm-eka-tvena-avaDAritAnAm-anumAnataH Beda-sidDiH
   bhāṭṭamatena vastuno dvyātmakatopanyāsaḥ /	BAwwa-matena vastunaH dvi-Atmaka-topanyAsaH /
   atra siddhāntasāramudīrayanti---samānya-viśeṣātmakāni sarvavastūni /	atra sidDAnta-sAram-udIrayanti----samAnya--viSeza-AtmakAni sarva-vastUni /
   tatra jvālādiṣu pratyakṣaṃ sāmānyaviṣayam, anumānantu viśeṣaviṣayamiti,	tatra jvAlA-Adizu pratyakzam sAmAnya-vizayam, anumAnantu viSeza-vizayam-iti,
   bhinnagocarapracāriṇoḥ pratyakṣā---numānayorvirodhābhāvāt, na	Binna-gocara-pracAriNoH pratyakza-a---numAnayoH-viroDa-aBAvAt, na
   pratyakṣeṇānumānodayavirodhaḥ /	pratyakzeNa-anumAna-udaya-viroDaH /
   kathaṃ punarakṣaṇikasyār'thakriyākāritā ? krameṇeti vadanti /	kaTam punar-akzaNikasya-AraTa-kriyA-kAritA ? krameNa-iti vadanti /
   sa khalu sahakārisamavadhānopahitaviśeṣāṃ bhāvastāṃ tāmarthakriyāṃ	sa Kalu sahakAri-samavaDAna-upahita-viSezAm BAvaH-tAm tAm-arTa-kriyAm
   krameṇaiva samapādayati /	krameNa-eva samapAdayati /
   nanu vikalpitaṃ-sahakāribhiḥ kiṃ vyatiriktaḥ, avyatirikte vā viśeṣa	nanu vikalpitaM--sahakAriBiH kim vyatiriktaH, avyatirikte vA viSeza
   ādhīyata iti, dūṣaṇāni ceha vikalpayugale pūrvamāveditāni /	ADIyate iti, dUzaNAni ca-iha vikalpa-yugale pUrvam-AveditAni /
   1051atrāpi ta eva prakriyāmanukramayanti /	1051atra-api te eva prakriyAm-anukramayanti /
   nedamasmanmatamekāntatobhinnanyeva sarvavastūni, abhinnāni 1052veti, kintu	na-idam-asmad-matam-ekAnta-toBinnanyeva sarva-vastUni, aBinnAni 1052veti, kintu
   sarvabhāveṣu bhedā-bhedau saṅgirāmahe /	sarva-BAvezu BedA--BedO saFgirAmahe /
   tatra bhedamātravikalpasambhavīni1053 dūṣaṇānyabhedāśrayaṇena parihṛtāni,	tatra Beda-mAtra-vikalpa-samBavI-ni1053 dUzaNAni-aBeda-ASrayaNena parihRtAni,
   abhedamātrāśritāni cabhedāvalambaneneti /	aBeda-mAtra-ASritAni ca-Beda-avalambanena-iti /
   nanvetau bhedā-bhedau kathamekatra virodhinau niviśete //	nanu-etO BedA--BedO kaTam-ekatra viroDinO niviSete //
   tatrā'huḥ--- nemau virodhinau, sahadarśanāt /	tatrA-ahuH-- na-imO viroDinO, saha-darSanAt /
   sahānavasthānalakṣaṇo hi virodhaḥ, anavasthānañcādarśananibandhanam /	saha-anavasTAna-lakzaNaH hi viroDaH, anavasTA-AnaQca-adarSana-nibanDanam /
   ato nāsti virodhaḥ /	atas na-asti viroDaH /
   tannirāsaḥ /	tad-nirAsaH /
   1054tadidamavicāritaramaṇīyamiti 1055prabhākaragurornānumatam /	1054tad-idam-avicArita-ramaNIyam-iti 1055-praBAkara-guroH-na-anumatam /
   sa hi dadarśa---bhedā-bhedāveva tāvadekatra na sambhavataḥ, virodhāt /	sa hi dadarSa----BedA--BedO=-eva tAvat-ekatra na samBavataH, viroDAt /
   na hvi tayossahadarśanamupapadyate /	na hvi tayossaha-darSanam-upapadyate /
   ekākārapratītireva khalvabhedadarśanam, vilakṣaṇākārapratītiśca	eka-AkAra-pratItiH-eva Kalva-Beda-darSanam, vilakzaNa-AkAra-pratItiH-ca
   bhedadarśanam /	Beda-darSanam /
   tatra yadyekākārā pratītiḥ, tadā vilakṣaṇākārapratītirnāsti /	tatra yadi-eka-AkArA pratItiH, tadA vilakzaNa-AkAra-pratItiH-na-asti /
   vilakṣaṇākāre ca pratīte, ekākārapratītireva nāsti /	vilakzaNa-AkAre ca pratIte, eka-AkAra-pratItiH-eva na-asti /
   tena bhinnā-bhinnaviśeṣāśrayaṇenār'thakriyāsamarthanaṃ na ghaṭata1056 iti	tena BinnA--Binna-viSeza-ASrayaNenAr-aTa-kriyA-samarTanam na Gawata1056 iti
   na ca pratyabhijñānenānumānavirodhaḥ,1057 pratyabhijñāyā eva	na ca pratyaBijQAnena-anumAna-viroDaH,1057 pratyaBijQAyE eva
   parīkṣaṇīyatvāt /	parIkzaNIya-tvAt /
   dṛṣṭā---śuktikāyāṃ "tadevedaṃ rajatami"ti matiḥ /	dRzwA---SuktikAyAm "tadeva-idam rajatam-i"ti matiH /
   sā ca sādṛśyavaśena bhedāgrahaṇanibandhanaiveti yuktātrāpi parīkṣā /	sA ca sAdRSya-vaSena Beda-agrahaNa-nibanDana-eva-iti yuktA-atra-api parIkzA /
   tatra parīkṣyamāṇasyārthakriyānupapattyā kṣaṇikatve nirṇīte,	tatra parIkzyamANasya-arTa-kriyA-anupapattyA kzaNika-tve nirNIte,
   1058sadṛśaparā---parotpattivipralambho 'yamiti niścīyate /	1058-sadRSa-parA----para-utpatti-vipralamBaH ayam-iti niScIyate /
   bhavati ca vimṛśato 'pi1059 diṅmohādiṣvanumānavaśena jātāyā api	Bavati ca vimRSataH api1059 diS-moha-Adizu-anumAna-vaSena jAtAyAH api
   pratīterviparyayaḥ /	pratIteH-viparyayaH /
   hutavahādiṣu cauṣṇyapratītirupajātā parīkṣyamāṇāpi nānyathopapadyate iti,	hutavaha-Adizu ca-OzNya-pratItiH-upajAtA parIkzyamANA-api na-anyaTA-upapadyate iti,
   na viparyayānumānodayaḥ /	na viparyaya-anumAna-udayaH /
   tasmādalamanena 1060vañcanādarśanenātinirbandhena1061 /	tasmAt-alam-anena 1060vaQcanA-darSanena-ati-nirbanDena1061 /
   siddhāntaḥ /	sidDAntaH /
   1062gambhīrataragurudarśanasāgarapāradṛśvānastu samprati	1062gamBIratara-guru-darSana-sAgara-pAradRSvAnaH-tu samprati
   samādhimabhidhati---stambhādiṣu prathamamanubhūteṣu punarantarā	samADim-aBiDati---stamBa-Adizu praTamam-anuBUtezu punar-antarA
   tirodhānādivaśena vicchinnopalambheṣu punaranubhavataḥ"sa evāyami"ti	tiroDAna-Adi-vaSena vicCinna-upalamBezu punar-anuBavataH"saH eva-ayami"ti
   tāvajjāyate matiḥ /	tAvat-jAyate matiH /
   tatra yadyarthakriyā sthirādapi kathañcidupapadyate, tato	tatra yadi-arTa-kriyA sTirAt-api kaTaQcid-upapadyate, tatas-
   bhedāgrahaṇanibandhano 'yamabhedavyavahāra iti kimiti kalpyate /	Beda-agrahaNa-nibanDanaH ayam-aBeda-vyavahAraH iti kim-iti kalpyate /
   upapadyate ca sthirādapi bhāvāt	upapadyate ca sTirAt-api BAvAt-
   sahakārivaśopajātāgantukakriyādirūpaviśeṣabhājaḥ krameṇār'thakriyā /	sahakAri-vaSa-upajAta-Agantuka-kriyA-Adi-rUpa-viSeza-BAjaH krameNa-Ar-aTa-kriyA /
   sa ca viśeṣo vyatirikta eva bhāvādarthakriyākāriṇaḥ /	sa ca viSezaH vyatiriktaH eva BAvAt-arTa-kriyA-kAriNaH /
   na ca sa evār'thakriyākārī, bhāvastūdāsta iti caturastram /	na ca saH evAr-aTa-kriyA-kArI, BAvaH-tu-udAstaH iti catur-astram /
   tathāvidhaviśeṣālīḍhataiva tasya sādhanatā, yadanantaramarthakriyodayaḥ,	taTAviDa-viSeza-AlIXa-tA-eva tasya sADana-tA, yat-anantaram-arTa-kriyA-udayaH,
   tadviśeṣayogitayaiva bhāveṣu sādhanatavavyavahāro laukikānām /	tad-viSeza-yogi-tayA-eva BAvezu sADana-tava-vyavahAraH lOkikAnAm /
   kathaṃ punarasau viśeṣastasyeti vyapadiśyate, tadāśrayatayaivānumānāt /	kaTam punar-asO viSezaH-tasya-iti vyapadiSyate, tad-ASraya-tayA-eva-anumAnAt /
   kathaṃ punastadāśrayataiva /	kaTam punar-tad-ASraya-tA-eva /
   svahetuvaśeneti matavā nivartatāṃ bhavāt, alamasmābhirdūramanuyātaiḥ /	sva-hetu-vaSena-iti matavA nivartatAm BavAt, alam-asmABiH-dUram-anuyAtEH /
   atha kasmādbhāvasyaiva bhedo nānumīyate, pratyabhijñānānuguṇyāditi vadāmaḥ	aTa kasmAt-BAvasya-eva BedaH na-anumIyate, pratyaBijQAna-anuguNyAt-iti vadAmaH
   dṛṣṭānusāri cānumānamucitam, dṛṣṭopapattimukhatvāt /	dRzwa-anusAri ca-anumAnam-ucitam, dRzwa-upapatti-muKa-tvAt /
   yathā cār'thakriyā dṛśte,1062 tathedamapi dṛśyate sthāvaro bhāva iti,	yaTA cAraTa-kriyA dRSte,1062 taTA-idam-api dRSyate sTAvaraH BAvaH iti,
   tadanuguṇamanumānamucitam /	tad-anuguNam-anumAnam-ucitam /
   tena sthāvare 'pyarthakriyāvyāpakakra-yaugapadyānivṛtterasiddho	tena sTAvare api-arTa-kriyA-vyApaka-kra-yOgapadyA-nivRtteH-asidDaH-
   vyāpakānupalambhaḥ, 1063tadasiddhau ca viparyaye bādhakābhāvāt,	vyApaka-anupalamBaH, 1063tadasidDO ca viparyaye bADaka-aBAvAt,
   asiddhatanmātrānubandhinīṃ kṣaṇikatāṃ na sattā sādhayitumalam,	asidDa-tanmAtra-anubanDinIm kzaNika-tAm na sattA sADayitum-alam,
   anaikāntikatvāditi /	anEkAntika-tvAt-iti /
   na cār'thakriyākāritaiva sattā, kintu 1064pramāṇasambandhayogyatā /	na cAraTa-kriyA-kAritA-eva sattA, kintu 1064-pramANa-sambanDa-yogya-tA /
   yatassvarūpasattā ca pramāṇasambandhayogyatā /	yatassvarUpa-sattA ca pramANa-sambanDa-yogya-tA /
   ator'thakriyāmakurvannapi sanniti, na kiñcidavadyam /	ator-aTa-kriyAm-akurvan=-api sanniti, na kiQcid-avadyam /
   yattvidamuditamanapekṣā bhāvā vināśaṃ prati---iti /	yat-tu-idam-uditam-anapekzA BAvAH vinASam prati---iti /
   tadapi vimṛśyamānaṃ 1065 dahyamānaṃ jātuṣamivā'bharaṇaṃ vilīyate1066 /	tat-api vimRSyamAnam 1065 dahyamAnam jAtuzam-iva-AaBaraNam vilIyate1066 /
   kaṃ khalu bhavanto vināśamabhimanyante ? pradhvaṃsābhāvo vināśa iti	kam Kalu BavantaH vinASam-aBimanyante ? praDvaMsa-aBAvaH vinASaH iti
   cet---kaḥ punaḥ pradhvaṃsābhāvaḥ ?"dadhni kṣīraṃ nāstīstye" vamādikā	cet---kaH punar praDvaMsa-aBAvaH ?"daDni kzIram na-asti-istye" vamAdikA
   bhāvaviṣayā saṃviditi vadyucyeta, tadāmṛtakalāyāmuditā	BAva-vizayA saMvid-iti vadyucyeta, tadA-amRta-kalAyAmuditA
   nītiruddharaṇīyā1067 /	nItiH-udDaraNIyA1067 /
   na hi nāstī"ti buddhirasti /	na hi na-asti-i"ti budDiH-asti /
   kintu dadhisvarūpamātrānubhava eva svayamprakāśe nañśabdaprayogamātrameva,	kintu daDi-svarUpa-mAtra-anuBavaH eva svayamprakASe nan-Sabda-prayoga-mAtram-eva,
   saiva hi payaso nāstitā, yā dṛśye 'pi tasmin dadhisvarūpamātropalabdhiḥ /	sA-eva hi payasaH na-astitA, yA dRSye api tasmin daDi-svarUpa-mAtra-upalabDiH /
   na ca tāṃ prati payasa eva nirapekṣasya hetutā, anupanipatite hetvantare,	na ca tAm prati payasaH eva nirapekzasya hetutA, anupanipatite hetu-antare,
   payasa evopalabdhe /	payasaH eva-upalabDe /
   na cedaṃ payonataramupalabhyata iti śakyaṃ vaktum /	na ca-idam payonataram-upalaByate iti Sakyam vaktum /
   pratyabhijñānasyābhedasādhakatvāt /	pratyaBijQAnasya-aBeda-sADaka-tvAt /
   nanu ca hetvantarāpekṣitve dhruvabhāvitā nopapadyate /	nanu ca hetu-antara-apekzi-tve Druva-BAvitA na-upapadyate /
   dhruvabhāvitā nopapadyate /	Druva-BAvitA na-upapadyate /
   dhruvabhāvitaiva kuto 'vagamyate ? darśanāditi cet ? hetvantareṇāpyavaśyaṃ	Druva-BAvitA-eva kutas avagamyate ? darSanAt-iti ced ? hetu-antareNa-api-avaSyam
   bhavitavyamiti, darśanādevāvagamyatām /	Bavitavyam-iti, darSanAt-eva-avagamyatAm /
   na ca bālā vayaṃ1068 yenaivaṃvidhavādād bhīṣayāmahe /	na ca bAlAH vayaM1068 yena-evaMviDa-vAdAt BIzayAmahe /
   yatpunaridaṃ svahetubhyo bhāvānāmapi naśvarāṇāmutpattau, hetvantarāyatte	yat-punar-idam sva-hetuByaH BAvAnAm-api naSvarANAm-utpattO, hetu-antarAyatte
   vināśe, vyatirekiṇi jāte 'pi pūrvavat bhāvasyopalabdhyādiprasaṅga iti /	vinASe, vyatirekiNi jAte api pUrvavat BAvasya-upalabDi-Adi-prasaFgaH iti /
   atrocyate---uktamasmābhiḥ---yathā tanmātropalabdhireva vināśa iti /	atra-ucyate---uktam-asmABiH---yaTA tanmAtra-upalabDiH-eva vinASaH iti /
   tena tasyā hetusadbhāvāt tayaiva bhavitavyam /	tena tasyAH hetu-sadBAvAt tayA-eva Bavitavyam /
   anupalabdhirapitasya saivetyanupalabdhireva tasya nopalabdhiḥ,	anupalabDiH-apitasya sA-eva-iti-anupalabDiH-eva tasya na-upalabDiH,
   tannibandhanaścābhāvavyavahāro 'pīti sarvamanākulam /	tad-nibanDanaH-ca-aBAva-vyavahAraH api-iti sarvam-anAkulam /
   sugatāśīviṣaviṣamakṣaṇabhaṅgaviṣānalāvalīḍhasāyāḥ /	sugata-ASIviza-viza-makzaNa-BaFga-viza-anala-avalIXa-sAyAH /
   mīmāṃsāyāṃ vihitā1069 marmamayī jīvarakṣeyam // 1 //	mImAMsAyAm vihitA1069 marma-mayI jIva-rakzeyam // 1 //
   iti mahāmahopādhyāyaśrīśālikānāthamiśrapraṇītāyāṃ prakaraṇapañcikāyāṃ	iti mahA-mahA-upADyAya-SrI-SAlikA-nATa-miSra-praNItAyAm prakaraNa-paQcikAyAm
   mīmāṃsājīvarakṣā nāma daśamaṃ prakaraṇaṃ samāptam //	mImAMsA-jIvarakzA nAma daSamam prakaraNam samAptam //
