   oṃ	om
   śrīmatprabhākaragurutantradhurandhareṇa	SrImat-praBA-kara-guru-tantra-DuranDareNa
   mahāmahopādhyāya-śālikanāthamiśreṇa praṇītā prakaraṇapañcikā	mahA-mahA-upADyAya--SAlika-nATa-miSreNa praNItA prakaraNa-paQcikA
   nyāyasiddhyākhyayā vyākhyayā viṣamasthalaṭipparāyā	nyAya-sidDi-AKyayA vyAKyayA vizama-sTalawipparAyA
   ca samalaṅkṛtā	ca samalaFkRtA
   953nyāyiśuddhirnāma	953nyAyiSudDiH-nAma
   navamaṃ prakaraṇam /	navamam prakaraNam /
   954apauruṣeye sambandhe śabdaḥ prāmāṇyamṛcchati /	954a-pOruzeye sambanDe SabdaH prAmANyam-RcCati /
   sa ca nityatvasiddhau syāditi tatpratipādyate // 1 //	sa ca nitya-tva-sidDO syAt-iti tat-pratipAdyate // 1 //
   yadyuccaritamātravināśī śabdo bhavet, tadā tasya vṛddhavyavahāreṇa	yadi-uccarita-mAtra-vinASI SabdaH Bavet, tadA tasya vRdDa-vyavahAreNa
   svābhāvikī svārthābhidhānaśaktiravasātumaśakyā /	svABAvikI sva-arTa-aBiDAna-SaktiH-avasAtum-aSakyA /
   bhūyobhūyaḥ prayogadarśane hi tattadasvārthaparihāreṇa niṣkṛṣya	BUyas-BUyas prayoga-darSane hi tad-tad-asva-arTa-parihAreNa nizkRzya
   svārthābhidhānasāmarthyamavadhāryate /	sva-arTa-aBiDAna-sAmarTyam-avaDAryate /
   na coccaritamātrāpavargiṇaśśabdasya punaḥ punaḥ prayogadarśanamupapadyate	na ca-uccarita-mAtra-apavargiNaH-Sabdasya punar punar prayoga-darSanam-upapadyate
   svārthābhidhānasāmarthyānavadhāraṇe ca prathamaśruta iva śabdo	sva-arTa-aBiDAna-sAmarTya-an-avaDAraNe ca praTama-SrutaH iva SabdaH-
   nār'thamavabodhayitumalam955 /	nAr-aTam-avaboDayitum-alam955 /
   arthañcānavabodhayataḥ prāmāṇyamayuktamiti, śabdasya prāmāṇyamicchatā	arTaQcA-anava-boDayataH prAmANyam-ayuktam-iti, Sabdasya prAmANyam-icCatA
   yuktamabhidhānasya nityatvasthānamiti saprayojanamidam /	yuktam-aBiDAnasya nitya-tva-sTAnam-iti sa-prayojanam-idam /
   nanu kṣaṇikatve 'pi varṇānāṃ 956gatvādiviṣayavṛddhavyavahārapūrvakameva	nanu kzaNika-tve api varNAnAm 956ga-tvA-Adi-vizaya-vRdDa-vyavahAra-pUrvakam-eva
   sambandhādhyavasānamupapadyate, kiṃ nityatvasthāpanayatnena /	sambanDa-aDyavasAnam-upapadyate, kim nitya-tva-sTApana-yatnena /
   ucyate---na pratyuccāraṇaṃ bhinneṣu varṇeṣu gatvādikaṃ kalpayituṃ śakyate,	ucyate---na pratyuccAraNam Binnezu varNezu gatvA-Adikam kalpayitum Sakyate,
   bhedāgraheṇāpi śuktikāra957jatabodhavadabhedapratyayābhimānopapatteḥ /	Beda-agraheNa-api Sukti-kAra-957jata-boDa-vat-aBeda-pratyaya-aBimAna-upapatteH /
   yatra hi bhedamadhyavasyata evābhedajñānam, tatrānyathānupapattyā	yatra hi Beda-maDyavasyataH eva-aBeda-jQAnam, tatra-anyaTA-anupapattyA
   sāmānyāśrayaṇaṃ ghaṭate /	sAmAnya-ASrayaNam Gawate /
   na cānityatvavādino 'pi958 varṇeṣu pratyuccāraṇaṃ sākṣādbhedādhyavasānaṃ	na ca-anitya-tva-vAdinaH api-958 varNezu pratyuccAraNam sAkzAt-Beda-aDyavasAnam
   sammatam /	sammatam /
   nanu ca yuktaṃ śuktikārajatādiṣu bhedāgrahaṇādabhedavyavahāra iti	nanu ca yuktam SuktikA-rajata-Adizu Beda-agrahaNAt-aBeda-vyavahAraH iti
   sāmānyāsambhavaḥ, nedaṃ rajatamiti bādhakapratyayodayāt, iha tu	sAmAnya-asamBavaH, na-idam rajatam-iti bADaka-pratyaya-udayAt, iha tu
   sāsānyopapatterbhrāntikalpanā niṣpramāṇikaiva, nāyaṃ gakāra iti	sAsAnya-upapatteH-BrAnti-kalpanA nizpramANikA-eva, na-ayam gakAraH iti
   bādhakābhāvāt /	bADaka-aBAvAt /
   ucyate /	ucyate /
   na bādhakamātrāyattaiva bhrāntikalpanā, kintu kāraṇadoṣāyattāpi /	na bADaka-mAtra-AyattA-eva BrAnti-kalpanA, kintu kAraNa-doza-AyattA-api /
   dṛṣṭañcātisādṛśyādbhedāgrahaṇād bhrantitvamiti, sākṣādanupajāte 'pi	dRzwaQcA-atisAdRSyAt-Beda-agrahaNAt Branti-tvamiti, sAkzAt-anupajAte api
   bādhake, yuktameva bhramāvadhāraṇam /	bADake, yuktam-eva Brama-avaDAraNam /
   ato na gatvādistatra sambhavati /	atas na gatvA-AdiH-tatra samBavati /
   959abhivyañjakavaidharmyādabhivyakterasambhave /	959aBivyaQjaka-vEDarmyAt-aBivyakteH-asamBave /
   prayatnānantaraṃ dṛṣṭerabhidhānaṃ prayatnajam // 2 // 960	prayatna-anantaram dRzweH-aBiDAnam prayatna-jam // 2 // 960
   kiñca puruṣaprayatnānantaraṃ hi śravaṇaṃ śabdasya	kiQca puruza-prayatna-anantaram hi SravaNam Sabdasya
   dvedhāvakalpate---prāgajātatvādanupalabdhaḥ, prayatnena janita	dveDA-avakalpate---prAga-jAta-tvAt-anupalabDaH, prayatnena janita
   upalabhyatāmāpadyate, anabhivyaktatvādvābhivyajyata iti /	upalaByatAm-Apadyate, anaBivyakta-tvAt-vA-aBivyajyate iti /
   tatra na tāvat---prayatnasya śabdaṃ pratyabhivyañjakatvaṃ sambhavati /	tatra na tAvat----prayatnasya Sabdam pratyaBivyaQjaka-tvam samBavati /
   961āvaraṇāpāyena kiñcidabhivyajyate,sannidhānena 962vā /	961a-AvaraNa-apAyena kiQcid-aBivyajyate,-sanniDAnena 962vA /
   na ca śabdasyā'varaṇamupapadyate /	na ca Sabdasya-AavaraNam-upapadyate /
   indrisambandhapratibandhena hyā'varaṇaṃ kuḍyādinā ghaṭāderupalabdham /	indri-sambanDa-pratibanDena hi-AavaraNam kuxya-AdinA Gawa-AdeH-upalabDam /
   na ca śabdasyendriyasambandhaḥ pratibandhuṃ śakyate, nityatvāt /	na ca Sabdasya-indriya-sambanDaH pratibanDum Sakyate, nitya-tvAt /
   utpattinirodho hi pratibandhaḥ /	utpatti-niroDaH hi pratibanDaH /
   na cāsau nityasyopapadyate /	na ca-asO nityasya-upapadyate /
   ākāśo hvi śrotrendriyaṃ śabdavattvāt, śabdopalambhakatayā ca śabdavattvaṃ	AkASaH hvi Srotra-indriyam Sabdavat-tva-at, Sabda-upalamBaka-tayA ca Sabdavat-tvam
   cakṣurvat /	cakzuH-vat /
   yathā---cakṣū rūpopalambhakaṃ rūpavat, tathā śrotramapi śabdavat /	yaTA----cakzuH rUpa-upalamBakam rUpavat, taTA Srotram-api Sabda-vat /
   ākāśaśca śabdavāniti sa eva śrotram, tadguṇaśca śabdastasminnityasamaveta	AkASaH-ca SabdavAn-iti saH eva Srotram, tad-guNaH-ca SabdaH-tasmin-nitya-samaveta
   iti, na tasyā'varaṇasambhavaḥ /	iti, na tasyAH-avaraNa-samBavaH /
   atastadapanayena nābhivyaktiḥ /	atas-tad-apanayena nABi-vyaktiH /
   ata eva sannidhānasyāsambhavaḥ, nityasannidhānādabhivyaṅyasya /	atas eva sanniDAnasya-asamBavaH, nitya-sanniDAnAt-aBivyaFyasya /
   kiñca---abhivyañjakāssamānadeśasthānekendriyāgrāhyān	kiQca---aBivyaQjakAssamAna-deSa-sTAn-eka-indriya-agrAhyAn
   yugapadevābhivyañjayanti, rūpādīniva pradīpādayaḥ /	yugapad-eva-aBivyaQjayanti, rUpa-AdIn-iva pradIpa-AdayaH /
   rūpam, parimāṇam, saṃkhyeti sarvaṃ sakṛdeva pradīpādabhirabhivyajyate /	rUpam, parimANam, saMKyA-iti sarvam sakRt-eva pradIpAt-aBiH-aBivyajyate /
   atassarvaśabdopalambho durnivāra eva /	atassarva-Sabda-upalamBaH durnivAraH eva /
   kiñca ākāśaviśeṣaguṇatvācchabdasya, ekatvādākāśasya	kiQca AkASa-viSeza-guNa-tvAt-Sabdasya, eka-tvAt-AkASasya
   srughnasthenābhivyaktaḥ pāṭalīputrasthenāpyupalabhyeta /	sruGna-sTena-aBivyaktaH pAwalI-putra-sTena-api-upalaByeta /
   sarvadā copalambhoparamo na syāt /	sarvadA ca-upalamBa-uparamaH na syAt /
   atha śrotrendriyasaṃsakara eva śabdasyābhivyaktiriṣyate, na so 'pi	aTa Srotra-indriya-saMsakaraH eva Sabdasya-aBivyaktiH-izyate, na saH api
   ghaṭate, kaḥ khalvindriyasya saṃskāraḥ---na	Gawate, kaH Kalu-indriyasya saMskAraH---na
   tāvadunmīlanavadāvaraṇāpagamaḥ, pūrvavadāvaraṇāsaṃbhavāt /	tAvat-unmIlana-vat-AvaraNa-apagamaH, pUrvavat-AvaraNa-asaMBavAt /
   nā'pyālokenevā'pyāyanaṃ963 cākṣuṣasya raśmeḥ koṣṭhyānāṃ vāyūnām, ākāśasya	nA-api-Alokena-ivA-apyAyanaM963 cAkzuzasya raSmeH kozWyAnAm vAyUnAm, AkASasya
   cāvayavasaṃyogāsambhavāt964 /	ca-avayava-saMyoga-asamBa-va-at964 /
   "sakṛcca saṃskṛtaṃ śrotraṃ sarvaśabdān prakāśayet /	"sakRt-ca saMskRtam Srotram sarva-SabdAn prakASayet /
   ghaṭāyonmīlitaṃ cakṣuḥ paṭaṃ na hi na 965budhyate //	GawAya-unmIlitam cakzuH pawam na hi na 965buDyate //
   " ślo. vā. śa. a. ślo. 60. 61 iti /	" Slo. vA. Sa. a. Slo. 60. 61 iti /
   tasmādabhivyañjakatve 'nupapanne, yadi 966prayatnakāraṇako 'pi na syāt,	tasmAt-aBivyaQjaka-tve anupapanne, yadi 966-prayatna-kAraNakaH api na syAt-,
   tadā tadapekṣopalabdhirna sambhavet /	tadA tad-apekzA-upalabDiH-na samBavet /
   tenedamanumānaṃ prayoktavyam---śabdaḥ	tena-idam-anumAnam prayoktavyam-----SabdaH
   puruṣaprayatnotpādyastadanabhivyaṅgyatve sati tadanantaropalabdheḥ, yo	puruza-prayatna-utpAdyaH-tad-ana-BivyaFgya-tve sati tad-anantara-upalabDeH, yaH-
   yadanabhivyaṅyastadanantaropalabhyaḥ, sa tasyotpādyaḥ,	yat-anaBivyaFyaH-tad-anantara-upalaByaH, sa tasya-utpAdyaH,
   yathā-ghaṭaḥkapālavyāpārasyeti /	yaTA--GawaH-kapAla-vyApArasya-iti /
   kena punaḥ prakāreṇa prayatnena śabda utpādyate /	kena punar prakAreNa prayatnena SabdaH utpAdyate /
   tatra	tatra
   967kecidāhuḥ---puruṣaprayatnodīritairvāyvavayavaissthānaviśeṣābhidhāta968	967kecid-AhuH-----puruza-prayatna-udIritEH-vAyu-avayavEH-sTAna-viSeza-aBiDAta968
   - saṃskārasaṃskṛtaissarvatodikkaissaṃyogākhyāsamavāyikāraṇānugṛhītaiśca	 saMskAra-saMskRtEH-sarvatodikkEssaMyoga-AKyA-sam-avAyi-kAraNa-anugRhItEH-ca
   svasamavetaḥ śabda ārabhyate /	sva-samavetaH SabdaH AraByate /
   vāyośca gatimattvāt, tadārabdhaśśabdo 'pi gatimān	vAyoH-ca gatimat-tva-at, tadA-ArabDaH-SabdaH api gatimAn
   karṇaśaṣkulīmaṇḍalāvacchinnena nabhasā śrotrabhāvamāpanneva	karNa-SazkulI-maNxala-avacCinnena naBasA Srotra-BAvam-Apan=-A-iva
   saṃyuktassannupalabhyate /	saMyukta-ssan=-upalaByate /
   vegākhyasaṃskāranibandhanā ca vāyorgatiriti, tadapagame gativicchedād dūre	vega-AKya-saMskAra-nibanDanA ca vAyoH-gatiH-iti, tad-apagame gati-vicCedAt dUre
   yacchotram, tatrāpratyāsannatvācchabdo na śrūyate /	yat-Sotram, tatra-apratyAsanna-tvAt-SabdaH na SrUyate /
   na 969caitadupapadyate---vāyavīyaścecchabdo bhavet, sparśanena	na 969ca-etat-upapadyate---vAyavIyaH-ced-SabdaH Bavet, sparSanena
   badhirairupalabhyeta /	baDirEH-upalaByeta /
   syānmatam--- 970abhibhūtatvāt sparśanenānupalabdhiriti /	syAt-matam-- 970aBiBUta-tvAt sparSanena-anupalabDiH-iti /
   tanna /	tat-na /
   pratyakṣopalabdhyarhatvāt971 /	pratyakza-upalabDi-arha-tvAt971 /
   yadi hyasāvabhibhūtaḥ, tarhi śrotreṇāpi nopalabhyeta /	yadi hi-asO=-aBiBUtaH, tarhi SrotreNa-api na-upalaByeta /
   na ca vācyaṃ na sparśanendriyagrāhyovāyuriti /	na ca vAcyam na sparSana-indriya-grAhya-uvAyuH-iti /
   tadanuvidhānena tadavagateḥ /	tad-anuviDAnena tad-avagateH /
   atha matam---sparśamātraṃ sparśanendriyeṇopalabhyate, na vāyudravyamiti /	aTa matam-----sparSa-mAtram sparSana-indriyeNa-upalaByate, na vAyu-dravyam-iti /
   tanna---sparśavyatireke 'pi972 dravyasya pratyabhijñāyamānatvāt973 /	tat-na---sparSa-vyatireke api972 dravyasya pratyaBijQAyamAna-tvAt973 /
   anye 974tvāhuḥ---saṃyogādvibhāgādvā'dyaśśabdo niṣpadyate /	anye 974tu-AhuH-----saMyogAt-viBAgAt-vA-adyaH-SabdaH nizpadyate /
   yathā tālvādivāyusaṃyogānugṛhītādvāyvākāśasaṃyogādākaśe śabdassañjāyate,	yaTA tAlu-Adi-vAyu-saMyoga-anugRhItAt-vAyu-AkASa-saMyogAt-AkaSe Sabdassan-jAyate,
   tathā tālvādivāyuvibhāgopakṛtādvāyvākāśavibhāgādākāśa eva	taTA tAlvAdi-vAyu-viBAga-upakRtAt-vAyu-AkASa-viBAgAt-AkASaH eva
   śabdaśśabdāntaramārabhate, tadapi śabdāntaramiti	SabdaH-Sabda-antaram-AraBate, tat-api Sabda-antaram-iti
   karṇaśaṣkulīmaṇḍalāvacchinne nabhasi śrotrabhāvamāpanne	karNa-SazkulI-maNxala-avacCinne naBasi Srotra-BAvam-Apanne
   niṣpannaśśabdaśśrūyata iti /	nizpannaH-SabdaH-SrUyate iti /
   975nānābhāve prayatnasya nānābhāvopalambhanāt /	975nAna-aBAve prayatnasya nAnA-BAva-upalamBanAt /
   vailakṣaṇye ca śabdasya vailakṣaṇyena kāryatā // 3 //	vElakzaNye ca Sabdasya vElakzaNyena kArya-tA // 3 //
   kiñca---abhivyaṅgyaścet prayatnena śabdo na pratiyatnaṃ bhedenopalabhyeta	kiQca---aBivyaFgyaH-ced prayatnena SabdaH na pratiyatnam Bedena-upalaByeta
   na khalvabhivyañjakapradīpabhede 'pi nānābhāvena bhāvānāmupalambhaḥ /	na Kalu-aBivyaQjaka-pradIpa-Bede api nAnA-BAvena BAvAnAm-upalamBaH /
   kārakabhedastu kāryabhedaheturiti 976saṃpratītaḥ /	kAraka-BedaH-tu kArya-Beda-hetuH-iti 976saMpratItaH /
   ataśśabdasya prayatno janayiteti niścīyate /	atas-Sabdasya prayatnaH janayitA-iti niScIyate /
   yathā kārakavekalakṣaṇyānuvidhāyinī kāryavailakṣaṇyasiddhiravihatā, tathā	yaTA kAraka-veka-lakzaNyA-anuviDAyinI kArya-vElakzaNya-sidDiH-avihatA, taTA
   vailaṇye 'pi cābhivyañjakasyābhivyaṅyavailakṣaṇyaṃ na sambhavati /	vElaNye api ca-aBivyaQjakasya-aBivyaFya-vElakzaNyam na samBavati /
   śabdastu prayatnasya mṛdutve, balavattve ca	SabdaH-tu prayatnasya mRdu-tve, balavat-tve ca
   mṛdurbalavāṃścopalabhyamānastatkāryatāṃ na jahātīti /	mRduH-balavAn=-ca-upalaByamAnaH-tad-kAryatAm na jahAti-iti /
   siddhāntaḥ /	sidDAntaH /
   977śabde tatpratyaye spaṣṭe nānāvyañjakakalpanāt /	977-Sabde tad-pratyaye spazwe nAnA-vyaQjaka-kalpanAt /
   upalabdhivyavasthānamupapannaṃ bhaviṣyati // 4 //	upalabDi-vyavasTAnam-upapannam Bavizyati // 4 //
   yadi śakṣyāmaśśabdasya spaṣṭaṃ pratyabhijñānamupadarśayitum, tadā	yadi SakzyAmaH-Sabdasya spazwam pratyaBijQAnam-upadarSayitum, tadA
   prayatnasya kārakatve niṣiddhe, abhivyañjakatve ca sthite,	prayatnasya kAraka-tve nizidDe, aBivyaQjaka-tve ca sTite,
   upalabdhivyavasthānaṃ vyañjakabahutvena varṇayiṣyāmaḥ /	upalabDi-vyavasTAnam vyaQjaka-bahu-tvena varNayizyAmaH /
   śrotrameva saṃskriyate, tatsaṃskārakatā ca----tadabhivyajjakatā /	Srotram-eva saMskriyate, tad-saMskAraka-tA ca----tad-aBivyajjaka-tA /
   koṣṭhyo hi vāyuḥ prayatnavadātmasaṃyogādudgacchati978 /	kozWyaH hi vAyuH prayatna-vat-Atma-saMyogAt-udgacCati978 /
   sa 979nābherudgacchannuraḥ- prabhṛtiṣvaṣṭasu sthāneṣvabhighātetana	sa 979nABeH-udgacCat-=-uraH praBRtizu-azwasu sTAnezu-aBiGAtetana
   saṃskṛto yāvadvegamabhipratiṣṭhamānaśśrotramanuprāptaśśabdopalambhānuguṇaṃ	saMskRtaH yAvat-vegam-aBipratizWamAnaH-Srotram-anuprAptaH-Sabda-upalamBa-anuguNam
   saṃskāramārabhate /	saMskAram-AraBate /
   tatsaṃyoga eva śrotrasaṃskāraḥ /	tad-saMyogaH eva Srotra-saMskAraH /
   vegavattvācca vāyoḥ, karmotpattau śrotravibhāgāt saṃyogoparame,	vegavat-tvAt-ca vAyoH, karma-utpattO Srotra-viBAgAt saMyoga-uparame,
   śabdasyānantaramupalambhavicchedaḥ /	Sabdasya-anantaram-upalamBa-vicCedaH /
   prayatnabhedācca vāyukarmabhedāduraḥprabhṛtisthānasaṃyogānyatvāvyavasthayā	prayatna-BedAt-ca vAyu-karma-BedAt-uraH-praBRti-sTAna-saMyoga-anyatva-avyavasTayA
   śabdaśravaṇam /	Sabda-SravaNam /
   śabdotpattivādyapyutpādakabhedamanumanyata eva, anyathā	Sabda-utpatti-vAdi-api-utpAdaka-Bedam-anumanyate eva, anyaTA
   kāryabhedāsambhāvāt /	kArya-Beda-asamBAvAt /
   yattūpavatirṇataṃ---yathonmīlanasaṃskṛtaṃ cakṣurna	yat-tu-upavatirNataM---yaTa-unmIlana-saMskRtam cakzuH-na
   samānadeśasthānupalabhyān vyavasthayopalambhayatīti /	samAna-deSa-sTa-anupalaByAn vyavasTayA-upalamBayati-iti /
   tadayuktam---tatraikatvādabhivyañjakasya /	tat-ayuktam----tatra-eka-tvAt-aBivyaQjakasya /
   ekemeva hyunmīlanaṃ sarvopalambhānuguṇanetrasaṃskārārambhakamiti, kuta	ekem-eva hi-unmIlanam sarva-upalamBa-anuguNa-netra-saMskAra-AramBaka-miti, kuta
   upalabdhirvyavatiṣṭhatām /	upalabDiH-vyavatizWatAm /
   ihatvekatvaṃ saṃskārāṇāmasiddham /	ihatu-eka-tvam saMskArANAm-asidDam /
   nanvabhivyaṅgyasyaikendriyagrāhyatve, abhivyañjakasyaikataiva prāpnoti /	nanu-aBivyaFgyasya-eka-indriya-grAhya-tve, aBivyaQjakasya-ekatA-eva prApnoti /
   ye samānendriyagrāhyāḥ, teṣāmeka evādyabhivyañjakaḥ /	ye samAna-indriya-grAhyAH, tezAm-ekaH eva-Adi-aBivyaQjakaH /
   yathā---āloko ghaṭādīnām /	yaTA---AlokaH Gawa-AdInAm /
   ekatve cābhivyañjakasyopalabdhivyavasthā nopapadyate /	ekatve ca-aBivyaQjakasya-upalabDi-vyavasTA na-upapadyate /
   ato 'bhivyañjakatvāsambhave, kārakatve vyavasthite,	atas aBivyaQjaka-tva-asamBave, kAraka-tve vyavasTite,
   bhedāgrahaṇanibandhanaiva pratyabhijñeti nyāyyā kalpanā---iti /	Beda-agrahaNa-nibanDanA-eva pratyaBijQA-iti nyAyyA kalpanA---iti /
   atrocyate /	atra-ucyate /
   ekendriyagrāhyatāpi bhavet, abhivyañjakabhedo 'pi bhavediti,	eka-indriya-grAhya-tA-api Bavet, aBivyaQjaka-BedaH api Bavet-iti,
   kimanupapannam /	kim-anupapannam /
   svābhāvikī hi yasya sambandhavyāptiḥ, tasya liṅgatvam /	svABAvikI hi yasya sambanDa-vyAptiH, tasya liFga-tvam /
   980āśaṅkyamānāśeṣopādhiparihāreṇa hi svārasikasambandhavyāptiniścayaḥ /	980A-SaFkyamAna-aSeza-upADi-parihAreNa hi svArasika-sambanDa-vyApti-niScayaH /
   iha tu na śakyate nirṇetuṃ---kimekendriyagrāhyatayā ghaṭādīnām,	iha tu na Sakyate nirNetuM---kim-eka-indriya-grAhya-tayA Gawa-AdInAm-,
   tadgatarūpādīnā ñcaiko 'bhivyañjakaḥ, uta rūpidravyatvāt,	tad-gata-rUpa-AdInA Qca-ekaH aBivyaQjakaH, uta rUpi-dravya-tvAt,
   tatsamavāyitvācceti /	tad-samavAyi-tvAt-ca-iti /
   ato 'navadhāritasambandhavyāptikamekendriyagrāhyatvaṃ	atas anavaDArita-sambanDa-vyAptikam-eka-indriya-grAhya-tvam
   nābhivyañjakaikyānumānasamartham /	nABi-vyaQjaka-Ekya-anumAna-samarTam /
   ato 'bhivyajjakatve 'pi prayatnasyopalabdhivyavasthopapattiḥ /	atas aBivyajjaka-tve api prayatnasya-upalabDi-vyavasTA-upapattiH /
   nanu sthiravāyvapanaya eva saṃskāraḥ /	nanu sTira-vAyu-apanayaH eva saMskAraH /
   apanīte ca tasmin, sarvaśabdopalabdhirdurnivārā /	apanIte ca tasmin, sarva-Sabda-upalabDiH-durnivArAH /
   ucyate---nāvaraṇānayanaṃ 981tasyābhivyañjakam, vāyunā	ucyate---nAvaraNa-Anayanam 981tasya-aBivyaQjakam, vAyunA
   śabdāvaraṇāsambhavāt, kiṃ 982tvadṛṣṭasāpekṣeṇa /	Sabda-AvaraNA-samBava-at, kim 982tu-adRzwa-sApekzeNa /
   eñcāpanetṛkāṣṭhyavāyubhedāt	eQcA-apanetR-kAzWya-vAyu-BedAt
   983sthiravāyuvibhāgalakṣaṇasaṃskārabhedādupapannaivopalabdhivyavasthā /	983-sTira-vAyu-viBAga-lakzaNa-saMskAra-BedAt-upapanna-eva-upalabDi-vyavasTA /
   api ca na vayaṃ sthiravāyvapanayaṃ saṃskāramācakṣmahe, kintu	api ca na vayam sTira-vAyu-apanayam saMskAram-Acakzmahe, kintu
   koṣṭhyavāyusaṃyogameva, prathamabhāvitvāt /	kozWya-vAyu-saMyogam-eva, praTama-BAvi-tvAt /
   kimiti tarhi bhāṣyakāreṇa"stimitāni vāyvantarāṇī" tyuktam ? koṣṭhyasya	kim-iti tarhi BAzya-kAreNa"stimitAni vAyu-antarANI" tyuktam ? kozWyasya
   vāyorvegavināśārtham /	vAyoH-vega-vinASa-arTam /
   984sparśavaddravyasaṃyogādvi vegavināśo 'nyatra pratīti iti, ihāpi	984-sparSa-vat-dravya-saMyogAt-vi vega-vinASaH anyatra prati-iti iti, iha-api
   tadarthameva sthiravāyukīrtanaṃ985 bhāṣye /	tad-arTam-eva sTira-vAyu-kIrtanaM985 BAzye /
   nanu caikatvādākāśasya, tasya ca śrotratvāt tatsaṃskāre, sarvapuruṣendriya	nanu ca-eka-tvAt-AkASasya, tasya ca Srotra-tvAt tad-saMskAre, sarva-puruza-indriya
   saṃskārāt sarve 'pi śabdamupalabheran /	saMskArAt sarve api Sabdam-upalaBeran /
   naiṣadoṣaḥ /	na-eza-dozaH /
   986dharmā-dharmopārjitakarṇaśaṣkulībhedāt /	986DarmA--Darma-upArjita-karNa-SazkulI-BedAt /
   karṇaśaṣkulīsaṃskāro hi śrotrasaṃskāraḥ, bhinnāśca pratipuruṣaṃ	karNa-SazkulI-saMskAraH hi Srotra-saMskAraH, BinnAH-ca prati-puruzam
   kārṇaśaṣkulya iti, asaṃskṛtakarṇaśaṣkulīko na śabdamupalabhate /	kArNa-SazkulyaH iti, asaMskRta-karNa-SazkulIkaH na Sabdam-upalaBate /
   anuvātañca 987dūrata eva śabdamupalabhate /	anuvAtaQca 987dUrataH eva Sabdam-upalaBate /
   bāhyavāyunodanānugṛhītasya koṣṭhyavāyuvegasya dūragamanahetutvāt /	bAhya-vAyunodana-anugRhItasya kozWya-vAyu-vegasya dUra-gamana-hetu-tvAt /
   śabdācchabdāntarārambhapakṣe tu nānuvātasya kaścidupayogaḥ /	SabdAt-Sabda-antara-AramBa-pakze tu na-anuvAtasya kaScid-upayogaH /
   abhivyajjakanānātvācchabdo nāneva lakṣyate /	aBivyajjaka-nAnA-tvAt-SabdaH nAnA-iva lakzyate /
   netravṛttivibhedena candrastaimirikairiva // 5 //	netra-vRtti-viBedena candraH-tEmirikEH-iva // 5 //
   spaṣṭe tadgrahe nānābhāvopalambhaśśabde tāvadasiddha eva /	spazwe tad-grahe nAnA-BAva-upalamBaH-Sabde tAvat-asidDaH eva /
   kintu parasparanirapekṣairabhivyañjakaiḥ	kintu paraspara-nirapekzEH-aBivyaQjakEH
   koṣṭhyavāyubhirnānāvaktṛsamutthairnānābhūtairbhinnaṃ	kozWya-vAyuBiH-nAnA-vaktR-samutTEH-nAnA-BUtEH-Binnam
   śrotrasaṃskāramārabhamāṇairnānābhūtaśabdabuddhiṃ janayadbhirnāneva śabdo	Srotra-saMskAram-AraBamANEH-nAnA-BUta-Sabda-budDim janayadBiH-nAnA-iva SabdaH-
   budhyate, candra iva timiravibhinnābhirnetravṛttibhiḥ /	buDyate, candraH iva timira-viBinnABiH-netra-vRttiBiH /
   nānādeśopalambhe hi sarveṣāṃ bhrāntisammatiḥ /	nAnA-deSa-upalamBe hi sarvezAm BrAnti-sammatiH /
   karṇacchidragatasyaiva śabdasya śravaṇaṃ yataḥ // 6 //	karNa=-Cidra-gatasya-eva Sabdasya SravaNam yatas // 6 //
   yaducyate---kāryatve śabdasya kāraṇadeśabhedānnānādeśopalambha988 iti /	yat-ucyate---kArya-tve Sabdasya kAraNa-deSa-BedAt-nAnA-deSa-upalamBa988 iti /
   tadayuktam /	tat-ayuktam /
   yadyapi kṛtakaśśabdaḥ, tathāpi	yadi-api kRtakaH-SabdaH, taTA-api
   saṃnikṛṣṭa-viprakṛṣṭayoryugapacchabdopalambhaprasaṅgena	saMnikRzwa--viprakRzwayoH-yugapad-Sabda-upalamBa-prasaFgena
   prativātā-nuvātayoścāviśeṣāpatternendriyaṃ prāptasyopalambhakam /	prativAta-a-nuvAtayoH-ca-aviSeza-ApatteH-na-indriyam prAptasya-upalamBakam /
   prāptāvapi nendriyaṃ śabdadeśamupasarpati, pratayakṣatvācchotradeśe	prAptO=-api na-indriyam Sabda-deSam-upasarpati, prata-yakza-tvAt-Sotra-deSe
   karṇaśaṣkulyāḥ prativātā-nuvātayośca tulyopalambhāpatteḥ /	karNa-SazkulyAH prativAta-a-nuvAtayoH-ca tulya-upalamBa-ApatteH /
   śabde tu śrotrapathaṃ prāpta upalabhyamāne deśabhedaḥ pratīyate /	Sabde tu Srotra-paTam prAptaH upalaByamAne deSa-BedaH pratIyate /
   ato bhrantireṣā-nānādeśeṣu śabda upalabhyata iti /	atas BrantiH-ezA-nAnA-deSezu SabdaH upalaByate iti /
   kinnibandhanā bhrāntiḥ /	kinnibanDanA BrAntiH /
   abhivyañjakadeśanibandhaneti brūmaḥ /	aBivyaQjaka-deSa-nibanDanA-iti brUmaH /
   tālvādisthānāghātasāpekṣo989 hi koṣṭhyo vāyurabhivyanakti /	tAlu-Adi-sTAnAGAta-sApekzaH-989 hi kozWyaH vAyuH-aBivyanakti /
   ato vaktṛdeśo 'pi bhavatyabhivyañjakadeśaḥ /	atas vaktR-deSaH api Bavati-aBivyaQjaka-deSaH /
   tena śabdaṃ śṛṇvatastadabhivyajjakadeśo 'pi tadavinābhāvopakalpito	tena Sabdam SRNvataH-tad-aBivyajjaka-deSaH api tad-avinA-aBAva-upakalpitaH-
   buddhistho bhavati /	budDi-sTaH Bavati /
   śabdābhivyaktiviśeṣeṇa ca dūrā-sannatve tasya kalpyete /	Sabda-aBivyakti-viSezeNa ca dUrA--sanna-tve tasya kalpyete /
   pratyakṣopalabhyamānavaktṛviṣaye ca śabdaśrutiviśeṣe digviśeṣo	pratyakza-upalaByamAna-vaktR-vizaye ca Sabda-Sruti-viSeze diS-viSezaH-
   niyatamavadhāritaḥ, ato digviśeṣakalpanāpi /	niyatam-avaDAritaH, atas diS-viSeza-kalpanA-api /
   yastu na tathā vivektumalam, tasyābhivyañjakadeśaṃ prati vyāmoho dṛśyata	yaH-tu na taTA vivektum-alam, tasya-aBivyaQjaka-deSam prati vyAmohaH dRSyata
   eva /	eva /
   evañcendriyāṇāṃ svānubhavāsamarthatvācchotragataśabdopalambhe	evaQca-indriyANAm sva-anuBava-asamarTa-tvAt-Sotra-gata-Sabda-upalamBe
   taddeśāgrahaṇāt, taduccāraṇapradeśasya pratīyamānatvāt,	tad-deSa-agrahaNAt, tad-uccAraNa-pradeSasya pratIyamAna-tvAt,
   tadgatatvapratipatteśca, tattaddeśagataśabdapratipattivyavahāraṃ	tad-gata-tva-pratipatteH-ca, tad-tad-deSa-gata-Sabda-pratipatti-vyavahAram
   pravartayatīti990 ghaṭata eveyaṃ bhrāntiḥ /	pravartayati-iti990 GawataH eva-iyam BrAntiH /
   vailakṣaṇyaṃ svabhāvane varṇānāṃ na ca sammatam /	vElakzaNyam svaBAvane varNAnAm na ca sammatam /
   nādālpatva-mahattvābhyāṃ tathātvabhrāntisambhavāt // 7 //	nAda-alpa-tva--mahat-tvAByAm taTA-tva-BrAnti-samBavAt // 7 //
   spaṣṭe tadgrahe prayatnastāvadvarṇānāṃ janako neti sthite,	spazwe tad-grahe prayatnaH-tAvat-varNAnAm janakaH na-iti sTite,
   tadanantaropalambhaniyamena991 cābhivyañjakatve nirṇīte,	tad-anantara-upalamBa-niyamena991 ca-aBivyaQjaka-tve nirNIte,
   abhivyañjakavṛddhihvāsayoścābhivyaṅgyavṛddhihvāsahetutvābhāvānna śabdo	aBivyaQjaka-vRdDi-hvAsayoH-ca-aBivyaFgya-vRdDi-hvAsa-hetutva-aBAvAt-na SabdaH-
   vardhate, hvasate vā /	varDate, hvasate vA /
   kintu balavati prayatne mahān vāyurutpadyate, 992tasyāvayavā bhūyāṃsaḥ	kintu balavati prayatne mahAn vAyuH-utpadyate, 992tasya-avayavAH BUyAMsaH
   karṇaśaṣkulīmaṇḍalasya nemibhāgairbahubhissambadhyante /	karNa-SazkulI-maNxalasya nemi-BAgEH-bahuBissambaDyante /
   tataścābhivyajjakasaṃyogabahutvāt, yugapadupalambhakabahutvāt, teṣāñca	tatas-ca-aBivyajjaka-saMyoga-bahu-tva-at, yugapad-upalamBaka-bahutva-at, tezAQca
   vicchedāgrahaṇānmahāniva śabdo 'vabhāti, tarūṇāmantarālāgrahaṇādiva	vicCeda-agrahaNAt-mahAn-iva SabdaH avaBAti, tarUNAm-antarAlA-grahaNAt-iva
   mahadvanam /	mahat-vanam /
   yadā te vāyvavayavāssahasā, vilambena vā saṃyujyante, tadopalambho 'pi	yadA te vAyu-avayava-assahasA, vilambena vA saMyujyante, tadA-upalamBaH api
   drutaḥ, vilambito vā /	drutaH, vilambitaH vA /
   yadā tveṣāmuccāraṇe tālvādīnāṃ saṃvṛtatvaṃ bhavati, tadā tadanurodhena	yadA tu-ezAm-uccAraNe tAlu-AdInAm saMvRta-tvam Bavati, tadA tad-anuroDena
   varṇopalabdhirapi ekamātrākālaiva bhavatīti, hvasvavarṇavyavahārasiddhiḥ /	varNa-upalabDiH-api eka-mAtrA-kAlA-eva Bavati-iti, hva-sva-varNa-vyavahAra-sidDiH /
   yadā 993vivṛtataratvam, asaṃvṛtatvaṃ vā tālvādīnāmeva sampadyate, tadā	yadA 993vivRtatara-tvam, asaMvRta-tvam vA tAlu-AdInAm-eva sampadyate, tadA
   varṇapratīterapi mātrākālavṛddhyā dīrghavarṇavyavahārasiddhiḥ,	varNa-pratIteH-api mAtrA-kAla-vRdDyA dIrGa-varNa-vyavahAra-sidDiH,
   vṛddhavyavahāre tadanurodhenāpyarthābhidhānadarśanāt, tathaiva	vRdDa-vyavahAre tad-anuroDena-api-arTa-aBiDAna-darSanAt, taTA-eva
   pratipādakatvamapyāśrīyate /	pratipAdaka-tvam-api-ASrIyate /
   na caivamabhidhānasyānityatvadoṣa, tadupādhiviśiṣṭasya varṇasya	na ca-evam-aBiDAnasya-anitya-tva-doza, tad-upADi-viSizwasya varNasya
   vācakasyānityatvāt1 ato varṇānupūrvyanityatve na kaściddoṣaḥ /	vAcakasya-anitya-tva-at1 atas varNa-AnupUrvya-nitya-tve na kaScid-dozaH /
   ānupūrvīviśeṣabhājāṃ varṇānāṃvācakabhūtānāṃ nityatvāt /	AnupUrvI-viSeza-BAjAm varNAnAMvAcaka-BUtAnAm nitya-tvAt /
   nanu 994kṣaṇikā śabdasyābhivyaktiriti, kathaṃ tadgrahaṇasambhavaḥ /	nanu 994kzaNikA Sabdasya-aBivyaktiH-iti, kaTam tad-grahaNa-samBavaH /
   upalabdhe hi ghaṭādibhāve tadvaśena pūrvānubhavāhitasaṃskāraprabodhena "sa	upalabDe hi Gawa-Adi-BAve tad-vaSena pUrva-anuBava-Ahita-saMskAra-praboDena "sa
   evāyami"ti pratyabhijñodīyate /	eva-ayam-i"ti pratyaBijQA-udIyate /
   śabde punaruccarita-tirohite, punaruttarakāle kathaṃ pratyabhijñodaya iti	Sabde punar-uccarita-tirohite, punar-uttara-kAle kaTam pratyaBijQA-udayaH iti
   tatrāha--- nāvaśyaṃ tadgraheṇaiva tatsaṃskāraprabodhanam /	tatra-aha-- na-avaSyam tad-graheNa-eva tad-saMskAra-praboDanam /
   tena hetvantarodbuddhāt saṃskārāttadgrahodayaḥ // 8 //	tena hetu-antara-udbudDAt saMskArAt-tad-graha-udayaH // 8 //
   yadi hyayaṃ niyamaḥ--tadupalambha eva tatsaṃskārodbodhaheturiti, tato	yadi hi-ayam niyamaH--tad-upalamBaH eva tad-saMskAra-udboDa-hetuH-iti, tatas-
   nopapadyate śabde pratyabhijñā /	na-upapadyate Sabde pratyaBijQA /
   saṃskārāstvaniyatodbodhahetava iti, kāraṇāntaravaśenodbuddhāt saṃskārāt	saMskArAH-tu-aniyata-udboDa-hetavaH iti, kAraNa-antara-vaSena-udbudDAt saMskArAt-
   prathamasamāgamasamaya eva śabde pratyabhijñā bhaviṣyati /	praTama-samAgama-samayaH eva Sabde pratyaBijQA Bavizyati /
   nanu"sa evāyaṃ gakāraḥ" iti 995pratītistadgrahaḥ, na	nanu"saH eva-ayam gakAraH" iti 995pratItiH-tad-grahaH, na
   punarbhedāgrahaṇāditi, kathameṣa nirṇayaḥ /	punar-Beda-agrahaNAt-iti, kaTam-eza nirNayaH /
   dṛṣṭo hi śuktikāyāṃ bhedāgrahāt"tadevedaṃ rajatami"ti pratyayaḥ---iti /	dRzwaH hi SuktikAyAm Beda-agrahAt"tadeva-idam rajatam-i"ti pratyayaH---iti /
   tatrā'ha--- 996bhede mānaṃ yadā nāsti śuktikā-rajatādivat /	tatrA-aha-- 996Bede mAnam yadA na-asti Sukti-kA-rajata-Adi-vat /
   tadā pratītisaṃsiddhastadgrahaḥ kena vāryate // 9 //	tadA pratIti-saMsidDaH-tad-grahaH kena vAryate // 9 //
   spaṣṭe hi śuktikā-rajatayorbhedāvasāyini pramāṇe,	spazwe hi Sukti-kA-rajatayoH-Beda-avasAyini pramANe,
   sādṛśyādbhedānavabādhādabhedapratītiriti kalpyate /	sAdRSyAt-Beda-an-avabADAt-aBeda-pratItiH-iti kalpyate /
   śabde tu na pratyakṣasiddhaḥ pratyuccāraṇaṃ bhedaḥ /	Sabde tu na pratyakza-sidDaH pratyuccAraNam BedaH /
   kathaṃ na siddhaḥ /	kaTam na sidDaH /
   nanu mahattvā-lpatvābhyāṃ vibhinno varṇa upalabhyate /	nanu mahat-tva-a-lpa-tvAByAm viBinnaH varNaH upalaByate /
   naita-devam /	na-eta-devam /
   mahattvā-lpatve pratiyato 'pi, varṇapratīte mahattvā-lpatve eva bhinne	mahat-tva-a-lpa-tve pratiyataH api, varNa-pratIte mahat-tva-a-lpa-tve eva Binne
   avabhātaḥ, na varṇāḥ /	avaBAtaH, na varNAH /
   na vā'numānenāpi bhedo 'vagantuṃ śakyata iti prāgeva niveditam /	na vA-anumAnena-api BedaH avagantum Sakyate iti prAk-eva niveditam /
   ato bhede pramāṇābhāvāt, abhinna evāyaṃ bhinnāvabhāsa iti,	atas Bede pramANa-aBAva-at, aBinnaH eva-ayam Binna-avaBAsaH iti,
   sākṣātpratītibalanaivāvasthāpitam // 9 //	sAkzAt-pratIti-balana-eva-avasTApitam // 9 //
   nanu ca tadgrahabalenaivānumānaṃ nirastam /	nanu ca tad-graha-balena-eva-anumAnam nirastam /
   niraste cānumāne, tadgraha itītaretarāśrayamiti /	niraste ca-anumAne, tad-grahaH iti-itaretara-ASrayam-iti /
   tatrā'ha--- anumānanirāsena 997tadgrahatvaṃ prasādhyate /	tatrA-aha-- anumAna-nirAsena 997tad-graha-tvam prasADyate /
   svayaṃ pratītisiddhatvād bhrāntiśaṅkā tu vāryate // 10 //	svayam pratIti-sidDa-tvAt BrAnti-SaFkA tu vAryate // 10 //
   bhedāgrahanibandhaneyaṃ bhrāntiriti śaṅkā kevalānumānanirāsenāpanīyate /	Beda-Agraha-nibanDanA-iyam BrAntiH-iti SaFkA kevala-anumAna-nirAsena-apanIyate /
   pratītibalasiddhastu tadgraho na kāraṇāntaramapekṣata iti,	pratIti-bala-sidDaH-tu tad-grahaH na kAraNa-antaram-apekzate iti,
   kathamitaretarāśrayatā /	kaTam-itaretara-ASraya-tA /
   nanu kimiti tadgrahabalājjvālāyāmapi bhedānumānaṃ na nirākriyataityata	nanu kim-iti tad-graha-balAt-jvAlAyAm-api Beda-anumAnam na nirAkriyata-etyata
   āha--- jvālābhedaṃ vinā 998bhāsāṃ vitatirnopapadyate /	Aha-- jvAlA-Bedam vinA 998BAsAm vitatiH-na-upapadyate /
   bhedājñānena sādṛśyāt pratyabhijñā tu yujyate // 11 //	Beda-ajQAnena sAdRSyAt pratyaBijQA tu yujyate // 11 //
   avayavī-jvālā /	avayavI--jvAlA /
   sarvaścāvayavī svāvayavasaṃyogena jātaḥ, tadvināśena vinaśyati /	sarvaH-ca-avayavI sva-avayava-saMyogena jAtaH, tad-vinASena vinaSyati /
   tantuvyatiṣaṅgajanito hi paṭastantuvibhāge vināśī dṛśyate /	tantu-vyatizaFga-janitaH hi pawaH-tantu-viBAge vinASI dRSyate /
   999prabhā ca gṛhodarādivartinī taijasaṃ rūpam /	999praBA ca gRha-udara-Adi-vartinI tEjasam rUpam /
   na ca dravyāśritā rūpādayo dravyaṃ virahayya vartante /	na ca dravya-ASritAH rUpa-AdayaH dravyam virahayya vartante /
   tena taijasāḥ paramāṇavo nityamabhibhūtatvādanupalambhamāna api,	tena tEjasAH paramANavaH nityam-aBiBUta-tvAt-anupalamBamAnaH api,
   pratyakṣato yāvatprabhāvitati sannidhīyanta ityaṅgīkaraṇīyam /	pratyakzataH yAvat-praBAvitati sanniDIyante iti-aFgIkaraNIyam /
   teṣu ca deśāntaramanuprāpteṣvetadāśrayaṇīyam-eteṣāṃ saṃyogā vighaṭanta iti	tezu ca deSa-antaram-anuprAptezu-etat-ASrayaNIyam--etezAm saMyogAH viGawantaH iti
   vighaṭiteṣu teṣu, tadārabdhe dravye 'pi nāśamupeyuṣi, 1000jvālādarśanaṃ	viGawitezu tezu, tad-ArabDe dravye api nASam-upeyuzi, 1000jvAlA-darSanam
   jvālāntaradarśanamantareṇa nopapadyate /	jvAlA-antara-darSanam-antareNa na-upapadyate /
   bhedāgrahaṇanibandhanā tu pratyabhijñā bhrāntiśśuktirajatādiṣu	Beda-agrahaNa-nibanDanA tu pratyaBijQA BrAntiH-Sukti-rajata-Adizu
   dṛṣṭatvādupapannā /	dRzwa-tvAt-upapannAH /
   vinā tu śabdebhedena na kiñcinnopapadyate /	vinA tu SabdeBedena na kiQcid-na-upapadyate /
   uktena nītimārgeṇa tadgraho 'to 'tra sammataḥ // 12 //	uktena nIti-mArgeNa tad-grahaH atas atra sammataH // 12 //
   pratyuccāraṇaṃ bhedavyatirekeṇāpi prayatnānantaropalabhyamānatvaṃ	pratyuccAraNam Beda-vyatirekeNa-api prayatna-anantara-upalaByamAna-tvam
   yathopapadyate, tathoktameveti, apratipakṣā pratyabhijñā /	yaTA-upapadyate, taTA-uktam-eva-iti, apratipakzA pratyaBijQA /
   1001sadasatkāraṇatvena tasmācchabdasya nityatā /	1001sada-sat-kAraNa-tvena tasmAt-Sabdasya nitya-tA /
   etadevava hi nityatvaṃ vyomādiṣvapi sammatam // 13 //	etat-evava hi nitya-tvam vyoma-Adizu-api sammatam // 13 //
   śabdasya prayatna eva kāraṇatayā sambhāvitaḥ /	Sabdasya prayatnaH eva kAraNa-tayA samBAvitaH /
   sa ca pratyabhijñābalenadvijīyādidarśaneṣvabhivyañjakatāmāpādita iti,	sa ca pratyaBijQA-balena-dvijIya-Adi-darSanezu-aBivyaQjaka-tAm-ApAdite iti,
   prathamadarśaṃne 'pyasāvabhivyañjaka eva /	praTama-darSaMne api-asO=-aBivyaQjakaH eva /
   ataḥ 1002kāraṇarahitatve 1003sati sattvānnityaśśabdo gaganādivat /	atas 1002kAraNa-rahita-tve 1003sati sattvAt-nityaH-SabdaH gagana-Adi-vat /
   1004tena nāsyānityateti //	1004tena na-asya-anitya-tA-iti //
   eṣā śālikanāthena śabdanityatvasādhanī /	ezA SAlika-nATena Sabda-nitya-tva-sADanI /
   prabhākaragurordṛṣṭyā nyāyaśuddhiḥ 1005prakīrtitā // 14 //	praBAkara-guroH-dRzwyA nyAya-SudDiH 1005-prakIrtitAH // 14 //
   iti mahāmahopādhyāyaśrīśālikanāthamiśrapraṇītāyāṃ prakaraṇapañcikāyāṃ	iti mahA-mahA-upADyAya-SrI-SAlika-nATa-miSra-praNItAyAm prakaraNa-paQcikAyAm
   nyāyaśuddhirnāma navamaṃ prakaraṇaṃ samāptam1006 //	nyAya-SudDiH-nAma navamam prakaraNam samAptam-1006 //
