   Pañcaviṃśatisāhasrikā Prajñāpāramitā	PaQcaviMSati-sAhasrikA PrajQApAramitA
   (PvSPL 1a)	(PvSPL 1a)
   namas sarvajñāya // evaṃ mayā śrutam ekasmin samaye bhagavān rājagṛhe	namaH sarvajQAya // evam mayA Srutam ekasmin samaye BagavAn rAjagRhe
   viharati sma gṛdhrakūṭe parvate mahatā bhikṣusaṃghena sārdhaṃ pañcamātrair	viharati sma gRDrakUwe parvate mahatA Bikzu-saMGena sArDam paQca-mAtrEH-
   bhikṣusahasrais sarvair arhadbhiḥ kṣīṇāsravair niṣkleśair vaśībhūtaiḥ	Bikzu-sahasrEH sarvEH arhadBiH kzINa-AsravEH nizkleSEH vaSIBUtEH
   suvimuktacittaiḥ suvimuktaprajñair ājāneyair mahānāgaiḥ kṛtakṛtyaiḥ	su-vimukta-cittEH su-vimukta-prajQEH AjAneyEH mahA-nAgEH kRtakRtyEH
   kṛtakaraṇīyair apahṛtabhārair anuprāptasvakārthaiḥ	kRta-karaNIyEH apahRta-BArEH anuprApta-svaka-arTEH
   parikṣīṇabhavasaṃyojanais samyagājñāsuvimuktacittais	parikzINa-Bava-saMyojanEH samyak-AjQA-su-vimukta-cittEH-
   sarvacetovaśiparamapāramiprāptaiḥ pañcamātrair bhikṣuṇīśatair upāsakair	sarva-cetaH-vaSi-parama-pArami-prAptEH paQca-mAtrEH BikzuNI-SatEH upAsakEH-
   upāsikābhiś ca sārdhaṃ sarvair dṛṣṭadharmair anekaiś ca	upAsikABiH ca sArDam sarvEH dRzwa-DarmEH anekEH ca
   bodhisatvakoṭīnayutaśatasahasraiḥ sārdhaṃ sarvair dhāraṇīpratilabdhaiḥ	boDisatva-kowIn-ayuta-Sata-sahasrEH sArDam sarvEH DAraNI-pratilabDEH
   śūnyatāvihāribhir animittagocaraiḥ praṇidhānākalpitaiḥ	SUnyatA-vihAriBiH animitta-gocarEH praNiDAna-akalpitEH
   kṣāntisamatāpratilabdhair asaṅgadhāraṇīpratilabdhair acyutābhijñair	kzAnti-samatA-pratilabDEH asaFga-DAraNI-pratilabDEH acyuta-aBijQEH-
   ādeyavacanair akuhakair alapakair apagatajñātṛlābhacittaiḥ	Adeya-vacanEH akuhakEH alapakEH apagata-jQAtR-lABa-cittEH
   nirāmiṣadharmadeśakair gambhīradharmakṣāntipāraṅgatair vaiśāradyaprāptair	nirAmiza-Darma-deSakEH gamBIra-Darma-kzAnti-pAraFgatEH vESAradya-prAptEH-
   mārakarmasamatikrāntaiḥ karmāvaraṇapratiprasrabdhair	mAra-karma-samatikrAntEH karma-AvaraNa-pratiprasrabDEH-
   dharmapravicayavibhaktinirdeśakuśalair	Darma-pravicaya-viBakti-nirdeSa-kuSalEH-
   asaṃkhyeyakalpapraṇidhānasusamārabdhaiḥ smitamukhaiḥ pūrvālāpibhiḥ	asaMKyeya-kalpa-praNiDAna-su-samArabDEH smita-muKEH pUrva-AlApiBiH
   apagatabhrūkuṭīmukhair gāthābhigītālapanakuśalair apagatalīnacittair	apagata-BrU-kuwI-muKEH gATA-aBigIta-Alapana-kuSalEH apagata-lIna-cittEH-
   anācchedyapratibhānair anantaparṣadabhibhaṃvanavaiśāradyasamanvāgatair	anAcCedya-pratiBAnEH ananta-parzad-aBiBaMvana-vESAradya-samanvAgatEH-
   anantakalpakoṭīniḥsaraṇakuśalair	ananta-kalpa-kowI-niHsaraNa-kuSalEH-
   māyāmarīcidakacandrasvapnapratiśrutkāpratibhāsapratibimbanirmāṇopamadharmādhimuktais	mAyA-marIci-daka-candra-svapna-pratiSrutka-apratiBAsa-pratibimba-nirmANa-upama-Darma-aDimuktEH-
   satvagaticaritasūkṣmanānādhimuktyavatārakuśalair apratihatacittair	satva-gati-carita-sUkzma-nAnA-aDimukti-avatAra-kuSalEH apratihata-cittEH-
   adhimātrakṣāntisamanvāgatair yathātmyāvataraṇakuśalais	aDimAtra-kzAnti-samanvAgatEH yaTA-AtmyA-avataraNa-kuSalEH-
   sarvabuddhakṣetrānantavyūhapraṇidhānaprasthānaparigṛhītair	sarva-budDa-kzetra-ananta-vyUha-praNiDAna-prasTAna-parigRhItEH-
   asaṃkhyeyalokadhātubuddhānusmṛtisamādhisatatasamitamabhimukhībhūtair	asaMKyeya-loka-DAtu-budDa-anusmRti-samADi-satata-samitam-aBimuKIBUtEH-
   aparimitabuddhādhyeṣaṇakuśalair	aparimita-budDa-aDyezaNa-kuSalEH-
   nānādṛṣṭyanuśayaparyavasthānakleśapraśamanakuśalais	nAnA-dRzwi-anuSaya-paryavasTAna-kleSa-praSamana-kuSalEH-
   samādhivikrīḍitaśatasahasranirhārakuśalaiḥ // tadyathā badhrapālena ca	samADi-vikrIxita-Sata-sahasra-nirhAra-kuSalEH // tat-yaTA baDrapAlena ca
   bodhisatvena mahāsatvena ratnākareṇa ca susārthavāhena ca naradattena ca	boDisatvena mahAsatvena ratna-AkareNa ca su-sArTavAhena ca naradattena ca
   varuṇadattena ca guhaguptena ca indradattena ca uttaramatinā ca	varuNa-dattena ca guhaguptena ca indra-dattena ca uttara-matinA ca
   viśeṣamatinā ca vardhamānamatinā ca amoghadarśinā ca susaṃprasthitena ca	viSeza-matinA ca varDamAna-matinA ca amoGa-darSinA ca su-saMprasTitena ca
   suvikrāntavikrāmiṇa ca nityodyuktena ca nityaprayuktena ca	su-vikrAnta-vikrAmiNa ca nitya-udyuktena ca nitya-prayuktena ca
   anikṣiptadhureṇa ca sūryagarbheṇa ca anupamamatinā ca avalokiteśvareṇa ca	anikzipta-DureNa ca sUrya-garBeNa ca anupama-matinA ca avalokita-ISvareNa ca
   mahāsthāmaprāptena ca mañjuśriyā ca vajramatinā ca ratnamudrāhastena ca	mahA-sTAma-prAptena ca maQjuSriyA ca vajra-matinA ca ratnamudrA-hastena ca
   nityotkṣiptahastena ca maitreyeṇa ca bodhisatvena mahāsatvena //	nitya-utkzipta-hastena ca mEtreyeNa ca boDisatvena mahAsatvena //
   evaṃpramukhair anekair bodhisatvakoṭīnayutaśatasahasraiḥ // atha khalu	evaMpramuKEH anekEH boDisatva-kowIn-ayuta-Sata-sahasrEH // aTa Kalu
   bhagavān svayam eva siṃhāsanaṃ prajñapya nyaṣīdat paryaṅkam ābhujya	BagavAn svayam eva siMhAsanam prajQapya nyazIdat paryaFkam ABujya
   ṛjukāyaṃ praṇidhānyā (PvSPL kā_a) abhūvan* sarvakṣaṇāś cāstamitā abhūvan*	Rju-kAyam praNiDAnyA (Pu-SPL kA_a) aBUvan* sarva-kzaNAH ca-astamitAH aBUvan*
   ye ca satvās tābhyo nirayatiryagyoniyamalokagatibhyaś cyutās te sarve	ye ca satvAH tAByaH niraya-tiryagyoni-yama-loka-gatiByaH cyutAH te sarve
   devamanuṣyeṣūpapadyante sma te devamanuṣyeṣūpapannā bhagavata evānubhāvena	deva-manuzyezu-upapadyante sma te deva-manuzyezu-upapannA BagavataH eva-anuBAvena
   pūrvajanmāny anusmaranti sma anusmṛtya tenaiva prītiprāmodyena	pUrva-janmAni anusmaranti sma anusmRtya tena-eva prIti-prAmodyena
   svakasvakeṣu buddhakṣetreṣu ye buddhā bhagavantas teṣām antikam	sva-ka-svakezu budDa-kzetrezu ye budDAH BagavantaH tezAm antikam
   upasaṃkrāntā upasaṃkramya teṣāṃ buddhānāṃ bhagavatāṃ pādavandanāṅ kṛtvā	upasaMkrAntAH upasaMkramya tezAm budDAnAm BagavatAm pAda-vandanAF kRtvA
   sarve prāñjalayo bhūtvā tān buddhān bhagavato namasyanti sma // atha khalu	sarve prAQjalayaH BUtvA tAn budDAn BagavataH namasyanti sma // aTa Kalu
   tenaiva kṣaṇalavamuhūrtena ye 'smiṃs trisāhasramahāsāhasre lokadhātau	tena-eva kzaNa-lava-muhUrtena ye asmin tri-sAhasra-mahA-sAhasre lokaDAtO
   andhās satvās te cakṣuṣā rūpāṇi paśyanti sma vadhirāḥ śrotreṇa śabdāñ	anDAH satvAH te cakzuzA rUpANi paSyanti sma vaDirAH SrotreNa SabdAn-
   cchṛṇvanti sma unmattāḥ smṛtiṃ pratilabhante sma vikṣiptacittā ekāgracittā	cCRNvanti smaH unmattAH smRtim pratilaBante sma vikzipta-cittA ekAgra-cittA
   bhavanti sma nagnāś cīvaraprāvṛtā bhavanti sma jighatsitāḥ pūrṇagātrā	Bavanti sma nagnAH cIvara-prAvRtAH Bavanti sma jiGatsitAH pUrNa-gAtrA
   bhavanti sma tṛṣitāḥ vigatapipāsā bhavanti sma rogaspṛṣṭāḥ vigatarogā	Bavanti sma tRzitAH vigata-pipAsA Bavanti sma roga-spRzwAH vigata-rogA
   bhavanti sma hīnendriyāḥ paripūrṇendriyā bhavanti sma	Bavanti sma hIna-indriyAH paripUrNa-indriyAH Bavanti sma
   aviratākuśalakāyavāṅmanaskarmāntājīvāḥ satvā	avirata-akuSalakAya-vAc-manaskarma-antA-jIvAH satvA
   viratākuśalakāyāvāṅmanaskarmāntājīvā bhavanti sma sarvasatvāś ca	virata-akuSala-kAya-avAk-manaskarmAntA-jIvAH Bavanti sma sarva-satvAH ca
   mātāpitṛsamacittā bhavanti sma bhrātṛbhaginī samacittā	mAtA-pitR-sama-cittAH Bavanti sma BrAtR-BaginI sama-cittA
   mitrāmātyajñātisālohitasamacittā daśakuśalakarmapathasevinaś ca bhavanti	mitra-amAtya-jQAti-sAlohita-sama-cittAH daSa-kuSala-karma-paTa-sevinaH ca Bavanti
   sma brahmacāriṇaḥ śucayo nirāmagandhāḥ sarvasukhasamarpitā īdṛśasukhaṃ	sma brahmacAriNaH SucayaH nirAma-ganDAH sarva-suKa-samarpitA IdRSa-suKam
   pratilabhante sma tadyathāpi nāma tṛtīyadhyānasamāpannasya tasminn eva ca	pratilaBante sma tat-yaTA-api nAma tRtIya-DyAna-samApannasya tasmin eva ca
   samaye evaṃrūpayā prajñāya samanvāgatā bhavanti sma yad	samaye evaMrUpayA prajQAya samanvAgatAH Bavanti sma yat-
   anyabuddhakṣetrasthā buddhā bhagavanta evam udānam udānayanti sma sādhu	anya-budDa-kzetra-sTAH budDAH BagavantaH evam udAnam udAnayanti sma sADu
   damaḥ sādhu śamaḥ sādhu saṃyamaḥ sādhu cīrṇo brahmacaryavāsaḥ sādhu	damaH sADu SamaH sADu saMyamaH sADu cIrNaH brahmacarya-vAsaH sADu
   praṇibhūteṣv avihiṃseti // atha khalu bhagavāṃs tasminn eva sihāsane	praNiBUtezu avihiMsa-iti // aTa Kalu BagavAn tasmin eva sihA-Asane
   niṣaṇṇaḥ iman trisāhasramahāsāhasraṃ lokadhātum abhibhūya tiṣṭhati bhāsate	nizaNNaH iman tri-sAhasra-mahA-sAhasram lokaDAtum aBiBUya tizWati BAsate
   tapati virocate sma ābhayā varṇena śriyā tejasā ca pūrvasyān diśi	tapati virocate smaH ABayA varNena SriyA tejasA ca pUrvasyAn diSi
   dakṣiṇasyāṃ paścimāyām uttarasyām adha-ūrdhvavidikṣu gaṅgānadīvālikopamāl	dakziNasyAm paScimAyAm uttarasyAm aDa-u-UrDva-vidikzu gaFgA-nadI-vAlikA-upamAl
   lokadhātūn abhibhūya tathāgatas tiṣṭhati bhāsate tapati virocate sma	lokaDAtUn aBiBUya taTAgataH tizWati BAsate tapati virocate sma
   ābhayā varṇena śriyā tejasā ca // tadyathāpi nāma sumeruḥ parvatarājaḥ	ABayA varNena SriyA tejasA ca // tat-yaTA-api nAma sumeruH parvata-rAjaH
   sarvvaparvatān abhibhūya tiṣṭhati bhāsate tapati virocate ābhayā varṇena	sarvu-aparvatAn aBiBUya tizWati BAsate tapati virocate ABayA varNena
   śriyā tejasā ca evam eva bhagavān sarvalokadhātūn abhibhūya tiṣṭhati	SriyA tejasA ca evam eva BagavAn sarva-loka-DAtUn aBiBUya tizWati
   bhāsate tapati virocate sma ābhayā varṇena śriyā tejasā ca // atha khalu	BAsate tapati virocate smaH ABayA varNena SriyA tejasA ca // aTa Kalu
   bhagavān punar eva yādṛk trisāhsaramahāsāhsre lokadhātau satvānām	BagavAn punar eva yAdRS tri-sAhsara-mahAsAhsre lokaDAtO satvAnAm
   ātmabhāvas tatsamānam ātmabhāvaṃ prākṛtam upadarśayāmāsa // atha khalu	Atma-BAvaH tad-samAnam Atma-BAvam prAkRtam upadarSayAmAsa // aTa Kalu
   yāvanto smiṃs trisāhasramahāsāhasre lokadhātau śuddhāvāsikāyikā (PvSPL	yAvantaH smin tri-sAhasra-mahA-sAhasre lokaDAtO SudDAvAsi-kAyikA (PvSPL
   kā_b) devā brahmakāyikāś ca paranirmitavaśavartinaś ca nirmāṇaratayaś ca	kA_b) devAH brahmakAyikAH ca paranirmitavaSavartinaH ca nirmANaratayaH ca
   tuṣitāś ca yāmāś ca trāyastriṃśāś ca cāturmahārājakāyikāś ca devās te tan	tuzitAH ca yAmAH ca trAyastriMSAH ca cAturmahArAja-kAyikAH ca devAH te tan
   tathāgatasyāsecanakam ātmabhāvaṃ dṛṣṭvā divyāni puṣpāṇi gṛhītvā	taTAgatasya-Asecanakam Atma-BAvam dRzwvA divyAni puzpANi gRhItvA
   divyagandhamālyavilepanacūrṇacīvaracchatraddhvajapatākāś ca gṛhītvā	divya-ganDa-mAlya-vilepana-cUrNa-cIvara=-Catrat-Dvaja-patAkAH ca gRhItvA
   divyāni cotpalakumudasaugandhikapundarīkapadmāni gṛhītvā divyāni ca	divyAni ca-utpala-kumuda-sOganDika-pundarIka-padmAni gRhItvA divyAni ca
   kesaratamālapatrāṇi gṛhītvā yena sa tathāgatasyāsecanaka ātmabhāvas	kesara-tamAla-patrANi gRhItvA yena sa taTAgatasya-AsecanakaH Atma-BAvaH-
   tenopasaṃkrāntā ye ceha trisāhasramahāsāhasre lokadhātau manuṣyās te pi	tena-upasaMkrAntAH ye ca-iha tri-sAhasra-mahA-sAhasre lokaDAtO manuzyAH te pi
   tan tathāgatasyāsecanakam ātmabhāvan dṛṣṭvā sthalajajalajāni puṣpāṇi	tat taTAgatasya-Asecanakam Atma-BAvan dRzwvA sTala-ja-jala-jAni puzpANi
   gṛhītvā yena sa tathāgatasyāsecanaka ātmabhāvas tenopasaṃkrāntāḥ // atha	gRhItvA yena sa taTAgatasya-AsecanakaH Atma-BAvaH tena-upasaMkrAntAH // aTa
   khalu te devās te ca manuṣyās tābhir divyābhiḥ	Kalu te devAH te ca manuzyAH tABiH divyABiH
   puṣpadhūpagandhamālyavilepanacūrṇacīvaracchatraddhvajapatākābhis te	puzpa-DUpa-ganDa-mAlya-vilepana-cUrNa-cIvara=-Catrat-Dvaja-patAkABiH te
   sthalajajalajaiḥ puṣpais tan tathāgatakāyam avakiranti smābhyavakiranti	sTala-ja-jala-jEH puzpEH tat taTAgata-kAyam avakiranti sma-aByavakiranti
   sma abhiprakiranti sma // atha khalu yais taiḥ	sma aBiprakiranti sma // aTa Kalu yEH tEH
   puṣpadhūpagandhamālyavilepanacūrṇacīvaracchatraddhvajapatākāvarṣaiḥ	puzpa-DUpa-ganDa-mAlya-vilepana-cUrNa-cIvara=-Catrat-Dvaja-patAkA-varzEH
   sthajajalajaiś ca puṣpair bhagavān avakīrṇas tāni sarvāny uparyantarīkṣe	sTaja-jala-jEH ca puzpEH BagavAn avakIrNaH tAni sarvAni upari-antarIkze
   bhagavato 'dhiṣṭhānena trisāhasramahāsāhasralokadhātupramāṇa ekaḥ	BagavataH aDizWAnena tri-sAhasra-mahA-sAhasra-loka-DAtu-pramANaH ekaH
   kūṭāgāraḥ saṃsthito bhūt* tataś ca kūṭāgārād divyāni puṣpapaṭṭadāmāni	kUwAgAraH saMsTitaH BUt* tatas ca kUwAgArAt divyAni puzpa-pawwa-dAmAni
   lambante sma pralambante sma abhipralambante sma taiś ca puṣpadāmabhiḥ	lambante sma pralambante sma aBipralambante sma tEH ca puzpa-dAmaBiH
   paṭṭadāmabhiś cāyan trisāhasramahāsāhasro lokadhātur atīva śobhate sma	pawwa-dAmaBiH ca-Ayan tri-sAhasra-mahA-sAhasraH lokaDAtuH atIva SoBate sma
   tena ca suvarṇavarṇena bhagavataḥ prabhāvabhāsena daśasu dikṣu pravisṛtena	tena ca suvarNa-varNena BagavataH praBAva-BAsena daSasu dikzu pravisRtena
   ekaikasyān diśi gaṅgānadīvālikopamā lokadhātavaḥ sphuṭā avabhāsitāś	ekEkasyAn diSi gaFgA-nadI-vAlikA-upamAH lokaDAtavaH sPuwAH avaBAsitAH-
   cābhūvan* asmiṃś ca trisāhasramahāsāhasre lokadhātau sarvacāturdvīpikeṣu	ca-aBUvan* asmin ca tri-sAhasra-mahA-sAhasre lokaDAtO sarva-cAturdvIpikezu
   lokadhātuṣu devamanuṣyānām* ekaikasyaitad abhūt* mama puratas tathāgato	lokaDAtuzu deva-manuzyAnAm* ekEkasya-etat aBUt* mama puratas taTAgataH-
   niṣiṇṇo dharman deśayati mama puratas tathāgato niṣiṇṇo dharman deśayatīti	niziNNaH Darman deSayati mama puratas taTAgataH niziNNaH Darman deSayati-iti
   // atha khalu bhagavāṃs tasminn eva siṃhāsane niṣaṇṇaḥ punar api smitam	// aTa Kalu BagavAn tasmin eva siMhAsane nizaNNaH punar api smitam
   akarot* yena smitāvabhāsenāyan trisāhasramahāsāhasro lokadhātuḥ sphuṭo	akarot* yena smita-avaBAsena-Ayan tri-sAhasra-mahA-sAhasraH lokaDAtuH sPuwaH-
   bhūt* yāvad daśasu dikṣu gaṅgānadīvālikopamā lokadhātavaḥ sphuṭā abhūvan*	BUt* yAvat daSasu dikzu gaFgA-nadI-vAlikA-upamAH lokaDAtavaH sPuwAH aBUvan*
   ye ceha trisāhasramahāsāhasre lokadhātau satvāḥ te pūrvasyān diśi	ye ca-iha tri-sAhasra-mahA-sAhasre lokaDAtO satvAH te pUrvasyAn diSi
   gaṅgānadīvālikopameṣu lokadhātuṣu buddhān bhagavataḥ paśyanti sma	gaFgA-nadI-vAlikA-upamezu lokaDAtuzu budDAn BagavataH paSyanti sma
   saśrāvakasaṃghāṃs tatra ca pūrvasyān diśi	sa-SrAvaka-saMGAn tatra ca pUrvasyAn diSi
   (PvSPL ki_a) gaṅgānadīvālikopameṣu lokadhātuṣu ye satvās te pīmāṃ sahāṃ	(PvSPL ki_a) gaFgA-nadI-vAlikA-upamezu lokaDAtuzu ye satvAH te pImAm sahAm
   lokadhātuṃ paśyanti sma śākyamuniñ ca tathāgataṃ sārdhaṃ bhikṣusaṃghena	lokaDAtum paSyanti sma SAkyamunin ca taTAgatam sArDam Bikzu-saMGena
   evan dakṣiṇasyān diśi paścimāyām uttarasyāṃ vidikṣv adha-ūrdhvandigbhāge	evan dakziNasyAn diSi paScimAyAm uttarasyAm vidikzu aDa-u-UrDvan-digBAge
   gaṅgānadīvālikopameṣu lokadhātuṣu buddhān bhagavantaḥ paśyanti sma	gaFgA-nadI-vAlikA-upamezu lokaDAtuzu budDAn BagavantaH paSyanti sma
   saśrāvakasaṃghāṃs teṣu ca lokadhātuṣu ye satvās te pīmāṃ sahāṃ lokadhātuṃ	sa-SrAvaka-saMGAn tezu ca lokaDAtuzu ye satvAH te pImAm sahAm lokaDAtum
   paśyanti sma śākyamuniñ ca tathāgataṃ sārdhaṃ bhikṣusaṃghena // atha khalu	paSyanti sma SAkyamunin ca taTAgatam sArDam Bikzu-saMGena // aTa Kalu
   pūrvasyān diśi gaṅgānadīvālikopamāl lokadhātūn atikramya tebhyo yā	pUrvasyAn diSi gaFgA-nadI-vAlikA-upamAt lokaDAtUn atikramya teByaH yA
   sarvapaścimā lokadhātū ratnāvatī nāma tatra ratnākaro nāma tathāgato 'rhan	sarva-paScimA lokaDAtuH ratnAvatI nAma tatra ratnAkaraH nAma taTAgataH arhan
   samyaksambuddhas tiṣṭhati dhriyate yāpayati sa imām eva prajñāpāramitāṃ	samyaksambudDaH tizWati Driyate yApayati saH imAm eva prajQApAramitAm
   bodhisatvānān deśayati atha tatra lokadhātau samantaraśmir nāma bodhisatvo	boDisatvAnAn deSayati aTa tatra lokaDAtO samantaraSmiH nAma boDisatvaH-
   mahāsatvas taṃ mahāntam avabhāsan dṛṣṭvā tañ ca mahāntaṃ pṛthivīcālan tañ	mahAsatvaH tam mahAntam avaBAsan dRzwvA taQ ca mahAntam pRTivI-cAlan taQ
   ca bhagavato secanakam atmabhāvan dṛṣṭvā yena sa bhagavān ratnākaras	ca BagavataH secanakam atma-BAvan dRzwvA yena sa BagavAn ratna-Akaras
   tathāgato 'rhan samyaksambuddhas tenopasaṃkrānta upasaṃkramya tasya	taTAgataH arhan samyaksambudDaH tena-upasaMkrAntaH upasaMkramya tasya
   bhagavataḥ pādāv abhivandya taṃ bhagavantaṃ ratnākaran tathāgatam etad	BagavataH pAdO aBivandya tam Bagavantam ratna-Akaran taTAgatam etat-
   avocat* ko bhagavan hetuḥ kaḥ pratyayo 'sya mahato 'vabhāsasya loke	avocat* kaH Bagavan hetuH kaH pratyayaH asya mahataH avaBAsasya loke
   prādurbhāvāyāsya ca mahataḥ pṛthivīcālasyāsya cāsecanakasya	prAdurBAvAya-asya ca mahataH pRTivI-cAlasya-asya ca-Asecanakasya
   tathāgatasyātmabhāvasya sandarśanāya // evam ukte sa bhagavān ratnākaras	taTAgatasya-Atma-BAvasya san-darSanAya // evam ukte sa BagavAn ratna-Akaras
   tathāgataḥ samantaraśmiṃ bodhisatvam etad avocat* asti kulaputretaḥ	taTAgataH samantaraSmim boDisatvam etat avocat* asti kula-putra-itas-
   paścime digbhāge gaṅgānadīvālikopamāl lokadhātūn atikramya sahā nāma	paScime digBAge gaFgA-nadI-vAlikA-upamAt lokaDAtUn atikramya sahA nAma
   lokadhātus tatra śākyamunir nāma tathāgato rhan samyaksambuddhas tiṣṭhati	lokaDAtuH tatra SAkyamuniH nAma taTAgataH rhan samyaksambudDaH tizWati
   dhriyate yāpayate sa bodhisatvānāṃ prajñāpāramitā saṃprakāśayati tasyām	Driyate yApayate sa boDisatvAnAm prajQApAramitA saMprakASayati tasyAm
   īdṛśo 'nubhāvaḥ // atha khalu samantaraśmir bodhisatvo ratnākaran	IdRSaH anuBAvaH // aTa Kalu samantaraSmiH boDisatvaH ratnAkaran
   tathāgatam etad avocat* gamiṣyāmy ahaṃ bhagavaṃs tāṃ sahāṃ lokadhātun taṃ	taTAgatam etat avocat* gamizyAmi aham Bagavan tAm sahAm lokaDAtun tam
   bhagavantaṃ śākyamunin tathāgatam arhantaṃ samyaksambuddhan darśanāya	Bagavantam SAkyamunin taTAgatam arhantam samyaksambudDan darSanAya
   vandanāya paryupāsanāya tāṃś ca bodhisatvān mahāsatvāṇ bhūyastvena	vandanAya paryupAsanAya tAn ca boDisatvAt mahAsatvAN BUyastvena
   kumārabhūtān dhāraṇīpratilabdhān samādhinirhārakuśalān	kumAra-BUtAn DAraNI-pratilabDAn samADi-nirhAra-kuSalAn
   sarvasamādhivaśipāraṅgatān darśanāya sa bhagavān āha gaccha tvaṃ kulaputra	sarva-samADi-vaSi-pAraFga-tAn darSanAya sa BagavAn Aha gacCa tvam kula-putra
   yasedānīṅ kālaṃ manyase // atha khalu ratnākaras tathāgato nānāratnamayāni	yasA-idAnIF kAlam manyase // aTa Kalu ratna-AkaraH taTAgataH nAnA-ratna-mayAni
   suvarṇanirbhāsāni sahasrapatrāṇi padmāni samantaraśmaye bodhisatvāya	suvarNa-nirBAsAni sahasra-patrANi padmAni samantaraSmaye boDisatvAya
   prādād evañ cāvādīd etais tvaṃ kulaputra padmais saparivāras taṃ	prAdAt evan ca-avAdIt etEH tvam kula-putra padmEH sa-parivAraH tam
   śākyamunin tathāgatam abhyavakireḥ evañ ca vadeḥ ratnākaro bhagavān*	SAkyamunin taTAgatam aByavakireH evan ca vadeH ratna-AkaraH BagavAn-*
   bhagavantam alpābādhatāṃ paripṛcchaty alpātaṃkatāṃ laghusamutthānatāṃ	Bagavantam alpa-AbADa-tAm paripRcCati alpAtaMka-tAm laGu-samutTAna-tAm
   (PvSPL ki_b) yātrāṃ balaṃ sukhasparśavihāratāṃ paripṛcchatīmāni ca tena	(PvSPL ki_b) yAtrAm balam suKa-sparSa-vihAra-tAm paripRcCati-imAni ca tena
   bhagavatā ratnākareṇa tathāgatenārhatā samyaksambuddhena nānāratnāmayāni	BagavatA ratna-AkareNa taTAgatena-arhatA samyaksambudDena nAnA-ratna-AmayAni
   suvarṇāvabhāsāni sahasrapatrāṇi padmāni prahitāni bhagavata iti	suvarNa-avaBAsAni sahasra-patrANi padmAni prahitAni BagavataH iti
   saṃprajānaṅkārī ca tvaṃ kulaputra tatra buddhakṣetre bhaves taṅ kasya	saMprajA-anaFkArI ca tvam kula-putra tatra budDa-kzetre BaveH taF kasya
   hetor durāsadā hi te kulaputra bodhisatvā ye tatra sahāyāṃ lokadhātāv	hetoH durAsadAH hi te kula-putra boDisatvAH ye tatra sahAyAm lokaDAtO=-
   upapannāḥ // atha khalu samantaraśmir bodhisatvas tasya ratnākarasya	upapannAH // aTa Kalu samantaraSmiH boDisatvaH tasya ratna-Akarasya
   tathāgatasya sakāśāt tāni nānāratnamayāni padmāni gṛhītvā suvarṇāvabhāsāni	taTAgatasya sakASAt tAni nAnA-ratna-mayAni padmAni gRhItvA suvarNa-avaBAsAni
   sahasrapatrāṇy anekair bodhisatvakoṭīnayutaśatasahasrair gṛhasthaiḥ	sahasra-patrANi anekEH boDisatva-kowIn-ayuta-Sata-sahasrEH gRhasTEH
   pravrajitair dārakair dārikābhiś ca parivṛtaḥ puraskṛtaḥ pūrvasyān diśi	pravrajitEH dArakEH dArikABiH ca parivRtaH puraskRtaH pUrvasyAn diSi
   teṣu gaṅgānadīvālikopameṣu buddhān bhagavatas satkurvan gurukurvan mānayan	tezu gaFgA-nadI-vAlikA-upamezu budDAn BagavataH satkurvan gurukurvan mAnayan
   pūjayan	pUjayan
   puṣpadhūpagandhamālyavilepanacūrṇacīvaracchatradhvajapatākāvaijayantībhir	puzpa-DUpa-ganDa-mAlya-vilepana-cUrNa-cIvara=-Catra-Dvaja-patAkA-vEjayantIBiH-
   yeneyaṃ sahā lokadhātus tena saṃprāptaḥ yena ca śākyamunis tathāgato 'rhan	yena-iyam sahA lokaDAtuH tena saMprAptaH yena ca SAkya-muniH taTAgataH arhan
   samyaksambuddhas tenopasaṃkrāmat upasaṃkramya bhagavataḥ pādau	samyaksambudDaH tena-upasaMkrAmat upasaMkramya BagavataH pAdO
   śirasābhivandyaikānte 'sthād ekānte sthitaś ca samantaraśmir bodhisatvo	SirasA-aBivandya-ekAnte asTAt ekAnte sTitaH ca samantaraSmiH boDisatvaH-
   bhagavantaṃ śākyamunin tathāgatam etad avocat* ratnākaro bhagavān	Bagavantam SAkyamunin taTAgatam etat avocat* ratna-AkaraH BagavAn
   bhagavantam alpābādhatāṃ paripṛcchaty alpātaṃkatāṃ laghūtthānatāṃ yātrāṃ	Bagavantam alpa-AbADa-tAm paripRcCati alpAtaMka-tAm laGu-utTAna-tAm yAtrAm
   balaṃ sukhasparśavihāratāñ ca paripṛcchatīmāni ca tena bhagavatā	balam suKa-sparSa-vihAra-tAn ca paripRcCati-imAni ca tena BagavatA
   ratnākareṇa tathāgatena nānāratnamayāni suvarṇanirbhāsāni sahasrapatrāṇi	ratna-AkareNa taTAgatena nAnA-ratna-mayAni suvarNa-nirBAsAni sahasra-patrANi
   padmāni prahitāni bhagavataḥ // atha khalu bhagavāñ cchākyamunis	padmAni prahitAni BagavataH // aTa Kalu BagavAn cSAkya-muni-s
   tathāgatas tāni padmāni gṛhītvā yena te pūrvasyān diśi gaṅgānadīvālikopamā	taTAgataH tAni padmAni gRhItvA yena te pUrvasyAn diSi gaFgA-nadI-vAlikA-upamA
   lokadhātavas tena prākṣipat taiś ca padmais te lokadhātavaḥ sphuṭā	lokaDAtavaH tena prAkzipat tEH ca padmEH te lokaDAtavaH sPuwA
   abhūvan* teṣu ca padmeṣu buddhavigrahā niṣaṇṇakās teṣu buddhakṣetreṣu	aBUvan* tezu ca padmezu budDa-vigrahAH nizaNNakAH tezu budDa-kzetrezu
   dharman deśayanti sma yad utemam eva prajñāpāramitāpratisaṃyuktaṃ yaiś ca	Darman deSayanti sma yat uta-imam eva prajQApAramitA-pratisaMyuktam yEH ca
   satvais sa dharmaś śrutas te sarve niyatā abhūvann anuttarāyāṃ	satvEH sa DarmaH SrutaH te sarve niyatAH aBUvan anuttarAyAm
   samyaksambodhau // atha khalu ye te bodhisatvā mahāsatvā gṛhasthāḥ	samyaksamboDO // aTa Kalu ye te boDisatvAH mahAsatvAH gRhasTAH
   pravrajitāś ca dārakā dārikāś ca tato ratnāvatyā lokadhātos samantaraśminā	pravrajitAH ca dArakAH dArikAH ca tatas ratnAvatyAH lokaDAtoH samantaraSminA
   bodhisatvena mahāsatvena sārdham āyātās te svakasvakaiḥ kuśalamūlair	boDisatvena mahAsatvena sArDam AyAtAH te sva-ka-svakEH kuSala-mUlEH-
   bhagavantaṃ śākyamuniṃ satkṛtya gurukṛtya saṃmānya saṃpūjya pādau	Bagavantam SAkya-munim satkRtya gurukRtya saMmAnya saMpUjya pAdO
   śirasābhivandyaikānte nyasīdan* ekāntaniṣannāś ca te gṛhasthās te ca	SirasA-aBivandya-ekAnte nyasIdan* ekAnta-nizannAH ca te gRhasTAH te ca
   pravrajitās te ca dārakās tāś ca dārikā bhagavantaṃ śākyamunin tathāgatam	pravrajitAH te ca dArakAH tAH ca dArikA Bagavantam SAkyamunin taTAgatam
   etad avocan* ratnākaro bhagavāṃs tathāgataḥ bhagavato 'lpabādhātāṃ	etat avocan* ratna-AkaraH BagavAn taTAgataH BagavataH alpa-bADAtAm
   paripṛcchaty alpātaṃkatāṃ laghusamutthānatāṃ yātrāṃ balaṃ	paripRcCati alpAtaMka-tAm laGu-samutTAna-tAm yAtrAm balam
   sukhasparśavihāratāñ ca paripṛcchati imāni ca tena bhagavatā ratnākareṇa	suKa-sparSa-vihAra-tAn ca paripRcCati imAni ca tena BagavatA ratna-AkareNa
   tathāgatena padmāni preṣitāni bhagavataḥ atha khalu bhagavāñ cchākyamunis	taTAgatena padmAni prezitAni BagavataH aTa Kalu BagavAn cSAkya-muni-s
   tathāgatas tāni padmā (PvSPL kham_a) manasikārād evaṃ hi śāriputra	taTAgataH tAni padmA (PvSPL Kam_a) manasikArAt evam hi SAriputra
   bodhisatvo mahāsatvaḥ prajñāpāramitāyāñ caran	boDisatvaH mahAsatvaH prajQApAramitAyAn caran
   pūrvanivāsānusmṛtyabhijñājñānasākṣātkriyā dānam abhinirharati sa divyena	pUrva-nivAsa-anusmRti-aBijQA-jQAna-sAkzAtkriyA dAnam aBinirharati sa divyena
   cakṣuṣā viśuddhenātikrāntamānuṣyakeṇa satvān paśyati cyavamānān	cakzuzA viSudDena-atikrAnta-mAnuzyakeNa satvAn paSyati cyavamAnAn
   upapadyamānān suvarṇān durvarṇān hīnān praṇītān sugatān durgatān	upapadyamAnAn suvarNAn durvarNAn hInAn praNItAn sugatAn durgatAn
   yathākarmopagān satvān yathābhūtaṃ prajānāty amī bhavantas satvāḥ	yaTA-karma-upagAn satvAn yaTABUtam prajAnAti amI BavantaH satvAH
   kāyaduścaritena samanvāgatā vāgduścaritena samanvāgatā manoduścaritena	kAya-duScaritena samanvAgatAH vAc-duScaritena samanvAgatAH manaH-duScaritena
   samanvāgatā āryāṇām apavādakā mithyādṛṣṭayas te	samanvAgatAH AryANAm apavAdakAH miTyA-dRzwayaH te
   mithyādṛṣṭikarmasamādānahetoḥ kāyasya bhedāt paraṃ maraṇād	miTyA-dRzwi-karma-sama-AdAna-hetoH kAyasya BedAt param maraNAt-
   apāyadurgativinipātan narakeṣūpapadyante amī punar bhavantas satvāḥ	apAya-durgati-vinipAtan narakezu-upapadyante amI punar BavantaH satvAH
   kāyasucaritena samanvāgatā vāksucaritena manaḥsucaritena samanvāgatā	kAya-su-caritena samanvAgatA vAc-su-caritena manaH-su-caritena samanvAgatA
   āryāṇām anapavādakās samyagdṛṣṭikās te samyagdṛṣṭikarmasamādānahetoḥ	AryANAm anapavAdakAH samyak-dRzwikAH te samyak-dRzwi-karma-samAdAna-hetoH
   kāyasya bhedāt paraṃ maraṇāt sugatau svargaloka upapadyanta iti divyena	kAyasya BedAt param maraNAt sugatO svarga-loke upapadyante iti divyena
   cakṣuṣā viśuddhenātikrāntamānuṣyakeṇa daśa diśi loke ākāśadhātuparyavasāne	cakzuzA viSudDena-atikrAnta-mAnuzyakeNa daSa diSi loke AkASa-DAtu-paryavasAne
   sarvalokadhātuṣu ṣaḍgatikānāṃ satvānāñ cyutopapādaṃ yathābhūtaṃ prajānāti	sarva-loka-DAtuzu zaxgatikAnAm satvAnAn cyuta-upapAdam yaTABUtam prajAnAti
   tena ca divyena cakṣuṣā na manyate tathā hi tac cakṣur acakṣur acintyatām	tena ca divyena cakzuzA na manyate taTA hi tat cakzuH acakzuH acintyatAm
   upādāya yo 'haṃ paśyāmīti na manyate sa tad eva cakṣur nopalabhate	upAdAya yaH aham paSyAmi-iti na manyate sa tat eva cakzuH na-upalaBate
   svabhāvaśūnyatām upādāya svabhāvaviviktatām upādāya svabhāvānutpattikām	svaBAva-SUnyatAm upAdAya svaBAva-vivikta-tAm upAdAya svaBAva-anutpattikAm
   upādāya sa divyacakṣuścetanām api notpādayati na	upAdAya sa divya-cakzuH-cetanAm api na-utpAdayati na
   divyacakṣurabhinirhāracetanām anyatra sarvākārajñatāmanasikārād evaṃ hi	divya-cakzuH-aBinirhAra-cetanAm anyatra sarva-AkAra-jQa-tA-manasikArAt evam hi
   śāriputra bodhisatvo mahāsatvaḥ prajñāpāramitāyāñ caran	SAriputra boDisatvaH mahAsatvaH prajQApAramitAyAn caran
   divyacakṣurabhijñāsākṣātkriyājñānam abhinirharati sa	divya-cakzuH-aBijQA-sAkzAt-kriyA-jQAnam aBinirharati sa
   āsravakṣayābhijñāsākṣātkriyājñānam abhinirharati na śrāvakabhūmiṃ vā	Asrava-kzaya-aBijQA-sAkzAt-kriyA-jQAnam aBinirharati na SrAvaka-BUmim vA
   pratyekabuddhabhūmiṃ vā patati nāpy anyaṅ kañcid dharmam āśaṃsamāno	pratyekabudDa-BUmim vA patati na-api anyaF kaQcid Darmam ASaMsamAnaH-
   'nyatrānuttarāṃ samyaksambodhim abhisambhotsyata iti sa tayā	anyatra-anuttarAm samyaksamboDim aBisamBotsyate iti sa tayA
   āsravakṣayasākṣātkriyābhijñājñānābhinirhārakuśalatayā na manyate tathā hi	Asrava-kzaya-sAkzAt-kriyA-aBijQA-jQAna-aBinirhAra-kuSala-tayA na manyate taTA hi
   taj jñānam ajñānam acintyatām upādāya so 'haṃ prajānāmīti na manyate sa	tat jQAnam ajQAnam acintyatAm upAdAya saH aham prajAnAmi-iti na manyate sa
   tad eva jñānan nopalabhate svabhāvaśūnyatām upādāya svabhāvaviviktatām	tat eva jQAnan na-upalaBate svaBAva-SUnyatAm upAdAya svaBAva-vivikta-tAm
   upādāya svabhāvopalabdhitām upādāya āsravakṣayajñānacetanām api notādayati	upAdAya svaBAva-upalabDi-tAm upAdAya Asrava-kzaya-jQAna-cetanAm api na-utAdayati
   nāsravakṣayasākṣātkriyābhijñājñānabhinirhāracetanām anyatra	na-Asrava-kzaya-sAkzAt-kriyA-aBijQA-jQA-anaBinirhAra-cetanAm anyatra
   sarvākārajñatāmanasikārād evaṃ hi śāriputra bodhisatvo mahāsatvaḥ	sarva-AkAra-jQa-tA-manasikArAt evam hi SAriputra boDisatvaH mahAsatvaH
   prajñāpāramitāyāñ caran nāśravakṣayasākṣātkriyābhijñājñānam abhinirharaty	prajQApAramitAyAn caran na-ASrava-kzaya-sAkzAt-kriyA-aBijQA-jQAnam aBinirharati-
   evaṃ punaś śāriputra bodhisatvasya mahāsatvasya prajñāpāramitāyāñ carataṣ	evam punar SAriputra boDisatvasya mahAsatvasya prajQApAramitAyAn carataz
   ṣaḍabhijnāḥ paripūrayante pariśuddhyanti cābhijñāḥ pariśuddhās	zaxaBijnAH paripUrayante pariSudDyanti ca-aBijQAH pariSudDA-as
   sarvākārajñatām asaṃyanti // santi śāriputra bodhisatvā mahāsatvā ye	sarva-AkAra-jQa-tAm asaMyanti // santi SAriputra boDisatvAH mahAsatvAH ye
   prajñāpāramitāyāñ caranto dānapāramitāyāṃ sthitvā sarvākārajñatāpanthānañ	prajQApAramitAyAn carantaH dAna-pAramitAyAm sTitvA sarva-AkAra-jQa-tA-panTAnaQ
   śodhanyanti atyantaśūnyatayā (PvSPL kham_b) anavagṛhītatām upādāya //	SoDanyanti atyanta-SUnya-tayA (PvSPL Kam_b) anavagRhIta-tAm upAdAya //
   santi śāriputra bodhisatvā mahāsatvā ye prajñāpāramitāyāñ carantaś	santi SAriputra boDisatvAH mahAsatvAH ye prajQApAramitAyAn carantaS
   śīlapāramitāyāṃ sthitvā sarvākārajñatāpanthānañ śodhayanti	SIla-pAramitAyAm sTitvA sarva-AkAra-jQa-tA-panTAnan SoDayanti
   atyantaśūnyatayā anaddhyāpattitām upādāya // santi śāriputra bodhisatvā	atyanta-SUnya-tayA anadDi-Apatti-tAm upAdAya // santi SAriputra boDisatvA
   mahāsatvā ye prajñāpāramitāyāñ carantaḥ kṣāntipāramitāyāṃ sthitvā	mahAsatvAH ye prajQApAramitAyAn carantaH kzAnti-pAramitAyAm sTitvA
   sarvākārajñatāpanthānañ śodhayanti atyantaśūnyatayā akṣobhaṇatām upādāya	sarva-AkAra-jQa-tA-panTAnan SoDayanti atyanta-SUnya-tayA akzoBaNa-tAm upAdAya
   // santi śāriputra bodhisatvā mahāsatvā ye prajñāpāramitāyāñ caranto	// santi SAriputra boDisatvAH mahAsatvAH ye prajQApAramitAyAn carantaH-
   vīryapāramitāyāṃ sthitvā sarvākārajñatāpanthānañ śodhayanti	vIrya-pAramitAyAm sTitvA sarva-AkAra-jQa-tA-panTAnan SoDayanti
   atyantaśūnyatayā kāyikacaitasikavīryāsraṃsanatām upādāya // santi	atyanta-SUnya-tayA kAyika-cEtasika-vIrya-AsraMsana-tAm upAdAya // santi
   śāriputra bodhisatvā mahāsatvā ye prajñāpāramitāyāñ caranto	SAriputra boDisatvAH mahAsatvAH ye prajQApAramitAyAn carantaH-
   dhyānapāramitāyāṃ sthitvā sarvākārajñatāpanthānañ śodhayanti	DyAna-pAramitAyAm sTitvA sarva-AkAra-jQa-tA-panTAnan SoDayanti
   atyantaśūnyatayā avikṣiptacittām upādāya // santi śāriputrā bodhisatvā	atyanta-SUnya-tayA avikzipta-cittAm upAdAya // santi SAriputrA boDisatvA
   mahāsatvā ye prajñāpāramitāyāñ carantas sarvākārajñatāpanthānañ śodhayanti	mahAsatvAH ye prajQApAramitAyAn carantaH sarva-AkAra-jQa-tA-panTAnan SoDayanti
   dauṣprajñyacittaparivarjanatām upādāya evaṅ khalu śāriputra bodhisatvā	dOzprajQya-citta-parivarjana-tAm upAdAya evaF Kalu SAriputra boDisatvA
   mahāsatvāṣ ṣaṭsu pāramitāsu sthitvā sarvākārajñatāpanthānañ śodhayanti	mahAsatvAH zawsu pAramitAsu sTitvA sarva-AkAra-jQa-tA-panTAnan SoDayanti
   atyantaśūnyatayā agamanānāgamanatām upādāyāparigrahatām upādāya tat kasya	atyanta-SUnya-tayA agamana-anAgamana-tAm upAdAya-aparigraha-tAm upAdAya tat kasya
   hetor dānam āgraham upādāya prajñapyate śīlan dauḥśīlyatām upādāya kṣāntir	hetoH dAnam Agraham upAdAya prajQapyate SIlan dOHSIlya-tAm upAdAya kzAntiH-
   akṣāntim upādāya vīryaṅ kausīdyam upādāya samādhir asamāhitatām upādāya	akzAntim upAdAya vIryaF kOsIdyam upAdAya samADiH asamAhita-tAm upAdAya
   prajñā dauṣprajñyam upādāya prajñapyate sa tīrṇa iti na manyate atīrṇa iti	prajQA dOzprajQyam upAdAya prajQapyate sa tIrNaH iti na manyate atIrNaH iti
   na manyate dānaṃ mātsaryam iti na manyate śīlan dauḥśīlyam iti kṣāntiḥ	na manyate dAnam mAtsaryam iti na manyate SIlan dOHSIlyam iti kzAntiH
   kṣobha iti vīryaṃ kausīdyam iti samādhir asamāhitateti prajñā	kzoBaH iti vIryam kOsIdyam iti samADiH asamAhita-tA-iti prajQA
   duṣprajñateti na manyate vindako 'ham iti na manyate satkṛta iti na	duzprajQa-tA-iti na manyate vindakaH aham iti na manyate satkRtaH iti na
   manyate asatkṛta iti na manyate tat kasya hetor na hi śāriputrānutpāda	manyate asatkRtaH iti na manyate tat kasya hetoH na hi SAriputrAn-utpAda
   ākṛṣṭo 'ham iti manyate na vandito 'ham iti na satkṛto 'ham iti nāsatkṛto	AkRzwaH aham iti manyate na vanditaH aham iti na satkRtaH aham iti na-asatkRtaH-
   'ham iti manyate tat kasya hetos tathā hi prajñāpāramitā sarvamanyanās	aham iti manyate tat kasya hetoH taTA hi prajQApAramitA sarvam-anyanAH-
   samucchinattīha śāriputra prajñāpāramitāyāñ carato bodhisatvasya	samucCinatti-iha SAriputra prajQApAramitAyAn carataH boDisatvasya
   mahāsatvasya ye guṇā bhavanti na te śrāvakapratyekabuddhānāṃ saṃvidyante	mahAsatvasya ye guNAH Bavanti na te SrAvaka-pratyekabudDAnAm saMvidyante
   // imān guṇān paripūrayan satvānś ca paribhāvayati buddhakṣetrāñ ca	// imAn guNAn paripUrayan satvAnH ca pariBAvayati budDa-kzetrAn ca
   pariśodhayati sarvākārajñatāñ cānuprāpnoti // punar aparañ śāriputra	pariSoDayati sarva-AkAra-jQa-tAn ca-anuprApnoti // punar aparan SAriputra
   bodhisatvo mahāsatvaḥ prajñāpāramitāyāñ caran sarvasatvānām antike	boDisatvaH mahAsatvaH prajQApAramitAyAn caran sarva-satvAnAm antike
   samacittatām utpādayati sarvasatvānām antike samacittatām utpādya	sama-citta-tAm utpAdayati sarva-satvAnAm antike sama-citta-tAm utpAdya
   sarvadharmasamatāṃ pratilabhate sarvadharmasamatāṃ pratilabhya tasyāṃ	sarva-Darma-sama-tAm pratilaBate sarva-Darma-sama-tAm pratilaBya tasyAm
   sarvadharmasamatāyāṃ sarvasatvān pratiṣṭhāpayati sa dṛṣṭa eva dharme	sarva-Darma-samatAyAm sarva-satvAn pratizWApayati sa dRzwaH eva Darme
   buddhānāṃ bhagavatāṃ priyo bhavati manaāpaś ca sarvabodhisatvānāṃ	budDAnAm BagavatAm priyaH Bavati manaApaH ca sarva-boDisatvAnAm
   sarvaśrāvakāṇāṃ sarvapratyekabuddhānāñ ca priyo bhavati manaāpaś ca sa	sarva-SrAvakANAm sarva-pratyekabudDAnAn ca priyaH Bavati manaApaH ca sa
   yatra (PvSPL khaḥ_a) yatropapadyate tatra tatra na jātu cakṣuṣāmanaāpāni	yatra (PvSPL KaH_a) yatra-upapadyate tatra tatra na jAtu cakzuzAm-anaApAni
   rūpāṇi paśyati na śrotreṇāmanaāpāñ cchabdāñ cchṛṇoti na ghrāṇenāmanaāpān	rUpANi paSyati na SrotreNa-Am-anaApAn cSabdAn cSRNoti na GrANena-Am-anaApAn
   gandhāñ jighrati na jihvayāmanaāpān rasān āsvādayati na kāyenāmanaāpān	ganDAn jiGrati na jihvayAm-anaApAn rasAn AsvAdayati na kAyena-Am-anaApAn
   sparśān spṛśati na manasāmanaāpān dharmān vijānāti na ca parihīyate	sparSAn spRSati na manasAm-anaApAn DarmAn vijAnAti na ca parihIyate
   sarvakārajñatāyāḥ // asmin khalu punaḥ prajñāpāramitānirdeśe nirdiśyamāne	sarva-kAra-jQa-tAyAH // asmin Kalu punar prajQApAramitA-nirdeSe nirdiSyamAne
   tataḥ parṣadas trīṇi bhikṣuśatāni bhagavantaṃ yathāprāvṛtaiś cīvarair	tatas parzadaH trINi Bikzu-SatAni Bagavantam yaTA-prAvRtEH cIvarEH-
   abhicchādayāmāsur anuttarāyāñ ca samyaksambodhau cittāny utpādayāmāsuḥ //	aBicCAdayAmAsuH anuttarAyAn ca samyaksamboDO cittAni utpAdayAmAsuH //
   atha khalu bhagavān smitam akarot* // atha khalv āyuṣmān ānanda	aTa Kalu BagavAn smitam akarot* // aTa Kalu AyuzmAn Ananda
   utthāyāsanād ekāṃsam uttarāsaṅgaṃ kṛtvā dakṣiṇañ jānumaṇḍalaṃ pṛthivyāṃ	utTAya-AsanAt eka-aMsam uttarAsaFgam kRtvA dakziNan jAnu-maNxalam pRTivyAm
   pratisthāpya yena bhagavāṃs tenāñjaliṃ praṇamya bhagavantam etad avocat ko	pratisTApya yena BagavAn tena-aQjalim praNamya Bagavantam etat avocat kaH-
   bhagavan hetuḥ kaḥ pratyayaḥ smitasya prāviṣkaraṇāya nāhetukān nāpratyayaṃ	Bagavan hetuH kaH pratyayaH smitasya prAvizkaraNAya na-ahetukAn na-apratyayam
   buddhā bhagavanta smitaṃ prāviṣkurvanti // bhagavān āha etāny ānanda trīṇi	budDAH Bagavanta smitam prAvizkurvanti // BagavAn Aha etAni Ananda trINi
   bhikṣuśatāny ekaṣaṣṭitame kalpe mahāketunāmānas tathāgatā arhantas	Bikzu-SatAni eka-zazwitame kalpe mahA-ketu-nAmAnaH taTAgatAH arhantas
   samyaksambuddhā loka utpatsyante tārakopame kalpe itaś cyutās santaḥ	samyaksambudDAH loke utpatsyante tAraka-upame kalpe itas cyutAH santaH
   akṣobḥyasya tathāgatasyārhatas samyaksambuddhasya buddhakṣetra	akzobHyasya taTAgatasya-arhataH samyaksambudDasya budDa-kzetra
   upapatsyante abhiratyāṃ lokadhātau ṣaṣṭiś ca devaputrasahasrāś cāsyāṃ	upapatsyante aBiratyAm lokaDAtO zazwiH ca deva-putra-sahasrAH ca-asyAm
   parṣady anayā dharmadeśanayā paripācitāni maitreyasya tathāgatasyārhatas	parzadI anayA Darma-deSanayA paripAcitAni mEtreyasya taTAgatasya-arhatas
   samyaksambuddhasyāntike parinirvāsyanti // atha khalu tasyāṃ velāyāṃ	samyaksambudDasya-antike parinirvAsyanti // aTa Kalu tasyAm velAyAm
   bhagavataś śākyamuneḥ parṣanmaṇḍalāc catasraḥ parṣado bhagavato 'nubhāvena	BagavataH SAkyamuneH parzad-maNxalAt catasraH parzadaH BagavataH anuBAvena
   pūrvasyān diśi buddhasahasraṃ paśyanti sma mahatā buddhakṣetraguṇavyūhān	pUrvasyAn diSi budDa-sahasram paSyanti sma mahatA budDa-kzetra-guNa-vyUhAn
   evan dakṣiṇasyān diśi paścimāyām uttarasyām uttarapūrvāyāṃ pūrvadakṣiṇāyān	evan dakziNasyAn diSi paScimAyAm uttarasyAm uttara-pUrvAyAm pUrva-dakziNAyAn
   dakṣiṇapaścimāyāṃ paścimottarāyām adha-ūrdhvam ekaikasyān diśi	dakziNa-paScimAyAm paScima-uttarAyAm aDa-u-UrDvam ekEkasyAn diSi
   buddhasahasraṃ buddhasahasraṃ paśyanti sma mahatā buddhakṣetraguṇavyūhena	budDa-sahasram budDa-sahasram paSyanti sma mahatA budDa-kzetra-guNa-vyUhena
   na ceha sahāyāṃ lokadhātau tān buddhakṣetraguṇavyūhān paśyanti yān daśasu	na ca-iha sahAyAm lokaDAtO tAn budDa-kzetra-guNa-vyUhAn paSyanti yAn daSasu
   dikṣu teṣāṃ buddhānāṃ bhagavatām // atha khalu bhagavataś śākyamuneḥ	dikzu tezAm budDAnAm BagavatAm // aTa Kalu BagavataH SAkyamuneH
   parṣanmaṇḍalād daśabhiḥ prāṇisahasraiḥ praṇidhānāni kṛtāni vayaṃ bhagavaṃs	parzad-maNxalAt daSaBiH prANi-sahasrEH praNiDAnAni kRtAni vayam Bagavan=-
   tāni puṇyāni kariṣyāmo yaiḥ puṇyair eteṣu buddhakṣetreṣūpapatsyāmahaṃ iti	tAni puNyAni karizyAmaH yEH puNyEH etezu budDa-kzetrezu-upapatsyAm-aham iti
   // atha khalu bhagavāṃs teṣāṃ kulaputrāṇām āśayaṃ viditvā tasyāṃ velāyāṃ	// aTa Kalu BagavAn tezAm kula-putrANAm ASayam viditvA tasyAm velAyAm
   smitam akarot* ānanda āha ko bhagavan hetuḥ kaḥ pratyayas smitasya	smitam akarot* AnandaH Aha kaH Bagavan hetuH kaH pratyayaH smitasya
   prāviṣkaraṇāya nāhetukan nāpratyayaṃ buddhā bhagavantaḥ smitam	prAvizkaraNAya na-ahetukan na-apratyayam budDAH BagavantaH smitam
   āviṣkurvanti // bhagavān āha paśyasi tvam ānandemāni daśa prāṇisahasrāṇi	Avizkurvanti // BagavAn Aha paSyasi tvam Ananda-imAni daSa prANi-sahasrANi
   ānanda āha paśyāmi bhagavan bhagavān āha etāny ānanda daśa	AnandaH Aha paSyAmi Bagavan BagavAn Aha etAni Ananda daSa
   prāṇisahasrāṇītaś cyutāni daśasu dikṣv eteṣu buddhakṣetreṣūpapatsyante na	prANi-sahasrANi-itas cyutAni daSasu dikzu etezu budDa-kzetrezu-upapatsyante na
   ca kadācit tathāgatavirahitā bhaviṣyanti tataḥ paścād vyūharājanāmānas	ca kadAcid taTAgata-virahitAH Bavizyanti tatas paScAt vyUha-rAja-nAmAnas
   tathāgatā arhantas samyaksaṃbuddhā loka utpatsyante // atha khalu āyuṣmāñ	taTAgatAH arhantaH samyaksaMbudDAH loke utpatsyante // aTa Kalu AyuzmAn-
   cchāriputra (PvSPL khaḥ_b) āyuṣmāñ ca mahāmaudgalyāyana āyuṣmāñ ca	cCAriputra (PvSPL KaH_b) AyuzmAn ca mahAmOdgalyAyanaH AyuzmAn ca
   subhūtir āyuṣmāñ ca pūrṇo maitrāyaṇīputra āyuṣmāñ ca mahākāśyapa ete cānye	suBUtiH AyuzmAn ca pUrNaH mEtrAyaNI-putraH AyuzmAn ca mahAkASyape ete ca-anye
   ca sambahulā abhijñātābhijñātā bhikṣavo bodhisatvāś ca mahāsatvā	ca sambahulAH aBijQAta-aBijQAtAH BikzavaH boDisatvAH ca mahAsatvA
   bhikṣubhikṣuṇyupāsakopāsikāś ca bhagavantam etad avocan mahāpāramiteyaṃ	Bikzu-Bi-kzuNI-upAsa-kopAsikAH ca Bagavantam etat avocat mahA-pAramitA-iyam
   bhagavann udārapāramiteyaṃ bodhisatvānāṃ mahāsatvānān yad uta	Bagavan udAra-pAramitA-iyam boDisatvAnAm mahA-satvAnAn yat uta
   prajñāpāramitā agrapāramiteyaṃ viśiṣṭapāramiteyaṃ parapāramiteyaṃ	prajQApAramitA agra-pAramitA-iyam viSizwa-pAramitA-iyam para-pAramitA-iyam
   pravarapāramiteyaṃ praṇītapāramiteyam anuttarapāramiteyan	pravara-pAramitA-iyam praNIta-pAramitA-iyam anuttara-pAramitA-iyan
   niruttarapāramiteyam asamapāramiteyam asamasamapāramiteyam	niruttara-pAramitA-iyam asama-pAramitA-iyam asama-sama-pAramitA-iyam
   ākāśapāramiteyaṃ svalakṣanaśūnyatāpāramiteyaṃ	AkASa-pAramitA-iyam sva-lakzana-SUnyatA-pAramitA-iyam
   sarvaguṇasamanvāgatapāramiteyaṃ sarvaśūnyatāsamanvāgatapāramiteyam	sarva-guNa-samanvAgata-pAramitA-iyam sarva-SUnyatA-samanvAgata-pAramitA-iyam
   anamṛdyapāramiteyaṃ bhagavan bodhisatvānāṃ mahāsatvānāṃ yad uta	anamRdya-pAramitA-iyam Bagavan boDisatvAnAm mahAsatvAnAm yat uta
   prajñāpāramitā atra hi bhagavan prajñāpāramitāyāñ caradbhir bodhisatvair	prajQApAramitA atra hi Bagavan prajQApAramitAyAn caradBiH boDisatvEH-
   mahāsatvair asamasaman dānan dattan tair asamasamā dānapāramitā paripūritā	mahAsatvEH asamasaman dAnan dattan tEH asamasamA dAna-pAramitA paripUritA
   tair asamasama ātmabhāvapratilabdhaye samasamasya dharmasya lābhino	tEH asamasamaH Atma-BAva-pratilabDaye sama-samasya Darmasya lABinaH-
   bhaviṣyanti yad utānuttarāyās samyaksambodheḥ // evam asamasamaṃ śīlaṃ	Bavizyanti yat uta-anuttarAyAH samyaksamboDeH // evam asama-samam SIlam
   kṣāntir vīryan dhyānam asamasamā prajñā bhāvitā tair asamasamā	kzAntiH vIryan DyAnam asamasamA prajQA BAvitA tEH asamasamA
   prajñāpāramitā paripūritā tair asamasama ātmabhāvaḥ pratilabdhas te	prajQApAramitA paripUritA tEH asamasamaH Atma-BAvaH pratilabDaH te
   samasamasya dharmasya lābhino bhaviṣyanti yadutānuttarāyās samyaksambodher	sama-samasya Darmasya lABinaH Bavizyanti yat-uta-anuttarAyAH samyaksamboDeH-
   atraive ca tvaṃ bhagavan prajñāpāramitāyāñ carann asamasamasya rūpasya	atra-eve ca tvam Bagavan prajQApAramitAyAn caran asamasamasya rUpasya
   lābhī jātaḥ asamasamāyā vedanāyās saṃjñāyās saṃskārāṇām asamasamasya	lABI jAtaH asamasamAyAH vedanAyAH saMjQAyAH saMskArANAm asamasamasya
   vijñānasya lābhī jātaḥ asamasamāṃ bodhim abhisambuddho samasaman	vijQAnasya lABI jAtaH asamasamAm boDim aBisambudDaH sama-saman
   dharmacakraṃ pravartitavān evam atītānāgatapratyutpannā buddhā bhagavanto	Darma-cakram pravartitavAn evam atIta-anAgata-pratyutpannAH budDAH BagavantaH-
   'traiva prajñāpāramitāyāñ caranto 'nuttarāṃ samyaksambodhim abhisambuddhā	atra-eva prajQApAramitAyAn carantaH anuttarAm samyaksamboDim aBisambudDA
   abhisambuddhyante abhisaṃbhotsyante ca tasmāt tarhi bhagavan	aBisambudDi-ante aBisaMBotsyante ca tasmAt tarhi Bagavan
   sarvadharmāṇāṃ pāraṅgantukāmena bodhisatvena mahāsatvena prajñāpāramitāyāṃ	sarva-DarmANAm pAraFgantu-kAmena boDisatvena mahAsatvena prajQApAramitAyAm
   yogaṅkaraṇīyo namaskaraṇīyās te bhagavaṃ bodhisatvā mahāsatvās	yogaFkaraNIyaH namaskaraNIyAH te Bagavam boDisatvA mahAsatva-as
   sadevamānuṣāsureṇa lokena ye 'syāṃ prajñāpāramitāyāñ caranti // evam ukte	sa-deva-mAnuza-asureNa lokena ye asyAm prajQApAramitAyAn caranti // evam ukte
   bhagavāṃs tān sambahulān mahāśrāvakāṃs tāṃś ca bodhisatvān mahāsatvān etad	BagavAn tAn sambahulAn mahA-SrAvakAn tAn ca boDisatvAt mahAsatvAn etat-
   avocad evam etat kulaputrā evam etan namaskaranīyās te bodhisatvā	avocat evam etat kula-putrAH evam etat namaskaranIyAH te boDisatvA
   mahāsatvās sadevamānuṣāsureṇa lokena ye 'syāṃ prajñāpāramitāyāñ caranti //	mahAsatvAH sa-deva-mAnuza-asureNa lokena ye asyAm prajQApAramitAyAn caranti //
   tat kasya hetor bodhisatvam* kulaputrā mahāsatvam āgamya manuṣyalokasya	tat kasya hetoH boDisatvam* kula-putrAH mahAsatvam Agamya manuzya-lokasya
   loke prādurbhāvo bhavaty evan devalokasya kṣatriyamahāsālakulānāṃ	loke prAdurBAvaH Bavati evan deva-lokasya kzatriya-mahA-sAla-kulAnAm
   brāhmaṇamahāsālakulānān gṛhapatimahāsālakulānāṃ rājñāñ cakravartināñ	brAhmaNa-mahA-sAla-kulAnAn gRhapati-mahA-sAla-kulAnAm rAjQAn cakravartinAQ
   cāturmahārājikānān devānān trāyastriṅśānāṃ yāmānān tuṣitānān	cAturmahArAjikAnAn devAnAn trAyaH-triFSAnAm yAmAnAn tuzitAnAn
   nirmāṇaratīnāṃ paranirmitavaśavartināṃ brahmakāyikānāṃ brahmapurohitānāṃ	nirmANa-ratInAm paranirmita-vaSavartinAm brahmakAyikAnAm brahma-purohitAnAm
   brahmapārṣadyānāṃ mahābrahmaṇāṃ parīttābhānām apramāṇābhānām ābhāsvarāṇāṃ	brahmapArzadyAnAm mahA-brahmaNAm parItta-ABAnAm apramANa-ABAnAm ABAsvarANAm
   parīttaśubhānām (PvSPL ga_a) apramāṇaśubhānāṃ śubhakṛtsnānāṃ bṛhatphalānām	parIttaSuBAnAm (PvSPL ga_a) apramANa-SuBAnAm SuBa-kRtsnAnAm bRhat-PalAnAm
   asaṃjñisatvānāṃ śuddhāvāsānāṃ sudṛśānāṃ sudarśanānām aspṛhāṇām atapānām	asaMjQi-satvAnAm SudDAvAsAnAm sudRSAnAm sudarSanAnAm aspRhANAm atapAnAm
   akaniṣṭhānāñ cākāśānantyāyatanopagānāṃ vijñānānantyāyatanopagānām	aka-nizWAnAn ca-AkASa-Anantya-Ayatana-upagAnAm vijQAna-Ananti-Ayatana-upagAnAm
   ākiñcanyāyatanopagānān naivasaṃjñānāsaṃjñāyatanopagānān devānāṃ loke	AkiQcanyAyatana-upagAnAt na-eva-saMjQAna-asaMjQA-Ayatana-upagAnAn devAnAm loke
   prādurbhāvo bhavati srotaāpannānāṃ sakṛdāgāminām anāgāminām arhataṃ	prAdurBAvaH Bavati srotaApannAnAm sakRdAgAminAm anAgAminAm arhatam
   pratyekabuddhānāṃ bodhisatvānāṃ mahāsatvānān tathāgatānām arhatāṃ	pratyekabudDAnAm boDisatvAnAm mahA-satvAnAn taTAgatAnAm arhatAm
   samyaksambuddhānāṃ loke prādurbhāvo bhavati bodhisatvaṃ mahāsatvam āgamya	samyaksambudDAnAm loke prAdurBAvaH Bavati boDisatvam mahA-satvam Agamya
   trayāṇāṃ ratnānāṃ yad idaṃ buddharatnasya dharmaratnasya saṃgharatnasya	trayANAm ratnAnAm yat idam budDa-ratnasya Darma-ratnasya saMGa-ratnasya
   loke prādurbhāvo bhavati bodhisatvaṃ mahāsatvam āgamya sarveṣāṃ laukikānāñ	loke prAdurBAvaH Bavati boDisatvam mahA-satvam Agamya sarvezAm lOkikAnAn-
   jīvitopakaraṇānām	jIvita-upakaraNAnAm
   annapānavastrayānaśayyāsanaglānapratyayabhaiṣajyapariskārāṇāṃ	anna-pAna-vastra-yAna-SayyA-Asana-glAna-pratyaya-BEzajya-pariskArANAm
   maṇimuktāvaiḍūryaśaṃkhaśilāpravāḷajātarūparajatānāṃ loke prādurbhāvo	maNi-muktA-vExUrya-SaMKa-SilA-pravA?a-jAtarUpa-rajatAnAm loke prAdurBAvaH-
   bhavati yāvat kulaputrās sarvasukhopadhānānān divyānāṃ mānuṣyakāṇāñ ca	Bavati yAvat kula-putrAH sarva-suKa-upaDAnAnAn divyAnAm mAnuzya-kANAn ca
   bhavasukhānān nirvāṇasukhānāñ ca loke prādurbhāvo bhavati sarvas sa	Bava-suKAnAn nirvANa-suKAnAn ca loke prAdurBAvaH Bavati sarvas sa
   kulaputrā bodhisatvaṃ mahāsatvam āgamya tat kasya hetos tathā hi kulaputrā	kula-putrAH boDisatvam mahA-satvam Agamya tat kasya hetoH taTA hi kula-putrA
   bodhisatvo mahāsatvaḥ prajñāpāramitāyāñ caran satvān* ṣaṭsu pāramitāsu	boDisatvaH mahAsatvaH prajQApAramitAyAn caran satvAn* zawsu pAramitAsu
   niyojayati dānan dāpayati śīle niyuṅkte kṣāntau pratiṣṭhāpayati vīrye	niyojayati dAnan dApayati SIle niyuFkte kzAntO pratizWApayati vIrye
   niyojayati dhyāne pratiṣṭhāpayati prajñāyāṃ niyojayati bodhisatvaṃ	niyojayati DyAne pratizWApayati prajQAyAm niyojayati boDisatvam
   mahāsatvam āgamya satvā dānapāramitāyāṃ yāvat prajñāpāramitāyāñ caranti te	mahAsatvam Agamya satvAH dAna-pAramitAyAm yAvat prajQApAramitAyAn caranti te
   dānapāramitāyāṃ yāvat prajñāpāramitāyāñ carantas sarvalaukikalokottarās	dAna-pAramitAyAm yAvat prajQApAramitAyAn carantaH sarva-lOkika-loka-uttarAs
   saṃpattīr anuprāpnuvanti tasmāt tarhi kulaputrā bodhisatvo mahāsatvas	saMpattIH anuprApnuvanti tasmAt tarhi kula-putrAH boDisatvaH mahAsatva-s
   sarvasatvānāṃ hitasukhāya pratipanno bhavati // atha khalu bhagavāṃs	sarva-satvAnAm hita-suKAya pratipannaH Bavati // aTa Kalu BagavAn=-
   tasyāṃ velāyāñ jihvendriyaṃ mūkhān nirṇāmyemān trisāhasramahāsāhasraṃ	tasyAm velAyAn jihvA-indriyam mUKAn nirNAmya-imAn tri-sAhasra-mahA-sAhasram
   lokadhātuñ jihvendriyeṇācchādayāmāsa atha khalu tato jihvendriyād	lokaDAtun jihvA-indriyeNa-AcCAdayAmAsa aTa Kalu tatas jihvA-indriyAt-
   anekavarṇā nānānvarṇā arciso niścārya pūrvasyān diśi gaṅgānadīvālikopamāl	aneka-varNAH nAnAnvarNAH arcisaH niScArya pUrvasyAn diSi gaFgA-nadI-vAlikA-upamAl
   lokadhātūn avabhāsayamāsuḥ evan dakṣiṇasyāṃ paścimāyām uttarasyāṃ pi dikṣv	lokaDAtUn avaBAsayamAsuH evan dakziNasyAm paScimAyAm uttarasyAm pi dikzu-
   adha-ūrdhvāyān diśi gaṅgānadīvālikopamāl lokadhātūn avabhāsayāmāsuḥ //	aDa-u-UrDvAyAn diSi gaFgA-nadI-vAlikA-upamAt lokaDAtUn avaBAsayAmAsuH //
   atha khalu pūrvasyān diśi gaṅgānadīvālikopameṣu lokadhātuṣv	aTa Kalu pUrvasyAn diSi gaFgA-nadI-vAlikA-upamezu lokaDAtuzu-
   aprameyāsaṃkhyeyā bodhisatvā mahāsatvās taṃ prabhāvyūhan dṛṣṭvā	aprameya-asaMKyeyAH boDisatvAH mahAsatvAH tam praBAvi-Uhan dRzwvA
   svakasvasvakeṣu buddhakṣetreṣu buddhān bhagavataḥ paripṛcchanti sma	sva-ka-sva-svakezu budDa-kzetrezu budDAn BagavataH paripRcCanti sma
   kasyāyaṃ bhagavann anubhāvo yenāyam evaṃrūpaḥ prabhāvabhāsas sandṛśyante	kasya-ayam Bagavan anuBAvaH yena-ayam evaMrUpaH praBAva-BAsaH sandRSyante
   te buddhā bhagavantas tān bodhisatvān mahāsatvān evam āhuḥ eṣa kulaputrāḥ	te budDAH BagavantaH tAn boDisatvAt mahAsatvAn evam AhuH eza kula-putrAH
   paścime digbhāge sahāyāṃ lokadhātau śākyamunir nāma tahāgato 'rhan	paScime diS-BAge sahAyAm lokaDAtO SAkyamuniH nAma tahA-gataH arhan
   samyaksambuddhas tena jihvendriyaṃ mukhān nirṇāmya daśasu dikṣu	samyaksambudDaH tena jihvA-indriyam muKAt nirNAmya daSasu dikzu
   gaṅgānadīvālikopamā lokadhātavo mahatāvabhāsena (PvSPL ga_b) sphuṭīkṛtā	gaFgA-nadI-vAlikA-upamA lokaDAtavaH mahatA-avaBAsena (PvSPL ga_b) sPuwIkRtA
   yad uta bodhisatvānāṃ mahāsatvānāṃ prajñāpāramitādeśanāya saṃprakāśanāya	yat uta boDisatvAnAm mahAsatvAnAm prajQApAramitA-deSanAya saMprakASanAya
   te bodhisatvā mahāsatvās tāṃs tathāgatān evam āhur gamiṣyāmo vayaṃ	te boDisatvAH mahAsatvAH tAn taTAgatAn evam AhuH gamizyAmaH vayam
   bhagavaṃs tāṃ sahāṃ lokadhātun taṃ bhagavantaṃ śākyamunin tathāgatam	Bagavan tAm sahAm lokaDAtun tam Bagavantam SAkyamunin taTAgatam
   arhantaṃ samyaksambuddhan darśanāya vandanāya paryupāsanāya tāṃś ca	arhantam samyaksambudDan darSanAya vandanAya paryupAsanAya tAn ca
   daśadiksannipatitān bodhisatvān mahāsatvān darśanāya tāñ ca	daSa-diS-sannipatitAn boDisatvAt mahAsatvAn darSanAya tAn ca
   prajñāpāramitāṃ śravaṇāya te buddhā bhagavanta evam āhur yasyedānīṃ	prajQApAramitAm SravaNAya te budDAH BagavantaH evam AhuH yasya-idAnIm
   kulaputrāḥ kālaṃ manyaddhva evan dakṣiṇasyān diśi paścimāyām uttarasyāṃ	kula-putrAH kAlam manyadDvaH evan dakziNasyAn diSi paScimAyAm uttarasyAm
   vidikṣv adha-ūrdhvāyān diśi gaṅgānadīvālikopameṣu lokadhātuṣv	vidikzu aDa-u-UrDvAyAn diSi gaFgA-nadI-vAlikA-upamezu lokaDAtuzu-
   aprameyāsaṃkhyeyā bodhisatvā mahāsatvās taṃ prabhāvyūhan dṛṣṭvā	aprameya-asaMKyeyAH boDisatvAH mahAsatvAH tam praBAvi-Uhan dRzwvA
   svakasvakeṣu buddhakṣetreṣu buddhān bhagavantaḥ paripṛcchanti sma kasyāyaṃ	sva-ka-svakezu budDa-kzetrezu budDAn BagavantaH paripRcCanti sma kasya-ayam
   bhagavann anubhāvo yenāyam evaṃrūpaḥ prabhāvabhāsas sandṛśyate te buddhā	Bagavan anuBAvaH yena-ayam evaMrUpaH praBAva-BAsaH sandRSyate te budDA
   bhagavantas tān bodhisatvān māhāsatvān evam āhuḥ eṣa kulaputrā	BagavantaH tAn boDisatvAt mAhAsa-tvAn evam AhuH eza kula-putrA
   adhodigbhāge sahāṃyāṃ lokadhātau śākyamunir nāma tāthāgato 'rhan	aDas-digBAge saha-aMyAm lokaDAtO SAkyamuniH nAma tATAgataH arhan
   samyaksambuddhas tena jihvendriyan nirṇāmya daśasu dikṣu	samyaksambudDaH tena jihvA-indriyan nirNAmya daSasu dikzu
   gaṅgānadīvālikopamā lokadhātavo mahatāvabhāsena sphuṭīkṛtā yad uta	gaFgA-nadI-vAlikA-upamA lokaDAtavaH mahatA-avaBAsena sPuwIkRtA yat uta
   bodhisatvānāṃ mahāsatvānāṃ prajñāpāramitān deśanāya saṃprakāśanāya te	boDisatvAnAm mahAsatvAnAm prajQApAramitAn deSanAya saMprakASanAya te
   bodhisatvā mahāsatvās tāṃs tathāgatān evam āhur gamiṣyāmo vayaṃ bhagavaṃs	boDisatvAH mahAsatvAH tAn taTAgatAn evam AhuH gamizyAmaH vayam Bagavan=-
   tāṃ sahāṃ lokadhātun tañ ca bhagavantaṃ śākyamunin tathāgatam arhantaṃ	tAm sahAm lokaDAtun taQ ca Bagavantam SAkyamunin taTAgatam arhantam
   samyaksambuddhan darśanāya vandanāya paryupāsanāya tāṃś ca	samyaksambudDan darSanAya vandanAya paryupAsanAya tAn ca
   daśadiksannipatitān bodhisatvān mahāsatvān darśanāya vandanāya tāñ ca	daSa-diS-sannipatitAn boDisatvAt mahAsatvAn darSanAya vandanAya tAn ca
   prajñāpāramitāṃ śravaṇāya te buddhā bhagavanta evam āhur yasyedānīṃ	prajQApAramitAm SravaNAya te budDAH BagavantaH evam AhuH yasya-idAnIm
   kulaputrāḥ kālaṃ manyadhve // atha khalu daśabhyo digbhyas te bodhisatvāḥ	kula-putrAH kAlam manyaDve // aTa Kalu daSaByaH digByaH te boDisatvAH
   puṣpadhūpagandhamālyavilepanacūrṇacīvaracchatradhvajapatākā gṛhītvā	puzpa-DUpa-ganDa-mAlya-vilepana-cUrNa-cIvara=-Catra-Dvaja-patAkA gRhItvA
   nānāratnasuvarṇarūpyapuṣpapuṭaṃ parigṛhītvā mahatyā	nAnA-ratna-suvarNa-rUpya-puzpa-puwam parigRhItvA mahatyA
   tūryatāṇḍāvacarasaṃgītyā bhagavantaṃ śākyamunin tathāgatam upasaṃkrāntā	tUrya-tANxAvacara-saMgItyA Bagavantam SAkyamunin taTAgatam upasaMkrAntA
   abhūvan* // atha khalu cāturmahārājikā devā yāvad akaniṣṭhā devā divyāni	aBUvan* // aTa Kalu cAturmahArAjikAH devAH yAvat akanizWA devAH divyAni
   puṣpadhūpagandhamālyavilepanacūrṇotpalapadmakumudapuṇḍarīkamaṇḍāravakesaratamālapatrāṇi	puzpa-DUpa-ganDa-mAlya-vilepana-cUrNa-utpala-padma-kumuda-puNxarI-ka-maNxArava-kesara-tamAla-patrANi
   gṛhītvā yena bhagavāṃs tenopasaṃkrāman* atha khalu te bodhisatvā	gRhItvA yena BagavAn tena-upasaMkrAman* aTa Kalu te boDisatvA
   mahāsatvās te ca devās taiḥ puṣpadhūpagandhamālyavilepanais tathāgatam	mahAsatvAH te ca devAH tEH puzpa-DUpa-ganDa-mAlya-vilepanEH taTAgatam
   arhantaṃ samyaksambuddham avakiranti sma atha khalu tāni puṣpāṇi viyad	arhantam samyaksambudDam avakiranti sma aTa Kalu tAni puzpANi viyat-
   abhyudgamyāsya trisāhasramahāsāhasrasya lokadhātor upariṣṭhāt puṣpavitānāṃ	aByudgamya-asya tri-sAhasra-mahA-sAhasrasya loka-DAtoH uparizWAt puzpa-vitAnAm
   saṃsthitañ caturaśrañ ca catusthūṇaṃ samambhāgaśas suvibhaktaṃ ramaṇīyaṃ	saMsTitan caturaSran ca catusTUNam samamBAgaSaH su-viBaktam ramaNIyam
   manoramaṃ yat puṣpavitānan dṛṣṭvā tato bodhisatvamahāsatvaparṣado	manoramam yat puzpa-vitAnan dRzwvA tatas boDisatva-mahA-satva-parzadaH-
   devaparṣadaś ca prāṇikoṭinayutaśatasahasreṇānutpattakeṣu dharmeṣu kṣāntiḥ	deva-parzadaH ca prANi-kowina-yuta-Sata-sahasreNa-anutpattakezu Darmezu kzAntiH
   pratilabdhā ta utthāyāsanebhya ekāṃsam uttarāsaṅgān kṛtvā dakṣiṇāni	pratilabDA te utTAya-AsaneByaH eka-aMsam uttarAsaFgAn kRtvA dakziNAni
   jānumaṇḍalāni pṛthivyāṃ pratiṣṭhāpya yena bhagavāṃs tenāñjaliṃ praṇamayya	jAnu-maNxalAni pRTivyAm pratizWApya yena BagavAn tena-aQjalim praNamayya
   bhagavantam etad avocan vayaṃ bhagavann anāgate (PvSPL gā_a) 'dhvany	Bagavantam etat avocan vayam Bagavan anAgate (PvSPL gAH-_a) aDvani-
   evaṃrūpāṇān dharmāṇāṃ lābhino bhavema yathā tathāgato 'rhan	evaMrUpANAn DarmANAm lABinaH Bavema yaTA taTAgataH arhan
   samyaksambuddhaḥ evañ ca śrāvakasaṃghaṃ pariharema evañ ca parṣadi dharman	samyaksambudDaH evan ca SrAvaka-saMGam pariharema evan ca parzadi Darman
   deśayema yathaitarhi tathāgato dharman deśayati // atha khalu bhagavāṃs	deSayema yaTA-etarhi taTAgataH Darman deSayati // aTa Kalu BagavAn=-
   teṣān daśadigabhyāgatānāṃ bodhisatvānāṃ mahāsatvānān teṣāñ ca devānām	tezAn daSa-diS-aByAgatAnAm boDisatvAnAm mahA-satvAnAn tezAn ca devAnAm
   āśayaṃ viditvā sarvadharmāṇām	ASayam viditvA sarva-DarmANAm
   anutpādāyānirodhāyānabhisaṃskārāyāprādurbhāvāya kṣāntiñ ca viditvā smitam	anutpAdAya-aniroDAya-anaBisaMskArAya-aprAdurBAvAya kzAntin ca viditvA smitam
   akarot* // atha khalv āyuṣmān ānanda utthāyāsanād ekāṃsam uttarāsaṅgaṅ	akarot* // aTa Kalu AyuzmAn AnandaH utTAya-AsanAt eka-aMsam uttarAsaFgaF
   kṛtvā dakṣiṇañ jānumaṇḍalaṃ pṛthivyāṃ pratiṣṭhāpya yena bhagavāṃs	kRtvA dakziNan jAnu-maNxalam pRTivyAm pratizWApya yena BagavAn=-
   tenāñjaliṃ praṇamayya bhagavantam etad avocat ko bhagavan hetuḥ kaḥ	tena-aQjalim praNamayya Bagavantam etat avocat kaH Bagavan hetuH kaH
   pratayaḥ smitasya prādurbhāvāya nāhetukan nāpratyayaṃ buddhā bhagavanta	pratayaH smitasya prAdurBAvAya na-ahetukan na-apratyayam budDAH Bagavanta
   smitam āviṣkurvanti evam ukte bhagavān āyuṣmantam ānandam etad avocad	smitam Avizkurvanti evam ukte BagavAn Ayuzmantam Anandam etat avocat-
   etenānanda prāṇikoṭīnayutaśatasahasreṇānutpattikeṣu dharmeṣu kṣāntiḥ	etena-Ananda prANi-kowIn-ayuta-Sata-sahasreNa-anutpattikezu Darmezu kzAntiH
   pratilabdhā ete cānāgate 'dhvany aṣṭāṣaṣṭyā kalpakoṭibhir	pratilabDAH ete ca-anAgate aDvani azwAzazwyA kalpa-kowiBiH-
   bodhyaṅgapuṣpanāmānas tathāgatā arhantas samyaksambuddhā loka utpatsyante	boDi-aFga-puzpa-nAmAnaH taTAgatAH arhantaH samyaksambudDAH loke utpatsyante
   puṣpākare kalpe // atha khalu bhagavāṃs tasyāṃ velāyām ayuṣmantaṃ subhūtim	puzpAkare kalpe // aTa Kalu BagavAn tasyAm velAyAm ayuzmantam suBUtim
   āmantrayāmāsa pratibhātu te subhūte bodhisatvānāṃ mahāsatvānāṃ	AmantrayAmAsa pratiBAtu te suBUte boDisatvAnAm mahAsatvAnAm
   prajñāpāramitām ārabhya dhārmikīṅ kathāṅ kartuṃ yathā bodhisatvā mahāsatvā	prajQApAramitAm AraBya DArmikIF kaTA-aF kartum yaTA boDisatvA mahAsatvA
   prajñāpāramitāyāñ caranto niryāyur iti // atha khalu teṣāṃ bodhisatvānāṃ	prajQApAramitAyAn carantaH niryAyuH iti // aTa Kalu tezAm boDisatvAnAm
   mahāsatvānān teṣāñ ca mahāśrāvakāṇān teṣāñ ca devaputrāṇām etad abhavat*	mahA-satvAnAn tezAn ca mahA-SrAvakANAn tezAn ca deva-putrANAm etat aBavat-*
   // kin nu khalv āyuṣmān subhūtis svakena prajñāpratibhānabalādhānena	// kid nu Kalu AyuzmAn suBUtiH svakena prajQA-pratiBAna-bala-ADAnena
   bodhisatvānāṃ mahāsatvānāṃ prajñāpāramitām upadekṣyaty uta buddhānubhāvena	boDisatvAnAm mahAsatvAnAm prajQApAramitAm upadekzyati uta budDa-anuBAvena
   // atha khalv āyuṣmān subhūtir buddhānubhāvena teṣāṃ bodhisatvānāṃ	// aTa Kalu AyuzmAn suBUtiH budDa-anuBAvena tezAm boDisatvAnAm
   mahāsatvānān teṣāñ ca mahāśrāvakāṇān teṣāñ ca devaputrāṇāñ cetasaiva	mahA-satvAnAn tezAn ca mahA-SrAvakANAn tezAn ca deva-putrANAn cetasA-eva
   cetaḥparivitarkam ājñāyāyuṣmantaṃ śāriputram etad avocat tat kiñcid	cetaH-parivitarkam AjQAya-Ayuzmantam SAriputram etat avocat tat kiQcid-
   āyuṣmañ cchāriputra bhagavataś śrāvakā bhāṣante deśayanty udīrayanti	Ayuzman cCAriputra BagavataH SrAvakAH BAzante deSayanti udIrayanti
   sarvas sa tathāgatasya puruṣākāro veditavyas taṅ kasya hetor yo hi	sarvaH sa taTAgatasya puruza-AkAraH veditavyaH taF kasya hetoH yaH hi
   tathāgatena dharmo deśitas tasyān dharmadeśanāyāṃ śikṣamāṇo bhagavataś	taTAgatena DarmaH deSitaH tasyAn Darma-deSanAyAm SikzamANaH BagavataS
   śrāvakās tān dharmatāṃ sākṣātkurvanti tān dharmatāṃ sākṣātkṛtya yad yad	SrAvakAH tAn Darma-tAm sAkzAtkurvanti tAn Darma-tAm sAkzAtkRtya yat yat-
   eva bhāṣante deśayanty upadiśanti sarvan tad dharmatayā na viruddhyate	eva BAzante deSayanti upadiSanti sarvan tat Darma-tayA na virudDyate
   tathāgata evaiṣa śāriputropāyakauśalyayogena bodhisatvānāṃ mahāsatvānāṃ	taTAgataH eva-eza SAriputra-upAya-kOSalya-yogena boDisatvAnAm mahAsatvAnAm
   prajñāpāramitām upadekṣyaty aviṣayo 'trāyuṣmāñ cchāriputra	prajQApAramitAm upadekzyati avizayaH atra-AyuzmAn cCAriputra
   sarvaśrāvakapratyekabuddhānāṃ bodhisatvānāṃ mahāsatvānāṃ prajñāpāramitām	sarva-SrAvaka-pratyekabudDAnAm boDisatvAnAm mahAsatvAnAm prajQApAramitAm
   upadeśam // atha khalv āyuṣmān subhūtir bhagavantam etad avocat*	upadeSam // aTa Kalu AyuzmAn suBUtiH Bagavantam etat avocat-*
   bodhisatvo mahāsatva iti bhagavann ucyate kasyaitad bhagavan	boDisatvaH mahAsatvaH iti Bagavan ucyate kasya-etat Bagavan
   dharmasyādhivacanaṃ yad uta bodhisatva iti prajñāpāramiteti vā nāhaṃ	Darmasya-aDivacanam yat uta boDisatvaH iti prajQApAramitA-iti vA na-aham
   bhagavaṃs tan dharmaṃ samanupaśyāmi (PvSPL gā_b) yad uta bodhisatva iti	Bagavan tat Darmam samanupaSyAmi (PvSPL gAH-_b) yat uta boDisatvaH iti
   prajñāpāramiteti vā so 'haṃ bhagavan bodhisatvam asamanupaśyan	prajQApAramitA-iti vA saH aham Bagavan boDisatvam asamanupaSyan
   prajñāpāramitām apy anupalabhamānaḥ katamaṃ bodhisatvaṃ katamasyāṃ	prajQApAramitAm api anupalaBamAnaH katamam boDisatvam katamasyAm
   prajñāpāramitāyām avavadiṣyāmy anuśāsiṣyāmi // evam ukte bhagavān	prajQApAramitAyAm avavadizyAmi anuSAsizyAmi // evam ukte BagavAn
   āyuṣmantaṃ subhūtim etad avocan nāmamātram idaṃ subhūte yad uta	Ayuzmantam suBUtim etat avocat nAma-mAtram idam suBUte yat uta
   prajñāpāramiteti bodhisatva iti bodhisatvanāmeti tad api nāma nādhyātman	prajQApAramitA-iti boDisatvaH iti boDisatva-nAma-iti tat api nAma na-aDyAtman
   na bahirdhā nobhayam antareṇopalabhyate tadyathā pi nāma subhūte satvas	na bahirDA na-uBayam antareNa-upalaByate tat-yaTA pi nAma suBUte satva-s
   satva iti nāmnocyate na ca kadācit satvopalabdhir yac ca nāma tad	satvaH iti nAmnA-ucyate na ca kadAcid satva-upalabDiH yat ca nAma tat-
   dharmaprajñaptimātran tasyāś ca dharmaprajñaptir notpādo na nirodho	Darma-prajQaptimAtran tasyAH ca Darma-prajQaptiH na-utpAdaH na niroDaH-
   'nyatra nāmasaṃketamātreṇa vyavahriyate tac ca nāma nādhyātman na bahirdhā	anyatra nAma-saMketa-mAtreNa vyavahriyate tat ca nAma na-aDyAtman na bahirDA
   nobhayam antareṇopalabhyate evam	na-uBayam antareNa-upalaByate evam
   ātmasatvajīvajantupoṣapuruṣapudgalamanujamānavakārakavedakajanakapaśyakā	Atma-satva-jIva-jantu-poza-puruza-pudgalam-anujamAnavakAraka-vedaka-janaka-paSyakA
   iti subhūte sarvam etad dharmaprajñaptimātran tasyāś ca dharmaprajñapter	iti suBUte sarvam etat Darma-prajQaptimAtran tasyAH ca Darma-prajQapteH-
   notpādo na nirodho 'nyatra nāmasaṃketanamātreṇa vyavahriyate tac ca nāma	na-utpAdaH na niroDaH anyatra nAma-saMketana-mAtreNa vyavahriyate tat ca nAma
   nādhyātmān na bahirdhā nobhayam antareṇopalabhyate evam eva subhūte yad	na-aDyAtmAt na bahirDA na-uBayam antareNa-upalaByate evam eva suBUte yat-
   ucyate prajñāpāramiteti bodhisatva iti bodhisatvanāmeti sarvam etad	ucyate prajQApAramitA-iti boDisatvaH iti boDisatva-nAma-iti sarvam etat-
   dharmaprajñaptimātran tasyāś ca dharmaprajñapter notpādo na nirodho	Darma-prajQaptimAtran tasyAH ca Darma-prajQapteH na-utpAdaH na niroDaH-
   'nyatra nāmasaṃketamātreṇa vyavahriyate tac ca nāma nādhyātmān na bahirdhā	anyatra nAma-saMketa-mAtreNa vyavahriyate tat ca nAma na-aDyAtmAt na bahirDA
   nobhayam antareṇopalabhyate tadyathāpi nāma subhūte idam ādhyātmakaṃ rūpam	na-uBayam antareNa-upalaByate tat-yaTA-api nAma suBUte idam ADyAtmakam rUpam
   iti sarvam etad dharmaprajñaptimātran tasyāś ca dharmaprajñapter notpādo	iti sarvam etat Darma-prajQaptimAtran tasyAH ca Darma-prajQapteH na-utpAdaH-
   na nirodho 'nyatra nāmasaṃketamātreṇa vyavahriyate tac ca nāma nādhyātman	na niroDaH anyatra nAma-saMketa-mAtreNa vyavahriyate tat ca nAma na-aDyAtman
   na bahirdhā nobhayam antareṇopalabhyate evaṃ vedanāsaṃjñāsaṃskārāvijñānam	na bahirDA na-uBayam antareNa-upalaByate evam vedanA-saMjQA-saMskAra-avijQAnam
   iti subhūte dharmaprajñaptimātram etad tasyāś ca dharmaprajñapter notpādo	iti suBUte Darma-prajQapti-mAtram etat tasyAH ca Darma-prajQapteH na-utpAdaH-
   na nirodho 'nyatra nāmasaṃketamātreṇa vyavahriyate tac ca nāma nādhyātman	na niroDaH anyatra nAma-saMketa-mAtreNa vyavahriyate tat ca nAma na-aDyAtman
   na bahirdhā nobhayam antareṇopalabhyate evam eva subhūte yad ucyate	na bahirDA na-uBayam antareNa-upalaByate evam eva suBUte yat ucyate
   prajñāpāramiteti bodhisatva iti bodhisatvanāmeti sarvam etan	prajQApAramitA-iti boDisatvaH iti boDisatva-nAma-iti sarvam etat-
   dharmaprajñaptimātran tasyāś ca dharmaprajñapter notpādo na nirodho	Darma-prajQaptimAtran tasyAH ca Darma-prajQapteH na-utpAdaH na niroDaH-
   'nyatra nāmasaṃketamātreṇa vyavahriyate tac ca nāma nādhyātman na bahirdhā	anyatra nAma-saMketa-mAtreNa vyavahriyate tat ca nAma na-aDyAtman na bahirDA
   nobhayam antareṇopalabhyate cakṣur iti subhūte dharmaprajñaptimātram etat	na-uBayam antareNa-upalaByate cakzuH iti suBUte Darma-prajQapti-mAtram etat-
   tasyāś ca dharmaprajñapter notpādo na nirodho 'nyatra nāmasaṃketamātreṇa	tasyAH ca Darma-prajQapteH na-utpAdaH na niroDaH anyatra nAma-saMketa-mAtreNa
   vyavahriyate tac ca nāma nādhyātman na bahirdhā nobhayam	vyavahriyate tat ca nAma na-aDyAtman na bahirDA na-uBayam
   antareṇopalabhyate // evaṃ śrotraṃ ghrāṇaṃ jihvā kāyo mana iti subhūte	antareNa-upalaByate // evam Srotram GrANam jihvA kAyaH manaH iti suBUte
   dharmaprajñaptimātram etat tasyāś ca dharmaprajñapter notpādo na nirodho	Darma-prajQapti-mAtram etat tasyAH ca Darma-prajQapteH na-utpAdaH na niroDaH-
   'nyatra dharmasaṃketamātreṇa vyavahriyate tac ca nāma nādhyātman na	anyatra Darma-saMketa-mAtreNa vyavahriyate tat ca nAma na-aDyAtman na
   bahirdhā nobhayam antareṇopalabhyate rūpam iti subhūte	bahirDA na-uBayam antareNa-upalaByate rUpam iti suBUte
   dharmaprajñaptimātram etat tasyāś ca dharmaprajñapter notpādo na nirodho	Darma-prajQapti-mAtram etat tasyAH ca Darma-prajQapteH na-utpAdaH na niroDaH-
   'nyatra nāmasaṃketamātreṇa vyavahriyate tac ca nāma nādhyātman na bahirdhā	anyatra nAma-saMketa-mAtreNa vyavahriyate tat ca nAma na-aDyAtman na bahirDA
   nobhayam antareṇopalabhyate. evaṃ śabdo gandho rasaḥ spraṣṭavyan dharma	na-uBayam antareNa-upalaByate. evam SabdaH ganDaH rasaH sprazwavyan Darma
   iti subhūte dharmapra	iti suBUte Darma-pra
