   namas tārāyai	namaH tArAyE
   (77.4) vyatirekātmikā vyāptir ākṣiptānvayarūpiṇī / vaidharmyavati dṛṣṭānte	(77.4) vyatireka-AtmikA vyAptiH Akzipta-anvaya-rUpiNI / vEDarmyavati dRzwAnte
   sattvahetor ihocyate /	sattva-hetoH iha-ucyate /
   (77.6) yat sat tat kṣaṇikam / yathā ghaṭaḥ / santaś cāmī vivādāspadībhūtāḥ	(77.6) yat sat tat kzaNikam / yaTA GawaH / santaH ca-amI vivAda-AspadIBUtAH
   padārthā iti svabhāvahetuḥ /	padArTAH iti svaBAva-hetuH /
   (77.8) na tāvad asyāsiddhiḥ sambhavati / yathāyogaṃ	(77.8) na tAvat asya-asidDiH samBavati / yaTAyogam
   pratyakṣānumānapramāṇapratīte dharmiṇi	pratyakza-anumAna-pramANa-pratIte DarmiNi
   sattvaśabdenābhipretasyārthakriyākāritvalakṣaṇasya sādhanasya	sattva-Sabdena-aBipretasya-arTa-kriyA-kAri-tva-lakzaNasya sADanasya
   pramāṇasamadhigatatvāt /	pramANa-samaDigata-tvAt /
   (77.10) na ca viruddhānaikāntikate / vyāpakānupalambhātmanā viparyaye	(77.10) na ca virudDa-anEkAntikate / vyApaka-anupalamBa-AtmanA viparyaye
   bādhakapramāṇena vyāpteḥ prasādhanāt /	bADaka-pramANena vyApteH prasADanAt /
   (77.11) yasya kramākramau na vidyete na tasyārthakriyāsāmarthyam / yathā	(77.11) yasya kramAkramO na vidyete na tasya-arTa-kriyA-sAmarTyam / yaTA
   śaśaviṣāṇasya / na vidyete cākṣaṇikasya kramākramāv iti vyāpakānupalambhaḥ	SaSa-vizANasya / na vidyete ca-akzaNikasya kramAkramO iti vyApaka-anupalamBaH
   (77.12) na tāvad ayam asiddho hetuḥ / akṣaṇike dharmiṇi	(77.12) na tAvat ayam asidDaH hetuH / akzaNike DarmiNi
   kramākramasadbhāvāyogāt / tathā hi prāptāparakālayor ekatve nityatvam /	krama-Akrama-sadBAva-ayogAt / taTA hi prApta-apara-kAlayoH eka-tve nitya-tvam /
   tasya kramākramayoge kṣaṇadvaye 'py avaśyaṃ bhedaḥ / bhedābhedayoś ca	tasya krama-Akrama-yoge kzaNa-dvaye api avaSyam BedaH / Beda-aBedayoH ca
   parasparavirodhāt kuto 'kṣaṇike kramākramasambhavaḥ / kṣaṇadvaye 'pi bhede	paraspara-viroDAt kutas akzaNike kramAkrama-samBavaH / kzaNa-dvaye api Bede
   kramākramayogaḥ / abhede hi prathama eva kṣaṇe śaktatvād / bhāvino 'pi	krama-akrama-yogaH / aBede hi praTamaH eva kzaNe Sakta-tvAt / BAvinaH api
   kāryasya karaṇaprasaṅge kathaṃ kāryāntarakaraṇe kramāntarāvakāśaḥ / na	kAryasya karaNa-prasaFge kaTam kArya-antara-karaNe krama-antara-avakASaH / na
   cākṣaṇikasyākrameṇaiva sakalasvakāryaṃ kṛtvā svāsthyam / kṣaṇāntare 'pi	ca-akzaNikasya-AkrameNa-eva sakala-sva-kAryam kRtvA svAsTyam / kzaNa-antare api
   śaktatvāt punas tatkāryakaraṇaprasaṅgāt /	Sakta-tvAt punar tad-kArya-karaNa-prasaFgAt /
   (77.18) tasmād akṣaṇikam iti pūrvāparakālayor abhedaḥ / kramākramayoga iti	(77.18) tasmAt akzaNikam iti pUrva-apara-kAlayoH aBedaH / krama-Akrama-yogaH iti
   pūrvāparakālayor bhedaḥ / anayoś ca parasparaparihārasthitilakṣaṇo	pUrva-apara-kAlayoH BedaH / anayoH ca paraspara-parihAra-sTiti-lakzaNaH-
   virodhaḥ /	viroDaH /
   (77.20) tad ayam akṣaṇike dharmiṇi kramākramābhāvalakṣaṇo hetur nāsiddho	(77.20) tat ayam akzaNike DarmiNi krama-akrama-aBAva-lakzaNaH hetuH na-asidDaH-
   vaktavyaḥ / kramākramayogitvākṣaṇikatvayor virodhād eva /	vaktavyaH / krama-Akrama-yogi-tva-akzaNika-tvayoH viroDAt eva /
   (78.1) nāpi viruddhaḥ / sapakṣe bhāvāt /	(78.1) na-api virudDaH / sa-pakze BAvAt /
   (78.2) na cānaikāntikaḥ / kramākramābhāvasyārthakriyāsāmarthyābhāvena	(78.2) na ca-anEkAntikaH / krama-akrama-aBAvasya-arTa-kriyA-sAmarTya-aBAvena
   vyāptatvāt /	vyApta-tvAt /
   (78.3) yenaiva hi pratyakṣātmanā pramāṇenāparaprakārābhāvād	(78.3) yena-eva hi pratyakza-AtmanA pramANena-apara-prakAra-aBAvAt-
   vidhibhūtābhyāṃ kramākramābhyāṃ vidhibhūtasyārthakriyāsāmarthyasya vyāptiḥ	viDi-BUtAByAm krama-AkramAByAm viDi-BUtasya-arTa-kriyA-sAmarTyasya vyAptiH
   prasādhitā, tenaivārthakriyāsāmarthyābhāvena kramākramābhāvasya vyāptiḥ	prasADitA, tena-eva-arTa-kriyA-sAmarTya-aBAvena krama-akrama-aBAvasya vyAptiH
   prasādhiteti svīkartavyam / na hi dahanādinā dhūmāder	prasADitA-iti svIkartavyam / na hi dahana-AdinA DUma-AdeH-
   vyāptisādhakapramāṇād aparaṃ dhūmādyabhāvena dahanādyabhāvasya	vyApti-sADaka-pramANAt aparam DUma-Adi-a-BAvena dahana-Adi-aBAvasya
   vyāptisādhakaṃ kiñcit pramāṇaṃ śaraṇabhūtam asti / tasmād vidhyor eva	vyApti-sADakam kiQcid pramANam SaraNa-BUtam asti / tasmAt viDyoH eva
   vyāptisādhakaṃ pramāṇam abhāvayor api vyāptisādhakam iti nyāyasya	vyApti-sADakam pramANam aBAvayoH api vyApti-sADakam iti nyAyasya
   duratikramatvāt sattvābhāvena kramākramābhāvo vyāpta eveti nānaikāntika	duratikrama-tvAt sattva-aBAvena krama-akrama-aBAvaH vyAptaH eva-iti na-anEkAntika
   ity anavadyo vyāpakānupalambhaḥ / tad ayam akṣaṇikād vinivartamāṇaḥ	iti anavadyaH vyApaka-anupalamBaH / tat ayam akzaNikAt vinivartamANaH
   svavyāpyaṃ sattvaṃ nivartya kṣaṇike viśrāmayatīti sattvahetoḥ	sva-vyApyam sattvam nivartya kzaNike viSrAmayati-iti sattva-hetoH
   kṣaṇabhaṅgasiddhir apy anavadyā. /	kzaNa-BaFga-sidDiH api anavadyA. /
   (78.10) nanu vyāpakānupalambhataḥ sattvasya kathaṃ	(78.10) nanu vyApaka-anupalamBataH sattvasya kaTam
   svasādhyapratibandhasiddhiḥ, asyāpy anekadoṣaduṣṭatvāt / tathā hi na tāvad	sva-sADya-pratibanDa-sidDiH, asya-api aneka-doza-duzwa-tvAt / taTA hi na tAvat-
   ayaṃ prasaṅga hetuḥ / sādhyadharmiṇi pramāṇasiddhatvāt,	ayam prasaFga hetuH / sADya-DarmiNi pramANa-sidDa-tvAt,
   parābhyupagamasiddhatvābhāvāt, viparyayaparyavasānābhāvāc ca / atha	para-aByupagama-sidDa-tva-aBAvAt, viparyaya-paryavasAna-aBAvAt ca / aTa
   svatantraḥ, tadāśrayāsiddhaḥ / akṣaṇikasyāśrayasyāsambhavāt / apratītatvād	svatantraH, tad-ASraya-asidDaH / akzaNikasya-ASrayasya-asamBavAt / apratIta-tvAt-
   vā / pratītir hi pratyakṣeṇānumānena vikalpamātreṇa vā syāt /	vA / pratItiH hi pratyakzeNa-anumAnena vikalpa-mAtreNa vA syAt /
   (79.1) prathamapakṣadvaye sākṣātpāramparyeṇa vā	(79.1) praTama-pakza-dvaye sAkzAt-pAramparyeNa vA
   svapratītilakṣaṇārthakāritve maulaḥ sādhāraṇo hetuḥ vyāpakānupalambhaś ca	sva-pratIti-lakzaNa-arTa-kAri-tve mOlaH sADAraNaH hetuH vyApaka-anupalamBaH ca
   svarūpāsiddhaḥ syāt / arthakriyākāritve kramākramayor	svarUpa-asidDaH syAt / arTa-kriyA-kAritve kramAkramayoH-
   anyatarasyāvaśyambhāvāt /	anyatarasya-avaSyamBAvAt /
   (79.4) antimapakṣe tu na kaścid dhetur anāśrayaḥ syāt /	(79.4) antima-pakze tu na kaScid DetuH anASrayaH syAt /
   vikalpamātrasiddhasya dharmiṇaḥ sarvatra sulabhatvāt /	vikalpa-mAtra-sidDasya DarmiNaH sarvatra sulaBa-tvAt /
   (79.6) api ca, tat kalpanājñānaṃ pratyakṣapṛṣṭhabhāvi vā syāt, liṅgajanma	(79.6) api ca, tat kalpanA-jQAnam pratyakza-pRzWa-BAvi vA syAt, liFga-janma
   vā, saṃskārajaṃ vā, sandigdhavastukaṃ vā, avastukaṃ vā /	vA, saMskAra-jam vA, sandigDa-vastukam vA, avastukam vA /
   (79.8) tatrādyapakṣadvaye 'kṣaṇikasya sattaivāvyāhatā / kathaṃ	(79.8) tatra-Adya-pakza-dvaye akzaNikasya sattA-eva-avyAhatA / kaTam
   bādhakāvatāraḥ /	bADaka-avatAraH /
   (79.9) tṛītye tu na sarvadā 'kṣaṇikasattāniṣedhaḥ / tadarpitasaṃskārābhāve	(79.9) tRItye tu na sarvadA akzaNika-sattA-nizeDaH / tad-arpita-saMskAra-aBAve
   tat smaraṇāyogāt /	tat smaraNa-ayogAt /
   (79.10) caturthe tu sandigdhāśrayatvaṃ hetudoṣaḥ /	(79.10) caturTe tu sandigDa-ASraya-tvam hetu-dozaH /
   (79.11) pañcame ca tadviṣayasyābhāvo na tāvad pratyakṣataḥ sidhyati /	(79.11) paQcame ca tad-vizayasya-aBAvaH na tAvat pratyakzataH siDyati /
   akṣaṇikātmanaḥ sarvadaiva tvanmate 'pratyakṣatvāt na cānumānatas	akzaNikA-AtmanaH sarvadA-eva tvad-mate apratyakza-tvAt na ca-anumAnatas
   tadabhāvas tatpratibaddhaliṅgān upalam bhādityāśrayāsiddhis tāvad uddhatā	tad-aBAvaH tad-pratibadDa-liFgAn upalam BAditi-ASraya-asidDiH tAvat udDatA
   / evaṃ dṛṣṭānto 'pi pratihantavyaḥ /	/ evam dRzwAntaH api pratihantavyaH /
   (79.14) svarūpāsiddho 'py ayaṃ hetūḥ / sthirasyāpi	(79.14) svarUpa-asidDaH api ayam hetUH / sTirasya-api
   kramākramisahakāryapekṣayā kramākramābhyām arthakriyopapatteḥ / nāpi	krama-Akrami-sahakArI-apekzayA krama-AkramAByAm arTa-kriyA-upapatteH / na-api
   kramayaugapadyapakṣoktadoṣaprasaṅgaḥ / tathā hi kramisahakāryapekṣayā	krama-yOgapadya-pakza-ukta-doza-prasaFgaH / taTA hi krami-sahakArI-apekzayA
   kramikāryakāritvan tāvad aviruddham /	krami-kArya-kAritvan tAvat avirudDam /
   (79.17) tathā ca śaṃkarasya saṃkṣipto 'yam abhiprāyaḥ / sahakārisākalyaṃ	(79.17) taTA ca SaMkarasya saMkziptaH ayam aBiprAyaH / sahakAri-sAkalyam
   hi sāmarthyam / tadvaikalyaṃ cāsāmarthyam / na ca tayor	hi sAmarTyam / tad-vEkalyam ca-asAmarTyam / na ca tayoH-
   āvirbhāvatirobhāvābhyān tadvataḥ kā cit kṣatiḥ / tasya tābhyām anyatvāt /	AvirBAva-tiroBAvAByAn tadvatas kA cit kzatiH / tasya tAByAm anya-tvAt /
   tat kathaṃ sahakāriṇo 'napekṣa kāryakaraṇaprasaṅga iti /	tat kaTam sahakAriNaH anapekza kArya-karaNa-prasaFgaH iti /
   (79.20) trilocanasyāpy ayaṃ saṃkṣiptārthaḥ / kāryam eva hi sahakāriṇam	(79.20) trilocanasya-api ayam saMkzipta-arTaH / kAryam eva hi sahakAriNam
   apekṣate / na ca kāryotpattihetuḥ / yasmād dvividhaṃ sāmarthyaṃ nijam	apekzate / na ca kArya-utpatti-hetuH / yasmAt dviviDam sAmarTyam nijam
   āgantukaṃ ca sahakāryantaram, tato 'kṣaṇikasyāpi kramavat sahakārinānātvād	Agantukam ca sahakAri-antaram, tatas akzaNikasya-api krama-vat sahakAri-nAnA-tvAt-
   api kramavat kāryanānātvopapatter aśakyaṃ bhāvānām pratikṣaṇam anyonyatvam	api krama-vat kArya-nAnA-tva-upapatteH aSakyam BAvAnAm pratikzaNam anyonya-tvam
   upapādayitum iti /	upapAdayitum iti /
   (79.24) nyāyabhūṣaṇo 'pi lapati / prathamakāryotpādanakāle hi	(79.24) nyAya-BUzaNaH api lapati / praTama-kArya-utpAdana-kAle hi
   uttarakāryotpādanasvabhāvaḥ / ataḥ prathamakāla evāśeṣāṇi kāryāṇi kuryād	uttara-kArya-utpAdana-svaBAvaH / atas praTama-kAle eva-aSezANi kAryANi kuryAt-
   iti cet /	iti ced /
   (79.26) tad idaṃ mātā me vandhyety ādivat svavacanavirodhād ayuktam / yo	(79.26) tat idam mAtA me vanDyA-iti Adi-vat sva-vacana-viroDAt ayuktam / yaH-
   hi uttarakāryajananasvabhāvaḥ sa katham ādau tat kāryaṃ kuryāt / na tarhi	hi uttara-kArya-janana-svaBAvaH sa kaTam AdO tat kAryam kuryAt / na tarhi
   tatkāryakaraṇasvabhāvaḥ / na hi nīlotpādanasvabhāvaḥ pītādikam api	tad-kArya-karaNa-svaBAvaH / na hi nIla-utpAdana-svaBAvaH pIta-Adikam api
   karotīti /	karoti-iti /
   (80.1) vācaspatir api paṭhati / nanv ayam akṣaṇikaḥ svarūpeṇa kāryaṃ	(80.1) vAcaspatiH api paWati / nanu ayam akzaNikaH sva-rUpeNa kAryam
   janayati / tac cāsya svarūpaṃ tṛtīyādiṣiva kṣaṇeṣu dvitīye 'pi kṣaṇe sad	janayati / tat ca-asya svarUpam tRtIya-Adiziva kzaNezu dvitIye api kzaNe sad
   iti tadāpi janayet / akurvan vā tṛtīyādiṣv api na kurvīta / tasya	iti tadA-api janayet / akurvan vA tRtIya-Adizu api na kurvIta / tasya
   tādāvasthyāt / atādavasthye vā tad evāsya kṣaṇikatvam /	tAdO=-asTyAt / atAdavasTye vA tat eva-asya kzaNika-tvam /
   (80.4) atrocyate / satyaṃ svarūpeṇa kāryaṃ janayati na tu tenaiva /	(80.4) atra-ucyate / satyam svarUpeNa kAryam janayati na tu tena-eva /
   sahakārisahitād eva tataḥ kāryotpattidarśanāt / tasmād	sahakAri-sahitAt eva tatas kArya-utpatti-darSanAt / tasmAt-
   vyāptivatkāryakāraṇabhāvo 'py ekatrānyayogavyavacchedena /	vyApti-vat-kArya-kAraNa-BAvaH api ekatra-anya-yoga-vyavacCedena /
   anyatrāyogavyavacchedenanāvaboddhavyaḥ / tathaiva laukikaparīkṣakāṇāṃ	anyatra-ayoga-vyavacCedenana-avabodDavyaH / taTA-eva lOkika-parIkzakANAm
   sampratipatter iti na kramikāryakāritvapakṣoktadoṣāvasaraḥ /	sampratipatteH iti na krami-kArya-kAri-tva-pakza-ukta-doza-avasaraH /
   (80.8) nāpy akṣaṇike yaugapadyapakṣoktadoṣāvakāśaḥ / ye hi kāryam	(80.8) na-api akzaNike yOgapadya-pakza-ukta-doza-avakASaH / ye hi kAryam
   utpāditavanto dravyaviśeṣās teṣāṃ vyāpārasya niyatakāryotpādanasamarthasya	utpAditavantaH dravya-viSezAH tezAm vyApArasya niyata-kArya-utpAdana-samarTasya
   niṣpādite kārye 'nuvartamāneṣv api teṣu dravyeṣu nivṛttārthād ūnā sāmagrī	nizpAdite kArye anuvartamAnezu api tezu dravyezu nivRtta-arTAt UnA sAmagrI
   jāyate / tat kathaṃ niṣpāditaṃ niṣpādayiṣyati / na hi daṇḍādayaḥ	jAyate / tat kaTam nizpAditam nizpAdayizyati / na hi daNxa-AdayaH
   svabhāvenaiva kartāro yenāmi niṣpatter ārabhya kāryaṃ vidadhyuḥ / kiṃ	svaBAvena-eva kartAraH yenAmi nizpatteH AraBya kAryam vidaDyuH / kim
   tarhi vyāpārāveśinaḥ / na ceyatā svarūpeṇa na kartāraḥ /	tarhi vyApAra-AveSinaH / na ceyatA svarUpeNa na kartAraH /
   svarūpakārakatvanirvāhaparatayā vyāpārasamāveśād iti /	sva-rUpa-kAraka-tva-nirvAha-para-tayA vyApAra-samAveSAt iti /
   (80.13) kiṃ ca kramākramābhāvaś ca bhaviṣyati / na ca sattvābhāva iti	(80.13) kim ca krama-akrama-aBAvaH ca Bavizyati / na ca sattva-aBAvaH iti
   sandigdhavyatireko 'py ayaṃ vyāpakānupalambhaḥ / na hi kramākramābhyām	sandigDa-vyatirekaH api ayam vyApaka-anupalamBaH / na hi krama-AkramAByAm
   anyasya prakārasyābhāvaḥ siddhaḥ / viśeṣaniṣedhasya	anyasya prakArasya-aBAvaH sidDaH / viSeza-nizeDasya
   śeṣābhyanujñāviṣayatvāt /	Seza-aByanujQA-vizaya-tvAt /
   (80.16) kiṃ ca prakārāntarasya dṛśyatve nātyantaniṣedhaḥ / adṛśyatve tu	(80.16) kim ca prakAra-antarasya dRSya-tve na-atyanta-nizeDaH / adRSya-tve tu
   nāsattāniścayo viprakarṣiṇām iti na kramākramābhyām arthakriyāsāmarthyasya	na-asattA-niScayaH vipra-karziNAm iti na krama-AkramAByAm arTa-kriyA-sAmarTyasya
   vyāptisiddhiḥ / ataḥ sandigdhavyatireko 'pi vyāpakānupalambhaḥ /	vyApti-sidDiH / atas sandigDa-vyatirekaH api vyApaka-anupalamBaH /
   (80.19) kiṃ ca dṛśyādṛśyasahakāripratyayasākalyavataḥ	(80.19) kim ca dRSya-adRSya-sahakAri-pratyaya-sAkalyavataH
   kramayaugapadyasyātyantaparokṣatvāt tena vyāptaṃ sattvam api parokṣam	krama-yOgapadyasya-atyanta-parokza-tvAt tena vyAptam sattvam api parokzam
   eveti na tāvat pratibandhaḥ pratyakṣataḥ sidhyati / nāpy anumānataḥ /	eva-iti na tAvat pratibanDaH pratyakzataH siDyati / na-api anumAnataH /
   tatpratibaddhaliṅgābhāvād iti /	tad-pratibadDa-liFga-aBAvAt iti /
   (80.22) api ca kramākramābhyām arthakriyākāritvaṃ vyāptam ity	(80.22) api ca krama-AkramAByAm arTa-kriyA-kAritvam vyAptam iti-
   atisubhāṣitam / yadi krameṇa vyāptaṃ katham akrameṇa, athākrameṇa na tarhi	ati-su-BAzitam / yadi krameNa vyAptam kaTam akrameNa, aTa-akrameNa na tarhi
   krameṇa / kramākramābhyāṃ vyāptim iti tu bruvatā vyāpter evābhāvaḥ	krameNa / krama-AkramAByAm vyAptim iti tu bruvatA vyApteH eva-aBAvaH
   pradarśito bhavati / na hi bhavaty agnir dhūmabhāvābhāvābhyāṃ vyāpta iti /	pradarSitaH Bavati / na hi Bavati agniH DUma-BAva-aBAvAByAm vyAptaH iti /
   ato vyāpter anaikāntikatvam /	atas vyApteH anEkAntika-tvam /
   (80.26) api ca kim idaṃ bādhakam akṣaṇikānām asattāṃ sādhayati / utasvid	(80.26) api ca kim idam bADakam akzaNikAnAm asattAm sADayati / uta-svid
   akṣaṇikāt sattvasya vyatirekam / atha sattvakṣaṇikatvayoḥ pratibandham /	akzaNikAt sattvasya vyatirekam / aTa sattva-kzaNika-tvayoH pratibanDam /
   (80.28) na pūrvo vikalpaḥ / uktakrameṇa hetor āśrayāsiddhatvāt /	(80.28) na pUrvaH vikalpaH / ukta-krameNa hetoH ASraya-asidDa-tvAt /
   (80.29) na ca dvitīyaḥ / yato vyāpakanivṛttisahitā vyāpyanivṛttir	(80.29) na ca dvitIyaH / yatas vyApaka-nivRtti-sahitA vyApya-nivRttiH-
   vyatirekaśabdasyārthaḥ / sā ca yadi pratyakṣeṇa pratīyate tadā taddhetuḥ	vyatireka-Sabdasya-arTaH / sA ca yadi pratyakzeNa pratIyate tadA tad-hetuH
   syād iti sattvam anaikāntikam / vyāpakānupalambhaḥ svarūpāsiddhiḥ / atha	syAt iti sattvam anEkAntikam / vyApaka-anupalamBaH svarUpa-asidDiH / aTa
   sā vikalpyate tadā pūrvoktakrameṇa pañcadhā vikalpya vikalpo dūṣaṇīyaḥ /	sA vikalpyate tadA pUrva-ukta-krameNa paQcaDA vikalpya vikalpaH dUzaNIyaH /
   (81.1) ata eva na tṛtīyo 'pi vikalpaḥ / vyatirekāsiddhau sambandhāsiddheḥ	(81.1) atas eva na tRtIyaH api vikalpaH / vyatireka-asidDO sambanDa-asidDeH
   (81.2) kiṃ ca na bhūtalavad atrākṣaṇiko dharmi dṛśyate / na ca	(81.2) kim ca na BU-tala-vat atra-akzaNikaH Darmi dRSyate / na ca
   svabhāvānupalambhe vyāpakānupalambhaḥ kasya cit dṛśyasya pratipattim	svaBAva-anupalamBe vyApaka-anupalamBaH kasya cit dRSyasya pratipattim
   antareṇāntarbhāvayituṃ śakyata iti /	antareNa-antar-BAvayitum Sakyate iti /
   (81.4) kiṃ cāsyābhāvadharmatve āśrayāsiddhatvam itaretarāśrayatvaṃ ca /	(81.4) kim ca-asya-aBAva-Darma-tve ASraya-asidDa-tvam itaretara-ASraya-tvam ca /
   bhāvadharmatve viruddhatvaṃ ca / ubhayadharmatve cānaikāntikatvam iti na	BAva-Darma-tve virudDa-tvam ca / uBaya-Darma-tve ca-anEkAntika-tvam iti na
   trayīṃ doṣajātim atipatati /	trayIm doza-jAtim atipatati /
   (81.6) yat punar uktam akṣaṇikatve kramayaugapadyābhyām arthakriyāvirodhād	(81.6) yat punar uktam akzaNika-tve krama-yOgapadyAByAm arTa-kriyA-viroDAt-
   iti / tatra virodhasiddhim anusaratā virodhy api pratipattavyaḥ /	iti / tatra viroDa-sidDim anusaratA viroDi api pratipattavyaH /
   tatpratītināntarīyakatvād virodhasiddheḥ / yathā tuhinadahanayoḥ	tad-pratItinA-antarIyaka-tvAt viroDa-sidDeH / yaTA tuhinadahanayoH
   sāpekṣadhruvabhāvayoś ca /	sa-apekzaDruva-BAvayoH ca /
   (81.8) pratiyogī cākṣaṇikaḥ pratīyamānaḥ pratītikāritvāt sann eva syāt	(81.8) pratiyogI ca-akzaNikaH pratIyamAnaH pratIti-kAri-tvAt san eva syAt-
   ajanakasyāprameyatvāt /	ajanakasya-aprameya-tvAt /
   (81.10) saṃvṛtisiddhenākṣaṇikatvena virodhasiddhir iti cet /	(81.10) saMvRti-sidDena-akzaNika-tvena viroDa-sidDiH iti ced /
   saṃvṛtisiddham api vāstavaṃ kālpanikaṃ vā syāt /	saMvRti-sidDam api vAstavam kAlpanikam vA syAt /
   (81.12) yadi vāstavaṃ kathaṃ tasyāsattvam / kathaṃ	(81.12) yadi vAstavam kaTam tasya-asattvam / kaTam
   cārthakriyākāritvavirodhaḥ / arthakriyāṃ kurvad dhi vāstavam ucyate /	ca-arTa-kriyA-kAritva-viroDaH / arTa-kriyAm kurvat Di vAstavam ucyate /
   (81.14) atha kālpanikam / tatra kiṃ virodho vāstavaḥ, kālpaniko vā / na	(81.14) aTa kAlpanikam / tatra kim viroDaH vAstavaH, kAlpanikaH vA / na
   tāvad vāstavaḥ / kalpitavirodhivirodhatvāt, vandhyāputravirodhavat / atha	tAvat vAstavaH / kalpita-viroDi-viroDa-tvAt, vanDyA-putra-viroDa-vat / aTa
   virodho 'pi kālpanikaḥ / na tarhi sattvasya vyatirekaḥ pāramārthika iti	viroDaH api kAlpanikaH / na tarhi sattvasya vyatirekaH pAramArTikaH iti
   kṣaṇabhaṅgo dattajalāñjalir iti /	kzaNa-BaFgaH datta-jala-aQjaliH iti /
   (81.17) ayam eva codyaprabandho 'smad gurūbhiḥ saṃgṛhītaḥ /	(81.17) ayam eva codya-prabanDaH asmat gurUBiH saMgRhItaH /
   (81.18) nityaṃ nāsti na vā pratītiviṣayas tenāśrayāsiddhatā hetoḥ	(81.18) nityam na-asti na vA pratIti-vizayaH tena-ASraya-asidDa-tA hetoH
   svānubhavasya ca kṣatir ataḥ kṣiptaḥ sapakṣo 'pi ca / śūnyaṃ ca dvitayena	sva-anuBavasya ca kzatiH atas kziptaH sa-pakzaH api ca / SUnyam ca dvitayena
   sidhyati na cāsattāpi sattā yathā no nityena virodhasiddhir asatā śakṣā	siDyati na ca-asattA-api sattA yaTA naH nityena viroDa-sidDiH asatA SakzA
   kramāder api / iti (kṣaṇabhaṅgādhyāye) /	krama-AdeH api / iti (kzaNa-BaFga-aDyAye) /
   (81.23) atrocyate / iha vastuny api dharmidharmavyavahāro dṛṣṭo yathā gavi	(81.23) atra-ucyate / iha vastuni api Darmi-Darma-vyavahAraH dRzwaH yaTA gavi
   gotvam, paṭe śuklatvam turage gamanam ityādi / avastuny api	go-tvam, pawe Sukla-tvam turage gamanam ityAdi / avastuni api
   dharmidharmavyavahāro dṛṣṭo yathā śaśaviṣāṇe tīkṣṇatvābhāvo vandhyāputre	Darmi-Darma-vyavahAraH dRzwaH yaTA SaSa-vizANe tIkzNa-tva-aBAvaH vanDyA-putre
   vaktṛtvābhāvo gaganāravinde gandhābhāva ityādi / tatrāvastuni dharmitvaṃ	vaktR-tva-aBAvaH gagana-aravinde ganDa-aBAvaH ityAdi / tatra-avastuni Darmi-tvam
   nāstīti kiṃ vastudharmeṇa dharmitvaṃ nāsti / āhosvid avastudharmeṇāpi /	na-asti-iti kim vastu-DarmeNa Darmi-tvam na-asti / Ahosvit avastu-DarmeNa-api /
   (81.27) prathamapakṣe siddhasādhanam / dvitīyapakṣe tu svavacanavirodhaḥ /	(81.27) praTama-pakze sidDa-sADanam / dvitIya-pakze tu sva-vacana-viroDaH /
   yad āhur guravaḥ //	yat AhuH guravaH //
   (81.28) dharmasya kasya cid avastuni mānasiddhā bādhāvidhivyavahṛtiḥ kim	(81.28) Darmasya kasya cit avastuni mAna-sidDA bADA-viDi-vyavahRtiH kim
   ihāsti no vā kvāpy asti cet katham iyanti na dūṣaṇāni nāsty eva cet	iha-asti no vA kvApi asti ced kaTam iyanti na dUzaNAni na-asti eva ced-
   svavacanapratirodhasiddhiḥ /	sva-vacana-pratiroDa-sidDiH /
   (82.1) avastuno dharmitvasvīkārapūrvakatvasya vyāpakasyābhāvād	(82.1) avastunaH Darmi-tva-svIkAra-pUrvaka-tvasya vyApakasya-aBAvAt-
   āśrayāsiddhidūṣaṇasyānupanyāsaprasaṅga ity arthaḥ / yenaiva hi	ASraya-asidDi-dUzaNasya-anupanyAsa-prasaFgaH iti arTaH / yena-eva hi
   vacanenāvastuno dharmitvaṃ pratiṣidhyate / tenaivāvastuno dharmitvābhāvena	vacanena-avastunaH Darmi-tvam pratiziDyate / tena-eva-avastunaH Darmi-tva-aBAvena
   dharmeṇa dharmitvam abhyupagatam / paraṃ tu pratiṣidhyata iti vyaktam idam	DarmeNa Darmi-tvam aByupagatam / param tu pratiziDyate iti vyaktam idam
   īśvaraceṣṭitam / tathā hy avastuno dharmitvaṃ nāstīti vacanena	ISvara-cezwitam / taTA hi avastunaH Darmi-tvam na-asti-iti vacanena
   dharmitvābhāvaḥ kim avastuni vidhīyata, anyatra vā, na vā kva cid apīti	Darmi-tva-aBAvaH kim avastuni viDIyata, anyatra vA, na vA kva cit api-iti
   trayaḥ pakṣāḥ /	trayaH pakzAH /
   (82.6) prathamapakṣe 'vastuno na dharmitvaniṣedhaḥ / dharmitvābhāvasya	(82.6) praTama-pakze avastunaH na Darmi-tva-nizeDaH / Darmitva-aBAvasya
   dharmasya tatraiva vidhānāt /	Darmasya tatra-eva viDAnAt /
   (82.7) dvitīye 'vastuni kimāyātam / anyatra dharmitvābhāvavidhānāt /	(82.7) dvitIye avastuni kim-AyAtam / anyatra Darmi-tva-aBAva-viDAnAt /
   (82.8) tṛtīyas tu pakṣo vyartha eva nirāśrayatvād iti katham avastuno	(82.8) tRtIyaH tu pakzaH vyarTaH eva nirASraya-tvAt iti kaTam avastunaH-
   dharmitvaniṣedhaḥ / tasmād yathā pramāṇopanyāsaḥ prameyatvasvīkāra	Darmitva-nizeDaH / tasmAt yaTA pramANa-upanyAsaH prameya-tva-svIkAra
   pūrvakatvena vyāptaḥ, vācakaśabdopanyāso vā vācyasvīkārapūrvakatvena	pUrvaka-tvena vyAptaH, vAcaka-Sabda-upanyAsaH vA vAcya-svIkAra-pUrvaka-tvena
   vyāptas tathā 'vastuno dharmitvaṃ nāstīti vacanopanyāso 'vastuno	vyAptaH taTA avastunaH Darmi-tvam na-asti-iti vacana-upanyAsaH avastunaH-
   dharmitvasvīkārapūrvakatvena vyāptaḥ / anyathā tadvacanopanyāsasya	Darmi-tva-svIkAra-pUrvaka-tvena vyAptaH / anyaTA tad-vacana-upanyAsasya
   vyarthatvāt /	vyarTa-tvAt /
   (82.11) tad yadi vacanopanyāso vyāpyadharmas tadā 'vastuno	(82.11) tat yadi vacana-upanyAsaH vyApya-DarmaH tadA avastunaH-
   dharmitvasvīkāro 'pi vyāpakadharmo durvāraḥ / atha na vyāpakadharmaḥ, tadā	Darmi-tva-svIkAraH api vyApaka-DarmaH durvAraH / aTa na vyApaka-DarmaH, tadA
   vyāpyasyāpi vacanopanyāsasyāsambhava iti mūkataivātra balād āyāteti kathaṃ	vyApyasya-api vacana-upanyAsasya-asamBavaH iti mUka-tA-eva-atra balAt AyAta-iti kaTam
   na svavacanapratirodhasiddhiḥ /	na sva-vacana-pratiroDa-sidDiH /
   (82.15) yad āhācāryaḥ / na hy abruvan paraṃ bodhayitum īśaḥ / [a]bruvan vā	(82.15) yat Aha-AcAryaH / na hi abruvan param boDayitum ISaH / [a]bruvan vA
   doṣam imaṃ parihartum iti mahati saṃkaṭe praveśaḥ /	dozam imam parihartum iti mahati saMkawe praveSaH /
   (82.17) avastuprastāve sahṛdayānāṃ mūkataiva yujyate iti cet / aho mahad	(82.17) avastu-prastAve sahRdayAnAm mUkatA-eva yujyate iti ced / aho mahat-
   vaidagdhyam / avastuprastāve svayam eva yathāśakti valgitvā bhagno	vEdagDyam / avastu-prastAve svayam eva yaTASakti valgitvA BagnaH-
   mūkataiva nyāyaprāpteti paribhāyayā niḥsartum icchati / na cāvastuprastāvo	mUkatA-eva nyAya-prAptA-iti pariBAyayA niHsartum icCati / na ca-avastu-prastAvaH-
   rājadaṇḍena vinā caraṇamardanādināniṣṭimātreṇa vā pratiṣedhuṃ śakṣate /	rAja-daNxena vinA caraNa-mardana-AdinA-anizwi-mAtreNa vA pratizeDum Sakzate /
   tataś cātrāpi kramākramabhāvasya sādhanatve sattvābhāvasya ca sādhyatve	tatas ca-atra-api kramAkrama-BAvasya sADana-tve sattva-aBAvasya ca sADya-tve
   sandigdhavastubhāvasyāvastvātmano vā kṣaṇikasya dharmitvaṃ kena	sandigDa-vastu-BAvasya-avastu-AtmanaH vA kzaNikasya Darmi-tvam kena
   pratiṣidhyate /	pratiziDyate /
   (82.22) trividho hi dharmo dṛṣṭaḥ / kaś cit vastuniyato nīlādiḥ / kaś cid	(82.22) triviDaH hi DarmaH dRzwaH / kaH cit vastu-niyataH nIla-AdiH / kaH cit-
   avastuniyato yathā sarvopākhyāvirahaḥ / kaś cid ubhayasādhāraṇo yathā	avastu-niyataH yaTA sarva-upAKyA-virahaH / kaH cit uBaya-sADAraNaH yaTA
   'nupalabdhimātram / tatra vastudharmeṇāvastuno dharmitvaniṣedha iti yuktam	anupalabDi-mAtram / tatra vastu-DarmeNa-avastunaH Darmi-tva-nizeDaH iti yuktam
   / na tv avastudharmeṇa / vastvavastudharmeṇa vā /	/ na tu avastu-DarmeNa / vastu-avastu-DarmeNa vA /
   svavacanasyānupanyāsaprasaṅgād ity akṣaṇikasyābhāve sandehe 'pi vā	sva-vacanasya-anupanyAsa-prasaFgAt iti akzaNikasya-aBAve sandehe api vA
   'vastudharmeṇa dharmitvam avyāhatam iti nāyam āśrayāsiddho	avastu-DarmeNa Darmi-tvam avyAhatam iti na-ayam ASraya-asidDaH-
   vyāpakānupalambhaḥ /	vyApaka-anupalamBaH /
   (82.27) akṣaṇikāpratītāvāśrayasiddho hetur iti yuktam uktām / tadapratītau	(82.27) akzaNikA-pratItO=-ASraya-sidDaH hetuH iti yuktam uktAm / tad-apratItO
   tadvyavahārāyogāt / kevalam asau vyavahārāṅgabhūtā pratītir vastvavastunor	tad-vyavahArA-yogAt / kevalam asO vyavahAra-aFga-BUtA pratItiH vastu-avastunoH-
   ekarūpā na bhavati / sākṣāt pāramparyeṇa vastusāmarthyabhāvinī hi	eka-rUpA na Bavati / sAkzAt pAramparyeNa vastu-sAmarTya-BAvinI hi
   vastupratītiḥ / yathā pratyakṣam anumānaṃ pratyakṣapṛṣṭhabhāvi ca vikalpaḥ	vastu-pratItiH / yaTA pratyakzam anumAnam pratyakza-pRzWa-BAvi ca vikalpaH
   / avastunas tu sāmarthyābhāvād vikalpamātram eva pratītiḥ / vastuno hi	/ avastunaH tu sAmarTya-aBAvAt vikalpa-mAtram eva pratItiH / vastunaH hi
   vastubalabhāvinī pratītir yathā sākṣāt pratyakṣam, paramparayā	vastu-bala-BAvinI pratItiH yaTA sAkzAt pratyakzam, paramparayA
   tatpṛṣṭhabhāvī vikalpo 'numānaṃ ca / avastuno na vastubalabhāvinī pratītis	tad-pRzWa-BAvI vikalpaH anumAnam ca / avastunaH na vastu-bala-BAvinI pratIti-s
   tatkārakatvenāvastutvahāniprasaṅgāt / tasmād vikalpamātram evāvastunaḥ	tad-kAraka-tvena-avastu-tva-hAni-prasaFgAt / tasmAt vikalpa-mAtram eva-avastunaH
   pratītiḥ /	pratItiH /
   (83.4) na hy abhāvah kaś cid vigrahavān yaḥ sākṣātkartavyo 'pi tu	(83.4) na hi aBAvam kaH cit vigrahavAn yaH sAkzAt-kartavyaH api tu
   vyavahartavyaḥ / sa ca vyavahāro vikalpād api sidhyaty eva / anyathā	vyavahartavyaH / sa ca vyavahAraH vikalpAt api siDyati eva / anyaTA
   sarvajanaprasiddho 'vastuvyavahāro na syāt / iṣyate ca /	sarva-jana-prasidDaH avastu-vyavahAraH na syAt / izyate ca /
   (83.6) taddharmitvapratiṣedhānubandhād ity akāmenāpi vikalpamātrasiddho	(83.6) tad-Darmitva-pratizeDa-anubanDAt iti akAmena-api vikalpa-mAtra-sidDaH-
   'kṣaṇikaḥ svīkartavya iti nāyam apratītatvād apy āśrayāsiddho hetur	akzaNikaH svIkartavyaH iti na-ayam apratIta-tvAt api ASraya-asidDaH hetuH-
   vaktavyaḥ / tataś cākṣaṇikasya vikalpamātrasiddhatve yad uktam /	vaktavyaH / tatas ca-akzaNikasya vikalpa-mAtra-sidDa-tve yat uktam /
   (83.9) na kaś cid dhetur anāśrayaḥ vikalpamātrasiddhasya dharmiṇaḥ	(83.9) na kaH cit DetuH anASrayaH vikalpa-mAtra-sidDasya DarmiNaH
   sarvatra sulabhatvād iti /	sarvatra sulaBa-tvAt iti /
   (83.10) tad asaṅgatam / vikalpamātrasiddhasya dharmiṇaḥ sarvatra sambhave	(83.10) tat asaFgatam / vikalpa-mAtra-sidDasya DarmiNaH sarvatra samBave
   'pi vastudharmeṇa dharmitvāyogāt / vastudharmahetutvāpekṣaya	api vastu-DarmeNa Darmi-tva-ayogAt / vastu-Darma-hetu-tva-apekzaya
   āśrayāsiddhasyāpi hetoḥ sambhavāt /	ASraya-asidDasya-api hetoH samBavAt /
   (83.11) yathā ātmano vibhutvasādhanārtham upanyastaṃ	(83.11) yaTA AtmanaH viBu-tva-sADana-arTam upanyastam
   sarvatropalabhyamānaguṇatvād iti sādhanam / vikalpaś cāyaṃ hetūpanyāsāt /	sarvatra-upalaByamAna-guNa-tvAt iti sADanam / vikalpaH ca-ayam hetu-upanyAsAt /
   pūrvaṃ sandigdhavastukaḥ / samarthite tu hetāv avastuka iti brūmaḥ /	pUrvam sandigDa-vastukaH / samarTite tu hetO avastukaH iti brUmaH /
   (83.14) na cātra sandigdhāśrayatvaṃ nāma hetudoṣaḥ / āstāṃ tāvat /	(83.14) na ca-atra sandigDa-ASraya-tvam nAma hetu-dozaH / AstAm tAvat /
   sandigdhasyāvastuno 'pi vikalpamātrasiddhasyāvastudharmāpekṣayā	sandigDasya-avastunaH api vikalpa-mAtra-sidDasya-avastu-Darma-apekzayA
   dharmitvaprasādhanāt / vastudharmahetvapekṣayaiva sandigdhāśrayasya	Darmi-tva-prasADanAt / vastu-Darma-hetu-apekzayA-eva sandigDa-ASrayasya
   hetvābhāsasya vyavasthāpanāt / yatheha nikuñje mayūraḥ kekāyitād iti /	hetvABAsasya vyavasTApanAt / yaTA-iha nikuQje mayUraH kekAyitAt iti /
   avastukavikalpaviṣayasyāsattvaṃ tu vyāpakānupalambhād eva prasādhitam /	avastuka-vikalpa-vizayasya-asattvam tu vyApaka-anupalamBAt eva prasADitam /
   evaṃ dṛṣṭāntasyāpi vyomotpalāder dharmitvaṃ vikalpamātreṇa pratītiś	evam dRzwAntasya-api vyoma-utpala-AdeH Darmi-tvam vikalpa-mAtreNa pratItiH-
   cāvagantavyā / tad evam avastudharmāpekṣayā 'vastunodharmitvasya	ca-avagantavyA / tat evam avastu-Darma-apekzayA avastunaH-Darmi-tvasya
   vikalpamātreṇa pratīteś cāpahnotum aśakyatvān nāyam āśrayāsiddho hetuḥ /	vikalpa-mAtreNa pratIteH ca-apahnotum aSakya-tvAt na-ayam ASraya-asidDaH hetuH /
   na ca dṛṣṭāntakṣatiḥ /	na ca dRzwAnta-kzatiH /
   (83.20) na caiṣa svarūpāsiddhaḥ / akṣaṇike dharmiṇi kramākramayor	(83.20) na ca-eza svarUpa-asidDaH / akzaNike DarmiNi kramAkramayoH-
   vyāpakayor ayogāt / tathā hi yadi tasya prathame kṣaṇe	vyApakayoH ayogAt / taTA hi yadi tasya praTame kzaNe
   dvitīyādikṣaṇabhāvikāryakaraṇasāmarthyam asti tadā	dvitIya-Adi-kzaNa-BAvi-kArya-karaNa-sAmarTyam asti tadA
   prathamakṣaṇabhāvikāryavat dvitīyādikṣaṇabhāvyam api (?) kāryaṃ kuryāt /	praTama-kzaNa-BAvi-kArya-vat dvitIya-Adi-kzaNa-BAvyam api (?) kAryam kuryAt /
   samarthasya kṣepāyogāt /	samarTasya kzepA-yogAt /
   (83.22) atha tadā sahakārisākalyalakṣaṇasāmarthyaṃ nāsti /	(83.22) aTa tadA sahakAri-sAkalya-lakzaNa-sAmarTyam na-asti /
   tadvaikalyalakṣaṇasyāsāmarthyasya sambhavāt / na hi bhāvaḥ svarūpeṇa	tad-vEkalya-lakzaNasya-asAmarTyasya samBavAt / na hi BAvaH sva-rUpeNa
   karotīti svarūpeṇaiva karoti / sahakārisahitād eva tataḥ	karoti-iti sva-rUpeNa-eva karoti / sahakAri-sahitAt eva tatas-
   kāryotpattidarsanāt iti cet /	kArya-utpatti-darsanAt iti ced /
   (83.24) yadā tāvad amī militāḥ santaḥ kāryaṃ kurvate	(83.24) yadA tAvat amI militAH santaH kAryam kurvate
   tadaikārthakaraṇalakṣaṇaṃ sahakāritvam eṣām astu ko niṣeddhā / militair	tadA-eka-arTa-karaNa-lakzaNam sahakAri-tvam ezAm astu kaH nizedDA / militEH-
   eva tu tatkāryaṃ karttavyam iti kuto labhyate / pūrvāparakālayor	eva tu tat-kAryam karttavyam iti kutas laByate / pUrva-apara-kAlayoH-
   ekasvabhāvatvād bhāvasya / sarvadā jananājananayor	eka-svaBAva-tvAt BAvasya / sarvadA jananA-jananayoH-
   anyataraniyamaprasaṅgasya durvāratvāt / tasmāt sāmagrī janikā naikaṃ	anyatara-niyama-prasaFgasya durvAra-tvAt / tasmAt sAmagrI janikA na-ekam
   janakam iti sthiravādināṃ manorājyasyāpy aviṣayaḥ /	janakam iti sTira-vAdinAm manaH-rAjyasya-api avizayaH /
   (83.29) kiṃ kurmo dṛśyate tāvad evam iti cet / dṛśyatāṃ kiṃ tu	(83.29) kim kurmaH dRSyate tAvat evam iti ced / dRSyatAm kim tu
   pūrvasthitād eva paścāt sāmagrīmadhyapraviṣṭād bhāvāt kāryotpattir	pUrva-sTitAt eva paScAt sAmagrI-maDya-pravizwAt BAvAt kArya-utpattiH-
   anyasmād eva viśiṣṭasāmagrīsamutpannāt kṣaṇād iti vivādapadam etat / tatra	anyasmAt eva viSizwa-sAmagrI-samutpannAt kzaNAt iti vivAda-padam etat / tatra
   prāg api sambhave sarvadaiva kāryotpattir na vā kadā cid apīti virodham	prAk api samBave sarvadA-eva kArya-utpattiH na vA kadA cit api-iti viroDam
   asamādhāya tad eva kāryotpattir iti sādhyānuvādamātrapravṛttaḥ kṛpām	asamADAya tat eva kArya-utpattiH iti sADya-anuvAda-mAtra-pravRttaH kRpAm
   arhati /	arhati /
   (84.3) na ca pratyabhijñānād evaikatvasiddhiḥ / tat pauruṣasya	(84.3) na ca pratyaBijQAnAt eva-eka-tva-sidDiH / tat pOruzasya
   lūnapunarjātakeśakuśakadalīstambādau nirdalanāt / vistareṇa ca	lUna-punar-jAta-keSa-kuSa-kadalI-stamba-AdO nirdalanAt / vistareNa ca
   pratyabhijñādūṣaṇam asmābhiḥ sthirasiddhidūṣaṇe pratipāditam iti tad	pratyaBijQA-t-UzaNam asmABiH sTira-sidDi-dUzaNe pratipAditam iti tat-
   evāvadhāryam /	eva-avaDAryam /
   (84.6) nanu kāryam eva sahakāriṇam apekṣate / na tu kāryotpattihetuḥ /	(84.6) nanu kAryam eva sahakAriNam apekzate / na tu kArya-utpatti-hetuH /
   yasmād dvividhaṃ sāmarthyaṃ nijam āgantukaṃ ca sahakāryantaraṃ, tato	yasmAt dviviDam sAmarTyam nijam Agantukam ca sahakAri-antaran, tatas-
   'kṣaṇikasyāpi kramavat sahakārinānātvād api kramavat kāryanānātvam iti cet	akzaNikasya-api krama-vat sahakAri-nAnAtvAt api krama-vat kArya-nAnA-tvam iti ced-
   (84.8) bhavatu tāvat nijāgantukabhedena dvividhaṃ sāmarthyam / tathāpi tat	(84.8) Bavatu tAvat nija-Agantuka-Bedena dviviDam sAmarTyam / taTA-api tat-
   prātisvikaṃ vastusvalakṣaṇaṃ sadyaḥ kriyādharmakamavaśyābhyupagantavyam /	prAtisvikam vastu-sva-lakzaNam sadyas kriyA-Darmakam-avaSya-aByupagantavyam /
   tad yadi prāg api, prāg api kāryaprasaṅgaḥ / atha paścād eva, na tadā	tat yadi prAk api, prAk api kArya-prasaFgaH / aTa paScAt eva, na tadA
   sthiro bhāvaḥ /	sTiraH BAvaH /
   (84.11) na ca kāryaṃ sahakāriṇo 'pekṣata iti yuktam, tasyāsattvāt / hetuś	(84.11) na ca kAryam sahakAriNaH apekzate iti yuktam, tasya-asattvAt / hetuH-
   ca sann api yadi svakāryaṃ na karoti, tadā tatkāryam eva tan na syāt /	ca san api yadi sva-kAryam na karoti, tadA tad-kAryam eva tat na syAt /
   svātantryāt /	svAtantryAt /
   (84.13) yaccoktam / yo hi uttarakāryajananasvabhāvah / sa katham ādau	(84.13) yat-ca-uktam / yaH hi uttara-kArya-janana-svaBAvah / sa kaTam AdO
   kāryaṃ kuryāt / na tarhi tatkāryakaraṇasvabhāvaḥ / na hi	kAryam kuryAt / na tarhi tad-kArya-karaNa-svaBAvaH / na hi
   nīlotpādanasvabhāvaḥ pītādikam api karotīti /	nIla-utpAdana-svaBAvaH pIta-Adikam api karoti-iti /
   (84.15) tad asaṅgatam / sthirasvabhāvatve bhāvasyottarakālam evedaṃ na	(84.15) tat asaFgatam / sTira-svaBAva-tve BAvasya-uttarakAlam eva-idam na
   pūrvakālam iti kuta etat / tadabhāvāc ca kāraṇam apy uttarakāryasvabhāvam	pUrva-kAlam iti kutas etat / tad-aBAvAt ca kAraNam api uttara-kArya-svaBAvam
   ity api kutaḥ /	iti api kutas /
   (84.17) kiṃ kurmaḥ / uttarakālam eva tasya janmeti cet / sthiratve	(84.17) kim kurmaH / uttarakAlam eva tasya janma-iti ced / sTira-tve
   tadanupapadyamānam asthiratām ādiśatu / sthiratve 'py eṣa eva svabhāvas	tat-anupapadyamAnam asTira-tAm AdiSatu / sTira-tve api ezaH eva svaBAvaH-
   tasya yad uttarakṣaṇa eva kāryaṃ karotīti cet / na, pramāṇabādhite	tasya yat uttarakzaNaH eva kAryam karoti-iti ced / na, pramANa-bADite
   svabhāvābhyupagamāyogād iti na tāvad akṣaṇikasya kramikāryakāritvam asti /	svaBAva-aByupagamA-yogAt iti na tAvat akzaNikasya krami-kArya-kAri-tvam asti /
   nāpyakramikāryakāritvasambhavaḥ / dvitīye 'pi kṣaṇe kārakasvarūpasadbhāve	na-api-akrami-kArya-kAri-tva-samBavaH / dvitIye api kzaNe kAraka-svarUpa-sadBAve
   punar api kāryakaraṇaprasaṅgāt /	punar api kArya-karaNa-prasaFgAt /
   (84.21) kārye niṣpanne tadviṣayavyāpārābhāvād ūnā sāmagrī na niṣpāditaṃ	(84.21) kArye nizpanne tad-vizaya-vyApAra-aBAvAt UnA sAmagrI na nizpAditam
   niṣpādayed iti cet / na, sāmagrīsambhavāsambhavayor api sadyaḥ	nizpAdayet iti ced / na, sAmagrI-samBava-asamBavayoH api sadyas-
   kriyākārakasvarūpasambhave janakatvam avadhāryam iti prāg eva pratipādanāt	kriyA-kAraka-svarUpa-samBave janaka-tvam avaDAryam iti prAk eva pratipAdanAt-
   / kāryasya hi niṣpāditatvāt punaḥ kartum aśakyatvam eva kāraṇam asamartham	/ kAryasya hi nizpAdita-tvAt punar kartum aSakya-tvam eva kAraNam asamarTam
   āvedayati /	Avedayati /
   (84.23) tad ayam akṣaṇike kramākramikāryakāritvābhāvo na siddhaḥ / na ca	(84.23) tat ayam akzaNike krama-Akrami-kArya-kAritva-aBAvaH na sidDaH / na ca
   kramākramābhyām aparaprakārasambhavo yena tābhyām avyāptau	krama-AkramAByAm apara-prakAra-samBavaH yena tAByAm avyAptO
   sandigdhavyatireko hetuḥ syāt / prakārāntaraśaṅkāyāṃ tasyāpi	sandigDa-vyatirekaH hetuH syAt / prakAra-antara-SaFkAyAm tasya-api
   dṛśyatvādṛśyatvaprakāradvayadūṣaṇe 'pi svapakṣe 'py anāśvāsaprasaṅgāt /	dRSya-tvAdRSya-tva-prakAra-dvaya-dUzaNe api sva-pakze api anASvAsa-prasaFgAt /
   tasmād anyo 'nyavyavacchedasthitir nāparaḥ prakāraḥ sambhavati /	tasmAt anyaH anya-vyavacCeda-sTitiH na-aparaH prakAraH samBavati /
   svarūpāpraviṣṭasya vastuno 'vastuno vā 'tatsvabhāvatvāt /	svarUpa-apravizwasya vastunaH avastunaH vA atad-svaBAva-tvAt /
   prakārāntarasyāpi kramasvarūpāpraviṣṭatvāt / tathātīndriyasya sahakāriṇo	prakAra-antarasya-api krama-svarUpa-apravizwa-tvAt / taTA-atIndriyasya sahakAriNaH-
   'dṛśyatve 'pyayogavyavacchedena dṛśyasahakārisahitasya sattvasya	adRSya-tve api-ayoga-vyavacCedena dRSya-sahakAri-sahitasya sattvasya
   dṛśyakramākramābhyāṃ vyāptiḥ pratyakṣād eva sidhyati / evaṃ	dRSya-krama-AkramAByAm vyAptiH pratyakzAt eva siDyati / evam
   kramākramābhyām arthakriyākāritvaṃ vyāptam iti kramākramayor anyo	krama-AkramAByAm arTa-kriyA-kAritvam vyAptam iti kramAkramayoH anyaH-
   'nyavyavacchedena sthitatvād etat prakāradvayaparihāreṇārthākriyakāritvam	anya-vyavacCedena sTita-tvAt etat prakAra-dvaya-parihAreNa-arTa-akriya-kAri-tvam
   anyatra na gatam ity arthaḥ / ata evaitayor vinivṛttau nivartate /	anyatra na gatam iti arTaH / atas eva-etayoH vinivRttO nivartate /
   (85.4) trilocanasyāpi vikalpatraye prathamadūṣaṇam	(85.4) trilocanasya-api vikalpa-traye praTama-dUzaNam
   āśrayāsiddhidoṣaparihārato nirastam /	ASraya-asidDi-doza-parihArataH nirastam /
   (85.5) dvitīyaṃ cāsaṅgatam / vikalpajñānena vyatirekasya pratītatvāt / na	(85.5) dvitIyam ca-asaFgatam / vikalpa-jQAnena vyatirekasya pratIta-tvAt / na
   hy abhāvaḥ kaś cid vigrahavān yaḥ sākṣatkartavyaḥ, api tu vikalpād eva	hi aBAvaH kaH cit vigrahavAn yaH sAkzatkartavyaH, api tu vikalpAt eva
   vyavahartavyaḥ / na hy abhāvasya vikalpād anyāpratipattir apratipattir vā	vyavahartavyaH / na hi aBAvasya vikalpAt anya-apratipattiH apratipattiH vA
   sarvathā / ubhayathāpi tadvyavahārahāniprasaṅgāt / evaṃ	sarvaTA / uBayaTA-api tad-vyavahAra-hAni-prasaFgAt / evam
   vaidharmyadṛṣṭāntasya hetuvyatirekasya ca vikalpād eva pratipattiḥ.4 /	vEDarmya-dRzwAntasya hetu-vyatirekasya ca vikalpAt eva pratipattiH.4 /
   (85.9) tṛtīyam api dūṣaṇam asaṅgatam / vyāpakānupalambhena nirdoṣeṇa	(85.9) tRtIyam api dUzaNam asaFgatam / vyApakAn-upalamBena nirdozeNa
   sattvasya kṣaṇikatvena vyāpter avyāhatatvāt /	sattvasya kzaNika-tvena vyApteH avyAhata-tvAt /
   (85.11) tad ayaṃ vyāpakānupalambho 'kṣaṇikasyāsattvam / sattvasya tato	(85.11) tat ayam vyApaka-anupalamBaH akzaNikasya-asattvam / sattvasya tatas-
   vyatirekaṃ kṣaṇikatvena vyāptiṃ ca sādhayatyekavyāpārātmakatvād iti	vyatirekam kzaNika-tvena vyAptim ca sADayati-eka-vyApAra-Atmaka-tvAt iti
   sthitam /	sTitam /
   (85.13) nanu vyāpakānupalabdhir iti yady anupalabdhimātraṃ tadā na tasya	(85.13) nanu vyApaka-anupalabDiH iti yadi anupalabDi-mAtram tadA na tasya
   sādhyabuddhijanakatvam avastutvāt / na cānyopalabdhir vyāpakānupalabdhir	sADya-budDi-janaka-tvam avastu-tvAt / na ca-anya-upalabDiH vyApaka-anupalabDiH-
   abhidhātuṃ śakyā bhūtalādivad anyasya kasya cid anupalabdher iti cet /	aBiDAtum SakyA BU-tala-Adi-vat anyasya kasya cit anupalabDeH iti ced /
   (85.15) tad asaṅgatam / dharmyupalabdher evānyatrānupalabdhitayā	(85.15) tat asaFgatam / DarmI-upalabDeH eva-anyatra-anupalabDi-tayA
   vyavasthāpanāt / yathā hi neha śiṃśapā vṛkṣābhāvād ity atra vṛkṣāpekṣayā	vyavasTApanAt / yaTA hi na-iha SiMSapA vRkza-aBAvAt iti atra vRkza-apekzayA
   kevalapradeśasya dharmiṇa upalabdhir vṛkṣānupalabdhiḥ / śiṃśapāpeksayā ca	kevala-pradeSasya DarmiNaH upalabDiH vRkza-anupalabDiH / SiMSapA-apeksayA ca
   kevalapradeśasya dharmiṇa upalabdhir eva śiṃśapāyā abhāvopalabdhir iti	kevala-pradeSasya DarmiNaH upalabDiH eva SiMSapAyAH aBAva-upalabDiH iti
   svabhāvahetuparyavasāyivyāpāro vyāpakānupalambhaḥ / tathā nityasya	svaBAva-hetu-paryavasAyi-vyApAraH vyApaka-anupalamBaH / taTA nityasya
   dharmiṇo vikalpabuddhyavasitasya kramikāritvākramikāritvāpekṣayā	DarmiNaH vikalpa-budDi-avasitasya kramikAri-tvA-krami-kAritva-apekzayA
   kevalagrahaṇād eva kramikāritvākramikāritvānupalambhaḥ / arthakriyāpekṣayā	kevala-grahaNAt eva kramikAri-tvA-krami-kAritvA-anupalamBaH / arTa-kriyA-apekzayA
   ca kevalapratītir evārthakriyāyoga pratītir iti vyāpakānupalambhāntarād	ca kevala-pratItiH eva-arTa-kriyA-yoga pratItiH iti vyApaka-anupalamBa-antarAt-
   asya na kaś cid viśeṣaḥ /	asya na kaH cit viSezaH /
   (85.22) adhyavasāyāpekṣayā ca bāhye 'kṣaṇike vastuni vyāpakābhāvād	(85.22) aDyavasAya-apekzayA ca bAhye akzaNike vastuni vyApaka-aBAvAt-
   vyāpyābhāvasiddhivyavahāraḥ / adhyavasāyaś ca samanantarapratyayabalād	vyApya-aBAva-sidDi-vyavahAraH / aDyavasAyaH ca samanantara-pratyaya-balAt-
   āyātākāraviśeṣayogād agṛhīte 'pi pravartanaśaktir bodhavyaḥ / īdṛśaś	AyAta-AkAra-viSeza-yogAt agRhIte api pravartana-SaktiH boDavyaH / IdRSaH-
   cādhyavasāyo 'smaccitrādvaitasiddhau nirvāhitaḥ / sa cāvisaṃvādī	ca-aDyavasAyaH asmad-citrA-dvEta-sidDO nirvAhitaH / sa ca-avisaMvAdI
   vyavahāraḥ parihartum aśakyaḥ / yad vyāpakaśūnyaṃ tadvyāpyaśūnyam iti /	vyavahAraH parihartum aSakyaH / yat vyApaka-SUnyam tat-vyApya-SUnyam iti /
   etasyaivārthasyānenāpi krameṇa pratipādanāt / ayaṃ ca nyāyo yathā	etasya-eva-arTasya-anena-api krameNa pratipAdanAt / ayam ca nyAyaH yaTA
   vastubhūte dharmiṇi tathā 'vastubhūte 'pīti ko viśeṣaḥ /	vastu-BUte DarmiNi taTA avastu-BUte api-iti kaH viSezaH /
   (85.27) tathā hy ekajñānasaṃsargy atra vikalpya eva / yathā ca	(85.27) taTA hi eka-jQAna-saMsargi atra vikalpya eva / yaTA ca
   hariṇaśirasi tenaikajñānasaṃsargiśṛṅgam upalabdhaṃ / śaśaśirasy api tena	hariNa-Sirasi tena-eka-jQAna-saMsargi-SRFgam upalabDam / SaSaSirasi api tena
   sahaikajñānasaṃsargitvasambhāvanayaiva śṛṅgaṃ niṣidhyate, tathā nīlādāv	saha-eka-jQAna-saMsargi-tva-samBA-avanayA-eva SRFgam niziDyate, taTA nIla-AdO=-
   apariniṣṭhitanityānityabhāve kramākramau svadharmiṇā sārdham	aparinizWita-nitya-aniti-aBAve kramAkramO svaDarmiNA sArDam
   ekajñānasaṃsargiṇau dṛṣṭau, yadi nitye bhavataḥ nityagrāhijñāne	eka-jQAna-saMsargiNO dRzwO, yadi nitye BavataH nitya-grAhi-jQAne
   svadharmiṇā nityena sahaiva gṛhyeyātām iti sambhāvanaya	sva-DarmiNA nityena saha-eva gRhyeyAtAm iti samBA-avanaya
   ekājñānasaṃsargadvārakam eva pratiṣidhyate / kathaṃ punar etasmin	eka-ajQAna-saMsarga-dvArakam eva pratiziDyate / kaTam punar etasmin
   nityajñāne kramākramayor asphuraṇam iti yāvatā kramākramakroḍikṛtam eva	nitya-jQAne kramAkramayoH asPuraNam iti yAvatA krama-Akrama-kroxi-kRtam eva
   nityaṃ vikalpayām iti cet. ata eva bādhakāvatāro viparītāropam antareṇa	nityam vikalpayAm iti cet. atas eva bADaka-avatAraH viparIta-Aropam antareNa
   tasya vaiyarthyāt.	tasya vEyarTyAt.
   (86.6) kālāntare 'py ekarūpatayā nityatvam. kramākramau ca kṣaṇadvaye	(86.6) kAla-antare api eka-rUpa-tayA nitya-tvam. krama-AkramO ca kzaNa-dvaye
   bhinnarūpatayā. tato nityatvasya kramākramikāryaśakteś ca	Binna-rUpatayA. tatas nitya-tvasya krama-Akrami-kArya-SakteH ca
   parasparaparihārasthitilakṣaṇatayā durvāro virodha iti kathaṃ nitye	paraspara-parihAra-sTiti-lakzaNa-tayA durvAraH viroDaH iti kaTam nitye
   kramākramayor antarbhāvaḥ. anantarbhāvāc ca suddhanityavikalpena	kramAkramayoH antarBAvaH. anantarBAvAt ca sudDa-nitya-vikalpena
   dūrīkṛtakramākramasamāropeṇa katham ullekhaḥ. tataś ca pratiyogini nitye	dUrIkRta-krama-Akrama-samAropeNa kaTam ulleKaH. tatas ca pratiyogini nitye
   'pi vikalpyamāne ekajñānasaṃsargilakṣaṇaprāpte nityopalabdhir eva	api vikalpyamAne eka-jQAna-saMsargi-lakzaNa-prApte nitya-upalabDiH eva
   nityaviruddhasyānupalabhyamānasya kramākramasyānupalabdhiḥ. tata eva	nitya-virudDasya-anupalaByamAnasya krama-Akramasya-anupalabDiH. tatas eva
   cārthakriyāśakter anupalabdhiḥ. tasmād vyāpakavivekidharmyupalabdhitayā na	ca-arTa-kriyA-SakteH anupalabDiH. tasmAt vyApaka-viveki-DarmI-upalabDi-tayA na
   vyāpakānupalambhāntarād asya viśeṣaḥ.	vyApaka-anupalamBa-antarAt asya viSezaH.
   (86.13) nanv etad avastudharmikopayogi vastv adhiṣṭhānatvāt	(86.13) nanu etat avastuDarmikA-upayogi vastu aDizWAna-tvAt-
   pramāṇavyavasthāyā iti cet. kim idaṃ vastvadhiṣṭhānatvam nāma. kiṃ	pramANa-vyavasTAyAH iti cet. kim idam vastu-aDizWAna-tvam nAma. kim
   paramparayāpi vastunaḥ sakāśād āgatatvam, atha vastuni kena cid ākāreṇa	paramparayA-api vastunaH sakASAt Agata-tvam, aTa vastuni kena cit AkAreNa
   vyavahārakāraṇatvam, vastubhūtadharmipratibaddhatvaṃ vā.	vyavahAra-kAraNa-tvam, vastu-BUta-Darmi-pratibadDa-tvam vA.
   (86.16) yady ādyaḥ pakṣas tadā kramākramasyārthakriyāyāś ca	(86.16) yadi AdyaH pakzaH tadA krama-Akramasya-arTa-kriyAyAH ca
   vyāptigrahaṇagocaravastupratibaddhatvam asyāpi. na kṣīṇam.	vyApti-grahaNa-gocara-vastu-pratibadDa-tvam asya-api. na kzINam.
   (86.18) na dvitīye 'pi pakṣe dosah sambhavati. kṣaṇabhaṅgivastu	(86.18) na dvitIye api pakze dosah samBavati. kzaNa-BaFgi-vaH-tu
   sādhanopāyatvād asya.	sADana-upAya-tvAt asya.
   (86.19) na cāntimo 'pi vikalpaḥ kalpyate. tasyaiva nityavikalpasya vastuno	(86.19) na ca-antimaH api vikalpaH kalpyate. tasya-eva nitya-vikalpasya vastunaH-
   dharmibhūtasya kramākramavad bāhyanityopādānaśūnyatvenārthakriyāvad	Darmi-BUtasya kramAkrama-vat bAhya-nitya-upAdAna-SUnya-tvena-arTa-kriyA-vat-
   bāhyanityopādānaśūnyatve prasādhanāt. paryudāsavṛttyā	bAhya-nitya-upAdAna-SUnya-tve prasADanAt. paryudAsa-vRttyA
   buddhisvabhāvabhūtākṣaṇikākāre vastubhūte dharmiṇi	budDi-svaBAva-BUta-akzaNikA-AkAre vastu-BUte DarmiNi
   pratibaddhatvasambhavāt.	pratibadDa-tva-samBavAt-.
   (86.23) ayam eva nyāyo na vaktā vandhyāsutaś caitanyābhāvād ityādau	(86.23) ayam eva nyAyaH na vaktA vanDyA-sutaH cEtanya-aBAvAt iti-AdO
   yojyaḥ. etena yathā vṛkṣābhāvādir antarbhāvayituṃ śakyate na tathāyam iti	yojyaH. etena yaTA vRkza-aBAva-AdiH antar-BAvayitum Sakyate na taTA-ayam iti
   trilocano 'pi nirastaḥ.	trilocanaH api nirastaH.
   (86.25) na ca kramādyabhāvas trayīṃ doṣajātiṃ nātikrāmati, abhāvadharmatve	(86.25) na ca krama-Adi-aBAvaH trayIm doza-jAtim na-atikrAmati, aBAva-Darma-tve
   'pi āśrayāsiddhidoṣaparihārāt.	api ASraya-asidDi-doza-parihArAt.
   (86.26) yat tvanena pramāṇāntarān nityānām asattvasiddhau	(86.26) yat tu-anena pramANa-antarAt nityAnAm asattva-sidDO
   kramādivirahasyābhāvadharmatā sidhyatīty uktam, tadvālasyāpi	krama-Adi-virahasya-aBAva-DarmatA siDyati-iti uktam, tad-vAlasya-api
   durabhidhānam. nityo hi dharmi. asattvaṃ sādhyam.	duraBiDAnam. nityaH hi Darmi. asattvam sADyam.
   kramikāryakāritvākramikāryakāritvaviraho hetuḥ. asya cābhāvadharmatvaṃ	krami-kArya-kAri-tva-Akrami-kArya-kAri-tva-virahaH hetuH. asya ca-aBAva-Darma-tvam
   nāma asattvalakṣaṇasvasādhyāvinābhāvitvam ucyate. tac ca kramākrameṇa	nAma asattva-lakzaNasvasADya-avinABAvi-tvam ucyate. tat ca kramAkrameNa
   sattvasya vyāptisiddhau sattvasya vyāpyasyābhāvena kramākramasya	sattvasya vyApti-sidDO sattvasya vyApyasya-aBAvena krama-Akramasya
   vyāpakasya viraho vyāptaḥ sidhyatīty abhāvadharmatvaṃ prāg eva vidhyor	vyApakasya virahaH vyAptaH siDyati-iti aBAva-Darma-tvam prAk eva viDyoH-
   vyāptisādhanāt pratyakṣād anumānād ekasmād vā pramāṇāntarāt siddham iti	vyApti-sADanAt pratyakzAt anumAnAt ekasmAt vA pramANa-antarAt sidDam iti
   netaretarāśrayadoṣaḥ.	na-itaretara-ASraya-dozaH.
   (87.7) na ca sattāyām ivāsattāyām api tulyaḥ prasaṅgo bhinnanyāyatvāt.	(87.7) na ca sattAyAm iva-asattAyAm api tulyaH prasaFgaH Binna-nyAya-tvAt.
   vastubhūtaṃ hi tatra sādhyaṃ sādhanaṃ ca. tayor dharmy api vastv eva	vastu-BUtam hi tatra sADyam sADanam ca. tayoH DarmI api vastu eva
   yujyate.	yujyate.
   (87.9) vastunas tu pratyakṣānumānābhyām eva siddhiḥ. tayor abhāve	(87.9) vastunaH tu pratyakza-anumAnAByAm eva sidDiH. tayoH aBAve
   niyamenāśrayāsiddhir iti yuktam. asattāsādhane tv avastudharmo hetur	niyamena-ASraya-asidDiH iti yuktam. asattA-sADane tu avastu-DarmaH hetuH-
   avastu vikalpamātrasiddhe dharmiṇi nāśrayāsiddhidoṣeṇa dūṣayituṃ śakyaḥ.	avastu vikalpa-mAtra-sidDe DarmiNi na-ASraya-asidDi-dozeNa dUzayitum SakyaH.
   tathā 'kṣaṇikasya kramayaugapadyābhyāmarthakriyāvirodhaḥ sidhyaty eva.	taTA akzaNikasya krama-yOgapadyAByAm-arTa-kriyA-viroDaH siDyati eva.
   (87.13) tathā vikalpādevākṣaṇiko virodhī siddhaḥ. vikalpollikhitaś cāsya	(87.13) taTA vikalpAt-eva-akzaNikaH viroDI sidDaH. vikalpa-ulliKitaH ca-asya
   svabhāvo nāpara ity api vyavahartavyam. anyathā tadanuvādena	svaBAvaH na-aparaH iti api vyavahartavyam. anyaTA tad-anuvAdena
   kramākramādirahitatvādiniṣedhādikam uktam. tatsvarūpasyānullekhād	krama-Akrama-Adi-rahita-tva-Adi-nizeDa-Adikam uktam. tad-svarUpasya-anulleKAd
   anyasyollekhād ity akṣaṇikaśaśaviṣāṇādiśabdānuccāraṇaprasaṅgaḥ. asti ca.	anyasya-ulleKAt iti akzaNika-SaSa-vizANa-Adi-SabdAn-uccAraNa-prasaFgaH. asti ca.
   ato yathā pramāṇābhāve 'pi vikalpasiddhasya vandhyāsutādeḥ	atas yaTA pramANa-aBAve api vikalpa-sidDasya vanDyA-suta-AdeH
   saundaryādiniṣedho 'nurūpas tathā vikalpopanītasyaivākṣaṇikarūpasya tad	sOndarya-Adi-nizeDaH anurUpaH taTA vikalpa-upanItasya-eva-akzaNika-rUpasya tat-
   eva pratyanīkākāreṇa saha virodhavyavasthāyāṃ kīdṛso doṣaḥ syāt. yadi	eva pratyanIka-AkAreNa saha viroDa-vyavasTAyAm kIdRsaH dozaH syAt. yadi
   cākṣaṇikānubhavābhāvāt virodhapratiṣedhas tarhi vandhyāputrādyanubhavād	ca-akzaNikA-anuBava-aBAvAt viroDa-pratizeDaH tarhi vanDyA-putra-Adi-anuBavAt-
   eva saundaryādiniṣedho 'pi mābhūt.	eva sOndarya-Adi-nizeDaH api mA-aBUt.
   (87.20) nanv evaṃ virodhasyāpāramārthikatvam. taddvāreṇa	(87.20) nanu evam viroDasya-apAram-ArTika-tvam. tad-dvAreNa
   kṣaṇabhaṅgasiddhir apy apāramārthikī syād iti cet.	kzaNa-BaFga-sidDiH api apAramArTikI syAt iti ced-.
   (87.21) na hi virodho nāma vastvantaraṃ kiñcit	(87.21) na hi viroDaH nAma vastu-antaram kiQcid-
   ubhayakoṭidattapādasambandhābhidhānam iṣyate, 'smābhir upapadyate vā.	uBaya-kowi-datta-pAda-sambanDa-aBiDAnam izyate, asmABiH upapadyate vA.
   yenaikasambandhino vastutvābhāve 'pāramārthikaṃ syāt. yathā tv iṣyate	yena-eka-sambanDinaH vastu-tva-aBAve apAramArTikam syAt. yaTA tu izyate
   tathā pāramārthika eva / viruddhābhimatayor anyo 'nyasvarūpaparihāramātraṃ	taTA pAramArTikaH eva / virudDa-aBimatayoH anyaH anya-svarUpa-parihAra-mAtram
   virodhārthaḥ / sa ca bhāvābhāvayoḥ pāramārthika eva / na bhāvo 'bhāvarūpam	viroDa-arTaH / sa ca BAva-aBAvayoH pAramArTikaH eva / na BAvaH aBAva-rUpam
   āviśati / nāpy abhāvo bhāvarūpaṃ praviśatīti yo 'yam anayor	AviSati / na-api aBAvaH BAva-rUpam praviSati-iti yaH ayam anayoH-
   asaṃkaraniyamaḥ sa eva pāramārthiko virodhaḥ / kālāntaraikarūpatayā hi	asaMkara-niyamaH saH eva pAramArTikaH viroDaH / kAla-antara-eka-rUpatayA hi
   nityatvam / kramākramau kṣaṇadvaye 'pi bhinnarūpatayā / tato	nitya-tvam / kramAkramO kzaNa-dvaye api Binna-rUpa-tayA / tatas-
   nityatvakramākramikāryakāritvayor bhāvābhāvavad virodho 'sty eva /	nitya-tva-krama-Akrami-kArya-kAri-tvayoH BAva-aBAva-vat viroDaH asti eva /
   (88.1) nanu nityatvaṃ kramayaugapadyavattvaṃ ca viruddhau dharmau vidhūya	(88.1) nanu nitya-tvam krama-yOgapadyavat-tvam ca virudDO DarmO viDUya
   nāparo virodho nāma, kasya vāstavatvam iti cet /	na-aparaH viroDaH nAma, kasya vAstava-tvam iti ced /
   (88.2) na, na hi dharmāntarasya sambhavena virodhasya pāramārthikatvaṃ	(88.2) na, na hi Darma-antarasya samBavena viroDasya pAramArTika-tvam
   brūmaḥ / kiṃ tu viruddhayor dharmayoḥ sadbhāve / anyathā	brUmaH / kim tu virudDayoH DarmayoH sadBAve / anyaTA
   virodhanāmadharmāntarasambhave 'pi yadi na viruddhau dharmau kva	viroDa-nAma-Darma-antara-samBave api yadi na virudDO DarmO kva
   pāramārthikavirodhasambhavaḥ / viruddhau ced dharmau tāvataiva tāttviko	pAramArTika-viroDa-samBavaH / virudDO ced DarmO tAvatA-eva tAttvikaH-
   virodhavyavahāraḥ / kim apareṇa pratijñāmātrasiddhena virodhanāmnā	viroDa-vyavahAraH / kim apareNa pratijQA-mAtra-sidDena viroDa-nAmnA
   vastvantareṇa /	vastu-antareNa /
   (88.7) tad ayaṃ pūrvapakṣasaṃkṣepaḥ / nityaṃ nāsti na vā pratītiviṣayas	(88.7) tat ayam pUrva-pakza-saMkzepaH / nityam na-asti na vA pratIti-vizaya-s
   tenāśrayāsiddhatā hetoḥ svānubhavasya ca kṣatir ataḥ kṣiptaḥ sapakṣo 'pi	tena-ASraya-asidDa-tA hetoH sva-anuBavasya ca kzatiH atas kziptaH sa-pakzaH api
   ca / śūnyaś ca dvitayena sidhyati na vā 'sattā 'pi sattā yathā no nityena	ca / SUnyaH ca dvitayena siDyati na vA asattA api sattA yaTA naH nityena
   virodhasiddhir asatā śakyā kramāder api / iti /	viroDa-sidDiH asatA SakyA krama-AdeH api / iti /
   (88.12) atra siddhāntasaṃkṣepaḥ / dharmasya kasya cid avastuni mānasiddhā	(88.12) atra sidDAnta-saMkzepaH / Darmasya kasya cit avastuni mAna-sidDA
   bādhāvidhivyavahṛtiḥ kim ihāsti no vā / kvāpy asti cet katham iyanti na	bADA-viDi-vyavahRtiH kim iha-asti naH vA / kvApi asti ced kaTam iyanti na
   dūṣaṇāni nāsty eva cet svavacanapratirodhasiddhiḥ /	dUzaNAni na-asti eva ced sva-vacana-pratiroDa-sidDiH /
   (88.17) tad vam nityaṃ na kramikāryakāritvākramikāryakāritvayogīti	(88.17) tat vam nityam na krami-kArya-kAri-tva-Akrami-kArya-kAri-tva-yogi-iti
   paramārthaḥ / tataś ca sattāyuktam api naiveti paramārthaḥ / tataś ca	parama-arTaH / tatas ca sattA-yuktam api na-eva-iti parama-arTaH / tatas ca
   kṣaṇikākṣaṇikaparihāreṇa rāśyantarābhāvād akṣaṇikān nivartamānam idaṃ	kzaNikA-kzaNika-parihAreNa rASi-antara-aBAvAt akzaNikAn nivartamAnam idam
   sattvaṃ kṣaṇika eva viśrāmyatvena vyāptaṃ sidhyatīti sattvāt	sattvam kzaNikaH eva viSrAmya-tvena vyAptam siDyati-iti sattvAt-
   kṣaṇikatvasiddhir avirodhini /	kzaNika-tva-sidDiH aviroDini /
   (88.21) prakṛtiḥ sarvadharmāṇaṃ yad bodhān muktir iṣyate / sa eva	(88.21) prakRtiH sarva-DarmANam yat boDAt muktiH izyate / saH eva
   tīrthyanirmāthī kṣaṇabhaṅgaḥ prasāditaḥ /	tIrTya-nirmATI kzaNa-BaFgaH prasAditaH /
   (88.23) iti kṛtir iyaṃ ratnakīrteḥ /	(88.23) iti kRtiH iyam ratna-kIrteH /
