   Vārāhagṛhyasūtra, 1	VArAha-gRhya-sUtra, 1
   ataḥ paraṃ pariśiṣṭā maitrāyaṇīyasūtrasya /	atas param pariSizwAH mEtrAyaNIya-sUtrasya /
   gṛhyapuruṣaḥ prāyaścittam	gRhya-puruzaH prAyaScittam
   anugrahikahautṛkaśulvikottareṣṭakavaiṣṇavādhvaryavikacāturhotṛkagonāmikākulapādarahasyapratigrahayamakavṛṣotsargapraśnadraviṇaṣaṭkāraṇapradhānasāṃdehikapravarādhyāyarudravidhānachando'nukramaṇyantarkyakalpapravāsavidhiprātarupasthānabhūtotpattir	anugrahika-hOtRka-SulvikA-uttara-izwaka-vEzNava-aDvarya-vikacA-turhotRka-gonAmikA-Akula-pAda-rahasya-pratigraha-yamaka-vRza-utsarga-praSna-draviNa-zawk
   iti dvāviṃśatiḥ pariśiṣṭasaṃkhyānām // VGrs_1.1	iti dvAviMSatiH pariSizwa-saMKyAnAm // VGrH-_1.1
   gṛhye 'gnau pākayajñān viharet // VGrs_1.2	gRhye agnO pAkayajQAn viharet // VGrH-_1.2
   hrasvatvāt pākayajñaḥ /	hrasva-tvAt pAkayajQaH /
   hrasvaṃ hi pāka ityācakṣate // VGrs_1.3	hrasvam hi pAkaH iti-Acakzate // VGrH-_1.3
   darśapūrṇamāsaprakṛtiḥ pākayajñavidhir aprayājo 'nanuyājo 'sāmidhenīkaḥ //	darSa-pUrNamAsa-prakRtiH pAkayajQa-viDiH aprayAjaH ananuyAjaH asAmiDenIkaH //
   VGrs_1.4	VGrH-_1.4
   svāhākārāntaṃ nigadya homāḥ // VGrs_1.5	svAhAkAra-antam nigadya homAH // VGrH-_1.5
   paratantrotpattir dakṣiṇāgnāv āhitāgniḥ kurvīta śālāgnāv anāhitāgniḥ //	paratantra-utpattiH dakziNa-agnO AhitAgniH kurvIta SAlAgnO anAhitAgniH //
   VGrs_1.6	VGrH-_1.6
   gomayena gocarmamātraṃ caturasraṃ sthaṇḍilam upalipyeṣumātraṃ tasmin	gomayena gocarma-mAtram catur-asram sTaNxilam upalipya-izu-mAtram tasmin
   lakṣaṇaṃ kurvīta satyasadasīti paścārdhād udīcīṃ lekhāṃ likhati /	lakzaNam kurvIta satya-sadasi-iti paSca-arDAt udIcIm leKAm liKati /
   ṛtasadasīti dakṣiṇārdhāt prācīm /	Rtasat-asi-iti dakziNa-arDAt prAcIm /
   gharmasadasīty uttarārdhāt prācīm /	Garma-sadasi-iti uttara-arDAt prAcIm /
   madhye dve tisro vā prācīḥ /	maDye dve tisraH vA prAcIH /
   ūrjasvatīti dakṣiṇām /	UrjasvatI-iti dakziNAm /
   payasvatīty uttarām /	payasvatI-iti uttarAm /
   indrāya tveti madhyād vā /	indrAya tvA-iti maDyAt vA /
   sarvāḥ prādeśamātryo darbheṇāvalikhet // VGrs_1.7	sarvAH prAdeSa-mAtryaH darBeNa-avaliKet // VGrH-_1.7
   adbhiḥ prokṣyāgniṃ sādayati // VGrs_1.8	adBiH prokzya-agnim sAdayati // VGrH-_1.8
   parisamuhya paristīrya paryukṣya tūṣṇīm idhmābarhiḥ saṃnahya grāgagrair	parisamuhya paristIrya paryukzya tUzNIm iDmAbarhiH saMnahya grAc-agrEH-
   dakṣiṇārambhair udaksaṃsthairayugmair dhātubhiḥ stṛṇāti // VGrs_1.9	dakziNa-AramBEH udak-saMsTEH-ayugmEH DAtuBiH stRNAti // VGrH-_1.9
   dakṣiṇato 'gner brahmāṇam upaveśyottarata udapātram // VGrs_1.10	dakziNatas agneH brahmANam upaveSya-uttaratas uda-pAtram // VGrH-_1.10
   barhiṣaḥ pavitre kurute // VGrs_1.11	barhizaH pavitre kurute // VGrH-_1.11
   samāv apracchinnaprāntau darbhau prādeśamātrau pavitre stho vaiṣṇavye	samO apracCinna-prAntO darBO prAdeSa-mAtrO pavitre sTaH vEzNavye
   ityoṣadhyā chittvā viṣṇormanasā pūte stha ity adbhis trir unmṛjya	iti-ozaDyA CittvA vizNoH-manasA pUte sTaH iti adBiH tris unmRjya
   prokṣaṇīr dharmaiḥ saṃskṛtya praṇītāṃ praṇīya nirvapaṇaprokṣaṇasaṃvapanam	prokzaNIH DarmEH saMskRtya praNItAm praNIya nirvapaNa-prokzaNa-saMvapanam
   iti yathādevataṃ carum adhiśritya sruksruvaṃ pramṛjyābhyukṣyāgnau	iti yaTAdevatam carum aDiSritya sruc-sruvam pramRjya-aByukzya-agnO
   pratāpyāditir asi nācchinnapattrety ājyam agnāv adhiśrayati // VGrs_1.12	pratApya-aditiH asi na-AcCinna-pattra-iti Ajyam agnO aDiSrayati // VGrH-_1.12
   pṛśneḥ payo 'sīty ājyaṃ nirvapati // VGrs_1.13	pRSneH payaH asi-iti Ajyam nirvapati // VGrH-_1.13
   pari vājapatir ityājyahaviś ca triḥ paryagnikaroti // VGrs_1.14	pari vAja-patiH iti-Ajya-haviH ca tris paryagnikaroti // VGrH-_1.14
   devas tvā savitotpunātv ityājyaṃ śrapayati // VGrs_1.15	devaH tvA savitA-utpunAtu iti-Ajyam Srapayati // VGrH-_1.15
   tūṣṇīm idhmābarhir viprokṣya yathā mnātam abhiparistṛṇāti // VGrs_1.16	tUzNIm iDmA-barhiH viprokzya yaTA mnAtam aBiparistRNAti // VGrH-_1.16
   paridhīn paridadhāti // VGrs_1.17	pariDIn paridaDAti // VGrH-_1.17
   tejo 'sītyājyamavekṣya paścādagnerdarbheṣvāsādayati // VGrs_1.18	tejaH asi-iti-Ajyam-avekzya paScAt-agneH-darBezu-AsAdayati // VGrH-_1.18
   abhighārya sthālīpākamuttarata udvāsayati // VGrs_1.19	aBiGArya sTAlIpAkam-uttaratas udvAsayati // VGrH-_1.19
   sakṛdevedhmamādhāya vairūpākṣaḥ prathamo homānām // VGrs_1.20	sakRt-eva-iDmam-ADAya vErUpAkzaH praTamaH homAnAm // VGrH-_1.20
   brahmāṇam āmantrya samidham ādhāyāghārāv āghāryājyabhāgau hutvā yunajmi	brahmANam Amantrya samiDam ADAya-AGArO AGArya-Ajya-BAgO hutvA yunajmi
   tveti ca yojayitvā // VGrs_1.21	tvA-iti ca yojayitvA // VGrH-_1.21
   nahy ayukto havyaṃ vahata iti ha vijñāyate // VGrs_1.22	nahi ayuktaH havyam vahate iti ha vijQAyate // VGrH-_1.22
   kāmaṃ purastāddhuro juhoti /	kAmam purastAt-DuraH juhoti /
   yukto vaha jātavedaḥ purastādidaṃ viddhi kriyamāṇaṃ yatheha /	yuktaH vaha jAtavedaH purastAt-idam vidDi kriyamANam yaTA-iha /
   tvaṃ bhiṣagbheṣajasyāsi goptā tvayā prasūtā gāmaśvaṃ pūruṣaṃ sanema /	tvam Bizaj-Bezajasya-asi goptA tvayA prasUtA gAm-aSvam pUruzam sanema /
   svāhā /	svAhA /
   iti // VGrs_1.23	iti // VGrH-_1.23
   viśvā agne tvayā vayaṃ dhārā udanyā iva /	viSvAH agne tvayA vayam DArAH udanyAH iva /
   atigāhemahi dviṣam // VGrs_1.24	ati-gAhemahi dvizam // VGrH-_1.24
   iti /	iti /
   nakṣatramiṣṭvā devatāṃ yajeta /	nakzatram-izwvA devatAm yajeta /
   ahorātramṛtuṃ tithiṃ ca // VGrs_1.25	ahorAtram-Rtum tiTim ca // VGrH-_1.25
   abhighārya yaddevataṃ haviḥ syāttac ca juhuyād yathādevataṃ yathādevatayā	aBiGArya yat-devatam haviH syAt-tat ca juhuyAt yaTAdevatam yaTAdevatayA
   carcā // VGrs_1.26	carcAH // VGrH-_1.26
   ākūtāya svāhā /	AkUtAya svAhA /
   ākūtaye svāheti jayān juhuyāt // VGrs_1.27	AkUtaye svAhA-iti jayAn juhuyAt // VGrH-_1.27
   prajāpatiḥ prāyacchat /	prajApatiH prAyacCat /
   iḍām agna iti sviṣṭakṛtam uttarārdhapūrvārdhe juhuyāt // VGrs_1.28	ixAm agne iti svizwakRtam uttara-arDa-pUrva-arDe juhuyAt // VGrH-_1.28
   mekṣaṇam upayāmaṃ pavitre cānvādadhyāt // VGrs_1.29	mekzaNam upayAmam pavitre ca-anvAdaDyAt // VGrH-_1.29
   anv adya no 'numatiḥ /	anu adya naH anumatiH /
   anv id anumate tvam iti /	anu id anumate tvam iti /
   bhūḥ svāheti prāyaścittāhutīśca // VGrs_1.30	BUH svAhA-iti prAyaScitta-AhutIH-ca // VGrH-_1.30
   tvan no 'gne /	tvat naH agne /
   sa tvan no 'gne /	sa tvat naH agne /
   mano jyotiḥ /	manaH jyotiH /
   trayastriṃśattantavaḥ /	trayastriMSat-tantavaH /
   ayāścāgne 'sīti ca // VGrs_1.31	ayAH-ca-agne asi-iti ca // VGrH-_1.31
   imaṃ stanaṃ madhumantaṃ dhayāpāṃ prapīnamagne salilasya madhye /	imam stanam maDumantam DayA-apAm prapInam-agne salilasya maDye /
   utsaṃ juṣasva madhumantam ūrmiṃ samudryaṃ sadanam āviśasva /	utsam juzasva maDumantam Urmim samudryam sadanam AviSasva /
   svāhā /	svAhA /
   iti paridhivimokam abhijuhoti // VGrs_1.32	iti pariDi-vimokam aBijuhoti // VGrH-_1.32
   annapata ityannasya juhuyāt // VGrs_1.33	annapate iti-annasya juhuyAt // VGrH-_1.33
   edho 'syedhīṣīmahi svāheti samidham ādadhāti /	eDaH asya-iDIzImahi svAhA-iti samiDam AdaDAti /
   samidasi samedhiṣīmahīti dvitīyām // VGrs_1.34	samiD-asi sameDizImahi-iti dvitIyAm // VGrH-_1.34
   barhiṣi pūrṇapātraṃ ninayet // VGrs_1.35	barhizi pUrNa-pAtram ninayet // VGrH-_1.35
   eṣo 'vabhṛthaḥ // VGrs_1.36	ezaH avaBRTaH // VGrH-_1.36
   pākayajñānām etattantram // VGrs_1.37	pAkayajQAnAm etat-tantram // VGrH-_1.37
   āpohiṣṭhīyābhir mārjayitvā paryukṣeta // VGrs_1.38	ApohizWIyABiH mArjayitvA paryukzeta // VGrH-_1.38
   varo dakṣiṇā /	varaH dakziNA /
   aśvaṃ varaṃ vidyāt /	aSvam varam vidyAt /
   gāmityeke // VGrs_1.39	gAm-iti-eke // VGrH-_1.39
   Vārāhagṛhyasūtra, 2	VArAha-gRhya-sUtra, 2
   prāṅmukham udaṅmukhaṃ vā sūtikālayaṃ kalpayitvā dhruvaṃ prapadye śubhaṃ	prAFmuKam udaFmuKam vA sUtikA-Alayam kalpayitvA Druvam prapadye SuBam
   prapadya āśāṃ prapadya iti kāle prapādayet // VGrs_2.1	prapadye ASAm prapadye iti kAle prapAdayet // VGrH-_2.1
   reto mūtramiti cyāvanībhyāṃ dakṣiṇaṃ kukṣim abhimṛśet /	retaH mUtram-iti cyAvanIByAm dakziNam kukzim aBimRSet /
   śrāvayedvā // VGrs_2.2	SrAvayet-vA // VGrH-_2.2
   putraṃ jātam anvakṣaṃ snātaṃ na mātopahanyād ā mantraprayogāt // VGrs_2.3	putram jAtam anvakzam snAtam na mAtA-upahanyAt A mantra-prayogAt // VGrH-_2.3
   agner abhyāhitasya parisamūḍhasya paristīrṇasya paścād ahate vāsasi	agneH aByAhitasya parisamUXasya paristIrNasya paScAt ahate vAsasi
   kumāraṃ prākśirasam uttānaṃ saṃveśya palāśasya madhyamaṃ parṇaṃ praveṣṭya	kumAram prAc-Sirasam uttAnam saMveSya palASasya maDyamam parNam pravezwya
   tenāsya karṇāv ājapet bhūs tvayi dadhānīti dakṣiṇe /	tena-asya karNO Ajapet BUH tvayi daDAni-iti dakziNe /
   bhuvas tvayi dadhānīti savye /	BuvaH tvayi daDAni-iti savye /
   svas tvayi dadhānīti dakṣiṇe /	svar tvayi daDAni-iti dakziNe /
   bhūr bhuvaḥ svas tvayi dadhānīti savye // VGrs_2.4	BUH BuvaH svar tvayi daDAni-iti savye // VGrH-_2.4
   athainam abhimantrayete /	aTa-enam aBimantrayete /
   aśmā bhava paraśur bhava hiraṇyam astṛtaṃ bhava /	aSmA Bava paraSuH Bava hiraNyam astRtam Bava /
   aṅgād aṅgāt sambhavasi hṛdayād adhijāyase /	aFgAt aFgAt samBavasi hRdayAt aDijAyase /
   ātmā vai putranāmāsi sa jīva śaradaḥ śatam /	AtmA vE putra-nAmA-asi sa jIva SaradaH Satam /
   iti // VGrs_2.5	iti // VGrH-_2.5
   yatra śete tadabhimṛśet veda te bhūmi hṛdayaṃ divi candramasi śritam /	yatra Sete tad-aBimRSet veda te BUmi hRdayam divi candramasi Sritam /
   vedāmṛtasya devā māhaṃ putryam aghaṃ rudam /	veda-amRtasya devAH mA-aham putryam aGam rudam /
   iti // VGrs_2.6	iti // VGrH-_2.6
   ājyaṃ saṃskṛtya brahmāṇam āmantrya samidham ādhāyāghārāv āghāryājyabhāgau	Ajyam saMskRtya brahmANam Amantrya samiDam ADAya-AGArO AGArya-Ajya-BAgO
   hutvā vyāhṛtibhiś catasra ājyāhutīr juhuyāt /	hutvA vyAhRtiBiH catasraH Ajya-AhutIH juhuyAt /
   jayābhyātānānāṃ rāṣṭrabhṛtaś caike // VGrs_2.7	jaya-aByAtAnAnAm rAzwraBRtaH ca-eke // VGrH-_2.7
   kāṃsye camase vāhūtisampātān avanīya tasmin suvarṇaṃ saṃnighṛṣya	kAMsye camase vA-AhUti-sampAtAn avanIya tasmin suvarNam saMniGRzya
   vyāhṛtibhiḥ kumāraṃ catuḥ prāśayet /	vyAhRtiBiH kumAram catuH prASayet /
   atyantam eke suvarṇaprāśanam udake nighṛṣyā dvādaśavarṣatāyāḥ // VGrs_2.8	atyantam eke suvarNa-prASanam udake niGRzyAH dvAdaSa-varzatAyAH // VGrH-_2.8
   iṣaṃ pinva /	izam pinva /
   ūrjaṃ pinveti stanau prakṣālya pradhāpayet /	Urjam pinveti stanO prakzAlya praDApayet /
   dakṣiṇaṃ pūrvaṃ savyaṃ paścāt // VGrs_2.9	dakziNam pUrvam savyam paScAt // VGrH-_2.9
   sviṣṭakṛte hutvā prāyaścittāhutīśca samidhamādhāya paryukṣati // VGrs_2.10	svizwakRte hutvA prAyaScitta-AhutIH-ca samiDam-ADAya paryukzati // VGrH-_2.10
   eṣa karmānto bahirdvāre 'gnir nityaḥ /	eza karmAntaH bahirdvAre agniH nityaH /
   kaṇasarṣapayavānāṃ homaḥ /	kaNa-sarzapa-yavAnAm homaH /
   vyāhṛtibhir juhuyāt // VGrs_2.11	vyAhRtiBiH juhuyAt // VGrH-_2.11
   apratirathaṃ japet /	apratiraTam japet /
   indro bhūtasyeti ṣaḍarcaṃ ca // VGrs_2.12	indraH BUtasya-iti zaxarcam ca // VGrH-_2.12
   sūtikālayaṃ yathākālaṃ samantād udakena pariṣiñcet // VGrs_2.13	sUtikA-Alayam yaTAkAlam samantAt udakena pariziQcet // VGrH-_2.13
   Vārāhagṛhyasūtra, 3	VArAha-gRhya-sUtra, 3
   evam eva daśamyāṃ kṛtvā pitā mātā ca putrasya nāma dadhyatām	evam eva daSamyAm kRtvA pitA mAtA ca putrasya nAma daDyatAm
   ghoṣavadādyantarantasthaṃ dīrghābhiniṣṭānāntaṃ kṛtaṃ na taddhitaṃ	Gozavat-Adi-antar-anta-sTam dIrGa-aBinizwAna-antam kRtam na tat-hitam
   dvyakṣaraṃ caturakṣaraṃ vā tyaktvā pitur nāmadheyāt	dvi-akzaram catur-akzaram vA tyaktvA pituH nAmaDeyAt-
   nakṣatradevateṣṭanāmāno vā // VGrs_3.1	nakzatra-devatA-izwa-nAmAnaH vA // VGrH-_3.1
   dvināmā tu brāhmaṇaḥ // VGrs_3.2	dvi-nAmA tu brAhmaNaH // VGrH-_3.2
   nāmaiva kanyāyāḥ akāravyavadhānam ākārāntam ayugmākṣaraṃ	nAma-eva kanyAyAH akAra-vyavaDAnam AkAra-antam ayugma-akzaram
   nadīnakṣatracandrasūryapūṣadevadattarakṣitāvarjam // VGrs_3.3	nadI-nakzatra-candra-sUrya-pUza-devadatta-rakzitA-varjam // VGrH-_3.3
   navanītena pāṇī pralipya somasya tvā dyumnenety enamabhimṛśet // VGrs_3.4	navanItena pANI pralipya somasya tvA dyumnena-iti enam-aBimRSet // VGrH-_3.4
   sarveṣu kumārakarmasv āgneyaḥ sthālīpākaḥ prājāpatyo vā // VGrs_3.5	sarvezu kumAra-karmasu AgneyaH sTAlIpAkaH prAjApatyaH vA // VGrH-_3.5
   sarvatrānādeśe 'gniḥ puṃsām aryamā strīṇām // VGrs_3.6	sarva-trAnAdeSe agniH puMsAm aryamA strINAm // VGrH-_3.6
   saṃvatsaraṃ mātāpitarau na māṃsam aśnīyātām // VGrs_3.7	saMvatsaram mAtA-pitarO na mAMsam aSnIyAtAm // VGrH-_3.7
   putrasya jātadante yajetāgniṃ gavā paśunā vā // VGrs_3.8	putrasya jAta-dante yajeta-agnim gavA paSunA vA // VGrH-_3.8
   viproṣitaḥ pratyetya putrasya mūrdhānaṃ trir ājighret paśūnāṃ tvā	viprozitaH pratyetya putrasya mUrDAnam tris AjiGret paSUnAm tvA
   hiṃkāreṇābhijighrāmīti // VGrs_3.9	hiMkAreNa-aBijiGrAmi-iti // VGrH-_3.9
   jātakarmavaddhastāṅguliṃ praveṣṭya tenāsya karṇāv ājapet // VGrs_3.10	jAtakarma-vat-hasta-aFgulim pravezwya tena-asya karNO Ajapet // VGrH-_3.10
   athainamabhimantrayate aśmā bhaveti // VGrs_3.11	aTa-enam-aBimantrayate aSmA Bava-iti // VGrH-_3.11
   agnidhanvantarī putravratī chāgameṣābhyām iṣṭvā dīrghāṇāṃ vyāhṛtibhiḥ	agni-DanvantarI putra-vratI CAga-mezAByAm izwvA dIrGANAm vyAhRtiBiH
   kumāraṃ catuḥ prāśayet /	kumAram catuH prASayet /
   āyurdā deveti ca // VGrs_3.12	AyuH-dA deva-iti ca // VGrH-_3.12
   kumārakarmāṇi śukla udagayane puṇye nakṣatre navamīvarjam /	kumAra-karmANi SuklaH udagayane puNye nakzatre navamI-varjam /
   sarva ṛtavo vivāhe 'māghacaitrau māsau parihāpyottaraṃ ca naidāgham //	sarve RtavaH vivAhe amAGa-cEtrO mAsO parihApya-uttaram ca nEdAGam //
   VGrs_3.13	VGrH-_3.13
   anvārambhayitvā havanam // VGrs_3.14	anvAramBayitvA havanam // VGrH-_3.14
   Vārāhagṛhyasūtra, 4	VArAha-gRhya-sUtra, 4
   tṛtīyavarṣasya jaṭāḥ kurvanti /	tRtIya-varzasya jawAH kurvanti /
   yathā vā kulakalpaḥ // VGrs_4.1	yaTA vA kula-kalpaH // VGrH-_4.1
   agnim upasamādhāya parisamuhya paristīrya paryukṣya dakṣiṇato 'gner	agnim upasamADAya parisamuhya paristIrya paryukzya dakziNatas agneH-
   brahmāṇam upaveśyottarata udapātraṃ śamīśamakavat // VGrs_4.2	brahmANam upaveSya-uttaratas uda-pAtram SamI-Samaka-vat // VGrH-_4.2
   athainam abhimantrayate hiraṇyavarṇāḥ śucaya iti catasṛbhiḥ /	aTa-enam aBimantrayate hiraNya-varNAH SucayaH iti catasRBiH /
   yā oṣadhaya ityanuvākena /	yAH ozaDayaH iti-anuvAkena /
   śaṃ no devīr abhiṣṭaya āpo bhavantu pītaye /	Sam naH devIH aBizwaye ApaH Bavantu pItaye /
   śaṃ yor abhisravantu naḥ /	Sam yoH aBisravantu naH /
   priyāḥ śaṃ na āpo dhanvanyāḥ śaṃ naḥ santu nūpyāḥ /	priyAH Sam naH ApaH DanvanyAH Sam naH santu nUpyAH /
   śaṃ naḥ samudryā āpaḥ śam u naḥ santu kūpyāḥ /	Sam naH samudryAH ApaH Sam u naH santu kUpyAH /
   śaṃ no mitraḥ śaṃ varuṇaḥ śaṃ no bhavatv aryamā /	Sam naH mitraH Sam varuNaH Sam naH Bavatu aryamA /
   śaṃ na indraś cāgniś ca śaṃ no viṣṇur urukramaḥ /	Sam naH indraH ca-agniH ca Sam naH vizNuH urukramaH /
   iti /	iti /
   tāsām udakārthān kurvīta paryukṣaṇe 'bhyundane snāpane ca // VGrs_4.3	tAsAm udaka-arTAn kurvIta paryukzaNe aByundane snApane ca // VGrH-_4.3
   ājyaṃ saṃskṛtya brahmāṇam āmantrya samidham ādhāyāghārāv āghāryājyabhāgau	Ajyam saMskRtya brahmANam Amantrya samiDam ADAya-AGArO AGArya-Ajya-BAgO
   hutvā agnā āyūṃṣi pavasa iti saptabhiḥ sapta hutvā // VGrs_4.4	hutvA agnO AyUMzi pavase iti saptaBiH sapta hutvA // VGrH-_4.4
   āyurdā deveti ca /	AyuH-dA deva-iti ca /
   ye keśinaḥ prathame sattram āsata yebhir āvṛtaṃ yadidaṃ virājati /	ye keSinaH praTame sattram Asata yeBiH AvRtam yat-idam virAjati /
   tebhyo juhomy āyuṣe dīrghāyutvāya svastaye /	teByaH juhomi Ayuze dIrGa-Ayu-tvAya svastaye /
   iti // VGrs_4.5	iti // VGrH-_4.5
   vyāhṛtibhiśca // VGrs_4.6	vyAhRtiBiH-ca // VGrH-_4.6
   uktaḥ karmāntaḥ pūrveṇa // VGrs_4.7	uktaH karmAntaH pUrveNa // VGrH-_4.7
   śītena vāya udakenedhi /	SItena vAyo udakena-iDi /
   uṣṇena vāya udakenedhīti taptā itarābhiḥ saṃsṛjya ārdradānava stha jīvadān	uzNena vAyo udakena-iDi-iti taptAH itarABiH saMsRjya Ardra-dAnava sTa jIvadAn
   avasthondatīriṣamāvadety apo 'bhimantrya dakṣiṇaṃ keśāntam abhyundyāt /	avasTA-unda-ti-Irizam-Avada-iti apaH aBimantrya dakziNam keSAntam aByundyAt /
   aditiḥ keśān vapatvāpa undantu jīvase /	aditiH keSAn vapa-tvA-apaH undantu jIvase /
   dīrghāyutvāya svastaye /	dIrGa-Ayu-tvAya svastaye /
   iti // VGrs_4.8	iti // VGrH-_4.8
   dakṣiṇasmin keśānte darbham ūrdhvāgraṃ nidadhāti // VGrs_4.9	dakziNasmin keSAnte darBam UrDva-agram nidaDAti // VGrH-_4.9
   oṣadhe trāyasvainam iti darbhamantardadhāti // VGrs_4.10	ozaDe trAyasva-enam iti darBam-antardaDAti // VGrH-_4.10
   svadhite mainaṃ hiṃsīr iti kṣureṇābhinidadhāti // VGrs_4.11	svaDite mA-enam hiMsIH iti kzureNa-aBinidaDAti // VGrH-_4.11
   yenāvapatsavitā kṣureṇa somasya rājño varuṇasya vidvān /	yena-avapat-savitA kzureNa somasya rAjQaH varuNasya vidvAn /
   tena brahmāṇo vapatedam asyāyuṣmān ayaṃ jaradaṣṭir yathāsat /	tena brahmANaH vapata-idam asya-AyuzmAn ayam jara-dazwiH yaTAsat /
   ahamasau /	aham-asO /
   iti pravapati // VGrs_4.12	iti pravapati // VGrH-_4.12
   dakṣiṇato mātānyā vāvidhavānaḍuhena gomayenābhūmigatān keśān parigṛhṇīyāt	dakziNatas mAtA-anyAH vA-aviDava-Anaxuhena gomayena-aBUmi-gatAn keSAn parigRhNIyAt-
   // VGrs_4.13	// VGrH-_4.13
   mā te keśān anugād varca etattathā dhātā dadhātu te /	mA te keSAn anugAt varcaH etat-taTA DAtA daDAtu te /
   tubhyamindro varuṇo bṛhaspatiḥ savitā varca ādadhuḥ /	tuByam-indraH varuNaH bRhaspatiH savitA varcaH AdaDuH /
   iti prapatato 'numantrayate // VGrs_4.14	iti prapatataH anumantrayate // VGrH-_4.14
   tena dharmeṇa punar apo 'bhimantryāparaṃ keśāntam abhyundyād uttaraṃ ca //	tena DarmeNa punar apaH aBimantrya-aparam keSAntam aByundyAt uttaram ca //
   VGrs_4.15	VGrH-_4.15
   anyau tu pravapanau yena pūṣā bṛhaspater agner indrasya cāyuṣe 'vapat /	anyO tu pravapanO yena pUzA bRhaspateH agneH indrasya ca-Ayuze avapat /
   tena te vapāmyāyuṣe dīrghāyutvāya svastaye /	tena te vapAmi-Ayuze dIrGa-Ayu-tvAya svastaye /
   iti paścāt /	iti paScAt /
   yena bhūyaś caratyayaṃ jyok ca paśyasi sūryam /	yena BUyas carati-ayam jyok ca paSyasi sUryam /
   tena te vapāmy āyuṣe dīrghāyutvāya suślokyāya suvarcase /	tena te vapAmi Ayuze dIrGa-Ayu-tvAya suSlokyAya suvarcase /
   ityuttarataḥ // VGrs_4.16	iti-uttaratas // VGrH-_4.16
   yat kṣureṇa parcayatā supeśasā vaptar vapasi keśān /	yat kzureNa parcayatA supeSasA vaptar vapasi keSAn /
   śundha śiro māsyāyuḥ pramoṣīḥ /	SunDa SiraH mAsi-AyuH pramozIH /
   iti lohāyasaṃ kṣuraṃ keśavāpāya prayacchati // VGrs_4.17	iti lohAyasam kzuram keSa-vApAya prayacCati // VGrH-_4.17
   yathārthaṃ keśayatnān kurvanti dakṣiṇataḥ kapardā vasiṣṭhānām ubhayato	yaTArTam keSa-yatnAn kurvanti dakziNatas kapardA vasizWAnAm uBayatas-
   'tribhārgavakāśyapānāṃ pañcacūḍā āṅgirasaḥ śikhino 'nye // VGrs_4.18	atri-BArgava-kASyapAnAm paQcacUxAH AFgirasaH SiKinaH anye // VGrH-_4.18
   vājim eke maṅgalārtham // VGrs_4.19	vAjim eke maFgala-arTam // VGrH-_4.19
   tryāyuṣaṃ kaśyapasya jamadagnes tryāyuṣam agastyasya tryāyuṣam /	tri-Ayuzam kaSyapasya jamadagneH tri-Ayuzam agastyasya tri-Ayuzam /
   yad devānāṃ tryāyuṣaṃ tan me astu śatāyuṣam /	yat devAnAm tri-Ayuzam tat me astu Sata-Ayuzam /
   iti śiraḥ saṃmṛśati // VGrs_4.20	iti SiraH saMmRSati // VGrH-_4.20
   parigṛhya gomayena keśān uttarapūrvasyāṃ gṛhasya mūṣyām antarā gehāt	parigRhya gomayena keSAn uttara-pUrvasyAm gRhasya mUzyAm antarA gehAt-
   paladaṃ ca nidadhyāt /	paladam ca nidaDyAt /
   arikte vā vapane /	arikte vA vapane /
   uptvāya keśāntān varuṇāya rājño bṛhaspatiḥ savitā viṣṇurindraḥ /	uptvAya keSAntAn varuNAya rAjQaH bRhaspatiH savitA vizNuH-indraH /
   tebhyo nidhānaṃ mahad anvavindann antarā dyāvāpṛthivī apa svaḥ //	teByaH niDAnam mahat anvavindan antarA dyAvApRTivI apa svar //
   VGrs_4.21	VGrH-_4.21
   iti /	iti /
   kartre varaṃ dadāti // VGrs_4.22	kartre varam dadAti // VGrH-_4.22
   pakṣmaguṇaṃ tilapiśitaṃ ca keśavāpāya prayacchati // VGrs_4.23	pakzma-guNam tila-piSitam ca keSa-vApAya prayacCati // VGrH-_4.23
   saṃvatsaraṃ mātā nāmlāya dhārayet /	saMvatsaram mAtA na-amlAya DArayet /
   roṣāya nāśnīyāt /	rozAya na-aSnIyAt /
   lavaṇavarjaṃ tūṣṇīm // VGrs_4.24	lavaNa-varjam tUzNIm // VGrH-_4.24
   kanyāyā āhutivarjam // VGrs_4.25	kanyAyAH Ahuti-varjam // VGrH-_4.25
   viduṣo brāhmaṇān arthasiddhiṃ vācayet // VGrs_4.26	viduzaH brAhmaNAn arTa-sidDim vAcayet // VGrH-_4.26
   evam uttareṣu // VGrs_4.27	evam uttarezu // VGrH-_4.27
   Vārāhagṛhyasūtra, 5	VArAha-gRhya-sUtra, 5
   garbhāṣṭameṣu brāhmaṇamupanayet /	garBa-azwamezu brAhmaNam-upanayet /
   ṣaṣṭhe saptame pañcame vā // VGrs_5.1	zazWe saptame paQcame vA // VGrH-_5.1
   tato garbhaikādaśeṣu kṣatriyaṃ garbhadvādaśeṣu vaiśyam // VGrs_5.2	tatas garBa-ekAdaSezu kzatriyam garBadvAdaSezu vESyam // VGrH-_5.2
   prākṣoḍaśād varṣād brāhmaṇasyāpatitā sāvitrī dvāviṃśāt kṣatriyasya	prAc-zoxaSAt varzAt brAhmaNasya-ApatitA sAvitrI dvAviMSAt kzatriyasya
   caturviṃśād vaiśyasya /	caturviMSAt vESyasya /
   ata ūrdhvaṃ patitasāvitrikā bhavanti /	atas UrDvam patita-sAvitrikAH Bavanti /
   nainān yājayeyur nādhyāpayeyur na vivaheyur na vivāhayeyuḥ // VGrs_5.3	na-enAn yAjayeyuH na-aDyApayeyuH na vivaheyuH na vivAhayeyuH // VGrH-_5.3
   abhyantaraṃ jaṭākaraṇaṃ bahir upanayanam // VGrs_5.4	aByantaram jawA-karaNam bahis upanayanam // VGrH-_5.4
   ukto 'gnisaṃskāro brahmaṇaśca // VGrs_5.5	uktaH agni-saMskAraH brahmaNaH-ca // VGrH-_5.5
   kumāraṃ paryuptinaṃ snātam abhyaktaśirasam upasparśanakalpe nopaspṛṣṭam	kumAram paryuptinam snAtam aByakta-Sirasam upasparSana-kalpe na-upaspRzwam
   agnerdakṣiṇato 'vasthāpya dadhikrāvṇo akāriṣam iti dadhnaḥ kumāraṃ triḥ	agneH-dakziNatas avasTApya daDikrAvNaH akArizam iti daDnaH kumAram tris-
   prāśayet // VGrs_5.6	prASayet // VGrH-_5.6
   iyaṃ duruktāt paribādhamānā varṇaṃ pavitraṃ punatī na āgāt /	iyam duruktAt paribADamAnA varNam pavitram punatI naH AgAt /
   prāṇāpānābhyāṃ balam ābhajantī śivā devī subhagā mekhaleyam /	prANa-apAnAByAm balam ABajantI SivA devI suBagA meKalA-iyam /
   ṛtasya goptrī tapasas tarutrī ghnatī rakṣaḥ sahamānā arātīḥ /	Rtasya goptrI tapasaH tarutrI GnatI rakzaH sahamAnAH arAtIH /
   sā mā samantam anuparyehi bhadre dhartāras te subhage mekhale mā riṣāma /	sA mA samantam anuparyehi Badre DartAraH te suBage meKale mA rizAma /
   iti mauñjīṃ triguṇāṃ triḥ parivītāṃ mekhalām ābadhnīte /	iti mOQjIm triguNAm tris parivItAm meKalAm AbaDnIte /
   maurvīṃ dhanurjyāṃ kṣatriyasya śāṇīṃ vaiśyasya // VGrs_5.7	mOrvIm DanuH-jyAm kzatriyasya SANIm vESyasya // VGrH-_5.7
   upavītam asi yajñasya tvopavītenopavyayāmīti yajñopavītam // VGrs_5.8	upavItam asi yajQasya tvA-upavItena-upavyayAmi-iti yajQopavItam // VGrH-_5.8
   yā akṛtan yā atanvan yā avāyan yā avāharan /	yAH akRtan yA atanvan yA avAyan yAH avAharan /
   yāś cāgnā devīr antān abhito 'tanvata tāstvā devīr jarase saṃvyayantām /	yAH ca-agnAH devIH antAn aBitas atanvata tAH-tvA devIH jarase saMvyayantAm /
   āyuṣmān ayaṃ paridhatta vāsaḥ paridhatta varcaḥ /	AyuzmAn ayam pariDatta vAsaH pariDatta varcaH /
   śatāyuṣaṃ kṛṇuhi dīrghamāyuḥ /	Sata-Ayuzam kRNuhi dIrGam-AyuH /
   śataṃ ca jīva śaradaḥ purūcīr vasūni cāyyo vibhajāya jīyān /	Satam ca jIva SaradaH purUcIH vasUni cAyyaH viBajAya jIyAn /
   ity ahataṃ vāsa ācchādya mitrasya cakṣurdharaṇaṃ balīyastejo yaśasvi	iti ahatam vAsaH AcCAdya mitrasya cakzuH-DaraNam balIyaH-tejaH yaSasvi
   sthaviraṃ ca dhṛṣṇu /	sTaviram ca DRzNu /
   anāhanasyaṃ vasanaṃ cariṣṇu parīdaṃ vājyaṃ vājinaṃ dadhe 'ham /	anAhanasyam vasanam carizNu pari-idam vA-Ajyam vAjinam daDe aham /
   iti kṛṣṇājinaṃ ca // VGrs_5.9	iti kRzNAjinam ca // VGrH-_5.9
   ājyaṃ saṃskṛtya brahmāṇam āmantrya samidham ādhāyāghārāv āghāryājyabhāgau	Ajyam saMskRtya brahmANam Amantrya samiDam ADAya-AGArO AGArya-Ajya-BAgO
   hutvāṣṭau jaṭākaraṇīyān juhuyāt // VGrs_5.10	hutvA-azwO jawA-karaNIyAn juhuyAt // VGrH-_5.10
   vyāhṛtibhiśca // VGrs_5.11	vyAhRtiBiH-ca // VGrH-_5.11
   uktaḥ karmāntaḥ pūrveṇa // VGrs_5.12	uktaH karmAntaH pUrveNa // VGrH-_5.12
   kālāya vāṃ gotrāya vāṃ jaitrāya vām audbhetrāya vām annādyāya vām	kAlAya vAm gotrAya vAm jEtrAya vAm OdBetrAya vAm annAdyAya vAm
   avanenijed ity udakenāñjaliṃ pūrayitvā sukṛtāya vāmiti pāṇī prakṣālya	avanenijet iti udakena-aQjalim pUrayitvA sukRtAya vAm-iti pANI prakzAlya
   idamahaṃ duryamanyā niṣplāvayāmīty ācamya niṣṭhīvati // VGrs_5.13	idam-aham duryamanyA nizplAvayAmi-iti Acamya nizWIvati // VGrH-_5.13
   bhrātṛvyāṇāṃ sapatnānām ahaṃ bhūyāsam uttama iti dvitīyam // VGrs_5.14	BrAtRvyANAm sapatnAnAm aham BUyAsam uttamaH iti dvitIyam // VGrH-_5.14
   prātar jitaṃ bhagamugraṃ huvema vayaṃ putram aditeryo vidhartā /	prAtar jitam Bagam-ugram huvema vayam putram aditeH-yaH viDartA /
   ādhraś cidyaṃ mantamānasturaś cidrājā cidyaṃ bhagaṃ bhakṣīmahīty āha /	ADraH cidyam mantamAnaH-turaH cit-rAjA cidyam Bagam BakzImahi-iti Aha /
   ity ādityam upatiṣṭheta // VGrs_5.15	iti Adityam upatizWeta // VGrH-_5.15
   brahmacaryam upāgāmupa mā hvayasveti brūyāt // VGrs_5.16	brahmacaryam upAgAm-upa mA hvayasva-iti brUyAt // VGrH-_5.16
   ehi brahmopehi brahma brahma tvā sa brahmasantam upanayāmy aham asāv iti	ehi brahma-upehi brahma brahma tvA sa brahmasantam upanayAmi aham asO iti
   // VGrs_5.17	// VGrH-_5.17
   athāsyābhivādanīyaṃ nāma gṛhṇāti // VGrs_5.18	aTa-asya-aBivAdanIyam nAma gRhNAti // VGrH-_5.18
   devasya te savituḥ prasave 'śvinorbāhubhyāṃ pūṣṇo hastābhyāṃ hastaṃ	devasya te savituH prasave aSvinoH-bAhuByAm pUzNaH hastAByAm hastam
   gṛhṇāmy aham asāv ity asya hastaṃ dakṣiṇena dakṣiṇam uttānam	gRhNAmi aham asO iti asya hastam dakziNena dakziNam uttAnam
   abhīvāṅguṣṭham abhīva lomāni gṛhṇīyāt // VGrs_5.19	aBi-iva-aFguzWam aBi-iva lomAni gRhNIyAt // VGrH-_5.19
   mām evānvetu te mano māmevāpi tvam anvihi /	mAm eva-anvetu te manaH mAm-eva-api tvam anvihi /
   agnau dhṛtamiva dīpyatāṃ hṛdayaṃ tava yan mayi /	agnO DRtam-iva dIpyatAm hRdayam tava yat mayi /
   ityenaṃ prekṣamāṇaṃ samīkṣate // VGrs_5.20	iti-enam prekzamANam samIkzate // VGrH-_5.20
   pṛṣṭhato 'sya pāṇim anvavahṛtya hṛdayadeśam anvārabhya japet prāṇānāṃ	pRzWatas asya pANim anvavahRtya hRdaya-deSam anvAraBya japet prANAnAm
   granthir asi sa mā visrasad iti /	granTiH asi sa mA visrasat iti /
   brahmaṇo granthirasīti nābhideśam // VGrs_5.21	brahmaNaH granTiH-asi-iti nABi-deSam // VGrH-_5.21
   gaṇānāṃ tvā gaṇapatiṃ havāmahe kaviṃ kavīnām upamaśravastamam /	gaNAnAm tvA gaNapatim havAmahe kavim kavInAm upamaSravastamam /
   jyeṣṭharājaṃ brahmāṇaṃ brahmaṇaspata ā naḥ kṛṇvann ūtibhiḥ sīda sādanam /	jyezWa-rAjam brahmANam brahmaNaspate A naH kRNvan UtiBiH sIda sAdanam /
   iti pradakṣiṇamagniṃ pariṇayet // VGrs_5.22	iti pradakziNam-agnim pariNayet // VGrH-_5.22
   paścādagner darbheṣūpaviśati dakṣiṇataśca brahmacārī // VGrs_5.23	paScAt-agneH darBezu-upaviSati dakziNatas-ca brahmacArI // VGrH-_5.23
   adhīhi bho ity upaviśya japati // VGrs_5.24	aDIhi Bo iti upaviSya japati // VGrH-_5.24
   prabhujya dakṣiṇaṃ jānuṃ pāṇī saṃdhāya darbhahastāv oṃ ity uktvā vyāhṛtīḥ	praBujya dakziNam jAnum pANI saMDAya darBa-hastO om iti uktvA vyAhRtIH
   sāvitrīṃ cānubrūyāt /	sAvitrIm ca-anubrUyAt /
   evaṃ kāṇḍānuvacaneṣu // VGrs_5.25	evam kANxa-anuvacanezu // VGrH-_5.25
   tatsaviturvareṇyam iti gāyatrīṃ brāhmaṇāya /	tat-savituH-vareNyam iti gAyatrIm brAhmaNAya /
   ā devo yātu savitā suratna iti triṣṭubhaṃ kṣatriyāya /	A devaH yAtu savitA suratnaH iti trizwuBam kzatriyAya /
   yuñjate mana iti jagatīṃ vaiśyāya /	yuQjate manaH iti jagatIm vESyAya /
   paccho 'rdharcaśaḥ sarvām antataḥ // VGrs_5.26	pacCas arDarcaSaH sarvAm antatas // VGrH-_5.26
   pālāśaṃ daṇḍaṃ brāhmaṇāya prayacchati naiyagrodhaṃ kṣatriyāyāśvatthaṃ	pAlASam daNxam brAhmaNAya prayacCati nEyagroDam kzatriyAya-aSvatTam
   vaiśyāya /	vESyAya /
   suśravaḥ suśravasaṃ māṃ kuru /	suSravaH suSravasam mAm kuru /
   yathā tvaṃ suśravaḥ suśravā asy evam ahaṃ suśravaḥ suśravā bhūyāsam /	yaTA tvam suSravaH suSravAH asi evam aham suSravaH suSravAH BUyAsam /
   yathā tvaṃ devānāṃ vedasya nidhigopo 'syevamahaṃ manuṣyāṇāṃ brahmaṇo	yaTA tvam devAnAm vedasya niDi-gopaH asi-evam-aham manuzyANAm brahmaNaH-
   nidhigopo bhūyāsamiti pratigṛhṇāti // VGrs_5.27	niDi-gopaH BUyAsam-iti pratigRhNAti // VGrH-_5.27
   ūrdhvakapālo brāhmaṇasya kamaṇḍaluḥ parimaṇḍalaḥ kṣatriyasya nicalkalo	UrDva-kapAlaH brAhmaNasya kamaNxaluH parimaNxalaH kzatriyasya nicalkalo
   vaiśyasya /	vESyasya /
   imā āpaḥ prabharāmy ayakṣmā yakṣmacātanīḥ /	imAH ApaH praBarAmi ayakzmA yakzma-cAtanIH /
   ṛtenāpaḥ prabharāmy amṛtena sahāyuṣā /	Rtena-apaH praBarAmi amRtena saha-AyuzA /
   iti pratigṛhṇāmīti pratigṛhya bhaikṣyacaryaṃ caret bhavati bhikṣāṃ dehīti	iti pratigRhNAmi-iti pratigRhya BEkzya-caryam caret Bavati BikzAm dehi-iti
   brāhmaṇaḥ bhavati madhyāṃ kṣatriyaḥ bhavaty antyāṃ vaiśyaḥ /	brAhmaNaH Bavati maDyAm kzatriyaH Bavati antyAm vESyaH /
   catasraḥ ṣaḍaṣṭau vāvidhavā apratyākhyāyinyaḥ /	catasraH zaz-azwO vA-aviDavAH apratyAKyAyinyaH /
   mātaraṃ prathamameke // VGrs_5.28	mAtaram praTamam-eke // VGrH-_5.28
   gurave nivedya // VGrs_5.29	gurave nivedya // VGrH-_5.29
   vāgyataḥ prāg grāmāt saṃdhyām āset /	vAgyataH prAk grAmAt saMDyAm Aset /
   tiṣṭhanpūrvām /	tizWan-pUrvAm /
   sāvitrīṃ trir adhītya adhvanām adhvapate svastyasyādhvanaḥ pāramaśīya /	sAvitrIm tris aDItya aDvanAm aDvapate svasti-asya-aDvanaH pAramaSIya /
   yā medhā apsaraḥsu gandharveṣu ca yanmanaḥ /	yAH meDAH apsaraHsu ganDarvezu ca yat-manaH /
   yā medhā daivī mānuṣī sā mām āviśatām iha /	yA meDA dEvI mAnuzI sA mAm AviSatAm iha /
   iti // VGrs_5.30	iti // VGrH-_5.30
   pratyetyāgniṃ paricaret /	pratyetya-agnim paricaret /
   imaṃ stomamarhata iti parisamūhet /	imam stomam-arhataH iti parisamUhet /
   edho 'sy edhiṣīmahīti samidham ādadhāti /	eDaH asi eDizImahi-iti samiDam AdaDAti /
   samid asi samedhiṣīmahīti dvitīyām // VGrs_5.31	samiD asi sameDizImahi-iti dvitIyAm // VGrH-_5.31
   apo 'dyānvacāriṣam ityupatiṣṭhate // VGrs_5.32	apaH adya-anvacArizam iti-upatizWate // VGrH-_5.32
   taṃ mā saṃsṛja varcaseti mukhaṃ parimṛjīta // VGrs_5.33	tam mA saMsRja varcasA-iti muKam parimRjIta // VGrH-_5.33
   yadagne tapasā tapo brahmacaryam upemasi /	yat-agne tapasA tapaH brahmacaryam upemasi /
   priyāḥ śrutasya bhūyasmāyuṣmantaḥ sumedhasaḥ /	priyAH Srutasya BUyasma-AyuzmantaH sumeDasaH /
   agne samidham ahāriṣaṃ bṛhate jātavedase /	agne samiDam ahArizam bRhate jAtavedase /
   sa me śraddhāṃ ca medhāṃ ca jātavedāḥ prayacchatu /	sa me SradDAm ca meDAm ca jAtavedAH prayacCatu /
   svāhā /	svAhA /
   iti samidham ādadhāti // VGrs_5.34	iti samiDam AdaDAti // VGrH-_5.34
   tejasā mā samaṅgdhi varcasā mā samaṅgdhi brahmavarcasena mā samaṅgdhīti	tejasA mA samaFgDi varcasA mA samaFgDi brahmavarcasena mA samaFgDI-iti
   mukhaṃ parimṛjīta // VGrs_5.35	muKam parimRjIta // VGrH-_5.35
   āyurdhā agne 'sīti yathārūpaṃ gātrāṇi saṃmṛśati // VGrs_5.36	AyurDA agne asi-iti yaTArUpam gAtrANi saMmRSati // VGrH-_5.36
   iha dhṛtiriti paryāyair aṃsaṃ grīvāścārcirālabhya rucaṃ no dhehīti lalāṭam	iha DRtiH-iti paryAyEH aMsam grIvAH-ca-arciH-AlaBya rucam naH Dehi-iti lalAwam
   abhimṛśet // VGrs_5.37	aBimRSet // VGrH-_5.37
   ādyantayoḥ paryukṣaṇam // VGrs_5.38	Adi-antayoH paryukzaNam // VGrH-_5.38
   gurave brahmaṇe ca varam uttarāsaṅgaṃ ca dadāti // VGrs_5.39	gurave brahmaNe ca varam uttarAsaFgam ca dadAti // VGrH-_5.39
   dvādaśarātram akṣāralavaṇam āśet // VGrs_5.40	dvAdaSa-rAtram akzAra-lavaNam ASet // VGrH-_5.40
   akṣārameke // VGrs_5.41	akzAram-eke // VGrH-_5.41
   vyuṣṭe dvādaśarātre ṣaḍrātre vā grāmāt prācīṃ vodīcīṃ vā diśam	vyuzwe dvAdaSa-rAtre zaz-rAtre vA grAmAt prAcIm vA-udIcIm vA diSam
   upaniṣkramya paścāt palāśasya yajñīyasya vā vṛkṣasya sāvitreṇa	upanizkramya paScAt palASasya yajQIyasya vA vRkzasya sAvitreNa
   sthālīpākeneṣṭvā jayaprabhṛtibhiścājyasya purastāt sviṣṭakṛto mekhalāṃ	sTAlIpAkena-izwvA jaya-praBRtiBiH-ca-Ajyasya purastAt svizwakRtaH meKalAm
   daṇḍaṃ cāpsu prāsyet // VGrs_5.42	daNxam ca-apsu prAsyet // VGrH-_5.42
   tatraiva haviḥśeṣaṃ bhuñjīteti śrutiḥ // VGrs_5.43	tatra-eva haviH-Sezam BuQjIta-iti SrutiH // VGrH-_5.43
   Vārāhagṛhyasūtra, 6	VArAha-gRhya-sUtra, 6
   upanayanaprabhṛti vratacārī syāt // VGrs_6.1	upanayana-praBRti vrata-cArI syAt // VGrH-_6.1
   upanayanena vratādeśā vyākhyātāḥ // VGrs_6.2	upanayanena vrata-AdeSAH vyAKyAtAH // VGrH-_6.2
   mārgavāsāḥ saṃhatakeśaḥ bhaikṣācaryavṛttiḥ saśalkadaṇḍaḥ saptamauñjīṃ	mArga-vAsAH saMhata-keSaH BEkza-Acarya-vRttiH sa-Salka-daNxaH sapta-mOQjIm
   mekhalāṃ dhārayed ācāryasyāpratikūlaḥ sarvakārī // VGrs_6.3	meKalAm DArayet AcAryasya-apratikUlaH sarva-kArI // VGrH-_6.3
   yadenam upeyāt tad asmai dadyāt /	yat-enam upeyAt tat asmE dadyAt /
   bahūnāṃ yena saṃyuktaḥ // VGrs_6.4	bahUnAm yena saMyuktaH // VGrH-_6.4
   nāsya śayyāmāviśet // VGrs_6.5	na-asya SayyAm-AviSet // VGrH-_6.5
   na rathamārohet // VGrs_6.6	na raTam-Arohet // VGrH-_6.6
   na saṃvaset // VGrs_6.7	na saMvaset // VGrH-_6.7
   na vihārārtho jalpet // VGrs_6.8	na vihAra-arTaH jalpet // VGrH-_6.8
   na rucyarthaḥ kaṃcanaṃ dhārayet // VGrs_6.9	na ruci-arTaH kaMcanam DArayet // VGrH-_6.9
   sarvāṇi sāṃsparśakāni strībhyo varjayet // VGrs_6.10	sarvANi sAMsparSakAni strIByaH varjayet // VGrH-_6.10
   na snāyād daṇḍavat // VGrs_6.11	na snAyAt daNxa-vat // VGrH-_6.11
   nodakamabhyupeyāt // VGrs_6.12	na-udakam-aByupeyAt // VGrH-_6.12
   na divā svapet // VGrs_6.13	na divA svapet // VGrH-_6.13
   traividyakaṃ brahmacaryaṃ caret // VGrs_6.14	trEvidyakam brahmacaryam caret // VGrH-_6.14
   indriyasaṃyataḥ sāyaṃ prātar bhaikṣyavṛttiḥ // VGrs_6.15	indriya-saMyataH sAyam prAtar BEkzya-vRttiH // VGrH-_6.15
   sāyaṃ prātar agniṃ paricaret // VGrs_6.16	sAyam prAtar agnim paricaret // VGrH-_6.16
   adhaḥśāyī ācāryādhīnavṛttiḥ tannisargād aśanam ayācitaṃ lavaṇam //	aDas-SAyI AcArya-aDIna-vRttiH tad-nisargAt aSanam ayAcitam lavaNam //
   VGrs_6.17	VGrH-_6.17
   vāgyato 'śnīyāt // VGrs_6.18	vAgyataH aSnIyAt // VGrH-_6.18
   madhumāṃse varjayet // VGrs_6.19	maDu-mAMse varjayet // VGrH-_6.19
   acchannavastrāṃ vivṛtāṃ striyaṃ na paśyet // VGrs_6.20	acCanna-vastrAm vivRtAm striyam na paSyet // VGrH-_6.20
   yaupyasya vṛkṣasya daṇḍī syāt // VGrs_6.21	yOpyasya vRkzasya daNxI syAt // VGrH-_6.21
   nānena praharedgave na brāhmaṇāya // VGrs_6.22	na-anena praharet-gave na brAhmaNAya // VGrH-_6.22
   na nṛtyagīte gacchet // VGrs_6.23	na nRtya-gIte gacCet // VGrH-_6.23
   na caine kuryāt // VGrs_6.24	na ca-ene kuryAt // VGrH-_6.24
   nāvalikhet // VGrs_6.25	na-avaliKet // VGrH-_6.25
   śikhājaṭaḥ sarvajaṭo vā syāt // VGrs_6.26	SiKAjawaH sarva-jawaH vA syAt // VGrH-_6.26
   śāṇīkṣaumājinavāsāḥ // VGrs_6.27	SANI-kzOma-ajina-vAsAH // VGrH-_6.27
   raktaṃ vasanakambalam aiṇeyaṃ brāhmaṇasya rauravaṃ kṣatriyasya ājaṃ	raktam vasana-kambalam ENeyam brAhmaNasya rOravam kzatriyasya Ajam
   vaiśyasya // VGrs_6.28	vESyasya // VGrH-_6.28
   etena dharmeṇa dvādaśavarṣāṇy ekavede brahmacaryaṃ caret /	etena DarmeNa dvAdaSa-varzANi eka-vede brahmacaryam caret /
   caturviṃśati dvayoḥ ṣaṭtriṃśati trayāṇām aṣṭācatvāriṃśati sarveṣām /	caturviMSati dvayoH zawtriMSati trayANAm azwAcatvAriMSati sarvezAm /
   yāvad grahaṇaṃ vā // VGrs_6.29	yAvat grahaNam vA // VGrH-_6.29
   malajñurabalaḥ kṛśaḥ snātvā sa sarvaṃ labhate yat kiṃcin manasepsitamiti	malajQurabalaH kRSaH snAtvA sa sarvam laBate yat kiMcid manasA-Ipsitam-iti
   // VGrs_6.30	// VGrH-_6.30
   etena dharmeṇa sādhv adhīte // VGrs_6.31	etena DarmeNa sADu aDIte // VGrH-_6.31
   mantrabrāhmaṇānyadhītya kalpaṃ mīmāṃsāṃ ca yājñiko 'dhītya vaktraṃ padaṃ	mantra-brAhmaNAni-aDItya kalpam mImAMsAm ca yAjQikaH aDItya vaktram padam
   smṛtiṃ caicchikaḥ // VGrs_6.32	smRtim ca-EcCikaH // VGrH-_6.32
   tau snātakau // VGrs_6.33	tO snAtakO // VGrH-_6.33
   śrotriyo 'nyo vedapāṭhī /	SrotriyaH anyaH veda-pAWI /
   na tasya snānam // VGrs_6.34	na tasya snAnam // VGrH-_6.34
   upaviśyācamanaṃ vidhīyate /	upaviSya-Acamanam viDIyate /
   antarjānu bāhū kṛtvā trir ācāmet // VGrs_6.35	antar-jAnu bAhU kRtvA tris AcAmet // VGrH-_6.35
   dviḥ parimṛjet /	dvis parimRjet /
   khāni copaspṛśecchīrṣaṇyāni // VGrs_6.36	KAni ca-upaspRSet-SIrzaNyAni // VGrH-_6.36
   Vārāhagṛhyasūtra, 7	VArAha-gRhya-sUtra, 7
   atha cāturhotṛkī dīkṣā saṃvatsaram // VGrs_7.1	aTa cAturhotRkI dIkzA saMvatsaram // VGrH-_7.1
   āghārāv āghāryājyabhāgau hutvā caturhot n svakarmaṇo juhuyāt /	AGArO AGArya-Ajya-BAgO hutvA catur-hot n sva-karmaNaH juhuyAt /
   saha pañcahotrā ṣaḍḍhotrā ca saptahotāram antataḥ // VGrs_7.2	saha paQcahotrA zaz-XotrA ca sapta-hotAram antatas // VGrH-_7.2
   hutvā vrataṃ pradāyādito dvāv anuvākāv anuvācayet // VGrs_7.3	hutvA vratam pradAya-Aditas dvO anuvAkO anuvAcayet // VGrH-_7.3
   athāgnivratāśvamedhikī dīkṣā saṃvatsaraṃ dvādaśarātraṃ vā // VGrs_7.4	aTa-agnivratA-aSvameDikI dIkzA saMvatsaram dvAdaSa-rAtram vA // VGrH-_7.4
   ākūtamagnimiti ṣaḍḍhutvā vrataṃ pradāyādito 'ṣṭāv anuvākān anuvācayet //	AkUtam-agnim-iti zaz-hutvA vratam pradAya-Aditas azwO anuvAkAn anuvAcayet //
   VGrs_7.5	VGrH-_7.5
   triṣavaṇam udakam āharet trīṃs trīn kumbhān // VGrs_7.6	trizavaNam udakam Aharet trIn trIn kumBAn // VGrH-_7.6
   trīṃśca samitpulān // VGrs_7.7	trIn=-ca samiD-pulAn // VGrH-_7.7
   bhasmani śayīta karīṣe sikatāsu bhūmau vā // VGrs_7.8	Basmani SayIta karIze sikatAsu BUmO vA // VGrH-_7.8
   nodakam abhyupeyāt // VGrs_7.9	na-udakam aByupeyAt // VGrH-_7.9
   saṃvatsare samāpte ghṛtavatāpūpenāgnim iṣṭvā vātsapraṃ vācayet //	saMvatsare samApte GRtavatA-pUpena-agnim izwvA vAtsapram vAcayet //
   VGrs_7.10	VGrH-_7.10
   smārtena yāvad adhyayanaṃ kāṇḍavrataviśeṣā homārthaś cādyantayor juhuyāt	smArtena yAvat aDyayanam kANxa-vrata-viSezAH homa-arTaH ca-Adi-antayoH juhuyAt-
   // VGrs_7.11	// VGrH-_7.11
   athainaṃ paridadīta agnaye tvā paridadāni /	aTa-enam paridadIta agnaye tvA paridadAni /
   vāyave tvā paridadāni /	vAyave tvA paridadAni /
   sūryāya tvā paridadāni /	sUryAya tvA paridadAni /
   prajāpataye tvā paridadānīti // VGrs_7.12	prajApataye tvA paridadAni-iti // VGrH-_7.12
   etenaivāśvamedho vyākhyātaḥ // VGrs_7.13	etena-eva-aSvameDaH vyAKyAtaH // VGrH-_7.13
   navamenānuvākena hutvā daśamenopatiṣṭheta // VGrs_7.14	navamena-anuvAkena hutvA daSamena-upatizWeta // VGrH-_7.14
   aśvāya ghāsamudakasthānam udakaṃ cābhyupeyāt // VGrs_7.15	aSvAya GAsam-udaka-sTAnam udakam ca-aByupeyAt // VGrH-_7.15
   etābhyām evamantrābhyāṃ traividyakaṃ vratamupeyāt // VGrs_7.16	etAByAm eva-mantrAByAm trEvidyakam vratam-upeyAt // VGrH-_7.16
   rahasyamadhyeṣyatā pravargyaḥ // VGrs_7.17	rahasyam-aDyezyatA pravargyaH // VGrH-_7.17
   tasya rahasye vratopāyanaṃ saminmantraśca // VGrs_7.18	tasya rahasye vrata-upAyanam samiD-mantraH-ca // VGrH-_7.18
   tiṣṭhed ahani rātrāv āsīta vāgyataḥ // VGrs_7.19	tizWet ahani rAtrO AsIta vAgyataH // VGrH-_7.19
   parvasu caivaṃ syāt // VGrs_7.20	parvasu ca-evam syAt // VGrH-_7.20
   sarvajaṭaśca syāt // VGrs_7.21	sarva-jawaH-ca syAt // VGrH-_7.21
   saṃvatsarāvaraḥ pravargyo bhavati // VGrs_7.22	saMvatsara-avaraH pravargyaH Bavati // VGrH-_7.22
   Vārāhagṛhyasūtra, 8	VArAha-gRhya-sUtra, 8
   varṣāsu śravaṇenādhyāyān upākaroti /	varzAsu SravaNena-aDyAyAn upAkaroti /
   hastena vā /	hastena vA /
   prauṣṭhapadīm ityeke // VGrs_8.1	prOzWapadIm iti-eke // VGrH-_8.1
   atha juhoti /	aTa juhoti /
   apvā nāmāsi tasyāste joṣṭrīṃ gameyam /	apvA nAma-asi tasyAH-te jozwrIm gameyam /
   aham iddhi pituḥ pari medhā amṛtasya jagrabha /	aham id-hi pituH pari meDAH amRtasya jagraBaH /
   ahaṃ sūrya ivājani /	aham sUryaH iva-ajani /
   svāhā /	svAhA /
   apvo nāmāsi tasya te joṣṭraṃ gameyam /	apvaH nAma-asi tasya te jozwram gameyam /
   aham iddhi pituḥ pari medhā amṛtasya jagrabha /	aham id-hi pituH pari meDAH amRtasya jagraBaH /
   ahaṃ sūrya ivājani /	aham sUryaH iva-ajani /
   svāhā /	svAhA /
   iti // VGrs_8.2	iti // VGrH-_8.2
   yuktirnāmāsi /	yuktiH-nAma-asi /
   yogo nāmāsi /	yogaH nAma-asi /
   matir nāmāsi /	matiH nAma-asi /
   sumatirnāmāsi /	sumatiH-nAma-asi /
   sarasvatī nāmāsi /	sarasvatI nAma-asi /
   sarasvān nāmāsi /	sarasvAn nAma-asi /
   tasyāste tasya te ity anuṣajet // VGrs_8.3	tasyAH-te tasya te iti anuzajet // VGrH-_8.3
   yuje svāhā /	yuje svAhA /
   prayuje svāhā /	prayuje svAhA /
   saṃyuje svāhā /	saMyuje svAhA /
   udyuje svāhā /	udyuje svAhA /
   udyujyamānāya svāheti jayaprabhṛtibhiś cājyasya purastāt sviṣṭakṛto	udyujyamAnAya svAhA-iti jaya-praBRtiBiH ca-Ajyasya purastAt svizwakRtaH-
   'ntevāsināṃ yogam icchann atha japati ṛtaṃ vadiṣyāmi satyaṃ vadiṣyāmi	antevAsinAm yogam icCan aTa japati Rtam vadizyAmi satyam vadizyAmi
   brahma vadiṣyāmi tan mām avatu tadvaktāram avatv avatu māmavatu vaktāram /	brahma vadizyAmi tat mAm avatu tad-vaktAram avatu avatu mAm-avatu vaktAram /
   vāṅ me manasi pratiṣṭhitā mano me vāci pratiṣṭhitam āvir āyur mayi dhehi /	vAc me manasi pratizWitAH manaH me vAci pratizWitam Avis AyuH mayi Dehi /
   vedasya vāṇī stha /	vedasya vANI sTa /
   upatiṣṭhantu chandāṃsy upākurmahe 'dhyāyān // VGrs_8.4	upatizWantu CandAMsi upAkurmahe aDyAyAn // VGrH-_8.4
   oṃ bhūr bhuvaḥ svariti darbhapāṇis triḥ sāvitrīm adhītyāditaś ca trīn	om BUH BuvaH svar-iti darBa-pANiH tris sAvitrIm aDItya-Aditas ca trIn
   anuvākāṃs tathāṅgānām ekaikam /	anuvAkAn taTA-aFgAnAm ekEkam /
   ko vo yunaktīti ca // VGrs_8.5	kaH vaH yunakti-iti ca // VGrH-_8.5
   tasyānadhyāyāḥ /	tasya-anaDyAyAH /
   sataḥ valīkakṣāraprabhṛti varṣaṃ na vidyotamāne na stanayatīti śrutiḥ	sataH valIka-kzAra-praBRti varzam na vidyotamAne na stanayati-iti SrutiH
   ākālikaṃ devatu mūlaṃ vidyuddhanvolkātyakṣarāḥ śabdāḥ ācāreṇānye //	AkAlikam devatu mUlam vidyut-Danva-ulkA-atyakzarAH SabdAH AcAreNa-anye //
   VGrs_8.6	VGrH-_8.6
   ardhapañcamān māsān adhītya pañcārdhaṣaṣṭhān vā dīkṣaṇāyanaṃ	arDa-paQcamAn mAsAn aDItya paQcArDa-zazWAn vA dIkzaNa-ayanam
   vādhītyāthotsṛjanty etena dharmeṇa ṛtam avādiṣaṃ satyam avādiṣaṃ	vA-aDItyA-aTa-utsRjanti etena DarmeNa Rtam avAdizam satyam avAdizam
   brahmāvādiṣaṃ tan mām āvīt tadvaktāram āvīd āvīn mām āvīd vaktāram /	brahma-a=-Adizam tat mAm AvIt tad-vaktAram AvIt AvIt mAm AvIt vaktAram /
   vāṅ me manasi pratiṣṭhitā mano me vāci pratiṣṭhitam āvir āyur mayi dhehi /	vAc me manasi pratizWitAH manaH me vAci pratizWitam Avis AyuH mayi Dehi /
   vedasya vāṇī stha /	vedasya vANI sTa /
   pratiśvasantu chandāṃsy utsṛjāmahe 'dhyāyān // VGrs_8.7	pratiSvasantu CandAMsi utsRjAmahe aDyAyAn // VGrH-_8.7
   oṃ bhūr bhuvaḥ svar ity antam adhītya ko vo vimuñcatīti ca // VGrs_8.8	om BUH BuvaH svar iti antam aDItya kaH vaH vimuQcati-iti ca // VGrH-_8.8
   pakṣiṇīṃ rātrīṃ nādhīyīta /	pakziNIm rAtrIm na-aDIyIta /
   ubhayataḥ pakṣāṃ vā // VGrs_8.9	uBayatas pakzAm vA // VGrH-_8.9
   nāta ūrdhvamabhreṣu // VGrs_8.10	na-atas UrDvam-aBrezu // VGrH-_8.10
   ākālikavidyutstanayitnuvarṣaṃ varṣaṃ ca // VGrs_8.11	AkAlika-vidyut-stanayitnu-varzam varzam ca // VGrH-_8.11
   athopaniṣadarhāḥ /	aTa-upanizad-arhAH /
   brahmacārī sucaritī medhāvī karmakṛd dhanadaḥ priyaḥ vidyayā vā vidyām	brahmacArI su-caritI meDAvI karma-kRt DanadaH priyaH vidyayA vA vidyAm
   anvicchan // VGrs_8.12	anvicCan // VGrH-_8.12
   tāni tīrthāni brahmaṇaḥ // VGrs_8.13	tAni tIrTAni brahmaNaH // VGrH-_8.13
   Vārāhagṛhyasūtra, 9	VArAha-gRhya-sUtra, 9
   ṣoḍaśavarṣasya godānam /	zoxaSa-varzasya go-dAnam /
   agniṃ vādhyeṣyamāṇasya /	agnim vA-aDyezyamANasya /
   agnigodāno maitrāyaṇiḥ // VGrs_9.1	agni-godAnaH mEtrAyaNiH // VGrH-_9.1
   jaṭākaraṇenokto mantravidhiḥ // VGrs_9.2	jawA-karaNena-uktaH mantra-viDiH // VGrH-_9.2
   upastha upakakṣayoś cādhiko mantraprayogaḥ /	upasTe upakakzayoH ca-aDikaH mantra-prayogaH /
   yat kṣureṇa parcayatā supeśasā vaptar vapasi keśaśmaśrūn /	yat kzureNa parcayatA supeSasA vaptar vapasi keSa-SmaSrUn /
   śundha śiro mukhaṃ māsyāyuḥ pramoṣīḥ /	SunDa SiraH muKam mAsi-AyuH pramozIH /
   iti // VGrs_9.3	iti // VGrH-_9.3
   bhūmau keśān nikhanet // VGrs_9.4	BUmO keSAn niKanet // VGrH-_9.4
   ante gāṃ dadyāt // VGrs_9.5	ante gAm dadyAt // VGrH-_9.5
   vede guruṇānujñātaḥ snāyāt // VGrs_9.6	vede guruNA-anujQAtaH snAyAt // VGrH-_9.6
   chandasy arthān buddhvā snāsyan gāṃ kārayet // VGrs_9.7	Candasi arTAn budDvA snAsyan gAm kArayet // VGrH-_9.7
   ācāryamarhayet // VGrs_9.8	AcAryam-arhayet // VGrH-_9.8
   āpo hi ṣṭheti tisṛbhiḥ hiraṇyavarṇāḥ śucaya iti catasṛbhiḥ snātvāhate	ApaH hi zWA-iti tisRBiH hiraNya-varNAH SucayaH iti catasRBiH snAtvA-Ahate
   vāsasī paridadhīta vasvasi vasumantaṃ māṃ kuru sauvarcasāya vāṃ tejase	vAsasI paridaDIta vasu-asi vasumantam mAm kuru sOvarcasAya vAm tejase
   brahmavarcasāya paridadhānīti // VGrs_9.9	brahmavarcasAya paridaDAni-iti // VGrH-_9.9
   viśvajanasya chāyāsīti chattraṃ dhārayate // VGrs_9.10	viSva-janasya CAyA-asi-iti Cattram DArayate // VGrH-_9.10
   mālāmābadhnīte yām aśvinau dhārayetāṃ bṛhatīṃ puṣkarasrajam /	mAlAm-AbaDnIte yAm aSvinO DArayetAm bRhatIm puzkara-srajam /
   tāṃ viśvair devair anumatāṃ mālāmāropayāmi /	tAm viSvEH devEH anumatAm mAlAm-AropayAmi /
   iti // VGrs_9.11	iti // VGrH-_9.11
   tejo 'sīti hiraṇyaṃ bibhṛyāt // VGrs_9.12	tejaH asi-iti hiraNyam biBRyAt // VGrH-_9.12
   pratiṣṭhe stho devate mā mā saṃtāptam ityupānahau // VGrs_9.13	pratizWe sTaH devate mA mA saMtAptam iti-upAnahO // VGrH-_9.13
   viṣṭambho 'sīti dhārayedvaiṇavīṃ yaṣṭim // VGrs_9.14	vizwamBaH asi-iti DArayet-vENavIm yazwim // VGrH-_9.14
   sodakaṃ ca kamaṇḍalum // VGrs_9.15	sa-udakam ca kamaNxalum // VGrH-_9.15
   nityavratāny āhur ācāryāḥ // VGrs_9.16	nitya-vratAni AhuH AcAryAH // VGrH-_9.16
   dvivastro 'ta ūrdhvam /	dvi-vastraH atas UrDvam /
   śobhanaṃ vāso bhartavyamiti śrutiḥ // VGrs_9.17	SoBanam vAsaH Bartavyam-iti SrutiH // VGrH-_9.17
   āmantrya gurūn gurvadhīnāṃśca svān gṛhānvrajet // VGrs_9.18	Amantrya gurUn guru-aDInAn=-ca svAn gRhAn-vrajet // VGrH-_9.18
   pratiṣiddham aparayā dvārā niḥsaraṇaṃ malavadvāsasā saha sambhāṣā	pratizidDam aparayA dvArA niHsaraNam malavat-vAsasA saha samBAzA
   rajasvadvāsasā saha śayyā gor guror duruktavacanam asthāne śayanaṃ sthānaṃ	rajasvat-vAsasA saha SayyA goH guroH durukta-vacanam asTAne Sayanam sTAnam
   smayanaṃ yānaṃ gānaṃ smaraṇamiti /	smayanam yAnam gAnam smaraNam-iti /
   tāni varjayet // VGrs_9.19	tAni varjayet // VGrH-_9.19
   yājanaṃ vṛttiḥ /	yAjanam vRttiH /
   uñchaṃ śilamayācitapratigrahaḥ sādhubhyo vā yācitam /	uQCam Silam-ayAcita-pratigrahaH sADuByaH vA yAcitam /
   asaṃsidhyamānāyāṃ vā vaiśyavṛttiḥ // VGrs_9.20	asaMsiDyamAnAyAm vA vESya-vRttiH // VGrH-_9.20
   svādhyāyavirodhino 'rthān utsṛjet // VGrs_9.21	svADyAya-viroDinaH arTAn utsRjet // VGrH-_9.21
   Vārāhagṛhyasūtra, 10	VArAha-gRhya-sUtra, 10
   vinītakrodhaḥ saharṣaḥ saharṣīṃ bhāryāṃ vindetānanyapūrvāṃ yavīyasīm //	vinIta-kroDaH sa-harzaH saharzIm BAryAm vindeta-ananya-pUrvAm yavIyasIm //
   VGrs_10.1	VGrH-_10.1
   asamānapravarair vivāhaḥ /	asamAna-pravarEH vivAhaH /
   ūrdhvaṃ saptamāt pitṛbandhubhyaḥ pañcamān mātṛbandhubhyo bījinaśca //	UrDvam saptamAt pitR-banDuByaH paQcamAn mAtR-banDuByaH bIjinaH-ca //
   VGrs_10.2	VGrH-_10.2
   kṛttikāsvātipūrvair iti varayet // VGrs_10.3	kRttikA-svAti-pUrvEH iti varayet // VGrH-_10.3
   mṛgaśiraḥśraviṣṭhottarāṇīty upayamet // VGrs_10.4	mRgaSiraH-SravizWA-uttarANi-iti upayamet // VGrH-_10.4
   pañca vivāhakārakāṇi bhavanti vittaṃ rūpaṃ vidyā prajñā bāndhavamiti //	paQca vivAha-kArakANi Bavanti vittam rUpam vidyA prajQA bAnDavam-iti //
   VGrs_10.5	VGrH-_10.5
   ekālābhe vittaṃ visṛjet /	eka-alABe vittam visRjet /
   dvitīyālābhe rūpam /	dvitIya-alABe rUpam /
   tṛtīyālābhe vidyām /	tRtIya-alABe vidyAm /
   prajñāyāṃ tu bāndhave ca vivadante // VGrs_10.6	prajQAyAm tu bAnDave ca vivadante // VGrH-_10.6
   anṛkṣarā ṛjavaḥ santu panthā yebhiḥ sakhāyo yantu no vareyam /	anRkzarAH RjavaH santu panTAH yeBiH saKAyaH yantu naH vareyam /
   samaryamā saṃ bhago no 'nunīyāt saṃ jāspatyaṃ suyamamastu devāḥ /	samaryamA sam BagaH naH anunIyAt sam jAspatyam suyamam-astu devAH /
   iti varakān vrajato 'numantrayate // VGrs_10.7	iti varakAn vrajataH anumantrayate // VGrH-_10.7
   bandhumatīṃ kanyām aspṛṣṭamaithunām upayacchetānagnikāṃ śreṣṭhām //	banDumatIm kanyAm aspRzwa-mETunAm upayacCeta-anagnikAm SrezWAm //
   VGrs_10.8	VGrH-_10.8
   vijñānamasyai kuryāt /	vijQAnam-asyE kuryAt /
   caturo loṣṭān āharet sītāloṣṭaṃ vediloṣṭaṃ gomayaloṣṭaṃ śmaśānaloṣṭaṃ ca	caturaH lozwAn Aharet sItA-lozwam vedi-lozwam gomaya-lozwam SmaSAna-lozwam ca
   // VGrs_10.9	// VGrH-_10.9
   teṣāmekaṃ gṛhṇīṣveti brūyāt /	tezAm-ekam gRhNIzva-iti brUyAt /
   śmaśānaloṣṭaṃ ced gṛhṇīyān nopayaccheta // VGrs_10.10	SmaSAna-lozwam ced gRhNIyAt na-upayacCeta // VGrH-_10.10
   asaṃspṛṣṭāṃ dharmeṇopayaccheta brāhmeṇa śaulkena vā // VGrs_10.11	asaMspRzwAm DarmeNa-upayacCeta brAhmeNa SOlkena vA // VGrH-_10.11
   śatamitirathaṃ dadyād gomithunaṃ vā // VGrs_10.12	Sata-miti-raTam dadyAt go-miTunam vA // VGrH-_10.12
   ubhayāṃs tejanīṣv āsej janyān kaumārikāṃś ca /	uBayAn tejanIzu Aset janyAn kOmArikAn ca /
   pūrve janyāḥ syur apare kaumārikāḥ // VGrs_10.13	pUrve janyAH syuH apare kOmArikAH // VGrH-_10.13
   caturo gomayapiṇḍān kṛtvā dvāv anyebhyas tathānyebhya iti prayacchet //	caturaH gomaya-piNxAn kRtvA dvO anyeByaH taTA-anyeByaH iti prayacCet //
   VGrs_10.14	VGrH-_10.14
   dhanaṃ na iti brūyuḥ /	Danam naH iti brUyuH /
   putrapaśavo na iti janyāḥ // VGrs_10.15	putra-paSavaH naH iti janyAH // VGrH-_10.15
   dadāni /	dadAni /
   pratigṛhṇānīti trir brahmadeyām // VGrs_10.16	pratigRhNAni-iti tris brahma-deyAm // VGrH-_10.16
   kṛtenāṃsena visaṃkaseyuḥ // VGrs_10.17	kRtena-aMsena visaMkaseyuH // VGrH-_10.17
   trir ānandaṃ māgadho hvayet // VGrs_10.18	tris Anandam mAgaDaH hvayet // VGrH-_10.18
   Vārāhagṛhyasūtra, 11	VArAha-gRhya-sUtra, 11
   ṣaḍarghyārhā bhavanti ṛtvigācāryo vivāhyo rājā snātakaḥ priyaśceti //	zaz-arGya-arhAH Bavanti Rtvij-AcAryaH vivAhyaH rAjA snAtakaH priyaH-ca-iti //
   VGrs_11.1	VGrH-_11.1
   aprākaraṇikānnā parisaṃvatsarād arhayanti /	aprAkaraNika-annA parisaMvatsarAt arhayanti /
   anyatra yājyāt karmaṇo vivāhāc ca // VGrs_11.2	anyatra yAjyAt karmaNaH vivAhAt ca // VGrH-_11.2
   na jīvapitṛko 'rghyaṃ pratigṛhṇīyāt // VGrs_11.3	na jIvapitRkaH arGyam pratigRhNIyAt // VGrH-_11.3
   athainam arhayanti // VGrs_11.4	aTa-enam arhayanti // VGrH-_11.4
   kāṃsye camase vā dadhani madhvāsicya varṣīyasāpidhāya virājo doho 'si	kAMsye camase vA daDani maDu-Asicya varzIyasA-apiDAya virAjaH dohaH asi
   virājo doho 'si virājo doham aśīya mayi dohaḥ padyāyai virāja iti	virAjaH dohaH asi virAjaH doham aSIya mayi dohaH padyAyE virAjaH iti
   madhuparkarmāhiyamāṇaṃ pratīkṣate // VGrs_11.5	maDu-parkarma-ahiyamANam pratIkzate // VGrH-_11.5
   sāvitreṇa viṣṭarau pratigṛhya rāṣṭrabhṛd asīty āsaṃdyām udagagram āstṛṇāti	sAvitreNa vizwarO pratigRhya rAzwraBRt asi-iti AsaMdyAm udagagram AstRNAti
   // VGrs_11.6	// VGrH-_11.6
   ahaṃ varṣma sadṛśānām udyatānām iva sūryaḥ /	aham varzma sadRSAnAm udyatAnAm iva sUryaH /
   idam ahaṃ tam adharaṃ karomi yo mā kaścābhidāsati /	idam aham tam aDaram karomi yaH mA kaH-ca-aBidAsati /
   ity ekasminn upaviśati // VGrs_11.7	iti ekasmin upaviSati // VGrH-_11.7
   mā tvadyoṣam ity anyataram adhastāt pādayor upakarṣati // VGrs_11.8	mA tvad-yozam iti anyataram aDastAt pAdayoH upakarzati // VGrH-_11.8
   viṣṭara āsīnāyaikaikaṃ triḥ prāha // VGrs_11.9	vizwaraH AsInAya-ekEkam tris prAha // VGrH-_11.9
   naiva bho ityāha /	na-eva Bo iti-Aha /
   na mā riṣāmeti // VGrs_11.10	na mA rizAma-iti // VGrH-_11.10
   ācamanīyāḥ prathamāḥ pratipadyante // VGrs_11.11	AcamanIyAH praTamAH pratipadyante // VGrH-_11.11
   amṛtopastaraṇam asīty ācāmati // VGrs_11.12	amRta-upastaraNam asi-iti AcAmati // VGrH-_11.12
   padyena pādau prakṣālayati // VGrs_11.13	padyena pAdO prakzAlayati // VGrH-_11.13
   spṛśaty argham // VGrs_11.14	spRSati arGam // VGrH-_11.14
   tataḥ praṇayati // VGrs_11.15	tatas praNayati // VGrH-_11.15
   sāvitreṇobhayato viṣṭaraṃ madhuparkaṃ pratigṛhya adityās tvā pṛṣṭhe	sAvitreNa-uBayatas vizwaram maDuparkam pratigRhya adityAH tvA pRzWe
   sādayāmīti bhūmau pratiṣṭhāpyāvasāyya suparṇasya tvā garutmataś	sAdayAmi-iti BUmO pratizWApyAvasAyya suparNasya tvA garutmataH-
   cakṣuṣāvekṣa ityavekṣya namo rudrāya pātrasada iti prādeśena pratidiśaṃ	cakzuzA-avekzaH iti-avekzya namaH rudrAya pAtra-sadaH iti prAdeSena pratidiSam
   vyuddiśyāṅguṣṭhenopamadhyamayā ca madhu vātā ṛtāyata iti tisṛbhiḥ	vyuddiSya-aFguzWena-upamaDyamayA ca maDu vAtA RtAyate iti tisRBiH
   saṃsṛjati // VGrs_11.16	saMsRjati // VGrH-_11.16
   satyaṃ yaśaḥ śrīḥ śrayatāmiti triḥ prāśnāti bhūyiṣṭham // VGrs_11.17	satyam yaSaH SrIH SrayatAm-iti tris prASnAti BUyizWam // VGrH-_11.17
   suhṛde 'vaśiṣṭaṃ prayacchati // VGrs_11.18	suhRde avaSizwam prayacCati // VGrH-_11.18
   amṛtapidhānam asīty ācāmati // VGrs_11.19	amRta-piDAnam asi-iti AcAmati // VGrH-_11.19
   asiviṣṭarapāṇir gāṃ prāha // VGrs_11.20	asi-vizwara-pANiH gAm prAha // VGrH-_11.20
   hato me pāpmā pāpmānaṃ me hata /	hataH me pApmA pApmAnam me hata /
   yāṃ tvā devā vasavo 'nvajīviṣur ādityānāṃ svasāraṃ rudramātaram /	yAm tvA devAH vasavaH anvajIvizuH AdityAnAm svasAram rudra-mAtaram /
   daivīṃ gāmaditiṃ janānām ārabhantām arhatām arhaṇāya /	dEvIm gAm-aditim janAnAm AraBantAm arhatAm arhaNAya /
   oṃ kuruteti sampreṣyati // VGrs_11.21	om kuruta-iti samprezyati // VGrH-_11.21
   catur avarān brāhmaṇān nānāgotrān ityekaikaṃ paśvaṅgaṃ pāyasaṃ vā bhojayet	catuH avarAn brAhmaNAn nAnA-gotrAn iti-ekEkam paSu-aFgam pAyasam vA Bojayet-
   // VGrs_11.22	// VGrH-_11.22
   yadyutsṛjet mātā rudrāṇāṃ duhitā vasūnāṃ svasādityānām amṛtasya nābhiḥ /	yadi-utsRjet mAtA rudrANAm duhitA vasUnAm svasA-AdityAnAm amRtasya nABiH /
   pra nu vocaṃ cikituṣe janāya mā gāmanāgāmaditiṃ vadhiṣṭa // VGrs_11.23	pra nu vocam cikituze janAya mA gAm-anAgAma-ditim vaDizwaH // VGrH-_11.23
   om utsṛjata tṛṇānyat tūdakaṃ pibatu // VGrs_11.24	om utsRjata tRNa-anyat tu-udakam pibatu // VGrH-_11.24
   ityukte paśum ālabhante // VGrs_11.25	iti-ukte paSum AlaBante // VGrH-_11.25
   śaṃ no mitra iti pāṇī prakṣālya yathārtham // VGrs_11.26	Sam naH mitraH iti pANI prakzAlya yaTArTam // VGrH-_11.26
   Vārāhagṛhyasūtra, 12	VArAha-gRhya-sUtra, 12
   athālaṃkaraṇam alaṃkaraṇam asi sarvasmā alaṃ bhūyāsam // VGrs_12.1	aTa-alaMkaraNam alaMkaraNam asi sarvasmE alam BUyAsam // VGrH-_12.1
   prāṇāpānau me tarpayāmi samānavyānau me tarpayāmy udānarūpe me tarpayāmi	prANa-apAnO me tarpayAmi samAna-vyAnO me tarpayAmi udAna-rUpe me tarpayAmi
   cakṣuḥśrotre me tarpayāmi sucakṣā aham akṣibhyāṃ bhūyāsaṃ suvarcā mukhena	cakzuH-Srotre me tarpayAmi su-cakzAH aham akziByAm BUyAsam suvarcAH muKena
   suśrutkarṇābhyām iti gandhācchādane // VGrs_12.2	suSrutkarNAByAm iti ganDa-AcCAdane // VGrH-_12.2
   paridhāsye yaśo dhāsye dīrghāyutvāya jaradaṣṭir asmi /	pariDAsye yaSaH DAsye dIrGa-Ayu-tvAya jara-dazwiH asmi /
   śataṃ ca jīva śaradaḥ purūcīrvasūni cāyyo vibhajāya jīyām /	Satam ca jIva SaradaH purUcIH-vasUni cAyyaH viBajAya jIyAm /
   ityahataṃ vāsa ācchādyāgniṃ prajvālya vyāhṛtibhir vrīhiyavān hutvā	iti-ahatam vAsaH AcCAdya-agnim prajvAlya vyAhRtiBiH vrIhi-yavAn hutvA
   maṅgalāny āśāset // VGrs_12.3	maFgalAni ASAset // VGrH-_12.3
   Vārāhagṛhyasūtra, 13	VArAha-gRhya-sUtra, 13
   atha pravadane kanyāmupavasitāṃ snātāṃ saśiraskām ahatenācchinnadaśena	aTa pravadane kanyAm-upavasitAm snAtAm sa-SiraskAm ahatena-AcCinna-daSena
   vāsasā saṃvītāṃ saṃstīrṇasya purastād vihitāni vāditrāṇi vidhivadupakalpya	vAsasA saMvItAm saMstIrNasya purastAt vihitAni vAditrANi viDivat-upakalpya
   purastāt sviṣṭakṛto vāce pathyāyai pūṣṇe pṛthivyā agnaye senāyai dhenāyai	purastAt svizwakRtaH vAce paTyAyE pUzNe pRTivyAH agnaye senAyE DenAyE
   gāyatryai triṣṭubhe jagatyā anuṣṭubhe paṅktaye virāje rākāyai sinīvālyai	gAyatryE trizwuBe jagatyA anuzwuBe paFktaye virAje rAkAyE sinIvAlyE
   kuhvai tvaṣṭra āśāyai sampattyai bhūtyai nirṛtyā anumatyai parjanyāyāgnaye	kuhvE tvazwre ASAyE sampattyE BUtyE nirRtyAH anumatyE parjanyAya-agnaye
   sviṣṭakṛte ca juhuyāt // VGrs_13.1	svizwakRte ca juhuyAt // VGrH-_13.1
   ājyaśeṣeṇa pāṇī pralipya kanyāyā mukhaṃ saṃmārṣṭi priyāṃ karomi pataye	Ajya-SezeNa pANI pralipya kanyAyAH muKam saMmArzwi priyAm karomi pataye
   devarāṇāṃ śvaśurāya ca /	devarANAm SvaSurAya ca /
   rucyai tvāgniḥ saṃsṛjatu ruciṣyā pataye bhava /	rucyE tvA-agniH saMsRjatu rucizyA pataye Bava /
   saubhāgyena tvā saṃsṛjatv ilā devī ghṛtapadīndrāṇy agnāyyaśvinī rāṭ /	sOBAgyena tvA saMsRjatu ilA devI GRta-padI-indrANi agnAyI-aSvinI rAj /
   vāgilā dyaur arundhatī /	vAgilA dyOH arunDatI /
   iti ca // VGrs_13.2	iti ca // VGrH-_13.2
   sarvāṇi vāditrāṇy abhimantrayate yā caturdhā pravadaty agnau yā vāte yā	sarvANi vAditrANi aBimantrayate yA caturDA pravadati agnO yA vAte yA
   bṛhatyuta /	bRhatI-uta /
   paśūnāṃ yāṃ brāhmaṇe nyadadhuḥ śivā sā pravadatv iha /	paSUnAm yAm brAhmaNe nyadaDuH SivA sA pravadatu iha /
   iti // VGrs_13.3	iti // VGrH-_13.3
   sarvāṇi vāditrāṇy alaṃkṛtya kanyā pravādayate śubhaṃ vada dundubhe	sarvANi vAditrANi alaMkRtya kanyA pravAdayate SuBam vada dunduBe
   suprajāstvāya gomukha /	suprajAH-tvAya gomuKaH /
   prakrīḍantu kanyāḥ sumanasyamānāḥ sahendrāṇyā savayasaḥ sanīḍāḥ /	prakrIxantu kanyAH sumanasyamAnAH saha-indrANyA sa-vayasaH sa-nIxAH /
   prajāpatiryo vasati prajāsu prajās tanvate sumanasyamānāḥ /	prajApatiH-yaH vasati prajAsu prajAH tanvate sumanasyamAnAH /
   sa imāḥ prajā ramayatu prajātyai svayaṃ ca no ramatāṃ śaṃ dadhānaḥ /	saH imAH prajAH ramayatu prajAtyE svayam ca naH ramatAm Sam daDAnaH /
   iti // VGrs_13.4	iti // VGrH-_13.4
   pravadanti kārālikāni // VGrs_13.5	pravadanti kArAlikAni // VGrH-_13.5
   kanyām udakenābhiṣiñcet // VGrs_13.6	kanyAm udakena-aBiziQcet // VGrH-_13.6
   Vārāhagṛhyasūtra, 14	VArAha-gRhya-sUtra, 14
   khe rathasya khe 'nasaḥ khe yugasya śatakratoḥ /	Ke raTasya Ke anasaH Ke yugasya SatakratoH /
   abālām indrastriḥ pūrtty akṛṇot sūryavarcasaḥ /	abAlAm indraH-tris pUrtti akRNot sUrya-varcasaH /
   ityathāsyā ahataṃ vāsaḥ prayacchati // VGrs_14.1	iti-aTa-asyE ahatam vAsaH prayacCati // VGrH-_14.1
   athaināṃ darbhaśulvena saṃnahyati saṃ tvā nahyāmi payasā pṛthivyāḥ saṃ tvā	aTa-enAm darBa-Sulvena saMnahyati sam tvA nahyAmi payasA pRTivyAH sam tvA
   nahyāmy adbhiroṣadhībhiḥ /	na-hyAmi adBiH-ozaDIBiH /
   saṃ tvā nahyāmi prajayā dhanena saha saṃnaddhā sunuhi bhāgadheyam /	sam tvA nahyAmi prajayA Danena saha saMnadDA sunuhi BAgaDeyam /
   iti // VGrs_14.2	iti // VGrH-_14.2
   athaināṃ vāsaso 'ntaṃ grāhayitvābhyudānayati aghoracakṣur apatighny edhi /	aTa-enAm vAsasaH antam grAhayitvA-aByudAnayati aGora-cakzuH apatiGnI eDi /
   ehi śivā paśubhyaḥ sumanāḥ suvarcāḥ /	ehi SivA paSuByaH sumanAH suvarcAH /
   dīrghāyupatnī prajayā svarvid indrapraṇayīr upa no vastum ehi /	dIrGa-Ayu-patnI prajayA svarvid indra-praNayIH upa naH vastum ehi /
   iti // VGrs_14.3	iti // VGrH-_14.3
   samūhanollepanoddhananāvekṣaṇam ity agnikāle bhūmisaṃskārān sarvatra	samUhana-ullepana-udDanana-avekzaNam iti agni-kAle BUmi-saMskArAn sarvatra
   yathānimittam // VGrs_14.4	yaTA-nimittam // VGrH-_14.4
   paścādagneḥ kaṭe tejanyāṃ vā darbheṣv āsanam // VGrs_14.5	paScAt-agneH kawe tejanyAm vA darBezu Asanam // VGrH-_14.5
   śucau bhūmipradeśe śamīśamakaśyāmākānāṃ priyaṅgudūrvāgaurasarṣapāṇāṃ	SucO BUmi-pradeSe SamI-Samaka-SyAmAkAnAm priyaFgu-dUrvA-gOrasarzapANAm
   yathālābhagandhasakṣīraphalavadbhyo vanaspatibhyo haritparṇakuśayavādibhiś	yaTA-lABa-ganDa-sakzIra-PalavadByaH vanaspatiByaH harit-parNa-kuSayava-AdiBiH-
   cānnair yā oṣadhayaḥ /	ca-annEH yAH ozaDayaH /
   samanyā yantīty anuvākena śaṃ no devīriti ca sahiraṇyāpo 'bhimantrya	samanyAH yanti-iti anuvAkena Sam naH devIH-iti ca sa-hiraNya-apaH aBimantrya
   praṇītodakumbhaṃ praṇayet // VGrs_14.6	praNIta-uda-kumBam praNayet // VGrH-_14.6
   taṃ lājāhutīṣu hūyamānāsu bhrātā brahmacārī vodgṛhya dhārayed dakṣiṇataśca	tam lAja-AhutIzu hUyamAnAsu BrAtA brahmacArI vA-udgRhya DArayet dakziNatas-ca
   // VGrs_14.7	// VGrH-_14.7
   lājān saṃskṛtān śamīparṇamiśrān śūrpeṇa dakṣiṇato mātānyā vāvidhavā //	lAjAn saMskRtAn SamI-parNa-miSrAn SUrpeNa dakziNatas mAtA-anyA vA-aviDavA //
   VGrs_14.8	VGrH-_14.8
   ājyaṃ saṃskṛtya brahmāṇam āmantrya samidham ādhāyāghārāv āghāryājyabhāgau	Ajyam saMskRtya brahmANam Amantrya samiDam ADAya-AGArO AGArya-Ajya-BAgO
   hutvā // VGrs_14.9	hutvA // VGrH-_14.9
   atha juhoti /	aTa juhoti /
   agnaye janavide svāhā /	agnaye jana-vide svAhA /
   somāya janavide svāhā /	somAya jana-vide svAhA /
   gandharvāya janavide svāhā /	ganDarvAya jana-vide svAhA /
   somaḥ prathamo vivide gandharvo vivida uttaraḥ /	somaH praTamaH vivide ganDarvaH vivide uttaraH /
   tṛtīyo 'gniṣṭe patisturyo 'haṃ manuṣyajāḥ /	tRtIyaH agnizwe patiH-turyaH aham manuzya-jAH /
   svāhā /	svAhA /
   somo 'dadad gandharvāya gandharvo 'dadad agnaye /	somaH adadat ganDarvAya ganDarvaH adadat agnaye /
   rayiṃ ca putrāṃś cādād agnir mahyamatho imām /	rayim ca putrAn ca-AdAt agniH mahyam-aTo imAm /
   iti // VGrs_14.10	iti // VGrH-_14.10
   hiraṇyagarbha ityaṣṭābhiḥ pratyṛcam ājyāhutīr juhuyāt // VGrs_14.11	hiraNyagarBaH iti-azwABiH pratyRcam Ajya-AhutIH juhuyAt // VGrH-_14.11
   yena karmaṇertset tatra jayāñ juhuyāditi jayānāṃ śrutiḥ /	yena karmaNA-Irtset tatra jayAn juhuyAt-iti jayAnAm SrutiH /
   tvā yathoktam /	tvA yaToktam /
   ākūtyai tvā svāhā /	AkUtyE tvA svAhA /
   bhūtyai tvā svāhā /	BUtyE tvA svAhA /
   kāmāyai tvā svāhā /	kAmAyE tvA svAhA /
   rakṣāyai tvā svāhā /	rakzAyE tvA svAhA /
   samṛdhe tvā svāhā /	samRDe tvA svAhA /
   samṛddhyai tvā svāhā /	samRdDyE tvA svAhA /
   ṛcā stomam /	RcA stomam /
   prajāpataye /	prajApataye /
   bhūḥ svāhā /	BUH svAhA /
   ayāś cāgne 'sīti ca // VGrs_14.12	ayAH ca-agne asi-iti ca // VGrH-_14.12
   uttarato 'gner darbheṣu prācīṃ kanyām avasthāpya purastāt pratyaṅmukha	uttaratas agneH darBezu prAcIm kanyAm avasTApya purastAt pratyaFmuKa
   upayantā devasya te savituḥ prasave 'śvinor bāhubhyāṃ pūṣṇo hastābhyāṃ	upayantAH devasya te savituH prasave aSvinoH bAhuByAm pUzNaH hastAByAm
   hastaṃ gṛhṇāmy aham asāv ity athāsyā upanayanavaddhastaṃ gṛhṇāti	hastam gRhNAmi aham asO iti aTa-asyAH upanayana-vat-hastam gRhNAti
   nīcāriktam ariktena /	nIca-Ariktam ariktena /
   gṛhṇāmi te saubhagatvāya hastaṃ mayā patyā jaradaṣṭir yathāsat /	gRhNAmi te sOBaga-tvAya hastam mayA patyA jara-dazwiH yaTAsat /
   bhago 'ryamā savitā puraṃdhir mahyaṃ tvādurgāharpatyāya devāḥ /	BagaH aryamA savitA puraMDiH mahyam tvA-durgA-harpatyAya devAH /
   ūrdhvā vāk samabhavat purā devāsurebhyaḥ /	UrDvA vAc samaBavat purA deva-asureByaH /
   yāṃ tvā viśvasya bhūtasya prāg āyāmy asyā agrataḥ /	yAm tvA viSvasya BUtasya prAk AyAmi asyAH agratas /
   sarasvati predam ava subhage vājinīvati /	sarasvati predam ava suBage vAjinIvati /
   yena bhūtaṃ samabhavad yena viśvamidaṃ jagat tāmadya gāthāṃ gāsyāmo yā	yena BUtam samaBavat yena viSvam-idam jagat tAm-adya gATAm gAsyAmaH yA
   strīṇām uttamaṃ manaḥ /	strINAm uttamam manaH /
   sā tvam asy amo 'ham amo 'hamasmi sā tvam /	sA tvam asi amaH aham amaH aham-asmi sA tvam /
   dyaur ahaṃ pṛthivī tvaṃ bṛhad ahaṃ rathaṃtaraṃ tvam /	dyOH aham pRTivI tvam bRhat aham raTaMtaram tvam /
   reto 'ham asmi retodhṛk tvam /	retaH aham asmi retoDRc tvam /
   sāmāham asmi ṛktvaṃ mano 'hamasmi vāktvam /	sAma-aham asmi Rc-tvam manaH aham-asmi vAc-tvam /
   sā mām anuvratā bhava sā mām anuprajāyasva /	sA mAm anuvratA Bava sA mAm anuprajAyasva /
   prajāṃ sṛjāvahā ubhau puṃse putrāya kartave /	prajAm sRja-AvahAH uBO puMse putrAya kartave /
   śriyai putrāya vethaveha sūnṛte /	SriyE putrAya veTavA-iha sUnRte /
   iti // VGrs_14.13	iti // VGrH-_14.13
   pradakṣiṇamagniṃ pariṇayet // VGrs_14.14	pradakziNam-agnim pariNayet // VGrH-_14.14
   paścād agner darbheṣvaśmānamavasthāpayati ātiṣṭhemam aśmānamaśmeva tvaṃ	paScAt agneH darBezu-aSmAnam-avasTApayati AtizWa-imam aSmAnam-aSmA-iva tvam
   sthirā bhava /	sTirA Bava /
   kṛṇvantu viśve devā āyuṣṭe śaradaḥ śatam /	kRNvantu viSve devAH Ayuzwe SaradaH Satam /
   iti // VGrs_14.15	iti // VGrH-_14.15
   atraivāsyā dvitīyaṃ vāsaḥ prayacchati // VGrs_14.16	atra-eva-asyAH dvitIyam vAsaH prayacCati // VGrH-_14.16
   uparyagnāv añjalau lājān bhrātā brahmacārī vopastīrṇa āvapet // VGrs_14.17	upari-agnO aQjalO lAjAn BrAtA brahmacArI vA-upastIrNaH Avapet // VGrH-_14.17
   tān abhighāritān avicchindatī juhuyāt /	tAn aBiGAritAn avicCindatI juhuyAt /
   kartānumantrayeta /	kartA-anumantrayeta /
   iyaṃ nāry upabrūte lājān āvapantikā /	iyam nArI upabrUte lAjAn AvapantikAH /
   dīrghāyurastu me patir edhantāṃ jñātayo mama /	dIrGa-AyuH-astu me patiH eDantAm jQAtayaH mama /
   aryamaṇaṃ nu devaṃ kanyāgnim ayakṣata /	aryamaNam nu devam kanyA-agnim ayakzata /
   so 'smāndevo 'ryamā preto muñcātu māmuta /	saH asmAn-devaH aryamA pretaH muQcAtu mAm-uta /
   svāhā /	svAhA /
   iti // VGrs_14.18	iti // VGrH-_14.18
   vīrasūr jīvapatnīr bhūyāsam iti sarvatra vācayet // VGrs_14.19	vIrasUH jIva-patnIH BUyAsam iti sarvatra vAcayet // VGrH-_14.19
   tubhyamagre paryaṇayaṃ sūryāṃ vahatunā saha /	tuByam-agre paryaNayam sUryAm vahatunA saha /
   punaḥ patibhyo jāyāṃ dā agne prajayā saha /	punar patiByaH jAyAm dAH agne prajayA saha /
   iti dvitīyaṃ pariṇayet // VGrs_14.20	iti dvitIyam pariNayet // VGrH-_14.20
   evameva tṛtīyam /	evam-eva tRtIyam /
   avasthāpanaprabhṛti samānam /	avasTApana-praBRti samAnam /
   pūṣaṇaṃ nu devam /	pUzaNam nu devam /
   varuṇaṃ nu devamiti homau /	varuNam nu devam-iti homO /
   kanyāgnim ayakṣateti samānam // VGrs_14.21	kanyA-agnim ayakzata-iti samAnam // VGrH-_14.21
   kāmena caturthī pūrayitvā dvir abhighāryottarārdhapūrvārdhe juhuyāt //	kAmena caturTI pUrayitvA dvis aBiGArya-uttara-arDa-pUrva-arDe juhuyAt //
   VGrs_14.22	VGrH-_14.22
   athaināṃ prācīṃ sapta padāni prakramayati ekam iṣe viṣṇustvāṃ nayatu /	aTa-enAm prAcIm sapta padAni prakramayati ekam ize vizNuH-tvAm nayatu /
   dve ūrje /	dve Urje /
   trīṇi rāyaspoṣāya /	trINi rAyaspozAya /
   catvāri māyobhavāya /	catvAri mAyoBavAya /
   pañca prajābhyaḥ /	paQca prajAByaH /
   ṣaḍ ṛtubhyaḥ /	zaw RtuByaH /
   sapta saptabhyo hotrābhyaḥ /	sapta saptaByaH hotrAByaH /
   viṣṇus tvāṃ nayatv iti dvitīyaprabhṛtyanuṣajet /	vizNuH tvAm nayatu iti dvitIya-praBRti-anuzajet /
   sakhī saptapadī bhava sakhyaṃ te gameyaṃ sakhyātte mā riṣam iti saptama	saKI saptapadI Bava saKyam te gameyam saKyAt-te mA rizam iti saptama
   enāṃ prekṣamāṇāṃ samīkṣate // VGrs_14.23	enAm prekzamANAm samIkzate // VGrH-_14.23
   pra tvā muñcātu varuṇasya pāśād yena tvābadhnāt savitā suśevaḥ /	pra tvA muQcAtu varuNasya pASAt yena tu-AbaDnAt savitA suSevaH /
   dhātuśca yonau sukṛtasya loke hṛṣṭā saṃ saha patyā bhūyāsam /	DAtuH-ca yonO sukRtasya loke hRzwA sam saha patyA BUyAsam /
   iti śulvaṃ visraṃsyodakumbhena mārjayante punantu mā pitara ityanuvākena /	iti Sulvam visraMsya-uda-kumBena mArjayante punantu mA pitaraH iti-anuvAkena /
   āpohiṣṭhīyenety eke // VGrs_14.24	ApohizWIyena-iti eke // VGrH-_14.24
   sumaṅgalīr iyaṃ vadhur imāṃ sametya paśyata /	su-maFgalIH iyam vaDuH imAm sametya paSyata /
   saubhāgyamasyai dattvā yathārthaṃ viparetana /	sOBAgyam-asyE dattvA yaTArTam viparetanaH /
   iti // VGrs_14.25	iti // VGrH-_14.25
   sthālīpākena śeṣo vyākhyātaḥ // VGrs_14.26	sTAlI-pAkena SezaH vyAKyAtaH // VGrH-_14.26
   pṛthaktvet /	pRTak-tvet /
   yena dyaur ugrety evaṃprabhṛtaya udvāhe homāḥ syuḥ /	yena dyOH ugra-iti evaMpraBRtayaH udvAhe homAH syuH /
   nāpāṇigrahaṇe lājāḥ /	na-apANigrahaNe lAjAH /
   samānaṃ prakramaṇaṃ mārjanaṃ ca // VGrs_14.27	samAnam prakramaNam mArjanam ca // VGrH-_14.27
   Vārāhagṛhyasūtra, 15	VArAha-gRhya-sUtra, 15
   aṅkau nyaṅkāv abhito rathaṃ ye dhvāntā vātā agram abhi ye saṃpatanti /	aFkO nyaFkO aBitas raTam ye DvAntAH vAtAH agram aBi ye saMpatanti /
   dūrehetiḥ patatrī vājinīvāṃs te no 'gnayaḥ paprayaḥ pārayantu /	dUrehetiH patatrI vAjinIvAn te naH agnayaH paprayaH pArayantu /
   iti cakram abhimantrayate // VGrs_15.1	iti cakram aBimantrayate // VGrH-_15.1
   sukiṃśukaṃ śalmaliṃ viśvarūpaṃ hiraṇyavarṇaṃ sudhuraṃ sucakram /	su-kiMSukam Salmalim viSva-rUpam hiraNya-varNam suDuram su-cakram /
   āroha sūrye amṛtasya panthāṃs tena yāhi gṛhān svasti /	Aroha sUrye amRtasya panTAn tena yAhi gRhAn svasti /
   ityāropayet // VGrs_15.2	iti-Aropayet // VGrH-_15.2
   upa māyantu devatā upa brahma suvīryam /	upa mAyantu devatAH upa brahma su-vIryam /
   upa kṣatraṃ ca yadbalamupa māmaitu yadbalam /	upa kzatram ca yat-balam-upa mAm-Etu yat-balam /
   iti prayāsyan japati // VGrs_15.3	iti prayAsyan japati // VGrH-_15.3
   anu māyantu devatā anu brahma suvīryam /	anu mA-Ayantu devatAH anu brahma su-vIryam /
   anu kṣatraṃ ca yad yaśamanu māmaitu yadyaśam /	anu kzatram ca yat yaSam-anu mAm-Etu yat-yaSam /
   iti prāñcaṃ prayāpya pradakṣiṇamāvṛtya yathārthalakṣaṇyavṛkṣaṃ caityaṃ	iti prAQcam prayApya pradakziNam-AvRtya yaTArTa-lakzaNya-vRkzam cEtyam
   vopatiṣṭheta // VGrs_15.4	vA-upatizWeta // VGrH-_15.4
   namo rudrāyaikavṛkṣasada ityekavṛkṣe japati /	namaH rudrAya-eka-vRkza-sadaH iti-eka-vRkze japati /
   ye vṛkṣeṣu śaṣpiñjarā iti ca // VGrs_15.5	ye vRkzezu SazpiQjarAH iti ca // VGrH-_15.5
   namo rudrāya catuṣpathasada iti catuṣpathe /	namaH rudrAya catuzpaTa-sadaH iti catuzpaTe /
   ye pathāṃ pathirakṣaya iti ca // VGrs_15.6	ye paTAm paTiH-akzayaH iti ca // VGrH-_15.6
   namo rudrāya śmaśānasada iti śmaśāne /	namaH rudrAya SmaSAna-sadaH iti SmaSAne /
   ye bhūtānām adhipataya iti ca // VGrs_15.7	ye BUtAnAm aDipatayaH iti ca // VGrH-_15.7
   namo rudrāya pātrasada iti piban /	namaH rudrAya pAtra-sadaH iti piban /
   ye anneṣu vividhyantīti ca // VGrs_15.8	ye annezu viviDyanti-iti ca // VGrH-_15.8
   ye tīrthānīti tīrthe // VGrs_15.9	ye tIrTAni-iti tIrTe // VGrH-_15.9
   yatrāpas taritavyā āsīd ati samudrāya vayunāya sindhūnāṃ pataye namaḥ /	yatra-apaH taritavyA AsIt ati samudrAya vayunAya sinDUnAm pataye namaH /
   nadīnāṃ sarvāsāṃ pitve juhutā viśvakarmaṇe /	nadInAm sarvAsAm pitve juhutA viSvakarmaNe /
   viśvahādābhyaṃ haviḥ /	viSva-hAda-aByam haviH /
   ity apsūdakāñjalīr juhuyāt // VGrs_15.10	iti apsu-udaka-aQjalIH juhuyAt // VGrH-_15.10
   yāvatāṃ sakhāyānaṃ svastimicchet tāvata udakāñjalīr juhuyāt amṛtam āsye	yAvatAm saKAyAnam svastim-icCet tAvataH udaka-aQjalIH juhuyAt amRtam Asye
   juhomyāyuḥ prāṇe pratidadhāmi amṛtaṃ brahmaṇā saha mṛtyuṃ tarema /	juhomi-AyuH prANe pratidaDAmi amRtam brahmaNA saha mRtyum tarema /
   prāsahād itīṣṭir asyaditir eva mṛtyuṃdhayamiti trir ācāmet // VGrs_15.11	prAsahAt iti-izwiH asi-aditiH eva mRtyuMDayam-iti tris AcAmet // VGrH-_15.11
   dviḥ parimṛjet // VGrs_15.12	dvis parimRjet // VGrH-_15.12
   yadyakṣā śamyāṇir vā riṣyeta tatraivāgnim upasamādhāyāgneyena	yadyakzA SamyANiH vA rizyeta tatra-eva-agnim upasamADAya-Agneyena
   sthālīpākeneṣṭvā jayaprabhṛtibhiś cājyasya pustāt sviṣṭakṛtaḥ //	sTAlIpAkena-izwvA jaya-praBRtiBiH ca-Ajyasya pustAt svizwakRtaH //
   VGrs_15.13	VGrH-_15.13
   aparasyāhnaḥ saṃdhikāle gṛhān prapādayet // VGrs_15.14	aparasya-ahnaH saMDi-kAle gRhAn prapAdayet // VGrH-_15.14
   rathādyaupāsanāt saṃtatāmulaparājīṃ stṛṇāti // VGrs_15.15	raTa-Adi-OpAsanAt saMtatAm-ulapa-rAjIm stRNAti // VGrH-_15.15
   tayābhyupaiti // VGrs_15.16	tayA-aByupEti // VGrH-_15.16
   gṛhānahaṃ sumanasaḥ prapadye 'vīraghnī vīravataḥ suśevā /	gRhAn-aham sumanasaH prapadye avIra-GnI vIravataH su-SevAH /
   irāṃ vahantī ghṛtam ukṣamāṇāṃs teṣv ahaṃ sumanāḥ saṃviśāmi /	irAm vahantI GRtam ukzamANAn tezu aham sumanAH saMviSAmi /
   ity abhyāhitāgniṃ sodakaṃ sauṣadhamāvasathaṃ prapadye /	iti aByAhita-agnim sa-udakam sa-OzaDam-AvasaTam prapadye /
   revatyā rohiṇyā yadvā puṇyoktam // VGrs_15.17	revatyAH rohiNyA yat-vA puNya-uktam // VGrH-_15.17
   ānaḍuhe carmaṇyupaviśya // VGrs_15.18	Anaxuhe carmaNi-upaviSya // VGrH-_15.18
   athāsyā brahmacāriṇaṃ jīvapitṛkaṃ jīvamātṛkam utsaṅgamupaveśayet //	aTa-asyAH brahmacAriNam jIva-pitRkam jIva-mAtRkam utsaFgam-upaveSayet //
   VGrs_15.19	VGrH-_15.19
   phalānāmañjaliṃ pūrayet tilataṇḍulānāṃ vā // VGrs_15.20	PalAnAm-aQjalim pUrayet tila-taNxulAnAm vA // VGrH-_15.20
   acyutā dhruvā dhruvapatnī dhruvaṃ paśyema viśvata iti dhruvaṃ jīvantīṃ	acyutA DruvA Druva-patnI Druvam paSyema viSvatas iti Druvam jIvantIm
   saptarṣīn arundhatīmiti darśayitvā prājāpatyena sthālīpākeneṣṭvā	saptarzIn arunDatIm-iti darSayitvA prAjApatyena sTAlIpAkena-izwvA
   jayaprabhṛtibhiś cājyasya purastāt sviṣṭakṛta ājyaśeṣe dadhyāsicya	jaya-praBRtiBiH ca-Ajyasya purastAt svizwakRtaH Ajya-Seze daDyAsicya
   dadhikrāvṇo akāriṣam iti dadhnaḥ pumāṃstriḥ prāśnāti // VGrs_15.21	daDikrAvNaH akArizam iti daDnaH pumAn=-tris prASnAti // VGrH-_15.21
   cakram ivānaḍuhaḥ padaṃ māmevānvetu te manaḥ /	cakram iva-anaxuhaH padam mAm-eva-anvetu te manaH /
   māṃ ca paśyasi sūryaṃ ca mā cānyeṣu manaskṛthāḥ /	mAm ca paSyasi sUryam ca mA ca-anyezu manaskRTAH /
   cākravākaṃ saṃvasanaṃ tan nau saṃvananaṃ kṛtam /	cAkravAkam saMvasanam tat nO saMvananam kRtam /
   ityavaśiṣṭaṃ jāyāyai prayacchati // VGrs_15.22	iti-avaSizwam jAyAyE prayacCati // VGrH-_15.22
   tūṣṇīṃ sā prāśnāti // VGrs_15.23	tUzNIm sA prASnAti // VGrH-_15.23
   saṃvatsaraṃ mudā tau brahmacaryaṃ carataḥ /	saMvatsaram mudA tO brahmacaryam carataH /
   dvādaśarātraṃ trirātram ekarātraṃ vā // VGrs_15.24	dvAdaSa-rAtram tri-rAtram eka-rAtram vA // VGrH-_15.24
   evameva caturthyāṃ kṛtvā hiraṇyagarbha ityaṣṭābhiḥ sthālīpākasya hutvā	evam-eva caturTyAm kRtvA hiraNyagarBaH iti-azwABiH sTAlIpAkasya hutvA
   jayaprabhṛtibhiścājyasya purastātsviṣṭakṛtaḥ // VGrs_15.25	jaya-praBRtiBiH-ca-Ajyasya purastAt-svizwakRtaH // VGrH-_15.25
   athāsyāḥ savye 'ṃse pūṣā te granthiṃ grathnātv iti vāsaso granthiṃ	aTa-asyAH savye aMse pUzA te granTim graTnAtu iti vAsasaH granTim
   kriyamāṇam anumantrayate // VGrs_15.26	kriyamANam anumantrayate // VGrH-_15.26
   catasro 'vidhavāḥ kurvanti /	catasraH aviDavAH kurvanti /
   tābhyo hiraṇyaṃ dadāti // VGrs_15.27	tAByaH hiraNyam dadAti // VGrH-_15.27
   saṃvatsaraṃ na pravaset /	saMvatsaram na pravaset /
   dvādaśarātraṃ trirātram ekarātraṃ vā // VGrs_15.28	dvAdaSa-rAtram tri-rAtram eka-rAtram vA // VGrH-_15.28
   Vārāhagṛhyasūtra, 16	VArAha-gRhya-sUtra, 16
   tau saṃnipātayataḥ /	tO saMnipAtayataH /
   apaśyaṃ tvā manasā cekitānaṃ tapaso jātaṃ tapaso 'bhibhūtam /	apaSyam tvA manasA cekitAnam tapasaH jAtam tapasaH aBiBUtam /
   iha prajāmiha rayiṃ rarāṇaḥ prajāyasva prajayā putrakāma /	iha prajAm-iha rayim rarANaH prajAyasva prajayA putra-kAmaH /
   apaśyaṃ tvā manasā dīdhyānāṃ svāyāṃ tanūm ṛtviye nādhamānām /	apaSyam tvA manasA dIDyAnAm svAyAm tanUm Rtviye na-aDamAnAm /
   upa mām uccā yuvatir babhūyāt prajāyasva prajayā putrakāme /	upa mAm uccA yuvatiH baBUyAt prajAyasva prajayA putra-kAme /
   prajāpate tanvaṃ me juṣasva tvaṣṭā vīraiḥ sahasāham indraḥ /	prajApate tanvam me juzasva tvazwA vIrEH sahasA-aham indraH /
   indreṇa devairvīrudhaḥ saṃvyayantāṃ bahūnāṃ puṃsāṃ pitarau syāva /	indreNa devEH-vIruDaH saMvyayantAm bahUnAm puMsAm pitarO syAva /
   ahaṃ prajā ajanayaṃ pṛthivyām ahaṃ garbham adadhāmoṣadhīṣu /	aham prajAH ajanayam pRTivyAm aham garBam adaDAma-uzaDIzu /
   ahaṃ viśveṣu bhuvaneṣvantar ahaṃ prajābhyo bibharṣi putrān /	aham viSvezu Buvanezu-antar aham prajAByaH biBarzi putrAn /
   iti stryādivyatyāsaṃ japataḥ // VGrs_16.1	iti stryAdivyatyAsam japataH // VGrH-_16.1
   karad iti bhasadabhimṛśet // VGrs_16.2	karat iti BasadaBimRSet // VGrH-_16.2
   janad ity uparijananam // VGrs_16.3	janat iti upari-jananam // VGrH-_16.3
   bṛhad iti jātaḥ pratiṣṭhitam // VGrs_16.4	bRhat iti jAtaH pratizWitam // VGrH-_16.4
   athāsyāstṛtīye garbhamāse puṃsā nakṣatreṇa yad ahaścandramā na dṛśyeta	aTa-asyAH-tRtIye garBa-mAse puMsA nakzatreNa yat ahar-candramAH na dRSyeta
   tadahar vopoṣyāplāvyāhataṃ vāsa ācchādya nyagrodhāvarohaśuṅgānyudapeṣaṃ	tat-ahar vA-upozya-AplAvya-Ahatam vAsaH AcCAdya nyagroDa-avaroha-SuFgAni-udapezam
   piṣṭvā dakṣiṇāsminnāsikāchidra āsiñcet hiraṇyagarbhaḥ /	pizwvA dakziNA-asminnAsikA-CidraH AsiQcet hiraNyagarBaH /
   adbhyaḥ saṃbhṛta ityetābhyām // VGrs_16.5	adByaH saMBRtaH iti-etAByAm // VGrH-_16.5
   athāsyā dakṣiṇaṃ kukṣim abhimṛśet pumān agniḥ pumānindraḥ pumāndevo	aTa-asyAH dakziNam kukzim aBimRSet pumAn agniH pumAn-indraH pumAn-devaH-
   bṛhaspatiḥ /	bRhaspatiH /
   pumānagniśca vāyuśca pumāngarbhas tavodare /	pumAn-agniH-ca vAyuH-ca pumAn-garBaH tava-udare /
   pumāṃsau mitrāvaruṇau pumāṃsāv aśvināv ubhau /	pumAMsO mitrAvaruNO pumAMsO aSvinO uBO /
   pumāṃsaṃ garbhaṃ jāyasva tvaṃ pumān anujāyatām /	pumAMsam garBam jAyasva tvam pumAn anujAyatAm /
   ityetābhyām // VGrs_16.6	iti-etAByAm // VGrH-_16.6
   athāsyāḥ pañcame ṣaṣṭhe saptame vā garbhamāse maṅgalyaiḥ snāpayitvā	aTa-asyAH paQcame zazWe saptame vA garBa-mAse maFgalyEH snApayitvA
   prājāpatyena sthālīpākeneṣṭvā jayaprabhṛtibhiścājyasya purastātsviṣṭakṛtaḥ	prAjApatyena sTAlIpAkena-izwvA jaya-praBRtiBiH-ca-Ajyasya purastAt-svizwakRtaH
   paścādagnerdarbheṣv āsīnāyāḥ sarvān keśān vipramucya tvamaryamā bhavasi	paScAt-agneH-darBezu AsInAyAH sarvAn keSAn vipramucya tvam-aryamA Bavasi
   yatkanīnāṃ devaḥ svadhāvo guhyaṃ bibharṣi /	yat-kanInAm devaH svaDAvaH guhyam biBarzi /
   añjanti vipraṃ sukṛtaṃ na gobhir yad dampatī sumanasā kṛṇoṣi /	aQjanti vipram sukRtam na goBiH yat dampatI sumanasA kRNozi /
   iti navanītena pāṇī pralipya sarvān keśān saṃprayauti // VGrs_16.7	iti navanItena pANI pralipya sarvAn keSAn saMprayOti // VGrH-_16.7
   indrāṇī cakre kaṅkataṃ sa sīmantaṃ visarpatu iti kaṅkataṃ gṛhṇāti //	indrANI cakre kaFkatam sa sImantam visarpatu iti kaFkatam gRhNAti //
   VGrs_16.8	VGrH-_16.8
   punaḥ patnīmagniriti keśaprasādhanaṃ kuryāt // VGrs_16.9	punar patnIm-agniH-iti keSa-prasADanam kuryAt // VGrH-_16.9
   śalalyā śamīśākhayā sapalāśayā /	SalalyA SamI-SAKayA sa-palASayA /
   antarvatī pumāṃsaṃ dīrghaṃ jīvantaṃ śatāyuṣam /	antarvatI pumAMsam dIrGam jIvantam Sata-Ayuzam /
   dīrghāyur asyā yaḥ patir jīvātu śaradaḥ śatam /	dIrGa-AyuH asyAH yaH patiH jIvAtu SaradaH Satam /
   iti triśvetayā sīmantaṃ karoti // VGrs_16.10	iti tri-SvetayA sImantam karoti // VGrH-_16.10
   athāsyāḥ patir dvedhā keśān badhnāti nīlalohitena sūtreṇa jīvorṇayā vā //	aTa-asyAH patiH dveDA keSAn baDnAti nIlalohitena sUtreNa jIva-UrNayA vA //
   VGrs_16.11	VGrH-_16.11
   Vārāhagṛhyasūtra, 17	VArAha-gRhya-sUtra, 17
   atha vaiśvadevaṃ vyākhyāsyāmaḥ // VGrs_17.1	aTa vESvadevam vyAKyAsyAmaH // VGrH-_17.1
   tatra sāyaṃprātaḥprabhṛtīnām agnihotravat parisamuhya paristīrya paryukṣya	tatra sAyaMprAtar-praBRtInAm agnihotra-vat parisamuhya paristIrya paryukzya
   sāyaṃ prātaḥ syādityeke // VGrs_17.2	sAyam prAtar syAt-iti-eke // VGrH-_17.2
   haviṣyasya vā siddhasya vaiśvadevaḥ // VGrs_17.3	havizyasya vA sidDasya vESvadevaH // VGrH-_17.3
   agnaye somāya prajāpataye dhanvantaraye vāstoṣpataye viśvebhyo devebhyo	agnaye somAya prajApataye Danvantaraye vAstozpataye viSveByaH deveByaH-
   'gnaye sviṣṭakṛte ca juhuyāt // VGrs_17.4	agnaye svizwakRte ca juhuyAt // VGrH-_17.4
   avaśiṣṭasya baliṃ haret // VGrs_17.5	avaSizwasya balim haret // VGrH-_17.5
   dadhimadhumiśrasyāgnaye purastāt yamāya dakṣiṇataḥ somāya paścāt	daDi-maDu-miSrasya-agnaye purastAt yamAya dakziNatas somAya paScAt-
   varuṇāyottarataḥ madhye varuṇāryamabhyāṃ brahmaṇe ca /	varuNAya-uttaratas maDye varuNa-ari-amaByAm brahmaNe ca /
   agnaye pṛthivyai vāyave 'ntarikṣāya sūryāya dive candramase nakṣatrebhya	agnaye pRTivyE vAyave antarikzAya sUryAya dive candramase nakzatreBya
   iti // VGrs_17.6	iti // VGrH-_17.6
   adbhyaḥ kumbhadeśe // VGrs_17.7	adByaH kumBa-deSe // VGrH-_17.7
   oṣadhivanaspatibhyo madhyadeśe // VGrs_17.8	ozaDi-vanaspatiByaH maDyadeSe // VGrH-_17.8
   kāmāya /	kAmAya /
   gṛhapataya iti śayyādeśe // VGrs_17.9	gRhapatayaH iti SayyA-deSe // VGrH-_17.9
   śriyai ca // VGrs_17.10	SriyE ca // VGrH-_17.10
   rakṣojanebhyo 'ntaḥ śaraṇe // VGrs_17.11	rakzaH-janeByaH antar SaraNe // VGrH-_17.11
   ākāśāyeti sthalikāṇḍābhyām // VGrs_17.12	AkASAya-iti sTalikA-aNxAByAm // VGrH-_17.12
   tūṣṇīṃ niṣkramyopari śaraṇe // VGrs_17.13	tUzNIm nizkramya-upari SaraNe // VGrH-_17.13
   kavyaṃ prācyām // VGrs_17.14	kavyam prAcyAm // VGrH-_17.14
   pitṛbhyaḥ svadhetyanuṣajet // VGrs_17.15	pitRByaH svaDA-iti-anuzajet // VGrH-_17.15
   nama ityante ca // VGrs_17.16	namaH iti-ante ca // VGrH-_17.16
   ye brāhmaṇāḥ prācyāṃ diśyarhantu /	ye brAhmaNAH prAcyAm diSi-arhantu /
   ye devā yāni bhūtāni prapadye tāni me svastyayanaṃ kurvantviti /	ye devAH yAni BUtAni prapadye tAni me svastyayanam kurvantu-iti /
   dakṣiṇasyām /	dakziNasyAm /
   pratīcyām /	pratIcyAm /
   uttarasyām /	uttarasyAm /
   ūrdhvāyām /	UrDvAyAm /
   ye brāhmaṇā iti sarvatrānuṣajet // VGrs_17.17	ye brAhmaNAH iti sarvatra-anuza-jet // VGrH-_17.17
   snehavad amāṃsam annaṃ bhojayitvā viduṣo brāhmaṇān arthasiddhiṃ vācayet //	sneha-vat amAMsam annam BojayitvA viduzaH brAhmaNAn arTa-sidDim vAcayet //
   VGrs_17.18	VGrH-_17.18
   baliharaṇasyānte yāmāśiṣam icchet tām āśāsīta // VGrs_17.19	bali-haraNasya-ante yAm-ASizam icCet tAm ASAsIta // VGrH-_17.19
   gṛhapatiḥ oṃ akṣayam annam astv ity āha // VGrs_17.20	gRhapatiH om akzayam annam astu iti Aha // VGrH-_17.20
   bhikṣāṃ pradāya sāyaṃ bhojanameva prātar āśet // VGrs_17.21	BikzAm pradAya sAyam Bojanam-eva prAtar ASet // VGrH-_17.21
   viproṣya gṛhānupatiṣṭhet // VGrs_17.22	viprozya gRhAn-upatizWet // VGrH-_17.22
