   bodhicittotpādasūtraśāstra	boDi-citta-utpAda-sUtra-SAstra
   prathamo vargaḥ	praTamaH vargaH
   adhyeṣaṇotpādaḥ	aDyezaNa-utpAdaH
   namāmyaparyantatathāatān gatān	namAmi-aparyanta-taTAatAn gatAn
   jinānahaṃ sāmpratikānanāgatān |	jinAn-aham sAmpratikAnana-AgatAn |
   nabhaḥsamākṣobhyadhiyo 'parājitān	naBaH-samAkzoBya-DiyaH aparAjitAn
   janān paritrātumatho mahākṛpān ||1||	janAn paritrAtum-aTo mahA-kRpAn ||1||
   1 | asti mahāvaipulyamanuttaraṃ saddharmamātṛkāpiṭakaṃ bodhisatvai	1 | asti mahA-vEpulyam-anuttaram sat-Darma-mAtRkA-piwakam boDisatvE
   rmahāsattvairabhyastam | tathāhi | (1) adhyepatantyabhisamboddhu	rmahA-sattvEH-aByastam | taTA-hi | (1) aDyepatanti-aBisambA-udDu
   manuttarāṃ bodhim | (2) prerayanti sattvān cittamutpādayituṃ gambhīrodāram	manuttarAm boDim | (2) prerayanti sattvAn cittam-utpAdayitum gamBIra-udAram
   | (3) pratiṣṭhāpayanti praṇidhānaṃ pariniṣpannam | (4) utsṛjantyātmabhāvaṃ	| (3) pratizWApayanti praNiDAnam parinizpannam | (4) utsRjanti-Atma-BAvam
   dhanāni ca nigṛhṇanti lobhaṃ mātsarya ca | (5) ācaranti pacaskandhaśīlam |	DanAni ca nigRhNanti loBam mAtsarya ca | (5) Acaranti paca-skanDa-SIlam |
   vinayanti cāparādhinaḥ | (6) bhāvayanti paramāṃ kṣāntiṃ	vinayanti ca-aparADinaH | (6) BAvayanti paramAm kzAntim
   dveṣāparaṇanigrahāya (7) janayanti voryotsāhaṃ sattvapratiṣṭhāpanāya (8)	dveza-AparaNa-nigrahAya (7) janayanti vA-uryotsAham sattva-pratizWApanAya (8)
   saṃgṛhṇanti dhyānāni sattvacittaparijñānāya | (9) bhāvayanti	saMgRhNanti DyAnAni sattva-citta-parijQAnAya | (9) BAvayanti
   prajñāmavidyānirodhāya | (10) praviśanti tathatādvāramāsaṅgaprahāṇāya |	prajQAm-avidyA-niroDAya | (10) praviSanti taTatA-dvAram-AsaFga-prahANAya |
   (11) pradarśayānti gaṃbhīratamāmalakṣaṇāṃ śūnyatācaryām | (12) anuśaṃsanti	(11) pradarSa-yAnti gaMBIratamAm-alakzaNAm SUnyatA-AcaryAm | (12) anuSaMsanti
   puṇyaṃ buddhabījānucchedāya | ityevamādīnaprameyānupāyān	puNyam budDa-bIja-anucCedAya | iti-evamAdIn-aprameyAn-upAyAn
   bodhidharmasahāyabhūtāni viśuddhimukhāni sarvebhyo 'nuttarakuśalakāmebhyo	boDi-Darma-sahAya-BUtAni viSudDi-muKAni sarveByaH anuttara-kuSala-kAmeByaH-
   vibhajya darśayāmi sambodhayitumanuttarāṃ samyaksambodhim ||	viBajya darSayAmi samboDayitum-anuttarAm samyaksamboDim ||
   2 | buddhaputrā buddhamāṣitamudgṛhṇādbhiḥ sattvānāmarthāya dharma	2 | budDa-putrAH budDa-mAzitam-udgRhNAdBiH sattvAnAm-arTAya Darma
   deśyadbhi rbuddhaputraiḥ prathamaṃ tāvadanuśaṃsayitavyā buddhaguṇā	deSyadBi rbudDa-putrEH praTamam tAvat-anuSaMsayitavyA budDa-guNA
   yāñcchrutvā sattvāścittamutpādayeyurgaveṣayituṃ buddhaprajñām |	yAQt-SrutvA sattvAH-cittam-utpAdayeyuH-ga-vezayitum budDa-prajQAm |
   cittotpādahetorbuddhabījamanucchinnaṃ bhavati | yadi	citta-utpAda-hetoH-budDa-bIjam-anucCinnam Bavati | yadi
   bhikṣubhikṣuṇyuyāsakopāsikā anusmaranti buddhamanusmaranti dharmaṃ	BikzuBi-kzuNyuyAsa-kopAsikAH anusmaranti budDam-anusmaranti Darmam
   punaranusmaranti yat tathāgatā bodhisattvamārgasamprasthānakāle dharma	punar-anusmaranti yat taTAgatAH boDisattva-mArga-samprasTAna-kAle Darma
   gaveṣayitumasaṃkhyeyakalpaṃ prayatnaduḥkhamudvahantītyevamanusmṛtyā	gavezayitum-asaMKyeya-kalpam prayatna-duHKam-udvahanti-iti-evam-anusmRtyA
   bodhisattvā nāmarthāya deśayanti dharma yāvadekāmapi gāthāṃ yena	boDisattvAH nAm-arTAya deSayanti Darma yAvat-ekAm-api gATAm yena
   dharmamimaṃ śrutvā bodhisattvā hitāṃ deśanāmabhinandattyavaropayanti	Darmam-imam SrutvA boDisattvAH hitAm deSanAm-aBinandatti-avaropayanti
   kuśalamūlānyācaranti buddhadharma prāpruvantyanuttarāṃ samyaksambodhim ||	kuSala-mUlAni-Acaranti budDa-Darma prApruvanti-anuttarAm samyaksamboDim ||
   3 | sattvānāmaprameyāṇāmanādijātimaraṇaduḥkhocchedāya bodhisattvā	3 | sattvAnAm-aprameyANAm-anAdi-jAti-maraNa-duHKa-ucCedAya boDisattvA
   mahasattvā abhilaṣantyaprameyāṇi kāyacittāni | ācaranti vīryam |	mahasattvAH aBilazanti-aprameyANi kAya-cittAni | Acaranti vIryam |
   gambhīramutpādayantimahāpraṇidhānaṃ | anutiṣṭhanti mahopāyam | utpādayanti	gamBIram-utpAdayanti-mahA-praNiDAnam | anutizWanti mahA-upAyam | utpAdayanti
   mahāmaitrī mahākarūṇām | gaveṣayanti mahāprajñāmadṭaṣṭoṣṇīṣalakṣaṇām ||	mahA-mEtrI mahA-karUNAm | gavezayanti mahA-prajQA-mad-wazwa-uzNIza-lakzaNAm ||
   4 | gaveṣayanta evaṃvidhānmahato buddhadharmān jñātavyaṃ yad dharmā	4 | gavezayantaH evaMviDAn-mahataH budDa-DarmAn jQAtavyam yat DarmA
   aprameyā aparyantāḥ | dharmāṇāmaprameyatvāttatpuṇyaphalavipāko	aprameyAH aparyantAH | DarmANAm-aprameya-tvAt-tad-puNya-Pala-vipAkaH-
   'pyaprameyaḥ | bhagavānavocat | bodhisattvāścedādivodhicittamutpādayanti	api-aprameyaH | BagavAn-avocat | boDisattvAH-ced-Adi-voDi-cittam-utpAdayanti
   teṣāṃ tasya durbalasyāpi kṣaṇasya puṇyaphalavipākaḥ	tezAm tasya durbalasya-api kzaNasya puNya-Pala-vipAkaH
   kalpakoṭiśatasahasrairapi vaktuṃ na pāryate kathaṃ	kalpa-kowi-Sata-sahasrEH-api vaktum na pAryate kaTam
   puarekadinamekamāsamekavarṣa yāvacchatavarṣaṃ samprasthitasya cittasya	puareka-dinam-ekam-Asam-ekavarza yAvat-Sata-varzam samprasTitasya cittasya
   puṇyaphalavipāko vaktuṃ pāryeta | tatkasya hetoḥ |	puNya-Pala-vipAkaH vaktum pAryeta | tat-kasya hetoH |
   sarvānsattvānsthāpayitumanutpādadharmakṣāntāvabhisaṃbodhayiumanuttarāṃ	sarvAn-sattvAn-sTApayitum-anutpAda-Darma-kzAntO=-aBisaMboDayium-anuttarAm
   samyaksambodhiḥ bodhisattvacaryāyā anantatvāt ||	samyaksamboDiH boDisattva-caryAyAH ananta-tvAt ||
   5 | buddhatmajā bodhisattvā ādibodhicittamutpādayanti | tathāhi |	5 | budDatma-jAH boDisattvAH Adi-boDi-cittam-utpAdayanti | taTA-hi |
   mahāsamudro yadādau samudeti jñātavyaḥ so 'dhamamadhyamottamamūlyānāṃ	mahA-samudraH yat-AdO samudeti jQAtavyaH saH aDama-maDyama-uttama-mUlyAnAm
   yāvadmulyānāṃ cintāmaṇiratnamuktāphalānāmākaro bhavati | eṣāṃ ratnānāṃ	yAvat-mulyAnAm cintAmaNi-ratna-muktAPalAnAm-AkaraH Bavati | ezAm ratnAnAm
   mahāsamudrādutpatteḥ | bodhisattvasya cittotpādā apyevam |	mahA-samudrAt-utpatteH | boDisattvasya citta-utpAdAH api-evam |
   yadādicittamutpadyate jñātavyaṃ taddevamanuṣyāṇāṃ	yat-Adi-cittam-utpadyate jQAtavyam tad-deva-manuzyANAm
   śrāvakapratyekabuddhabodhisattvānāṃ sarvakuśaladharmāṇāṃ dhyānasya	SrAvaka-pratyekabudDa-boDisattvAnAm sarva-kuSala-DarmANAm DyAnasya
   prajñāyāścotpatterākaraḥ ||	prajQAyAH-ca-utpatteH-AkaraH ||
   6 | punastathāhi | trisāhasramahāsāhasro lokadhāturyadā samudeti jñātavyaṃ	6 | punar-taTA-hi | tri-sAhasra-mahA-sAhasraH lokaDAtuH-yadA samudeti jQAtavyam
   tatra ye paṃcaviṃśatirbhavā steṣu yāvantaḥ sattvāḥ sarvānvahati	tatra ye paMcaviMSatiH-BavA stezu yAvantaH sattvAH sarvAn-vahati
   sarveṣāmāśrayo bhavatyāvāso bhavati | bodhisattvasya cittotpādā apyevam |	sarvezAm-ASrayaH Bavati-AvAsaH Bavati | boDisattvasya citta-utpAdAH api-evam |
   yadā tatsamudeti sarveṣāmāśrayo bhavatyaprameyāṇāṃ sattvānām | ṣaḍgatiṣu	yadA tat-samudeti sarvezAm-ASrayaH Bavati-aprameyANAm sattvAnAm | zaxgatizu
   caturyoniṣu ye samyagmithyādṭaṣṭayo 'bhyastakuśalābhyastākuśalā	catur-yonizu ye samyak-miTyAt-wazwayaH aByasta-kuSala-aByastA-kuSalA
   rakṣitaśuddhaśīlakṛtacaturgurupārājikāḥ satkṛtaratnatrayaninditasaddharmāḥ	rakzita-SudDa-SIla-kRta-caturguru-pArAjikAH satkRta-ratna-traya-nindita-sad-DarmAH
   samalāstairthikāḥ śramaṇabrāhmaṇāḥ kṣatriyabrāhmaṇavaiśyaśūdrāstān sarvān	sa-malAH-tErTikAH SramaNa-brAhmaNAH kzatriya-brAhmaNa-vESya-SUdrAH-tAn sarvAn
   vahati sarveṣāmāśrayo bhavatyāvāso bhavati ||	vahati sarvezAm-ASrayaH Bavati-AvAsaH Bavati ||
   7 | punarboddhisattvo maitrī karuṇāṃ ca puraskṛtya cittamutpādayāti |	7 | punar-bodDi-sattvaH mEtrI karuNAm ca puraskRtya cittam-utpAda-yAti |
   maitrī bodhisattvasyāparyantāprameyā tasmādaparyantaścittotpādaḥ	mEtrI boDisattvasya-aparyanta-aprameyA tasmAt-aparyantaH-citta-utpAdaH
   sattvadhātusamaḥ | tathāhi | ākāśena na kiñcidyadanāvṛtam | bodhisattvasya	sattva-DAtu-samaH | taTA-hi | AkASena na kiQcid-yat-anAvRtam | boDisattvasya
   cittotpādā apyevamaprameyā aparyantā akṣayāḥ | ākāśasvākṣayatvātsattvā	citta-utpAdAH api-evam-aprameyAH aparyantAH akzayAH | AkASa-sva-akzaya-tvAt-sattvA
   akṣayāḥ sattvānāmakṣayatvād bodhisattvasya cittotpādā api sattvadhātusamāḥ	akzayAH sattvAnAm-akzaya-tvAt boDisattvasya citta-utpAdAH api sattva-DAtu-samAH
   8 | sattvadhātornāsti paryanta iti buddhaśāsana manusṛtya saṃkṣepata	8 | sattva-DAtoH-na-asti paryante iti budDa-SAsana manusRtya saMkzepata
   ucyate | pūrvadikparyantaṃ santi koṭisahasragaṃgānadīvālukāsamā asaṃkhyeyā	ucyate | pUrva-diS-paryantam santi kowi-sahasra-gaMgA-nadI-vAlukA-samA asaMKyeyA
   buddhalokadhātavaḥ | evaṃ dakṣiṇapaścimottarāsu dikṣu caturṣu	budDa-loka-DAtavaH | evam dakziNa-paScima-uttarAsu dikzu caturzu
   vidikṣūrdhvamadha ekaikasyāṃ santi koṭisahasra gaṃgānadīvālukāsamā	vidikzu-UrDvam-aDas ekEkasyAm santi kowi-sahasra gaMgA-nadI-vAlukA-samA
   asaṃkhyeyā buddhalokadhātavaḥ | akhilāste cūrṇitā rajāṃsi bhaveyu rnemāni	asaMKyeyAH budDa-loka-DAtavaH | aKilAH-te cUrNitAH rajAMsi Baveyu rna-imAni
   rajāṃsi māṃsacakṣurgocarāṇi syuḥ | koṭiśatasahasra	rajAMsi mAMsa-cakzuH-gocarANi syuH | kowi-Sata-sahasra
   gaṃgānadīvālukāsameṣvasaṃkhyeyeṣu trisāhasramahāsāhasralokadhātuṣuyāvantaḥ	gaMgA-nadI-vAlukA-samezu-asaMKyeyezu tri-sAhasra-mahA-sAhasra-loka-DAtuzuyAvantaH
   sattvāḥ sarvete saṃgatā udgṛhṇīyurekaṃ rajaḥ | dviguṇitakoṭiśatasahasra	sattvAH sarvete saMgatAH udgRhNIyuH-ekam rajaH | dvi-guNita-kowi-Sata-sahasra
   gaṃgānadivālukāsameṣvasaṃkhyeyeṣu trisāhasramahāsāhasralokadhātuṣu	gaMgAnadi-vAlukA-samezu-asaMKyeyezu tri-sAhasra-mahA-sAhasra-lokaDAtuzu
   yāvantaḥ sattvā gṛhṇīyuste dve rajasī | evaṃ viparivartanamānā udgṛhṇanto	yAvantaH sattvAH gRhNIyuH-te dve rajasI | evam viparivartana-mAnAH udgRhNantaH-
   daśadikṣvekaikasyāṃ koṭisahasra gaṃgānadī bālukāsameṣva saṃkhyeyeṣu	daSa-dikzu-ekEkasyAm kowi-sahasra gaMgA-nadI bAlukA-samezva saMKyeyezu
   buddhalokadhātuṣu yāvatpṛthivībhṛtarajāṃsi paryantaṃ nayeyustathāpi na	budDa-lokaDAtuzu yAvat-pRTivIBRta-rajAMsi paryantam nayeyuH-taTA-api na
   paryantaḥ sattavadhātoḥ | tathāhi | kaścitpuruṣaḥ keśamikaṃ śatadhā	paryantaH sattava-DAtoH | taTA-hi | kaScid-puruzaH keSamikam SataDA
   vibhajyaikena bhāgena mahāsamudjalājjalalavaṃ gṛhṇāti | mayā sattvānāṃ	viBajya-ekena BAgena mahA-samudjalAt-jala-lavam gRhNAti | mayA sattvAnAm
   viṣaye bhāṣitaṃ tadevamalpaṃ yaścāpi na mayā bhāṣitaṃ tadyathā	vizaye BAzitam tat-evam-alpam yaH-ca-api na mayA BAzitam tat-yaTA
   mahāsamudrajalam | yadi nāma buddho 'prameyamaparyantamasaṃkhyeyaṃ	mahA-samudra-jalam | yadi nAma budDaH aprameyam-aparyantam-asaMKyeyam
   kalpamavadānaṃ vyākaroti tathāpi na paryantaḥ | bodhisattvasya cittotpādā	kalpam-avadAnam vyAkaroti taTA-api na paryantaH | boDisattvasya citta-utpAdA
   avṛṇvantyevaṃbhūtānapi sattvān| tatkathaṃ buddhaputrāḥ | syādbodhicittasya	avRNvanti-evaMBUtAn-api sattvAn| tat-kaTam budDa-putrAH | syAt-boDi-cittasya
   paryantaḥ ||	paryantaH ||
   9 | yadi bodhisattvā evaṃvidhaṃ bhāṣitaṃ śrutvā nottrasiṣyanti na	9 | yadi boDisattvAH evaMviDam BAzitam SrutvA na-uttrasizyanti na
   saṃtrasiṣyanti na saṃtrāsamāpatsyante na vinivartipyante na bilayaṃ	saMtrasizyanti na saMtrAsam-Apatsyante na vinivartipyante na bilayam
   gamiṣyanti jñātavyaṃ te dhruvamutpādayiṣyanti bodhicittamiti | yadi hi	gamizyanti jQAtavyam te Druvam-utpAdayizyanti boDi-cittam-iti | yadi hi
   sarve 'premayā buddhā aprameyamasaṃkhyeyaṃ kalpaṃ yāvadanuśaṃsanti	sarve apremayA budDAH aprameyam-asaMKyeyam kalpam yAvat-anuSaMsanti
   tadguṇān tathāpi na paryantaḥ | tatkasya hetoḥ |	tad-guNAn taTA-api na paryantaH | tat-kasya hetoH |
   bodhicittasyāparimitatvānna paryantaḥ | ityevamādīnaprameyāṃllābhān	boDi-cittasya-aparimita-tvAt-na paryantaH | iti-evamAdIn-aprameyAn=-lABAn
   vyākuryādyena sattvāḥ sssṛṇvantyācarantūtpāda yanti bodhicittam ||	vyAkuryAt-yena sattvAH sssRNvantyAcarantu-utpAda yanti boDi-cittam ||
   (iti bodhicittotpādasūtraśāstre 'vyeṣaṇotpādonāma prathamo vargaḥ ||)	(iti boDi-citta-utpAda-sUtra-SAstre avyezaNa-utpAdaH-nAma praTamaH vargaH ||)
   dvitīyo vargaḥ	dvitIyaH vargaH
   bodhicittotpādaḥ	boDi-citta-utpAdaH
   1 | bodhisattvaḥ kathaṃ bodhicittamutpādayati | kaiśca pratyayaiḥ bodhi	1 | boDisattvaH kaTam boDi-cittam-utpAdayati | kEH-ca pratyayEH boDi
   samudāgacchati | yadi bodhisattvaḥ paricinoti kalyāṇamitrāṇi | pūjayati	samudAgacCati | yadi boDisattvaH paricinoti kalyANa-mitrANi | pUjayati
   buddhān saṃgṛhṇāti kuśalamūlāni | gavepayati praṇītadharmān | bhavati	budDAn saMgRhNAti kuSala-mUlAni | gavepayati praNIta-DarmAn | Bavati
   nityaṃ suratacittaḥ | kṣamate duḥkhānyāpatitāni | bhavati maitraḥ kāruṇika	nityam surata-cittaH | kzamate duHKAni-ApatitAni | Bavati mEtraH kAruNika
   ṛjucittaḥ | bhavati samacittaśayaḥ | śraddhayābhinandati mahāyānam |	Rju-cittaH | Bavati sama-citta-SayaH | SradDayA-aBinandati mahAyAnam |
   gaveṣayati buddhaprajñām | yadi puruṣasya santime daśadharmā	gavezayati budDa-prajQAm | yadi puruzasya santime daSa-DarmA
   utpādayatyanuttarasamyaksamboddicittam ||	utpAdayati-anuttara-samyaksambA-uddi-cittam ||
   2 | punaścatvāraḥpratyayā yaiścittamutpādayati saṃgrahītumanuttarāṃ bodhim	2 | punar-catvAraH-pratyayAH yEH-cittam-utpAdayati saMgrahItum-anuttarAm boDim
   | katame catbāraḥ | anuvicintayanbuddhānbodhicittamutpādayatīti prathamaḥ	| katame catbAraH | anuvicintayan-budDAn-boDi-cittam-utpAdayati-iti praTamaH
   | pratyavekṣamāṇakāyasyādīnavān bodhicittamutpādayatīti dvitīyaḥ |	| pratyavekzamANa-kAyasya-AdInavAn boDi-cittam-utpAdayati-iti dvitIyaH |
   dayamānaḥ sattveṣu bodhicittamutpādayatīti tṛtīyaḥ | gaveṣayannuttamaṃ	dayamAnaH sattvezu boDi-cittam-utpAdayati-iti tRtIyaH | gavezayan=-uttamam
   phalaṃ bodhicittamutpādayatīi caturthaḥ ||	Palam boDi-cittam-utpAdayatIi caturTaH ||
   3 | buddhānuvicintanā punaḥ pañcaprakārā | anuvicintayati	3 | budDa-anuvicintanA punar paQca-prakArAH | anuvicintayati
   yaddaśadikṣvatītānāgatapratyutpannāḥ sarve buddhāścittotpādārambhe	yad-daSat-ikzu-atIta-anAgata-pratyutpannAH sarve budDAH-citta-utpAda-AramBe
   'dhunāhamivāsan kleśasvabhāvāante cābhavansamyaksambuddhā anuttarā	aDunA-aham-iva-Asan kleSa-svaBAva-aante ca-aBavan-samyaksambudDA anuttarA
   bhagavanta iti heto rbodhicittamutpādayāmīti prathamā | anuvicintayati yat	BagavantaH iti hetoH rboDi-cittam-utpAdayAmi-iti praTamA | anuvicintayati yat-
   sarve triṣvadhvasu buddhā mahotsāhamudapādayan pṛthakpṛthagvāptumanuttarāṃ	sarve trizu-aDvasu budDAH mahA-utsAham-udapAdayan pRTak-pRTak-vAptum-anuttarAm
   bodhim | yadi bodhiḥ prāptavyo dharmo mayāpi prāptavyetihetorutpādayāmi	boDim | yadi boDiH prAptavyaH DarmaH mayA-api prAptavyA-iti-hetoH-utpAdayAmi
   bodhicittamiti dvitīyā | anuvicintayati yatsarve triṣvadhvasu buddhā	boDi-cittam-iti dvitIyA | anuvicintayati yat-sarve trizu-aDvasu budDA
   udapādayanmahāprajñāṃ pratyatiṣṭhipannādyāvaraṇe varacittaṃ saṃcinvanto	udapAdayan-mahA-prajQAm pratyatizWipannAdya-AvaraNe vara-cittam saMcinvantaH-
   duṣkaracaryāmudadīdharannātmānamatyakramiṣustridhātum |	duzkara-caryAm-udadIDaran=-AtmAnam-atyakramizuH-triDAtum |
   ahamapyevamātmānamuddhareyamiti hetorutpādayāmi bodhicittamiti tṛtītā |	aham-api-evam-AtmAnam-udDarA-iyam-iti hetoH-utpAdayAmi boDi-cittam-iti tRtItA |
   anuvicintayati yatsarve triṣvadhvanu buddhā lokanāyakāḥ pāraṃgatā	anuvicintayati yat-sarve trizu-aDvanu budDAH loka-nAyakAH pAraMgatA
   jātijarāmaraṇakleśamahāsamudāt | ahamapi puruṣaḥ pāraṃ brajeyamiti	jAti-jarA-maraNa-kleSa-mahA-samudAt | aham-api puruzaH pAram brajeyam-iti
   hetoratpādayāmi bodhicittamiti caturthī | anuvicintayati yatsarve	hetoH-at-pAdayAmi boDi-cittam-iti caturTI | anuvicintayati yat-sarve
   tripvadhvasu buddhā udapādayanmahāvīryamudasṛjannātmabhāvaṃ jīvitaṃ	tripvaDvasu budDAH udapAdayat-mahA-vIryam-udasRjan=-Atma-BAvam jIvitam
   dhanāni cāmārgayansarvajñatām | ahamapi sāmpratamanusareyaṃ buddhāniti	DanAni ca-amArgayan-sarvajQa-tAm | aham-api sAmpratam-anusareyam budDAn-iti
   hetorutpādayāmi bodhicittamiti paṃcamī ||	hetoH-utpAdayAmi boDi-cittam-iti paMcamI ||
   4 | kāyasyādīnavapratyavekṣā bodhicittotpādāya punaḥ paṃcaprakārā |	4 | kAyasya-AdInava-pratyavekzA boDi-citta-utpAdAya punar paMca-prakArAH |
   ātmānaṃ pratyavekṣate yatkāye 'sminnubhaye pañcaskandhāścaturmahābhūtāni	AtmAnam pratyavekzate yat-kAye asmin=-uBaye paQca-skanDAH-catur-mahABUtAni
   kurvantyaprameyāṇyaśubhakarmāṇītikāmayate tatparityāgamiti prathamā |	kurvanti-aprameyANi-aSuBa-karmANi-itikAmayate tat-parityAgam-iti praTamA |
   ātmānaṃ pratyavekṣate yatkāye 'sminnavacchidrāṇi yebhyaḥ sravanti	AtmAnam pratyavekzate yat-kAye asmin=-avacCidrANi yeByaH sravanti
   durgandhimalāmedhyānīti kurute taṃ pratyanādaramitidvitīyā | ātmānaṃ	durganDi-mala-ameDyAni-iti kurute tam pratyanAdaram-iti-dvitIyA | AtmAnam
   pratyavekṣate yatkāye 'smillobhadveṣamohā aprameyāḥ kleśā nirdahanti	pratyavekzate yat-kAye asmil-loBa-dveza-mohAH aprameyAH kleSAH nirdahanti
   kuśalacittamiti kāmayate nirvāpayitumiti tṛtīyā | ātmānaṃ pratyavekṣate	kuSala-cittam-iti kAmayate nirvApayitum-iti tRtIyA | AtmAnam pratyavekzate
   yatkāyo 'yaṃ phenabudbudavatkṣaṇaṃkṣaṇamutpadyate nirudhyate tena dharmāḥ	yat-kAyaH ayam Pena-budbuda-vat-kzaNaMkzaNam-utpadyate niruDyate tena DarmAH
   prahātavyā iti kāmayate prahātumiti caturthī | ātmānaṃ pratyavekṣate	prahAtavyAH iti kAmayate prahAtum-iti caturTI | AtmAnam pratyavekzate
   yatkāyo 'yamavidyāvṛtatayā sarvadā karityaśubhakarmāṇi saṃsarati ṣaḍgatiṣu	yat-kAyaH ayam-avidyA-AvRta-tayA sarvadA kariti-aSuBa-karmANi saMsarati zaxgatizu
   na cāsya lābha iti paṃcamī |	na ca-asya lABaH iti paMcamI |
   5 | uttamaphalagaveṣaṇā bodhicittotpādāya punaḥ paṃcaprakārā | paśyati	5 | uttama-Pala-gavezaNA boDi-citta-utpAdAya punar paMca-prakArAH | paSyati
   tathāgatānāṃ bhāsvaranirmalāṃ sallakṣaṇānuvyañjananiṣpattiṃ yāṃ	taTAgatAnAm BAsvara-nirmalAm sat-lakzaNa-anuvyaQjana-nizpattim yAm
   saṃgacchataḥ kleśā vyapagatā bhavantīti saṃgṛhṇatīti prathamā | paśyati	saMgacCataH kleSAH vyapagatAH Bavanti-iti saMgRhNati-iti praTamA | paSyati
   tathāgatānāṃ dharmakāyaṃ nityamavasthitaṃ pariśuddhaṃ niṣkalaṃkamiti	taTAgatAnAm Darma-kAyam nityam-avasTitam pariSudDam nizkalaMkam-iti
   saṃgṛhṇatīti dvitīyā | paśyati tathāgatānāṃ	saMgRhNati-iti dvitIyA | paSyati taTAgatAnAm
   śīlasamādhiprajñāvimuktivimuktijñānadarśanapariśuddhadharmaskandhāmiti	SIla-samADi-prajQA-vimukti-vimukti-jQAna-darSana-pariSudDa-Darma-skanDAm-iti
   saṃgṛhṇatīti tṛtīyā | paśyati tathāgatānāṃ daśa balāni catvāri	saMgRhNati-iti tRtIyA | paSyati taTAgatAnAm daSa balAni catvAri
   vaiśaradyāni mahākaruṇāṃ trīṇi smṛtyupasthānānīti saṃgṛhṇatīti caturthī |	vESaradyAni mahA-karuNAm trINi smRti-upasTAnAni-iti saMgRhNati-iti caturTI |
   paśyati tathāgatānāṃ sarvajñatāṃ kṛpāṃ sattveṣu yanmaitrīkaruṇābhyāṃ	paSyati taTAgatAnAm sarvajQa-tAm kRpAm sattvezu yat-mEtrI-karuNAByAm
   samāvṛtya vibhrāntānnayati sarvānsanmārgamiti saṃgṛhṇatīti pañcamī ||	samAvRtya viBrAntAn-nayati sarvAn-sat-mArgam-iti saMgRhNati-iti paQcamI ||
   6 | kṛpā sattveṣu bodhicittotpādāya punaḥ pañcaprakārā | paśyati	6 | kRpA sattvezu boDi-citta-utpAdAya punar paQca-prakArAH | paSyati
   sattvānavidyayā vinibaddhāniti prathamā | paśyati	sattva-an-avidyayA vinibadDAn-iti praTamA | paSyati
   satvānnānāduḥkhaparyavasthitāniti dvitīyā | paśyati sattvansaṃgṛhṇato	satvAt-nAnA-duHKa-paryavasTitAn-iti dvitIyA | paSyati sattvan-saMgRhNataH-
   'kuśalakarmāṇīti tṛtīyā | paśyati sattvānkurvato gurutarāṇi duścaritānīti	akuSala-karmANi-iti tRtIyA | paSyati sattvAn-kurvataH gurutarANi duScaritAni-iti
   caturthī | paśyatisattvānanācarataḥ samyagdharmamiti pañcamī ||	caturTI | paSyati-sattva-AnanAcarataH samyak-Darmam-iti paQcamI ||
   7 | avidyābandhanaṃ punaścatuḥprakāram | paśyati	7 | avidyA-banDanam punar-catur-prakAram | paSyati
   sattvānmoharāgavibhrāntānvedayato mahākṛcchraduḥkhānīti prathamam |	sattvAt-moha-rAga-viBrAntAn-vedayataH mahAkRcCra-duHKAni-iti praTamam |
   paśyati sattvānaśraddadhānānhetuphalayoḥ kurvato 'śubhakarmāṇīti dvitīyam	paSyati sattvAn-aSraddaDAnAn-hetu-PalayoH kurvataH aSuBa-karmANi-iti dvitIyam
   | paśyati sattvānutsṛjataḥ samyagdharmaṃ śraddadhānān mṛṣāmārgamiti	| paSyati sattvAn-utsRjataH samyak-Darmam SraddaDAnAt mRzA-mArgam-iti
   tṛtīyam | paśyati sattvānkleśanadyāṃ majjataścatuḥpravāheṣūnmajjata iti	tRtIyam | paSyati sattvAn-kleSa-nadyAm majjataH-catur-pravAhezu-unmajjate iti
   caturtham ||	caturTam ||
   8 | nānāduḥkhaparyavasthānaṃ punaścatuḥprakāram | paśyati sattvānbibhyato	8 | nAnA-duHKa-paryavasTAnam punar-catur-prakAram | paSyati sattvAn-biByataH-
   jātijarāvyādhimaraṇebhyo vimokṣamagaveṣayataḥ karmāṇi punaḥ kurvata iti	jAti-jarA-vyADi-maraNeByaH vimokzam-aga-vezayataH karmANi punar kurvataH iti
   prathamam | paśyati	praTamam | paSyati
   sattvāñcchokaparidevadaurmanasyaduḥkhitānnityamaviśrāntakarmaṇa iti	sattvAQt-Soka-parideva-dOrmanasya-duHKitAn-nityam-aviSrAnta-karmaNaH iti
   dvitīyam | paśyati sattvānpriyaviyogaduḥkhamūḍhānupāyāsaktāniti tṛtīyam |	dvitIyam | paSyati sattvAn-priya-viyoga-duHKa-mUXa-anupAya-AsaktAn-iti tRtIyam |
   paśyati sattvānapriyasaṃyogaduḥkhitānnityamatikrāntabhederṣyānapi	paSyati sattvAnapriya-saMyoga-duHKitAn-nityam-atikrAnta-Beda-IrzyAn-api
   kṛtāpriyāniti caturtham ||	kRta-apriyAn-iti caturTam ||
   9 | akuśalasaṃgrahaḥpunaścatuḥprakāraḥ | paśyati sattvānkāmārāgātkurvato	9 | akuSala-saMgrahaH-punar-catur-prakAraH | paSyati sattvAn-kAmArAgAt-kurvataH-
   'śubhāniti prathamaḥ | paśyati sattvāñjānato 'pi kāmānāṃ	aSuBAn-iti praTamaH | paSyati sattvAn-jAnataH api kAmAnAm
   duḥkhotpādakatamanutsṛjataḥ kāmāniti dvitīyaḥ | paśyati sattvānsukhaṃ	duHKa-utpAda-katama-nutsRjataH kAmAn-iti dvitIyaH | paSyati sattvAn-suKam
   kāmayato 'pi śīlapādavimukhāniti tṛtīyaḥ | paśyati	kAmayataH api SIla-pAda-vimuKAn-iti tRtIyaH | paSyati
   sattvānduḥkhamanabhinandato 'pi carato 'virataṃ duḥkhāyeti caturthaḥ ||	sattvAn-duHKam-anaBinandataH api carataH aviratam duHKAya-iti caturTaH ||
   10 | gurutarapāpācāraḥ punaścatuḥprakāraḥ | paśyati	10 | gurutara-pApa-AcAraH punar-catur-prakAraH | paSyati
   sattvānaparādhyatoguruśīlaṃ bhaye 'pi pramādina iti prathamaḥ |	sattvAn-apara-aDyata-uguru-SIlam Baye api pramAdinaH iti praTamaH |
   paśyatisattvānkurvato 'tyantāśubhāni pañcānantaryakarmāṇi drohāvṛtatvena	paSyati-sattvAn-kurvataH atyanta-aSuBAni paQca-anantarya-karmANi droha-AvRta-tvena
   notpādayato hriyamapatrapāṃceti dvitīyaḥ | paśyati sattvānnindato	na-utpAdayataH hriyam-apatra-pAMca-iti dvitIyaH | paSyati sattvAt-nindataH-
   mahāyānavaipulyasaddharmānvālyaparigṛhītānsamudgatamadamānāniti tṛtīyaḥ |	mahAyAna-vEpulya-sat-DarmAnvAlya-parigRhItAn-samudgata-mada-mAnAn-iti tRtIyaH |
   paśyati sattvānbuddhimato 'pyucchindataḥ kuśalamūlānyathāpi mānino na	paSyati sattvAn-budDimataH api-ucCindataH kuSala-mUlAni-aTa-api mAninaH na
   kadāpyanuśocata iti caturthaḥ ||	kadApi-anuSocate iti caturTaH ||
   11 | samyagdharmānācaraṇaṃ punaścatuḥprakāram | paśyati sattvānaṣṭākṣaṇeṣu	11 | samyak-DarmAn-AcaraNam punar-catur-prakAram | paSyati sattvAn-azwa-akzaNezu
   na śṛṇvataḥ saddharmamajānataścarituṃ kuśalamiti prathamam | paśyati	na SRNvataH sat-Darmam-ajAnataH-caritum kuSalam-iti praTamam | paSyati
   sattvānbuddhotpāde nāpitaṃ saddharmaṃ śṛṇvato 'pi na gṛhṇata iti dvitīyam	sattvAn-budDa-utpAde nApitam sat-Darmam SRNvataH api na gRhNate iti dvitIyam
   | paśyati sattvānudgṛhṇata stairthikavādānkurvata ātmaklamathānuyogān	| paSyati sattvAn-udgRhNata stErTika-vAdAn-kurvataH Atma-klamaTa-anuyogAn
   nityamapagacchato vimokṣāditi tṛtīyam | dṛśyati sattvāṃllabdhaṃ	nityam-apagacCataH vimokzAt-iti tRtIyam | dRSyati sattvAn=-labDam
   naivasaṃjñānāsaṃjñāṃ nāma samādhi nirvāṇamivodgṛhṇataḥ kuśalavipākānte	na-evasaMjQAna-asaMjQAm nAma samADi nirvANam-iva-udgRhNataH kuSala-vipAka-ante
   punaścyavatastisṛtiṣu durgatiṣviti caturtham ||	punar-cyavatastisRtizu durgatizu-iti caturTam ||
   12 | bodhisattvaḥ paśyati sattvānavidyayākarmāṇi kurvato dīrgharātraṃ	12 | boDisattvaH paSyati sattvAnavidyayA-karmANi kurvataH dIrGarAtram
   vedayato duḥkhāni parityajataḥsaddharmaṃ vismarato niḥsaraṇamārganityevaṃ	vedayataH duHKAni parityajataH-sat-Darmam vismarataH niHsaraNa-mArgan-iti-evam
   kāraṇādutpādayati mahāmaitrīṃ karūṇāṃ pradīptaśirasrāṇavacca	kAraNAt-utpAdayati mahA-mEtrIm karUNAm pradIpta-SirasrANa-vat-ca
   gaveṣayatyanuttarāṃ samyagyambodhiṃ sarvānsattvā	gavezayati-anuttarAm samyak-yamboDim sarvAn-sattvA
   keśaduḥkhitānahamuddharāmi niravaśeṣamiti | buddhātmajāḥ saṃkṣepeṇa	keSa-duHKitAn-aham-udDarAmi niravaSezam-iti | budDa-AtmajAH saMkzepeNa
   meyadamuktam | vādikarmiko bodhisattvaḥ sakāraṇaṃ cittamutpādayatīti |	meya-damuktam | vAdi-karmikaH boDisattvaH sa-kAraNam cittam-utpAdayati-iti |
   vistareṇa ceducyeta na tasya parimāṇaṃ na tasya paryantaḥ ||	vistareNa ced-ucyeta na tasya parimANam na tasya paryantaH ||
   (iti bodhicittotpādasutraśāstre bodhicittotpādo nāma dvitīyo vargaḥ ||)	(iti boDi-citta-utpAda-sutra-SAstre boDicittotpAdaH nAma dvitIyaH vargaH ||)
   tṛtiyo vargaḥ	tRtiyaH vargaH
   pratidhānam	pratiDAnam
   1 | bodhisattvaḥ kathamutpādayati bodhim | kayā karmacaryayā paripūrayati	1 | boDisattvaH kaTam-utpAdayati boDim | kayA karma-caryayA paripUrayati
   bodhim | utpāditacitto bodhisattvaḥ śuvidarśanābhūmi madhiṣṭhito	boDim | utpAdita-cittaH boDisattvaH Suvi-darSana-aBUmi maDizWitaH-
   dṭaḍhmādāvutpādayati samyakpraṇidhānaṃ saṃgrahītuṃ sarvānaprameyānsattvān	dwaXma-AdO=-utpAdayati samyak-praNiDAnam saMgrahItum sarvAn-aprameyAn-sattvAn
   | gaveṣayāmyahamanuttarāṃ bodhiṃ pāratrātuṃ niravaśepaṃ	| gavezayAmi-aham-anuttarAm boDim pAratrAtum niravaSepam
   prāpayitumanupadhinirvāṇam | tasmāccittotpādādarabhya mahākaruṇāyāḥ	prApayitum-anupaDi-nirvANam | tasmAt-citta-utpAdAt-araBya mahA-karuNAyAH
   karuṇācittenotpādayati daśottaraṇi samyakpraṇidhānāni ||	karuNA-cittena-utpAdayati daSa-uttaraNi samyak-praNiDAnAni ||
   2 | katamāni daśa | kāmaye yanmayā purā janmanīhacānena kāyena	2 | katamAni daSa | kAmaye yat-mayA purA janmanI-ha-cAnena kAyena
   yadavaropitaṃ kuśalamūlaṃ tadutsṛjāmyaparmantebhyaḥ sarvasattvebhyaḥ |	yat-avaropitam kuSala-mUlam tad-utsRjAmya-parmanteByaH sarva-sattveByaH |
   pariṇāmayāmi ca sarvānanuttarāyāṃ bodhau | kṣaṇaṃ kṣaṇaṃ praṇidhānametanme	pariNAmayAmi ca sarvAn-anuttarAyAm boDO | kzaNam kzaNam praNiDAnam-etat-me
   saṃvarddheta jātau jātau ca jāyeta nityaṃ cittānubaddhaṃ na kadāpi	saMvardDeta jAtO jAtO ca jAyeta nityam citta-anubadDam na kadApi
   vismriyeta dhāraṇyā ca parikṣyeta |	vismriyeta DAraNyA ca parikzyeta |
   kāmaye yadahaṃ pariṇāmya mahābodhāvanena kuśalamūlena sarvajātinivāseṣu	kAmaye yat-aham pariNAmya mahA-boDA=-anena kuSala-mUlena sarva-jAti-nivAsezu
   nityaṃ pūjayeyaṃ sarvabuddhānna kadāpyabuddhakṣetreṣu saṃbhaveyam |	nityam pUjayeyam sarva-budDAt-na kadApi-abudDa-kzetrezu saMBaveyam |
   kāmaye yadahamutpadya buddhakṣetre ṣūpagaccheyaṃ buddhānupatiṣṭheyaṃ	kAmaye yat-aham-utpadya budDa-kzetre zu-upagacCeyam budDAn-upatizWeyam
   buddhāñchāyeva śarīramanugataḥ kṣaṇamapi na dūrībhaveyaṃ buddhebhyaḥ |	budDAn-CAyA-iva SarIram-anugataH kzaNam-api na dUrIBaveyam budDeByaH |
   kāmaye yadahamupagato buddhāṃstai ryathākāmaṃ mamārthāya deśitena dharmeṇa	kAmaye yat-aham-upagataH budDAn=-tEH ryaTAkAmam mama-arTAya deSitena DarmeNa
   niṣpādayeyaṃ bodhisattvapaṃcābhijñānāni |	nizpAdayeyam boDisattva-paMca-aBijQAnAni |
   kāmaye yadahaṃ niṣpādya bodhisattvapaṃcābhijñānāni saṃvṛtisatyaṃ	kAmaye yat-aham nizpAdya boDisattva-paMca-aBijQAnAni saMvRti-satyam
   vijñaptiprasṛtaṃ pratibudhya paramārthasatyaṃ bhṛtasvamāvaṃ parijñāya	vijQapti-prasRtam pratibuDya parama-arTa-satyam BRta-svamAvam parijQAya
   prāpnuyāṃ samyagdharmajñānam |	prApnuyAm samyak-Darma-jQAnam |
   kāmaye yadahaṃ prāpya samyagdharmajñānamaviśrāntacittena deśayeyaṃ	kAmaye yat-aham prApya samyak-Darma-jQAnam-aviSrAnta-cittena deSayeyam
   sattvebhyo nidarśayitumupadeśahitān ababodhayituṃ ca tānsarvān |	sattveByaH nidarSayitum-upadeSa-hitAn ababoDayitum ca tAn-sarvAn |
   kāmaye yadahamababodhya sarvānsattvānbuddhānubhāvena gaccheyaṃ daśadikṣu	kAmaye yat-aham-ababoDya sarvAn-sattvAn-budDa-anuBAvena gacCeyam daSa-dikzu
   niravaśeṣeṣu lokadhātuṣu pūjatituṃ buddhāñchrotuṃ saddarmān	niravaSezezu lokaDAtuzu pUjatitum budDAn-Srotum sat-darmAn
   saṃparigrahītuṃ sattvān |	saMparigrahItum sattvAn |
   kāmaye yadahaṃ buddhakṣetreṣu saddharmamudgṛhyānupravarteyaṃ pariśuddhaṃ	kAmaye yat-aham budDa-kzetrezu sadDarmam-udgRhya-anupravarteyam pariSudDam
   dharmacakram | daśadi kathātuṣu sarvesattvā mama deśanāṃ śrutvā mama	Darma-cakram | daSadi kaTAtuzu sarvesattvAH mama deSanAm SrutvA mama
   nāmākarṇya parityajantu sarvānkleśānu dayantu bodhicittam |	nAma-AkarNya parityajantu sarvAn-kleSa-anu dayantu boDi-cittam |
   kāmaye yadahaṃ sarvasattveṣu bodhicittamutpādya nityaṃ paripāluyituṃ	kAmaye yat-aham sarva-sattvezu boDi-cittam-utpAdya nityam paripAluyitum
   parihareyamalābhaṃ prapaccheyamaprameyasukhānyutsṛjeyaṃ jīvitaṃ	parihareyam-alABam prapacCeyam-aprameya-suKAni-utsRjeyam jIvitam
   dhanānicoddhareyaṃ sattvānudvaheyaṃ saddharmam |	Dana-Anica-udDarA-iyam sattvAn-udvaheyam sadDarmam |
   kāmaye yadahaṃ saddharmamudūḍhaya caritvāpi saddharmaṃ cittena nācareyam |	kAmaye yat-aham sadDarmam-udUXaya caritvA-api sadDarmam cittena na-Acareyam |
   yathā sattvā ācaritadharmāṇo 'pi nācaritadharmāṇo na ca nācaritadharmāṇaḥ	yaTA sattvAH Acarita-DarmANaH api na-Acarita-DarmANaH na ca na-Acarita-DarmANaH
   | vinetuṃ vānnotsṛjeyaṃ samyakpraṇidhānam | itīme samutpāditacittānāṃ	| vinetum vAn-na-utsRjeyam samyak-praNiDAnam | iti-ime samutpAdita-cittAnAm
   bodhisattvānāṃ samyagmahāpraṇidhānāni | imāni daśamahāpraṇidhānāni	boDisattvAnAm samyak-mahA-praNiDAnAni | imAni daSa-mahA-praNiDAnAni
   sarvasattvadhātuṣṛdgṛhṇanti gaṃgānadībālakāsamāni praṇidhānāni | yadi ca	sarva-sattva-DAtu-zRt-gRhNanti gaMgA-nadI-bAlakA-samAni praNiDAnAni | yadi ca
   sattvānāṃ samāptiḥ syānmama dhānānāmapi samāptirbhavet | naca khalu	sattvAnAm samAptiH syAt-mama DAnAnAm-api samAptiH-Bavet | na-ca Kalu
   sattvānāṃ samāptistena mama praṇidhānānāmapi na samāptiḥ ||	sattvAnAm samAptiH-tena mama praNiDAnAnAm-api na samAptiH ||
   3 | punaḥ khalu dānaṃ bodhihetuḥ sarvasattvānugrāhakatvāt | śīlaṃ	3 | punar Kalu dAnam boDi-hetuH sarva-sattva-anugrAhaka-tvAt | SIlam
   bodhihetuḥ daśalaprāptyā mūlapraṇihitaparipūrakatvāt |	boDi-hetuH daSala-prAptyA mUla-praNihita-paripUraka-tvAt |
   kṣāntirbodhheturdvatrīśallakṣaṇāśītyanupyañjanasaṃprāpakatvāt | vīryaṃ	kzAntiH-boDhetuH-dvatrI-Sat-lakzaNa-aSIti-anupyaQjana-saMprApaka-tvAt | vIryam
   bodhihetuḥ kuśalācāravardhakatayā sotsāhaṃ sattvaparipācakatvāt | dhyānaṃ	boDi-hetuH kuSala-AcAra-varDaka-tayA sa-utsAham sattva-paripAcaka-tvAt | DyAnam
   bodhiheturbodhisattvānāṃ samyagātmasaṃyamanena	boDi-hetuH-boDisattvAnAm samyak-Atma-saMyamanena
   sattvacittacaryāvavodhakatvāt | prajñā bodhiheturniravaśepaṃ	sattva-citta-caryA-avavoDaka-tvAt | prajQA boDi-hetuH-niravaSepam
   dharmabhāvalakṣaṇāvavodhakatvāt | saṃkṣepata ucyate ṣaḍimāḥ pāramitā	Darma-BAva-lakzaNa-avavoDaka-tvAt | saMkzepataH ucyate zaw-imAH pAramitA
   bodheḥ samyaghetuḥ | catvāro brahmavihārāḥ saptaviśadbodhipākṣikā dharmā	boDeH samyak-etuH | catvAraH brahma-vihArAH sapta-viSat-boDi-pAkzikA DarmA
   sahasraśaḥ kuśalācārāḥ sahakāriṇaḥ pūrayitāraḥ | yadi bodhisattva ācarati	sahasraSas kuSala-AcArAH sahakAriNaH pUrayitAraH | yadi boDisattvaH Acarati
   ṣaṭ pāramitāstadanusṛtya carati caryāṃ krameṇopaityanuttarāṃ	zaw pAramitAH-tat-anusRtya carati caryAm krameNa-upEti-anuttarAm
   samyaksambodhim ||	samyaksamboDim ||
   4 | buddhātmajā bodhi gaveṣayadbhirna pramaditavyam | pramādācaraṇena	4 | budDa-AtmajA boDi gavezayadBiH-na pramaditavyam | pramAda-AcaraNena
   vinaśyatikuśalamūlam | bodhisattvo damayati ṣaḍindriyāṇi na pramādyati	vinaSyati-kuSala-mUlam | boDisattvaH damayati zaz-indriyANi na pramAdyati
   cedācarituṃ śaknoti ṣaṭ pāramitāḥ | bodhisattvaścittamutpādya	ced-Acaritum Saknoti zaw pAramitAH | boDisattvaH-cittam-utpAdya
   pratiṣṭhāpayati sthairyaṃ saṃpratiṣṭhāpayati dṭaḍhaṃ praṇidhānam |	pratizWApayati sTEryam saMpratizWApayati dwaXam praNiDAnam |
   praṇihitaṃ pratiṣṭhāpya na kadāpi pramādyati na ca bhavati kusīdo na ca	praNihitam pratizWApya na kadApi pramAdyati na ca Bavati kusIdaH na ca
   dīrghasūtraḥ | tatkasya hetoḥ | praṇihitamadhiṣṭhitaḥ	dIrGasUtraH | tat-kasya hetoH | praNihitam-aDizWitaH
   paṃcavastūnyudgṛhṇāti | dṭaḍhayati cittamiti prathamam | atikrāmyati	paMcavaH-tUni-udgRhNAti | dwaXayati cittam-iti praTamam | atikrAmyati
   kleśāniti dvitīyam | niruṇaddhi vicintya pramādacittamiti tṛtīyam |	kleSAn-iti dvitIyam | niruNadDi vicintya pramAda-cittam-iti tRtIyam |
   bhinatti paṃcanīvaraṇānīti caturtham | sotsāhamācarati ṣaṭ pāramitā iti	Binatti paMcanIvaraNAni-iti caturTam | sa-utsAham-Acarati zaw pAramitA iti
   paṃcamam | tathācānuśaṃsitaṃ bhagavatā tathāgatai rmahāprājñai	paMcamam | taTA-ca-anuSaMsitam BagavatA taTAgatEH rmahA-prAjQE
   rbhahāprājñai rbhagavadbhi vyākhyāteṣu guṇeṣu	rBaha-aprAjQEH rBagavadBi vyAKyAtezu guNezu
   kṣāntiprajñāpuṇyavalānāmadhigameṣu praṇidhānabalamuttamamiti ||	kzAnti-prajQA-puNyavalAnAm-aDigamezu praNiDAna-balam-uttamam-iti ||
   5 | kathaṃ pratiṣṭhāpayati praṇidhānam | yadi kaścidāyāti bahubidhaṃ	5 | kaTam pratizWApayati praNiDAnam | yadi kaScid-AyAti bahu-biDam
   yācituṃ tadahaṃ dadāmi yāvannotpādayāmi kṣaṇamapi mātsaryacittam |	yAcitum tat-aham dadAmi yAvat-na-utpAdayAmi kzaNam-api mAtsarya-cittam |
   kṣaṇamapinimeṣamapyutpādaya nnaśubhacittaṃ dānapratyayena cedgaveṣayāmi	kzaNam-api-nimezam-api-utpAdaya nnaSuBa-cittam dAna-pratyayena ced-ga-vezayAmi
   śubhavipākaṃ tadahaṃ pratārayāmi daśadikṣu bhagavato	SuBa-vipAkam tat-aham pratArayAmi daSa-dikzu BagavataH-
   'prameyānāparyantānasaṃkhyeyān pratputpannāṃstathāgatān anāgate 'śvanyapi	aprameyAn-AparyantAn-asaMKyeyAn pratputpannAn=-taTAgatAn anAgate aSvanI-api
   na pūrayeyaṃ dhruvamanuttarāṃ samyaksambodhim | yadyahaṃdhārayāmi śīlaṃ	na pUrayeyam Druvam-anuttarAm samyaksamboDim | yadi-ahaMDArayAmi SIlam
   yāvadutsṛjannapyātmabhāvaṃ (jīvitaṃ) pratiṣṭhāpayāmi pariśūddhaṃ cittaṃ	yAvat-utsRjan=-api-Atma-BAvam (jIvitaM) pratizWApayAmi pariSUdDam cittam
   praṇidadhāmi yanna pratinivarte nānuśocāmi | yadyamācarāmi kṣāntiṃ	praNidaDAmi yat-na pratinivarte na-anuSocAmi | yadyam-AcarAmi kzAntim
   pareṇākrāntaḥ pratyaṃgaṃ vibhajyamāno 'pi cchidyamāno 'pyutpādayāmi nityaṃ	pareNa-AkrAntaH pratyaMgam viBajyamAnaH api cCidyamAnaH api-utpAdayAmi nityam
   maitrīṃ praṇidadhāmi yannācareyaṃ dveṣam | yadyahamācarāmi vīryamupalabhya	mEtrIm praNidaDAmi yat-na-Acareyam dvezam | yadi-aham-AcarAmi vIryam-upalaBya
   śītoṣṇarājadasyujalāgnisiṃhavyāghravṛkanirjakāntārān dṭaḍhikaromi cittaṃ	SIta-uzNa-rAja-dasyu-jala-agni-siMha-vyAGra-vRka-nirjakAntArAn dwaXikaromi cittam
   praṇidadhāmi yanna pratinivarte | yadyahaṃ bhāvayāmi dhyānaṃ bāhyai	praNidaDAmi yat-na pratinivarte | yadi-aham BAvayAmi DyAnam bAhyE
   rvastubhiḥ kliśyamāno 'pi vyākulacittau 'pyanubadhnāmi smṛtiṃ karmasthāne	rvastuBiH kliSyamAnaH api vyAkula-cittO api-anubaDnAmi smRtim karma-sTAne
   | kṣaṇamapi na kadācidutpādayāmyadharmyāṃ vikṣepasaṃjñām | yadyahaṃ	| kzaNam-api na kadAcid-utpAdayAmyaDarmyAm vikzepa-saMjQAm | yadi-aham
   bhāvayāmi prajñāṃ sarvadharmāstathatābhūtānpaśyanparigṛhṇapi |	BAvayAmi prajQAm sarva-DarmAH-taTatA-BUtAn-paSyan-parigRhNapi |
   kuśalākuśaleṣu saṃskṛtāsaṃskṛteṣu jātimaraṇanirvāṇeṣu notpādayāmi	kuSala-akuSalezu saMskRta-asaMskRtezu jAti-maraNa-nirvANezu na-utpAdayAmi
   dvaitadṭaṣṭim | yadyahaṃ nimeṣamapi kṣaṇamapyanuśocandviṣan	dvEtat-wazwim | yadi-aham nimezam-api kzaNam-api-anuSocandvizan
   pratinivartamānaḥ saṃjñāṃ vikṣipan	pratinivartamAnaH saMjQAm vikzipan
   dvaitadṭaṣṭimutpādayañchilakṣāntivīryadhyānaprajñābhiḥ śubhavipākaṃ	dvEtat-wazwim-utpAdayan-Sila-kzAnti-vIrya-DyAna-prajQABiH SuBa-vipAkam
   gaveṣayāmi tadahaṃ pratārayāmi	gavezayAmi tat-aham pratArayAmi
   daśadiglokadhātuṣvaprameyānaparyantānasaṃkhyeyān pratyutpannāṃstathāgatān	daSa-diS-lokaDAtuzu-aprameyAn-aparyantAn-asaMKyeyAn pratyutpannAn=-taTAgatAn
   | anāgate 'dhvanyapi na khalupūrayeyamanuttarāṃ samyaksaṃbodhim |	| anAgate aDvani-api na Kalu-pUrayeyam-anuttarAm samyaksaMboDim |
   6 | bodhisattvo daśamahāpraṇidhānai rgṛhṇāti saddharmacaryām | ṣaṇmahā	6 | boDisattvaH daSa-mahA-praNiDAnEH rgRhNAti sadDarma-caryAm | zaz-mahA
   praṇidhānai rdamayati prāmadacittam | sotsāhaṃ varati vīryam | ācarati ṣat	praNiDAnEH rdamayati prAmada-cittam | sa-utsAham varati vIryam | Acarati zat-
   pāramitāḥ paripūrayatyanuttarāṃ samyaksaṃbodhim ||	pAramitAH paripUrayati-anuttarAm samyaksaMboDim ||
   (iti bodhicittotpādasutraśātre praṇidhānaṃ nāma tṛtīyo vargaḥ ||)	(iti boDi-citta-utpAda-sutra-SAtre praNiDAnam nAma tRtIyaH vargaH ||)
   caturtho vargaḥ	caturTaH vargaH
   dānapāramitā	dAna-pAramitA
   1 | bodhisattvaḥ kathaṃ dānaṃ dadāti | dānamātmaparobhayalābhāya	1 | boDisattvaH kaTam dAnam dadAti | dAnam-Atma-paroBaya-lABAya
   cedevaṃvidhaṃ dānaṃ niṣpādayati bodhimārgam | bodhisattvaḥ kāmayate	ced-evaMviDam dAnam nizpAdayati boDi-mArgam | boDisattvaH kAmayate
   vinetuṃ sattvānaparhatuṃ duḥkhāni dadāti tasmāddānam |	vinetum sattvAn-aparhatum duHKAni dadAti tasmAt-dAnam |
   dānamutsṛjannityamutpādayatyātmavitteṣu tyāgacittam | yācakeṣu	dAnam-utsRjat-nityam-utpAdayati-Atma-vittezu tyAga-cittam | yAcakezu
   mātāpitṛgurukalyāṇamitreṣvivotpādayatyādaracittam | janayati	mAtA-pitR-guru-kalyANa-mitrezu-iva-utpAdayati-Adara-cittam | janayati
   mātāpitṛgurukalyāṇamitrasaṃjñām | putra ivotpādayati daridreṣu hīneṣu	mAtA-pitR-guru-kalyANa-mitra-saMjQAm | putraH iva-utpAdayati daridrezu hInezu
   karuṇācittam | janayati putrasaṃjñām | yathāprārthitaṃ vitaratyādareṇa	karuNA-cittam | janayati putra-saMjQAm | yaTAprArTitam vitarati-AdareNa
   muditacittenetyucyate bodhisattvasyādidānacittam ||	mudita-cittena-iti-ucyate boDisattvasya-AdidAna-cittam ||
   2 | dānacaryāhetoḥ prasarati yaśaḥ | yatra va kacijjāyate bhavantyasya	2 | dAna-caryA-hetoH prasarati yaSaH | yatra va kacid-jAyate Bavanti-asya
   prabhṛtāni dhanānītyasyātmalābhaḥ | tarpayansattvānāṃ cittaṃ śikṣayati	praBRtAni DanAni-iti-asya-Atma-lABaH | tarpayan-sattvAnAm cittam Sikzayati
   vinayati vidadhāti tānavimatsarānityeṣa paralābhaḥ | vitarannalakṣaṇaṃ	vinayati vidaDAti tAn-avimatsarAn-iti-eza para-lABaH | vitaranna-lakzaNam
   mahādānaṃ sattveṣu pariṇāmyātmanā salābhinaḥ karotītyeṣa ubhayalābhaḥ |	mahAdAnam sattvezu pariNAmi-AtmanA sa-lABinaH karoti-iti-ezaH uBaya-lABaH |
   dānacaryāhetoḥ prāpnoti vartipadam |	dAna-caryA-hetoH prApnoti varti-padam |
   upasaṃgṛhṇātyaprameyānsarvasattvānyāvadāprāpte	upasaMgRhNAti-aprameyAn-sarva-sattvAn-i-Avada-aprApte
   rbuddhatvasyākṣayadharmakośabhyetyevaṃ niṣpādayati bodhimārgam ||	rbudDa-tvasya-akzaya-DarmakoSaByA-iti-evam nizpAdayati boDi-mArgam ||
   3 | dānaṃ trividham | prathamaṃ dharmadānaṃ dvitīyamabhayadānaṃ	3 | dAnam triviDam | praTamam Darma-dAnam dvitIyam-aBaya-dAnam
   tṛtīyamāmipadānam | dharmadānamudbodhayati lokāñchīlagrahaṇāya	tRtIyamAm-ipadAnam | Darma-dAnam-udboDayati lokAn-SIla-grahaNAya
   pravrajyācittacaraṇāya | mithyādṭaṣṭeḥ prahāṇāya deśayati śāśvatocchedau,	pravrajyA-citta-caraNAya | miTyAdwazweH prahANAya deSayati SASvata-ucCedO,
   caturaḥ viparyāsān pāpānāmādīnavaṃ ca, vibhajya prakāśayati paramārtham	caturaH viparyAsAn pApAnAm-AdInavam ca, viBajya prakASayati parama-arTam
   anuśaṃsati vīryaguṇānbhāṣate pramādātyayapāpamityucyate dharmadānam | yadi	anuSaMsati vIrya-guNAn-BAzate pramAda-atyaya-pApam-iti-ucyate Darma-dAnam | yadi
   sattvo vibheti nṛpātsaṃhādvyābrādvṛkājjalādagne rdasyoścaurādvā	sattvaH viBeti nRpAt-saMhAdvyAbrAt-vRkAt-jalAt-agne rdasyoH-cOrAt-vA
   bodhisattvo dṛṣṭe tatparitrāyat ityamayadānam | ātmano vittāni yāvad	boDisattvaH dRzwe tad-paritrAyat iti-amaya-dAnam | AtmanaH vittAni yAvat-
   ratnaṃ hastinamaśvaṃ rathaṃ vasrāṇi dhānyaṃ vāsasī peyaṃ khādyaṃ	ratnam hastinam-aSvam raTam vasrANi DAnyam vAsasI peyam KAdyam
   yāvatkavalamātramekasūtraṃ prabhūtamalpaṃ vā vitaranna mātsaryaṃ kurute |	yAvat-kavala-mAtram-eka-sUtram praBUtam-alpam vA vitarat-na mAtsaryam kurute |
   yathāprārthitaṃ tarpayati yācakānityāmiṣadānam ||	yaTAprArTitam tarpayati yAcakAn-iti-Amiza-dAnam ||
   4 | āmiṣadānaṃ punaḥ pañcavidham | prathamaṃ saralacittadānaṃ dvitīyaṃ	4 | Amiza-dAnam punar paQcaviDam | praTamam sarala-citta-dAnam dvitIyam
   śraddhā cittadānaṃ tṛtīyaṃ yathākāladānaṃ caturthaṃ svahastena dānaṃ	SradDA citta-dAnam tRtIyam yaTAkAla-dAnam caturTam sva-hastena dAnam
   paṃcamaṃ yathādharmadānam ||	paMcamam yaTADarma-dAnam ||
   5 | adātavyaṃ dānaṃ punaḥ paṃcaprakāram | adharmeṇopārjitaṃ dhanaṃ na	5 | adAtavyam dAnam punar paMca-prakAram | aDarmeNa-upArjitam Danam na
   dātavyaṃ syāpariśūddhatvāt | madyaṃ na dātavyaṃ parebhyo viṣaṃ ca	dAtavyam syA-pariSUdDa-tvAt | madyam na dAtavyam pareByaH vizam ca
   sattvānāṃ vikṣepasattvāt | mṛgayopakaraṇāni na dātavyāni	sattvAnAm vikzepa-sattvAt | mRgayA-upakaraNAni na dAtavyAni
   parebhyassattvānāṃ kleśakaratvāt | na dātavyāḥ parebhyassattvānāṃ	pareByaH-sattvAnAm kleSa-kara-tvAt | na dAtavyAH pareByaH-sattvAnAm
   hisakatvāt | gītaṃ striyaśca na dātavyāḥ parebhyaścittapavitratāyā	hisaka-tvAt | gItam striyaH-ca na dAtavyAH pareByaH-citta-pavitra-tAyAH-
   dūṣakatvāt | saṃkṣepata ucyate | yanna yathādharmaṃ yacca vikṣepakaraṃ	dUzaka-tvAt | saMkzepataH ucyate | yat-na yaTADarmam yat-ca vikzepa-karam
   vikṣepakaraṃ sattvānāṃ tanna dātavyaṃ parebhyaḥ | śiṣṭaṃ sarvaṃ	vikzepa-karam sattvAnAm tat-na dAtavyam pareByaH | Sizwam sarvam
   yatsukhayati sattvāṃstaducyate yathādharmadānam ||dānaricirlabhate	yat-suKayati sattvAn=-tat-ucyate yaTADarma-dAnam ||dAn-ariciH-laBate
   paṃcabidhaṃ kīrtikuśalalābham | sāmīpyaṃ labhate sarvasatāmiti prathamaḥ |	paMcabiDam kIrti-kuSala-lABam | sAmIpyam laBate sarva-satAm-iti praTamaH |
   sarve sattvāstaṃ draṣṭumabhilaṣantīti dvitīyaḥ | janakāyaṃ praviṣṭaḥ	sarve sattvAH-tam drazwum-aBilazanti-iti dvitIyaH | jana-kAyam pravizwaH
   satkriyate janairiti tṛtīyaḥ | prasarannasya yaśovarṇaḥ śrūyate daśasu	satkriyate janEH-iti tRtIyaH | prasaran=-asya yaSaH-varNaH SrUyate daSasu
   dikṣviti caturthaḥ | bhavati bodheḥ samyaguttamo heturiti paṃcamaḥ ||	dikzu-iti caturTaH | Bavati boDeH samyak-uttamaH hetuH-iti paMcamaH ||
   6 | bodhisattvaḥ sarvadātetyucyate | sarvadānaṃ na bahudhanaṃ kintu	6 | boDisattvaH sarva-dAtA-iti-ucyate | sarva-dAnam na bahu-Danam kintu
   dānacittam | yathādharmaṃ dhanamupārjyopādāya yaddadāti taducyate	dAna-cittam | yaTADarmam Danam-upArjya-upAdAya yat-dadAti tat-ucyate
   sarvadānam pariśuddhacittena yadaśāṭhayadānaṃ taducyate sarvadānam |	sarva-dAnam pariSudDa-cittena yat-aSAWaya-dAnam tat-ucyate sarva-dAnam |
   daridrāndṭaṣṭrā dayācittena yaddadāti taducyate sarvadānam |	daridra-an-dwazwrA dayA-cittena yat-dadAti tat-ucyate sarva-dAnam |
   duḥkhitāndṭaṣṭrā karuṇācittena yaddadāti taducyate sarvadānam | daridro	duHKitA-andwazwrA karuNA-cittena yat-dadAti tat-ucyate sarva-dAnam | daridraH-
   'lpadhano 'pi yaddadāti taducyate sarvadānam | spṛhaṇīyāni	alpa-DanaH api yat-dadAti tat-ucyate sarva-dAnam | spRhaNIyAni
   ratnajātānyudāracittena yaddadāti taducyate sarvadānam | apaśyañchīlāśīlaṃ	ratna-jAtAni-udAra-cittena yat-dadAti tat-ucyate sarva-dAnam | apaSyan-SIlA-SIlam
   kṣetrākṣetraṃ yaddadāti taducyate sarvadānam apaśyaz ṇchilāśīlaṃ	kzetrAkzetram yat-dadAti tat-ucyate sarva-dAnam apaSyaH NCilA-SIlam
   kṣetākṣetraṃ yaddadāti taducyate sarvadānam |	kzetAkzetram yat-dadAti tat-ucyate sarva-dAnam |
   agaveṣayandevamānupakalyāṇasukhāni yaddadāti taducyate sarvadānam |	agavezayan-devamAnupakalyANa-suKAni yat-dadAti tat-ucyate sarva-dAnam |
   gaveṣayannanuttarāṃ bodhi yaddadāti taducyate sarvadānam | ditsayā	gavezayan=-anuttarAm boDi yat-dadAti tat-ucyate sarva-dAnam | ditsayA
   dānakāle pradāya yannānuśocati taducyate sarvadānam ||	dAna-kAle pradAya yat-na-anuSocati tat-ucyate sarva-dAnam ||
   7 | yadi puṣpāṇi dadāti labhate dhāraṇīsaptabodhipuṣpāṇi | yadi gandhaṃ	7 | yadi puzpANi dadAti laBate DAraNI-sapta-boDi-puzpANi | yadi ganDam
   dadāti labhate śīlasamādhiprajñāḥ | (śīlasamādhiprajñādhūpaṃ prajvālya)	dadAti laBate SIla-samADi-prajQAH | (SIla-samADi-prajQA-DUpam prajvAlya)
   dhūpayati cātmānam | yadi phalaṃ dadāti labhate pūrayati cānāsravaphalam |	DUpayati ca-AtmAnam | yadi Palam dadAti laBate pUrayati ca-anAsrava-Palam |
   yadyāhāraṃ dadātikāyavāgrū pavalasukhasampannobhavati | yadi vastrāṇi	yadi-AhAram dadAtikA-yava-agrU pavala-suKa-sampanna-uBavati | yadi vastrANi
   dadāti labhate 'vadātaṃ rūpamapanayatyāhrīkyamanapatrāpyam | yadi pradīpaṃ	dadAti laBate avadAtam rUpam-apanayati-AhrIkyam-anapatrApyam | yadi pradIpam
   dadāti buddhacakṣurlabhate bhāsvaraṃ sarvadharmasvabhāvānām | yadi	dadAti budDa-cakzuH-laBate BAsvaram sarva-Darma-svaBAvAnAm | yadi
   hastyaśvarathayānāni dadāti labhate 'nuttaraṃ yānamṛddhiṃca |	hasti-aSva-raTa-yAnAni dadAti laBate anuttaram yAnam-RdDiMca |
   yadyalaṅkārāndadāti labhate 'śītyanuvyañjanāni | yadi ratnāni dadāti	yadi-alaFkArAn-dadAti laBate aSIti-anuvyaQjanAni | yadi ratnAni dadAti
   labhate dvātriṃśanmahāpuruṣalakṣaṇāni | pariśrameṇa [sattva-]sevāṃ	laBate dvAtriMSat-mahApuruza-lakzaNAni | pariSrameNa [sattva-]sevAm
   yadyācarati labhate daśavalāni caturvaiśaradyāni |	yadi-Acarati laBate daSavalAni catur-vESaradyAni |
   saṃkṣepata ucyate | rāṣṭraṃ nagaraṃ dārānputrāñchira ścakṣura hastapādau	saMkzepataH ucyate | rAzwram nagaram dArAn-putrAn-Sira Scakzura hasta-pAdO
   yāvatsarvakāyaṃ dadātyantarā citramātsaryaṃ prāptamanuttarāṃ bodhiṃ	yAvat-sarva-kAyam dadAti-antarA citra-mAtsaryam prAptam-anuttarAm boDim
   parinirvāpayituṃ sattvān | bodhisattvo mahāsattva ācarandānacaryāṃ	parinirvApayitum sattvAn | boDisattvaH mahAsattvaH Acaran-dAna-caryAm
   bhavatyavittadṭaṣṭi rdānādānayoralakṣaṇatvāttatasmātpūrayati dānapāramitām	Bavati-avittad-wazwi rdAna-AdAnayoH-alakzaNa-tvAt-tatasmAt-pUrayati dAna-pAramitAm
   (iti bodhicittotpādasṛtraśāstre dānapāramitā nāma caturtho vargaḥ ||)	(iti boDi-citta-utpAda-sRtra-SAstre dAnapAramitA nAma caturTaH vargaH ||)
   paṃcamo vargaḥ	paMcamaH vargaH
   śīlapāramitā	SIla-pAramitA
   1 | bodhisattvaḥ kathamācaratiśīlam | śīlamātmaparobhayalābhāya	1 | boDisattvaH kaTam-Acarati-SIlam | SIlam-Atma-paroBaya-lABAya
   cedevaṃvidhaṃ śilaṃ niṣpādayati bodhimārgam | bodhisattvaḥ kāmayatevinetuṃ	ced-evaMviDam Silam nizpAdayati boDi-mArgam | boDisattvaH kAmayatevinetum
   sattvānaparhatuṃ duḥkhānyācarati tasmācchīlam | śīlamācaransarvāṇi	sattvAn-aparhatum duHKAni-Acarati tasmAt-SIlam | SIlam-Acaran-sarvANi
   pavitrayati kāyavāṅmanaḥkarmāṇi | akuśalacaryāsu pariharati cittam |	pavitrayati kAya-vAc-manaH-karmANi | akuSala-caryAsu pariharati cittam |
   samyakprabhavati cāvajñāpayituṃ duṣkṛtaṃ śīlavidhātaṃ ca | kṣudreṣvapi	samyak-praBavati ca-avajQApayitum duzkRtam SIla-viDAtam ca | kzudrezu-api
   pātakeṣu cittena vibheti nityamityucyate bodhisattvasyādiśīlacittam |	pAtakezu cittena viBeti nityam-iti-ucyate boDisattvasya-Adi-SIla-cittam |
   2 | śīlācaraṇahetoḥ sarvān parityajati pāpātyayān kuśalāvāsepūtpadyate	2 | SIla-AcaraNa-hetoH sarvAn parityajati pApa-atyayAn kuSala-AvAsa-Ipu-utpadyate
   nityamityasyātmalābhaḥ | śikṣayati sattvānakartuṃ duṣkṛtamiti paralābhaḥ |	nityam-iti-asya-Atma-lABaH | Sikzayati sattvAn-akartum duzkRtam-iti para-lABaH |
   caritvābodhaye śīlaṃ pariṇāmya sattveṣvātmanā salābhinaḥ	caritvA-AboDaye SIlam pariNAmya sattvezu-AtmanA sa-lABinaH
   karotityubhavalābhaḥ | śīlācaraṇahetorlabhate vairāgyaṃ	karotiti-uBava-lABaH | SIla-AcaraNa-hetoH-laBate vErAgyam
   yāvatkṣapayatyāsravānparipūrayati cānuttarāṃ samyaksambodhimiti	yAvat-kzapayati-AsravAn-paripUrayati ca-anuttarAm samyaksamboDim-iti
   niṣyādayati bodhimārgam ||	nizyAdayati boDi-mArgam ||
   3 | śīlaṃ tāvattrividham | prathamaṃ kāyaśīlaṃ dvitīyam vākśīlaṃ tṛtīyaṃ	3 | SIlam tAvat-triviDam | praTamam kAya-SIlam dvitIyam vAc-SIlam tRtIyam
   cittaśīlam | udgṛhṇankāyaśīlaṃ sākalyena	citta-SIlam | udgRhNan-kAya-SIlam sAkalyena
   pariharatihiṃsāstainyakāmamithyācārān | virataḥ prāṇātipātādvirato	pariharati-hiMsA-stEnya-kAma-miTyA-AcArAn | virataH prANa-atipAtAt-virataH-
   'dattādānādvirato 'brahmacaryānnapunarvidadhāti prāṇātipātādīnāṃ	adatta-AdAnAt-virataH abrahmacaryAt-napunar-vidaDAti prANa-atipAta-AdInAm
   hetupratyāyāṃnsteṣāmupāyāṃśca na ca praharato sattvāndaṇḍena	hetu-pratyAyAM=-=-tezAm-upAyAn=-ca na ca praharataH sattvAn-daNxena
   kāṣṭheneṣṭikayā prastareṇa vā | parakīyamarthajātaṃ parakīyaṃ bhogyajātaṃ	kAzWena-izwikayA prastareNa vA | parakIyam-arTa-jAtam parakIyam Bogya-jAtam
   yāvattṛṇamātramapi patramātramapi nādattamādatte na ca khalu punaḥ	yAvat-tRNa-mAtram-api patra-mAtram-api na-adattam-Adatte na ca Kalu punar-
   kadācidapimohakaṃ rūpaṃ nirikṣate | caturṣu	kadAcid-api-mohakam rUpam nirikzate | caturzu
   sādarībhavatīryāpatheṣvityucyate kāyaśīlam ||	sa-AdarI-Bava-tIrya-apaTezu-iti-ucyate kAya-SIlam ||
   4 | udgṛhṇanvākśīlaṃ sākalyena prajahāti mṛṣāvādaṃ paiśunyaṃ pāruṣyaṃ	4 | udgRhNanvAc-SIlam sAkalyena prajahAti mRzAvAdam pESunyam pAruzyam
   sambhinnapralāpam | na kadāpi pratārayati na ca saṃgatānbhinatti	samBinna-pralApam | na kadApi pratArayati na ca saMgatAn-Binatti
   nābhyākhyāti na ca kṛtrimāṃ vācamudāharati nāpi	nABi-AKyAti na ca kRtrimAm vAcam-udAharati na-api
   lokāprāsādakamupāyamāracayati bhāṣate viśvastaṃ madhuramakapaṭaṃ bhāṣate	loka-aprAsAdakam-upAyam-Aracayati BAzate viSvastam maDuram-akapawam BAzate
   nityahitam | śikṣayati kuśalamācaritumityucyate vākśīlam ||	nitya-hitam | Sikzayati kuSalam-Acaritum-iti-ucyate vAc-SIlam ||
   5 | udgṛhṇaṃścittaśīlaṃ niruṇaddhi lobhadveṣamithyādṭaṣṭīḥ | nityaṃ	5 | udgRhNan=-citta-SIlam niruNadDi loBa-dveza-miTyAt-wazwIH | nityam
   vidadhāti mṛducittam | nātyayānācarati | śraddhadhāti pāpakarmaṇāmaśūbhaṃ	vidaDAti mRdu-cittam | na-atyayAn-Acarati | SradDaDAti pApa-karmaNAm-aSUBam
   phalaṃ bhavatīti bhavanābalena nāśubhānyacarati | kṣudreṣvapi pāreṣu	Palam Bavati-iti Bavana-abalena na-aSuBAni-acarati | kzudrezu-api pArezu
   janayati gurutara (pāpa)saṃjñām | ajñānataḥ kurvanpāpāni vibheti	janayati gurutaraH (pApa)-saMjQAm | ajQAnataH kurvan-pApAni viBeti
   paścāttatpatte sattveṣu notpādayati dveṣam | dṭaṣṭvā sattvānutpādayati	paScAt-tad-patte sattvezu na-utpAdayati dvezam | dwazwvA sattvAn-utpAdayati
   snehacittam | kṛtaṃ jānāti pratyupakaropyavimatsaracittaḥ | puṇyācaraṇe	sneha-cittam | kRtam jAnAti pratyupakaropya-vimatsara-cittaH | puNya-AcaraNe
   chandaṃ janayan nityaṃ śikṣayati janān | nityaṃbhāvayati maitrīcittam |	Candam janayan nityam Sikzayati janAn | nityaMBAvayati mEtrI-cittam |
   karuṇāyatesarveṣvityucyate cittaśīlam ||	karuNA-Ayate-sarvezu-iti-ucyate citta-SIlam ||
   6 | eteṣāṃ daśakuśalakarmapathānāṃ paṃcākāro lābhaḥ nigṛhyate	6 | etezAm daSa-kuSala-karma-paTAnAm paMcAkAraH lABaH nigRhyate
   duścaritamiti prathamaḥ | utpadyate kuśalacittamiti dvitīyaḥ | nirudhyante	duScaritam-iti praTamaH | utpadyate kuSala-cittam-iti dvitIyaH | niruDyante
   kleśā iti tṛtīyaḥ | paripūryate viśuddhacittamiti caturthaḥ | samedhate	kleSAH iti tRtIyaH | paripUryate viSudDa-cittam-iti caturTaH | sameDate
   śīlamiti paṃcamaḥ ||	SIlam-iti paMcamaH ||
   7 | kuśalamacaranpuruṣo na carati cetpramādamadhigacchati samyaksmṛtim |	7 | kuSalam-acaran-puruzaH na carati ced-pramAdam-aDigacCati samyak-smRtim |
   vivinakti kuśalākuśalam | jñātavyamevaṃvidhaḥ prabhavati puruṣo	vivinakti kuSala-akuSalam | jQAtavyam-evaMviDaH praBavati puruzaH-
   dhruvamācarituṃ daśakuśalakarmāṇi | caturaśītisahasrāṇyamprameyāṇi	Druvam-Acaritum daSa-kuSala-karmANi | caturaSIti-sahasrANi-amprameyANi
   śīlāṅgāni daśakuśaleṣveva śīleṣvantarbhavanti | santīmāni daśakuśalaśīlāni	SIla-aFgAni daSa-kuSalezu-eva SIlezu-antarBavanti | santi-imAni daSa-kuSala-SIlAni
   sarvakuśalaśīlamūlāni | prahāṇātkāyavākcittaśūbhānāṃ	sarva-kuSala-SIla-mUlAni | prahANAt-kAya-vAc-citta-SUBAnAm
   nirodhātsarvākuśaladharmāṇāmucyate śīlamiti ||	niroDAt-sarva-akuSala-DarmANAm-ucyate SIlam-iti ||
   8 | śīlaṃ paṃcavidham | prathamaṃ prātimokṣaśīlam | dvitīyaṃ	8 | SIlam paMcaviDam | praTamam prAtimokza-SIlam | dvitIyam
   dhyānasahacaraśīlam | tṛtīyamanāsravaśīlam | caturthamindriyadamanaśīlam |	DyAna-sahacara-SIlam | tRtIyam-anAsrava-SIlam | caturTam-indriya-damana-SIlam |
   paṃcamamavijñaptiśīlam | caturudīritajñaptikarmaṇopādhyādavāptamucyate	paMcamam-avijQapti-SIlam | catur-udIrita-jQapti-karmaNA-upADyAt-avAptam-ucyate
   prātimokṣaśīlam | caturmauladhyānacaturasamāpattidhyānamucyate dhyānaśīlam	prAtimokza-SIlam | catur-mOla-DyAna-catura-samApatti-DyAnam-ucyate DyAna-SIlam
   | maulacaturdhyānaprathamadhyānāsamāpattirucyate 'nāsravaśīlam |	| mOla-catuH-DyAna-praTama-DyAna-asam-ApattiH-ucyate anAsrava-SIlam |
   damannindriyāṇi vidadhāti samyaksmṛticittam | paśyañchṛṇvanbudhyañjānabrū	daman=-indriyANi vidaDAti samyak-smRti-cittam | paSyan-SRNvan-buDi-aQjAn-abrU
   paśabdagandharasaspraṣṭavyāni notpādayatyasaṃprajanyamityucyata	paSabda-ganDa-rasa-sprazwavyAni na-utpAdayati-asaMprajanyam-iti-ucyata
   indriyadamanaśīlam | utsṛjatyātmabhāvamanāgate 'dhvanyakartuṃ	indriya-damana-SIlam | utsRjati-Atma-BAvam-anAgate aDvanyakartum
   punaraśubhamityucyate 'vijñaptiśīlam|	punar-aSuBam-iti-ucyate avijQapti-SIlam|
   9 | bodhisattva ācarati śīlaṃ śrāvakapratyekabuddhāveṇikam |	9 | boDisattvaH Acarati SIlam SrAvaka-pratyekabudDa-AveNikam |
   aveṇikatvāducyate kuśalaśīlagrahaṇam | kuśalaśīlagrahaṇatvātkaroti	aveNika-tvAt-ucyate kuSala-SIla-grahaNam | kuSala-SIla-grahaNa-tvAt-karoti
   sarvasattvāṃllābhinaḥ gṛhṇan maitrīcittaśīlaṃ paritrāyate sukhayituṃ	sarva-sattvAn=-lABinaH gRhNan mEtrI-citta-SIlam paritrAyate suKayitum
   sattvān | gṛhṇan karuṇācittaśīlaṃ kṣamate sarvaduḥkhānyuddhartuṃ vipattiḥ	sattvAn | gRhNan karuNA-citta-SIlam kzamate sarva-duHKAni-udDartum vipattiH
   | gṛhṇanmuditācittaśīlaṃ nandatyakuśīdatvācca kuśalānyācarati |	| gRhNan-mudita-acitta-SIlam nandati-akuSIda-tvAt-ca kuSalAni-Acarati |
   gṛhṇannupekṣācittaśīlaṃ śavumitrayorbhavatiu samaḥ parihartuṃ rāgadveṣam |	gRhNan=-upekzA-citta-SIlam Savu-mitrayoH-Bavatiu samaH parihartum rAga-dvezam |
   gṛhṇāti dānaśīlaṃ śikṣayituṃ sāntvayituṃ ca sarvasattvāt | gṛhṇan	gRhNAti dAna-SIlam Sikzayitum sAntvayitum ca sarva-sattvAt | gRhNan
   kṣāntiśīlaṃ bhavati nityaṃ mṛducitto dveṣāvaraṇabaprahīṇatvāt |	kzAnti-SIlam Bavati nityam mRdu-cittaH dveza-AvaraNa-baprahINa-tvAt |
   gṛhṇanvīryaśīlaṃ vardhayati pratidinaṃ kuśalakarmāṇyapratinivartanāt |	gRhNan-vIrya-SIlam varDayati pratidinam kuSala-karmANi-apratinivartanAt |
   gṛhṇanśyānaśīlaṃ prajahāti rāgamakuśalaṃ vardhayitudhyānāṅḥāni | gṛhṇan	gRhNan-SyAna-SIlam prajahAti rAgam-akuSalam varDayitu-DyAna-aFHAni | gRhNan
   prajñāśīlaṃ bahu śṛṇoti kuśalamūlaṃ (tatprati) atṛpteḥ | gṛhṇāti	prajQA-SIlam bahu SRNoti kuSala-mUlam (tad-prati) atRpteH | gRhNAti
   kalyāṇamitrasaṃgrahaśīlaṃ paripūrayituṃ bodhimanuttaraṃ mārgam |	kalyANa-mitra-saMgraha-SIlam paripUrayitum boDim-anuttaram mArgam |
   gṛhṇātyakalyāṇabhitraparityāgaśīlaṃ parityaktuṃ trividhaṃ duścaritamaṣṭau	gRhNAti-akalyANa-Bitra-parityAga-SIlam parityaktum triviDam duScaritam-azwO
   bhayasthānānī ||	Baya-sTAnAnI ||
   10 | bodhisattvo gṛhṇanpariśuddhaśīlaṃ na pratiṣṭhito bhavati kāmadhātau	10 | boDisattvaH gRhNan-pariSudDa-SIlam na pratizWitaH Bavati kAmaDAtO
   na ca rūpadhātau nāpi ca pratiṣṭhito bhavatyarūpadhātāviti pariśuddhaśīlam	na ca rUpa-DAtO na-api ca pratizWitaH Bavati-arUpa-DAtO=-iti pariSudDa-SIlam
   | pariharati rāgarajāsyapanayati dveṣāvagṇaṃ niruṇaddhyavidyāvaraṇamiti	| pariharati rAgarajAsi-apanayati dveza-a=-agNam niruNadDi-avidyA-AvaraNam-iti
   pariśuddhaśīlam | parihārati dvāvantau śāśvatam cocchedaṃ	pariSudDa-SIlam | parihArati dvO=-antO SASvatam ca-ucCedam
   cāpratilaumahetupratyayeneti pariśuddhaśīlam| na spṛśati	ca-apratilOma-hetu-pratyayena-iti pariSudDa-SIlam| na spRSati
   rūpavedanāsaṃjñāsaṃskāravijñānāni prajñaptilakṣaṇānīti pariśuddhaśīlam |	rUpa-vedanA-saMjQA-saMskAra-vijQAnAni prajQapti-lakzaNAni-iti pariSudDa-SIlam |
   na badhnāti hetau notpādayati dṭaṣṭīrna pratiṣṭhāpayati vicikitsākaukṛtye	na baDnAti hetO na-utpAdayati dwazwIH-na pratizWApayati vicikitsA-kOkRtye
   iti pariśuddhaśīlam | na pratiṣṭhāpayati	iti pariSudDa-SIlam | na pratizWApayati
   rāgadveṣamohāstrīṇyakuśalamūlānīti pariśuddhaśīlam | na	rAga-dveza-moha-astrINi-akuSala-mUlAni-iti pariSudDa-SIlam | na
   pratiṣṭhāpayatyātmamānaṃ madamānamabhimānaṃ mānātimānaṃ mahāmānaṃ mṛduḥ	pratizWApayati-Atma-mAnam mada-mAnam-aBimAnam mAna-atimAnam mahAmAnam mRduH
   kuśalasnigdho bhavatīti pariśuddhaśīlam | neñjati	kuSala-snigDaH Bavati-iti pariSudDa-SIlam | na-iQjati
   lābhālābhanindāpraśaṃsāyaśo 'yaśasukhaduḥkheṣu nānulipyate lokasatye śūnye	lABa-AlABa-nindA-praSaMsA-yaSaH ayaSa-suKa-duHKezu na-anulipyate loka-satye SUnye
   prajñatau bhavati cānugataḥ paramārthasatyamiti pariśuddhaśīlam |	prajQatO Bavati ca-anugataH parama-arTa-satyam-iti pariSudDa-SIlam |
   akleśamaparitāpaṃ śāntaṃ vimuktilakṣaṇamidaṃśīlam | saṃkṣepata ucyate	akleSam-aparitApam SAntam vimukti-lakzaNam-idaMSIlam | saMkzepataH ucyate
   kāyajīvita nirapekṣo 'nityasaṃjñādarśanenotpādayati vairāgyaṃ sodyogaṃ	kAya-jIvita nirapekzaH anitya-saMjQA-darSanena-utpAdayati vErAgyam sa-udyogam
   kuśalamūlaṃ bhāvayannabhyutsāhena vīryamācaratīti pariśūddhaśīlam |	kuSala-mUlam BAvayan=-aByutsAhena vIryam-Acarati-iti pariSUdDa-SIlam |
   bodhisattvasya śīlamācarato na bhavati pariśūddhacittadṭaṣṭiḥ	boDisattvasya SIlam-AcarataH na Bavati pariSUdDa-cittadwazwiH
   saṃjñāvimuktihetoritīyaṃ śīlapāramitā ||	saMjQA-vimukti-hetoriti-iyam SIla-pAramitA ||
   (iti bodhicittātpādasuitraśāstre śīlapāramitā nāma paṃcamo vargaḥ ||)	(iti boDi-cittAt-pAda-suitra-SAstre SIlapAramitA nAma paMcamaH vargaH ||)
   ṣaṣṭho vargaḥ	zazWaH vargaH
   kṣāntipāramitā	kzAnti-pAramitA
   1 | bodhisattvaḥ kathamācarati kṣāntim | kṣāntirātmaparobhayalābhāya	1 | boDisattvaH kaTam-Acarati kzAntim | kzAntiH-Atma-paroBaya-lABAya
   cedevaṃvidhā kṣāntirniṣpādayati bodhimārgam | bodhisattvaḥ kāmayate	ced-evaMviDA kzAntiH-nizpAdayati boDi-mArgam | boDisattvaH kAmayate
   vinetuṃ sattvānaparhartuṃ duḥkhānyācarati tasmātkṣāntim |	vinetum sattvAn-aparhartum duHKAni-Acarati tasmAt-kzAntim |
   kṣāntimācarataścitaṃ vinītaṃ bhavati | sattvānāmupekṣate balavanmadamānaṃ	kzAntim-AcarataH-citam vinItam Bavati | sattvAnAm-upekzate balavat-mada-mAnam
   (svayaṃ) na cācarati | paśyantudvṛttānutpādayati karuṇām |	(svayan) na ca-Acarati | paSyantudvRttAn-utpAdayati karuNAm |
   mṛdulamudīrayandeśayati kuśalacaryām | vibhajya darśayati yo dvepo yā ca	mRdulam-udIrayan-deSayati kuSala-caryAm | viBajya darSayati yaH dvepaH yA ca
   kṣāntiryaśca tayorvipāka itīdaṃ bodhisattvasyādikṣānticittam ||	kzAntiH-yaH-ca tayoH-vipAkaH iti-idam boDisattvasya-AdikzAnti-cittam ||
   2 | kṣāntyācaraṇahetoḥ pāpakaṃ vidurī bhavati | kāyacittaṃ praśāntaṃ	2 | kzAnti-AcaraNa-hetoH pApakam vidurI Bavati | kAya-cittam praSAntam
   bhavatītyasyātmalābhaḥ | vinayati sattvānanuvartate sarvāniti paralābhaḥ |	Bavati-iti-asya-Atma-lABaH | vinayati sattvAn-anuvartate sarvAn-iti para-lABaH |
   caritvā mahatīmanuttarāṃ kṣānti sattveṣu pariṇāmyātmanā salābhinaḥ	caritvA mahatIm-anuttarAm kzAnti sattvezu pariNAmi-AtmanA sa-lABinaH
   karotītyubhayalābhaḥ | kṣānticaryāhetorlabhate janamataṃ yāvallabhate	karoti-iti-uBaya-lABaH | kzAnti-caryA-hetoH-laBate jana-matam yAvat-laBate
   buddhasya śobhanottamāni lakṣaṇānuvyañjanānīti niṣpādayati bodhimārgam ||	budDasya SoBana-uttamAni lakzaNa-anuvyaQjanAni-iti nizpAdayati boDi-mArgam ||
   3 | kṣāntistrividhā | tadyathā kāyakṣāntirvākkṣānti rmanaḥkṣāntiśceti | kā	3 | kzAntiH-triviDA | tat-yaTA kAya-kzAntiH-vAkkzAnti rmanaHkzAntiH-ca-iti | kA
   nāma kāyakṣāntiḥ | yadi kaścanākrośati nindati tāḍayati yāvatāharati	nAma kAya-kzAntiH | yadi kaScana-AkroSati nindati tAxayati yAvat-A-Aharati
   tatsarvaṃ kṣamate | paśyansattvānatrāṇe bhaye ca vyatiharati tairātmānaṃ	tat-sarvam kzamate | paSyan-sattva-anatrANe Baye ca vyatiharati tEH-AtmAnam
   na ca śrāmyatīti kāyakṣāntiḥ ||	na ca SrAmyati-iti kAya-kzAntiH ||
   4 | kā nāma vākkṣāntiḥ | ākrośakaṃ paśyanna pratyākrośati niḥśabdaṃ	4 | kA nAma vAc-kzAntiH | AkroSakam paSyan-na pratyAkroSati niHSabdam
   kṣamate | ākośakamakāraṇamapyupagataṃ vilokayanmadhurayā girā	kzamate | AkoSakamakAraNam-api-upagatam vilokayat-maDurayA girA
   sampratīcchati | mṛpaiva dūṣyamāṇo nirnimittamabhyākhyātaḥ sarvaṃ kṣamata	sampratIcCati | mRpA-eva dUzyamANaH nirnimittam-aByAKyAtaH sarvam kzamata
   iti vākkṣāntiḥ ||	iti vAc-kzAntiH ||
   5 | kā nāma manaḥkṣānti | dveṣiṇamavalokayannodgṛhṇāti dvepacitaṃ kopito	5 | kAH nAma manaH-kzAnti | dveziNam-avalokayat-na-udgRhNAti dvepa-citam kopitaH-
   na vikarotyātmacittam | nindāpakīrtiṣvati citte bhavati nivaira iti	na vikaroti-Atma-cittam | nindA-apakIrtizu-ati citte Bavati nivEraH iti
   manaḥkṣānti ||	manaH-kzAnti ||
   6 | tāḍitaṃ jagati dvividham | ucitamanucittaṃ ca | satyaparādhe	6 | tAxitam jagati dviviDam | ucitam-anucittam ca | satya-parADe
   saṃdihānena kena cijjanena tāḍitaḥ	saMdiha-anena kena cit-janena tAxitaH
   kṣametāmṛtamivodgṛhṇīyādādaramutpādayettāḍayitari | kasmāt | sādhu śīlaṃ	kzameta-amRtam-iva-udgRhNIyAt-Adaram-utpAdayet-tAxayitari | kasmAt | sADu SIlam
   śikṣayanmāṃ cikitsati pāpādapanayati | yadyanucitameva māmapakaroti	Sikzayat-mAm cikitsati pApAt-apanayati | yadi-anucitam-eva mAm-apakaroti
   māmapahanti tadā cintayenna kṛto mayāparādho 'tītakarmaṇāmevaitatkāritaṃ	mAm-apahanti tadA cintayet-na kRtaH mayA-aparADaH atIta-karmaNAm-eva-etat-kAritam
   tena soḍhavyameca | punarevaṃ vibhāvayedyatvāri bhūtānīmāni	tena soXavyam-eca | punar-evam viBAvayet-yatvAri BUtAni-imAni
   pañcaskaṃghapratyayairabhisaṃhatāni yāni tāḍayante tāḍayanti ca |	paQca-skaMGa-pratyayEH-aBisaMhatAni yAni tAxayante tAxayanti ca |
   punarevaṃ paśyedyatsa puruṣo 'jña ivonmatta iveti mayā karuṇāyitavyaṃ	punar-evam paSyet-yat-sa puruzaH ajQaH iva-unmattaH iva-iti mayA karuNAyitavyam
   kimuta na kṣantavyam ||	kim-uta na kzantavyam ||
   7 | ākrośo dvividhaḥ | ucito 'nucitaśca | ucitamuktaṃ cenmayāpatraptavyam	7 | AkroSaH dviviDaH | ucitaH anucitaH-ca | ucitam-uktam ced-mayA-apatraptavyam
   | anucitamuktaṃ cenmavā na kiṃcidapi kartavyam | dhavaniriva vāyuriva	| anucitam-uktam ced-mavA na kiMcid-api kartavyam | Dava-niH-iva vAyuH-iva
   cātigacchannāpakaroti māmiti soḍhavyam | dviṣṭo 'pyevameva soḍhavyaḥ |	ca-atigacCat-na-apakaroti mAm-iti soXavyam | dvizwaH api-evam-eva soXavyaH |
   kupito mayi mayā soḍhavyaḥ | ahaṃ cettaṃ pratikupyeyaṃ	kupitaH mayi mayA soXavyaH | aham ced-tam pratikupyeyam
   durgatimadhigaccheyamanāgate 'dhvani vedayeyaṃ mahāduḥkham |	durgatim-aDigacCeyam-anAgate aDvani vedayeyam mahA-duHKam |
   pratyayairebhirmama kāyaścedbhidyeta viśīryeta mayā notpādanīyo dvepaḥ |	pratyayEH-eBiH-mama kAyaH-ced-Bidyeta viSIryeta mayA na-utpAdanIyaH dvepaH |
   pratyayānāmatītakarmaṇāmetaditi gambhīraṃ pratyavekṣaṇīyam karūṇācaraṇīyā	pratyayAnAm-atIta-karmaNAm-etat-iti gamBIram pratyavekzaNIyam karUNa-AcaraNIyA
   maitrī ca | karuṇāyitavyaṃ sarveṣu | yadyehaṃ na prabhavāmyevamalpamapi	mEtrI ca | karuNAyitavyam sarvezu | yadyeham na praBavAmi-evam-alpam-api
   duḥkhaṃ soḍhuṃ na ca śaknomi damayituṃ svacittaṃ tatkathamahaṃ	duHKam soXum na ca Saknomi damayitum sva-cittam tat-kaTam-aham
   prabhaviṣyāmi vinetuṃ sattvānvimocayituṃ	praBavizyAmi vinetum sattvAn-vimocayitum
   sarvānakuśaladharmānpūrayitumanuttaraṃ phalam ||	sarvAn-akuSala-DarmAn-pUrayitum-anuttaram Palam ||
   8 | yo hi dhīmānsukhena kṣāntimācarati labhate sa ākāravaiśiṣṭyam |	8 | yaH hi DImAn-suKena kzAntim-Acarati laBate saH AkAra-vESizwyam |
   bahudhanau bhavati janāstamavalokya muditā bhavanti sukhitāśca bhavanti	bahu-DanO Bavati janAH-tam-avalokya muditAH Bavanti suKitAH-ca Bavanti
   sukhitāśca bhavanti mānayantyanu vartante ca | puruṣaṃ cedvikalāṅgaṃ	suKitAH-ca Bavanti mAnayanti-anu vartante ca | puruzam ced-vikala-aFgam
   paśyedvībhatsadarśanaṃ vikalendriyamakiñcanaṃ jāniyāttadidaṃ	paSyet-vIBatsa-darSanam vikala-indriyam-akiQcanam jAniyAt-tat-idam
   dvepapratyayaiḥ kāritam | ebhiḥ pratyayai dhīṃmānācaredgambhīrāṃ kṣāntim	dvepa-pratyayEH kAritam | eBiH pratyayE DIMmAn-a-Acaret-gamBIrAm kzAntim
   9 | kṣāntyutpādapratyayasya santīmāni daśa vastūni | ātmani nātmalakṣaṇaṃ	9 | kzAnti-utpAda-pratyayasya santi-imAni daSa vastUni | Atmani na-Atma-lakzaNam
   paśyatīti prathamam | na jātimedaṃ manasi karotīti dvitīyam |	paSyati-iti praTamam | na jAti-medam manasi karoti-iti dvitIyam |
   pratinivartate madamānāditi tṛtīyam | apakurvantaṃ na pratyayakarotīti	pratinivartate madamAnAt-iti tRtIyam | apakurvantam na pratyaya-karoti-iti
   caturtham | anityalakṣaṇaṃ paśyatīti paṃcamam | maitrī karuṇā cācaratīti	caturTam | anitya-lakzaNam paSyati-iti paMcamam | mEtrI karuNA ca-Acarati-iti
   ṣaṣṭham | na cittena pramādyatīti sanamam | upekṣate	zazWam | na cittena pramAdyati-iti sa-namam | upekzate
   kṣutpipāsāduḥkhaduḥkhādīnītyaṣṭamam | dvepaṃ prajahātīti navamam | prajñā	kzuD-pipAsA-duHKa-duHKa-AdIni-iti-azwamam | dvepam prajahAti-iti navamam | prajQA
   bhāvayatīti daśamam | puruṣaścedimāni pūrayati daśa vastṛmi jñātavyaṃ	BAvayati-iti daSamam | puruzaH-ced-imAni pUrayati daSa vastRmi jQAtavyam
   śaknoti sa puruṣaḥ kṣāntimācaritum ||	Saknoti sa puruzaH kzAntim-Acaritum ||
   10 | bodhisattvo mahāsattvaḥ pariśuddhāyāṃ yadācarati caramāyāṃ kṣāntau	10 | boDisattvaH mahAsattvaH pariSudDAyAm yat-Acarati caramAyAm kzAntO
   praviśate śūnyatāmalakṣaṇamapraṇihitamasaṃskṛtam | na ca	praviSate SUnyatAm-alakzaNam-apraNihitam-asaMskRtam | na ca
   dṭaṣṭijñānapraṇihitasaṃskṛtaiḥ saṃpariṣvakto bhavati nāpi ca	dwazwi-jQAna-praNihita-saMskRtEH saMparizvaktaH Bavati na-api ca
   śūnyatālakṣaṇāpraṇihitāsaṃskṛteṣu rajyati | dṛṣṭijñānapraṇihitasaṃskṛtaṃ	SUnyatA-lakzaNa-apraNihita-asaMskRtezu rajyati | dRzwi-jQAna-praNihita-saMskRtam
   sarvamevaśūnyamityevaṃvidhā kṣāntiradvayalakṣaṇā pariśuddhā caramā	sarvam-eva-SUnyam-iti-evaMviDA kzAntiH-advaya-lakzaNA pariSudDA caramA
   kṣāntirityucyate |	kzAntiH-iti-ucyate |
   yadi viśati saṃyojanaparikṣayaṃ yadi viśati śāntaṃ	yadi viSati saMyojana-parikzayam yadi viSati SAntam
   nirvāṇamasaṃpṛktajātimaraṇaṃ na cāsya rāgo bhavati saṃyojanakṣaye na ca	nirvANam-asaMpRkta-jAti-maraNam na ca-asya rAgaH Bavati saMyojana-kzaye na ca
   śānte na nirvāṇe | saṃyojanajātijarāmaraṇaṃ sarvaṃ śūnyamityevaṃvidhā	SAnte na nirvANe | saMyojana-jAti-jarA-maraNam sarvam SUnyam-iti-evaMviDA
   kṣāntiradvayalakṣaṇā pariśuddhā caramā kṣāntirityucyate |	kzAntiH-advaya-lakzaNA pariSudDA caramA kzAntiH-iti-ucyate |
   bhāvo na svato jāyate na parato jāyate na dvābhyāṃ jāyate | api ca	BAvaH na svatas jAyate na paratas jAyate na dvAByAm jAyate | api ca
   nāstyupādo na cocchedo na ca vināśo na cāvināśo na kṣaya ityevaṃvidhā	na-asti-upAdaH na ca-ucCedaH na ca vinASaH na ca-avinASaH na kzayaH iti-evaMviDA
   kṣāntiradvayalakṣaṇā pariśuddhā caramā kṣāntirityucyate |	kzAntiH-advaya-lakzaNA pariSudDA caramA kzAntiH-iti-ucyate |
   na kṛtākṛtaṃ nāsaṃgo na bhedo na niṣpattirna caryā notpādavīryaṃ na	na kRta-akRtam na-asaMgaH na BedaH na nizpattiH-na caryA na-utpAda-vIryam na
   karaṇotpāda ityevaṃvidhā kṣāntiranutpādakṣāntiḥ | bodhisattvo	karaNa-utpAdaH iti-evaMviDA kzAntiH-anutpAda-kza-antiH | boDisattvaH-
   yadācaratyevaṃvidhāṃ kṣānti labhate vyākaraṇakṣāntim | bodhisattva ācarati	yat-Acarati-evaMviDAm kzAnti laBate vyAkaraNa-kzAntim | boDisattvaH Acarati
   kṣāntiṃ bhāvalakṣaṇaśūnyatāṃ sattvābhāvahetaustataḥ pūrayāte	kzAntim BAva-lakzaNa-SUnyatAm sattva-aBAva-hetOH-tatas pUrayAte
   kṣāntipāramitām ||	kzAnti-pAramitAm ||
   (iti bodhicittotpādasūtraśāstre kṣāntipāramitā māna ṣaṣṭho vargaḥ ||)	(iti boDi-citta-utpAda-sUtra-SAstre kzAnti-pAramitA mAna zazWaH vargaH ||)
   saptamo vargaḥ	saptamaH vargaH
   vīryapāramitā	vIrya-pAramitA
   1 | bodhisattvaḥ kathamācarati vīryam |	1 | boDisattvaH kaTam-Acarati vIryam |
   vīryamātmaparobhayalābhāyacedevaṃvidhaṃ vīryaṃ niṣpādayati bodhimārgam |	vIryam-Atma-paroBaya-lABAyaced-evaMviDam vIryam nizpAdayati boDi-mArgam |
   bodhisattvaḥ kāmayate vinetuṃ sattvānāparhatuṃ duḥkhānyācarati	boDisattvaH kAmayate vinetum sattvAnAparhatum duHKAni-Acarati
   tasmādvīryam | vīryamācaransarvādhvasu sarvadotsāhacaryayā saṃgṛhṇāti	tasmAt-vIryam | vIryam-Acaran-sarva-aDvasu sarvadA-utsAha-caryayA saMgRhNAti
   pariśūddhaṃ brahmacaryaṃ pariharati kausīdyaṃ na ca cittena pramādyati |	pariSUdDam brahmacaryam pariharati kOsIdyam na ca cittena pramAdyati |
   kṛcchreṣvahitāpakṣavastuṣu sarvadāsya vīryavattayā cittaṃ nāntataḥ	kRcCrezu-ahitA-pakza-vastuzu sarvadA-asya vIryavat-tayA cittam na-antatas-
   pratyāvartata iti bodhisattvasyādi vīryacittam ||	pratyAvartate iti boDisattvasya-Adi vIrya-cittam ||
   2 | vīryācaraṇena labhate lokacaraṃ lokottaramanuttaraṃ	2 | vIrya-AcaraNena laBate loka-caram lokottaram-anuttaram
   saddharmamityasyātmalābhaḥ | śikṣayati sattvānyenācaraṃtyabhyutsāhena	sadDarmam-iti-asya-Atma-lABaH | Sikzayati sattvAnyena-AcaraMti-aByutsAhena
   kuśalamiti paralābhaḥ | caritvā bodheḥ samyaghetuṃ sattveṣu pariṇāmyātmanā	kuSalam-iti para-lABaH | caritvA boDeH samyak-etum sattvezu pariNAmi-AtmanA
   salābhinaḥ karotītyubhayalābhaḥ | vīryacaryāhetorlabhate paramapariśuddhaṃ	sa-lABinaH karoti-iti-uBaya-lABaH | vIrya-caryA-hetoH-laBate parama-pariSudDam
   satphalamatikramya ca bhūmī ryāvacchīghraṃ pūrayati sambodhimiti	sat-Palam-atikramya ca BUmiH ryAvat-SIGram pUrayati samboDim-iti
   niṣpādayati bodhimārgam ||	nizpAdayati boDi-mArgam ||
   3 | vīryaṃ dvividham | gavepayatyanuttaraṃ mārgamiti prathamam |	3 | vIryam dviviDam | gavepayati-anuttaram mArgam-iti praTamam |
   paritrātuṃ duḥkhādvipulābhilāpeṇa vīryaṃ janayatīti dvitīyam |	paritrAtum duHKAt-vipula-aBilApeNa vIryam janayati-iti dvitIyam |
   pūrayanbodhisattvo daśānusmṛtīrutpādayati bodhicittam | ācarati vīryam |	pUrayan-boDisattvaH daSa-anusmRtIH-utpAdayati boDi-cittam | Acarati vIryam |
   kā daśānusmṛtayaḥ | prathamā buddhānusmṛtiraprameyapuṇyā | dvitīyā	kA daSa-anusmRtayaH | praTamA budDa-anusmRtiH-aprameya-puNyA | dvitIyA
   dharmānusmṛtiracintyavimuktiḥ | tṛtīyā saṃghānusmṛtiḥ pariśuddhatayā	Darma-anusmRtiH-acintya-vimuktiH | tRtIyA saMGa-anusmRtiH pariSudDa-tayA
   niṣkalaṃkā | caturthī mahāmaitryanusmṛtiḥ sattvavyavasthāpanāya |	nizkalaMkA | caturTI mahA-mEtrI-anusmRtiH sattva-vyavasTApanAya |
   paṃcamīmahākaruṇānusmṛtirduḥkhataḥ paritrāṇāya | ṣaṣṭhī	paMcamI-mahA-karuNa-anusmRtiH-duHKataH paritrANAya | zazWI
   samyaksamādhiskandhānusmṛtiranurocayituṃ kuśalācaraṇāya | saptamī	samyak-samADi-skanDa-anusmRtiH-anurocayitum kuSala-AcaraNAya | saptamI
   mithyāsamādhiskandhānusmṛtiruddhartuṃ (sattvān kuśala-)mūlaṃ	miTyA-samADi-skanDa-anusmRtiH-udDartum (sattvAn kuSala-)mUlam
   pratyānayanaya | aṣṭamī pretānusmṛtiḥ kṣutpipāsoṣṇatākleśamayī | navamī	pratyAnayanayaH | azwamI preta-anusmRtiH kzuD-pipAsA-uzNa-tA-kleSa-mayI | navamI
   tiryaganusmṛti dīrghaduḥkhavedanātmikā | daśamī	tiryak-anusmRti dIrGa-duHKa-vedanA-AtmikA | daSamI
   narakānusmṛtirdāhanabharjanavedanātmikā | bodhisattva evaṃ bhāvayati	naraka-anusmRtiH-dAhana-Barjana-vedanA-AtmikA | boDisattvaH evam BAvayati
   daśānusmṛtīstriratnapuṇyāni | bhāvayeyamahaṃ samyaksamādhi maitrī karuṇāṃ	daSa-anusmRtIH-tri-ratna-puNyAni | BAvayeyam-aham samyak-samADi mEtrI karuNAm
   (tatra) sattvānārocayeyamahaṃ mṛṣā dhyāyatastridurgatiduḥkhāduddhareyaṃ	(tatra) sattvAnArocayeyam-aham mRzA DyAyataH-tridurgati-duHKAt-udDareyam
   nityamahaṃ parirakṣayeyamityevaṃ cintayati | saṃcintayannavikṣitaṃ	nityam-aham parirakzayeyam-iti-evam cintayati | saMcintayan=-avikzitam
   divānaktaṃ bhāvayati sotsāhaṃ na ca viśrāmyatīti samyaksmṛtitā vīryaṃ	divAnaktam BAvayati sa-utsAham na ca viSrAmyati-iti samyak-smRti-tA vIryam
   samudeti ||	samudeti ||
   4 | vīryaṃ puna rbodhisattvasya caturvidham | tathāhi |	4 | vIryam puna rboDisattvasya caturviDam | taTA-hi |
   catuḥsamyakpradhāna [prahāṇa]mārgamācarato 'nutpannānāmakuśalānāṃ	catur-samyak-praDAnaH [prahANa]-mArgam-AcarataH anutpannAnAm-akuSalAnAm
   dharmāṇāṃ punaranutpādaḥ | utpannānāṃ punarakuśalānāṃ dharmāṇāṃ śīghraṃ	DarmANAm punar-anutpAdaH | utpannAnAm punar-akuSalAnAm DarmANAm SIGram
   samprahāṇam | anutpannānāṃ kuśalānāṃ dharmāṇāmupāyena samutpādaḥ |	samprahANam | anutpannAnAm kuSalAnAm DarmANAm-upAyena samutpAdaH |
   utpannānāṃ kuśalānāṃ dharmāṇāṃ paripūraṇaṃ saṃvarddhanaṃ ca | evaṃ	utpannAnAm kuSalAnAm DarmANAm paripUraNam saMvardDanam ca | evam
   bodhisattva ācarati catvāri samyakpradhānāni na ca viśrāmyatītyucyate	boDisattvaH Acarati catvAri samyak-praDAnAni na ca viSrAmyati-iti-ucyate
   vīryam |	vIryam |
   5 | vīryaṃ kṣapayati sarvakleśadhātūnsampravardhayati bodheranuttarāyāḥ	5 | vIryam kzapayati sarva-kleSa-DAtUn-sampravarDayati boDeH-anuttarAyAH
   samyaghetum | kāyacittamahāduḥkhānyakhilānyapi sahamāno bodhisattvo	samyak-etum | kAya-citta-mahA-duHKAni-aKilAni-api sahamAnaH boDisattvaH-
   'vasthāpayitumamilapati sattvānna ca viśrāmyatītyucyate vīryam ||	avasTApayitum-amilapati sattvAt-na ca viSrAmyati-iti-ucyate vIryam ||
   6 | bodhisattvaḥ vigatakalmapo 'cāṭukuṭilaḥ paryavasitamithyāvīrya ācarati	6 | boDisattvaH vigata-kalmapaH acAwu-kuwilaH paryavasita-miTyA-vIryaH Acarati
   samyagvīryam | tathāhi | ācarati śraddhāṃ dānaṃ śīlaṃ kṣāntiṃ dhyānaṃ	samyak-vIryam | taTA-hi | Acarati SradDAm dAnam SIlam kzAntim DyAnam
   prajñāṃ maitrī karuṇāṃ muditāmupekṣām | sābhilāṣaṃ karogyakaravaṃ	prajQAm mEtrI karuNAm muditAm-upekzAm | sa-aBilAzam karogya-karavam
   kariṣyāmīti viśvastacittaḥ sarvadācarati vīryam | nānutāpo 'sya	karizyAmi-iti viSvasta-cittaH sarvadA-Acarati vIryam | na-anutApaH asya
   kuśaladharmeṣu | pradīptaśira iva paritrāyate sattvānna ca cittaṃ	kuSala-Darmezu | pradIpta-SiraH iva paritrAyate sattvAt-na ca cittam
   parāvartayatītyucyate vīryam ||	parAvartayati-iti-ucyate vIryam ||
   7 | kāyajīvitanirapekṣo 'pi bodhisattvaḥ paritrātuṃ (sattvān) duḥkhebhyaḥ	7 | kAya-jIvita-nirapekzaH api boDisattvaH paritrAtum (sattvAn) duHKeByaH
   paripālayatuṃ saddharmaṃ kāyamapekṣate nopekṣata īryāpathaṃ sarvadā	paripAlayatum sadDarmam kAyam-apekzate na-upekzate IryA-paTam sarvadA
   bhāvayituṃ kuśaladharmān | kuśaladharmācaraṇakāle na cittena kusīdo	BAvayitum kuSala-DarmAn | kuSala-Darma-AcaraNa-kAle na cittena kusIdaH-
   bhavati | kāyajīvitavidhāte 'pi dharmaṃ na parityajatīti bodhisattvo	Bavati | kAya-jIvita-viDAte api Darmam na parityajati-iti boDisattvaH-
   bodhimārgaṃ caransotsāhamācarati vīryam | kusīdaḥ puruṣo 'samartho	boDi-mArgam caran-sa-utsAham-Acarati vIryam | kusIdaH puruzaH asamarTaH-
   naikakālaṃ sarvaṃ dadāti na ca śīlamudgṛṇāyi na ca kṣamate duḥkhāni na	na-eka-kAlam sarvam dadAti na ca SIlam-udgRNAyi na ca kzamate duHKAni na
   cācaratyabhyutsāhena vīryam | na ca samādhau smṛtisaṃprajanyacitto bhavati	ca-Acarati-aByutsAhena vIryam | na ca samADO smRti-saMprajanya-cittaH Bavati
   na ca kuśalākuśalaṃ vivinakti | tenocyate dhīryamupādāya ṣaṭpāramitāḥ	na ca kuSala-akuSalam vivinakti | tena-ucyate DIryam-upAdAya zaz-pAramitAH
   saṃpravardhanta iti | bodhisattvo mahāsattvaḥ saṃpravardhayati ced vīryaṃ	saMpravarDante iti | boDisattvaH mahAsattvaH saMpravarDayati ced vIryam
   labhate 'cirāt samyaksaṃvodhim ||	laBate acirAt samyak-saMvoDim ||
   8 | bodhisattvo mahāniṣpattyutpādena punaścaturvidhaṃ vīryaṃ janayati |	8 | boDisattvaH mahA-nizpatti-utpAdena punar-caturviDam vIryam janayati |
   tanna prathamamutpādayati mahāniṣpattiṃ dvitīyaṃ saṃgṛhṇāti śūraṃgamaṃ	tat-na praTamam-utpAdayati mahAnizpattim dvitIyam saMgRhNAti SUraMgamam
   tṛtīyamācarati kuśalamūlaṃ caturthaṃ vinayati sattvān | kathaṃ	tRtIyam-Acarati kuSala-mUlam caturTam vinayati sattvAn | kaTam
   bodhisattvomahāniṣpattimutpādayati | jātimaraṇeṣu kṣamate 'sya cittaṃ na	boDisattvaH-mahA-nizpattim-utpAdayati | jAti-maraNezu kzamate asya cittam na
   ca gaṇayati kalpasaṃkhyāmaprameyeṣvaparyanteṣu	ca gaNayati kalpa-saMKyAm-aprameyezu-aparyantezu
   niyutakoṭiśatasahasragaṃgānadībālukāvadasaṃkhyeyeṣu kalpeṣu	niyuta-kowi-Sata-sahasra-gaMgA-nadI-bAlukA-vada-saMKyeyezu kalpezu
   buddhamārgamudgrahīṣyāmyaklāntacitta ityakusīdasya [mahā]niṣpattivīryam |	budDa-mArgam-udgrahIzyAmi-aklAnta-cittaH iti-akusIdasya [mahA]-nizpatti-vIryam |
   bodhisattvaḥ saṃgṛhṇañchūraṃgamaṃ janayati vīryam trisāhasramahāsāhasro	boDisattvaH saMgRhNan-SUraMgamam janayati vIryam tri-sAhasra-mahA-sAhasraH-
   'yaṃ lokadhātuḥ paripūrṇo 'nnineti draṣṭuṃ buddhaṃ śrotuṃ dharma	ayam lokaDAtuH paripUrNaH anninA-iti drazwum budDam Srotum Darma
   sthāpayituṃ sattvānkuśaladharmeṣvatikrāmatyetamagniṃ vinetuṃ sattvān	sTApayitum sattvAn-kuSala-Darmezu-atikrAmati-etam-agnim vinetum sattvAn
   saṃpratiṣṭhāpayati cittaṃ mahākaruṇāyāmiti śūraṃgamavīryam | bodhisattva	saMpratizWApayati cittam mahA-karuNAyAm-iti SUraMgama-vIryam | boDisattva
   ācarankuśalaṃmūlaṃ janayati vīryam | utpāditāni sarvāṇi kuśalamūlāni	Acaran-kuSalaMmUlam janayati vIryam | utpAditAni sarvANi kuSala-mUlAni
   pariṇāmayatyanuttarāyāṃ samyaksaṃbodhau paripūrayituṃ sarvajñatāmiti	pariNAmayati-anuttarAyAm samyaksaMboDO paripUrayitum sarvajQa-tAm-iti
   kuśalamūlācaraṇavīryam | bodhisattvaḥ vinayansattvāñjanayati vīryam |	kuSala-mUla-AcaraNa-vIryam | boDisattvaH vinayan-sattvAn-janayati vIryam |
   aprameyāḥ sattvabhāvā aparyantā ākāśadhātusamā aparisaṃkhyeyāḥ |	aprameyAH sattva-BAvAH aparyantAH AkASa-DAtu-samAH aparisaMKyeyAH |
   bodhisattvaḥ praṇidadhāti yannirvāpayitavyānte yathā na kaścanāvaśiṣyate |	boDisattvaH praNidaDAti yat-nirvApayitavyAnte yaTA na kaScana-avaSizyate |
   nirvāpayituṃ sotsāhamācarati vīryamiti [sattva-]vinayavīryam ||	nirvApayitum sa-utsAham-Acarati vIryam-iti [sattva--]vinaya-vIryam ||
   9 | saṃkṣepata ucyate | bodhisattvo bhāvayati mārgasahāyāṃ	9 | saMkzepataH ucyate | boDisattvaH BAvayati mArga-sahAyAm
   puṇyasahāyāmanuttarāṃ prajñām | saṃgṛhṇanbuddhadharmānutpādayati vīryam |	puNya-sahAyAm-anuttarAm prajQAm | saMgRhNan-budDa-DarmAn-utpAdayati vIryam |
   aparyantā buddhaguṇāaprameyāḥ | bodhisattvasya mahāsattvasya	aparyantAH budDa-guNAa-prameyAH | boDisattvasya mahAsattvasya
   mahāniṣpatyutpādena janitaṃ vīryamapyeṣamaparyantamaprameyam | bodhisattvo	mahAnizpati-utpAdena janitam vIryam-api-ezam-aparyantam-aprameyam | boDisattvaH-
   mahāsattvo vīryamācarannaviraktacittobhavatyuddhartuṃ duḥkhānīti pūrayati	mahAsattvaH vIryam-Acaran=-avirakta-cittoBavati-udDartum duHKAni-iti pUrayati
   vīryapāramitām ||	vIrya-pAramitAm ||
   (iti bodhicittotpādasūtraśāstre vīryapāramitā māna saptamo vargaḥ ||)	(iti boDi-citta-utpAda-sUtra-SAstre vIrya-pAramitA mAna saptamaH vargaH ||)
   aṣṭamo vargaḥ	azwamaH vargaH
   dhyāmapāramiatā	DyAma-pAramiatA
   1 | bodhisattvaḥ kathamāvarati dhyānam | dhyānamātmaparobhayalābhāya	1 | boDisattvaH kaTam-Avarati DyAnam | DyAnam-Atma-paroBaya-lABAya
   cedevaṃvidhaṃ dhyānaṃ niṣpādyati bodhimārgam | bodhisattvaḥ kāmayate	ced-evaMviDam DyAnam nizpAdyati boDi-mArgam | boDisattvaH kAmayate
   vinetuṃ sattvānaparhatuṃ duḥkhānyacarati tasmāddhyānam | yogāvacaraḥ	vinetum sattvAn-aparhatum duHKAni-acarati tasmAt-DyAnam | yoga-avacaraH
   svacittaṃ saṃgṛhṇan sarvavikṣepaikhyavahito gacchantiṣṭhanniṣīdañchayāno	sva-cittam saMgRhNan sarva-vikzepa-eKya-vahitaH gacCan-tizWat-nizIdan-SayAnaH-
   vā smṛtimabhimukhīmupasthāpayati | paśyatyanulobhaṃ pratilobhaṃ kapālaṃ	vA smRtim-aBimuKIm-upasTApayati | paSyati-anuloBam pratiloBam kapAlam
   śīrṣa kaśerukāṃ bāhkurparamuraḥ parśakāṃ śroṇi kaṭaṃ jānvadharaṃ guṇau |	SIrza kaSerukAm bAhkurparamuraH parSakAm SroNi kawam jAnu-aDaram guNO |
   anusmaratyānapānamiti bodhisattvasyādidhyānacittam ||	anusmaratyAnapAnam-iti boDisattvasya-Adi-DyAna-cittam ||
   2 | dhyānacaryāhetorna prāpnotyakuśalāni sadāsya nandati	2 | DyAna-caryA-hetoH-na prApnoti-akuSalAni sadA-asya nandati
   cittamityasyātmalābhaḥ | vinayansattvānācārayati samyaksmṛtimiti	cittam-iti-asya-Atma-lABaH | vinayan-sattvAn-AcArayati samyak-smRtim-iti
   paralābhaḥ | caritvā pariśuddhaṃ samādhiṃ vītākuśalavitarkavicāraḥ	para-lABaH | caritvA pariSudDam samADim vIta-akuSala-vitarka-vicAraH
   sattveṣu pariṇāmyātmanā salābhinaḥ karotītyubhayalābhaḥ | dhyānacaryā	sattvezu pariNAmi-AtmanA sa-lABinaH karoti-iti-uBaya-lABaH | DyAna-caryA
   hetorlabhate 'ṣṭau vimokṣānyāvacchraraṃgamavajasamādhimiti niṣpādayati	hetoH-laBate azwO vimokzAn-yAvat-SraraMgam-avaja-samADim-iti nizpAdayati
   bodhimārgam ||	boDi-mArgam ||
   3 | dhyānaṃ tribhirdharmairupajāyate | ke vayaḥ | prathamaḥ śrutamayī	3 | DyAnam triBiH-DarmEH-upajAyate | ke vayaH | praTamaH Sruta-mayI
   prajñā | dvitīyaścintāmayī prajñā | tṛtīyo bhāvanāmayī prajñā |	prajQA | dvitIyaH-cintA-mayI prajQA | tRtIyaH BAvanA-mayI prajQA |
   tribhirebhirdharmaiḥ krameṇopajāyante sarvasamādhayaḥ ||	triBiH-eBiH-DarmEH krameNa-upajAyante sarva-samADayaH ||
   4 | kā nāma śrutamayī prajñā | yathā yathā dharmāñcaṇoti tathā tathasya	4 | kA nAma Sruta-mayI prajQA | yaTA yaTA DarmAQcaNoti taTA taTasya
   cittṃ prītaṃ bhavati sukhitam | punarevamanusmarati	cittm prItam Bavati suKitam | punar-evam-anusmarati
   santyānantaryavimokṣādayo buddhadharmāḥ | ime dharmā bahuśratenāvāpyante |	santi-Anantarya-vimokza-AdayaH budDa-DarmAH | ime DarmAH bahu-Sratena-avApyante |
   evamanusmmṛtya sarvadā dharmagaveṣaṇākāle 'syottarottasmutsāhaḥ	evam-anusmmRtya sarvadA Darma-gavezaNA-kAle asya-uttara-utta-smutsAhaH
   saṃpravardhate 'horātraṃ dharmaśravaṇe 'syābhirucirbhavati na ca	saMpravarDate ahorAtram Darma-SravaNe asya-aBiruciH-Bavati na ca
   klāntirnāpyasyatuptiriti śrutamayī prajñā |	klAntiH-na-api-asi-atuptiH-iti Sruta-mayI prajQA |
   5 | kā nāma cintāmayī prajñā | cintayati sarve	5 | kA nAma cintA-mayI prajQA | cintayati sarve
   saṃskṛtadharmāstathatālakṣaṇāḥ | tathā hi | anityā duḥkhāḥ śūnyā anātmāno	saMskRta-DarmAH-taTatA-lakzaNAH | taTA hi | anityAH duHKAH SUnyAH anAtmAnaH-
   'śucayaḥ kṣaṇaṃ kṣaṇamutpadyante nirudhyante 'ciraṃ pamohāgninā jvalitāḥ	aSucayaH kzaNam kzaNam-utpadyante niruDyante aciram pamoha-agninA jvalitAH
   saṃvarddhayanti paścimaṃ duḥkhamahāskandham | māyāvanmṛṣeva bhāgha it	saMvardDayanti paScimam duHKa-mahA-skanDam | mAyAvat-mRzA-iva BAGaH it
   sarveṣu saṃskṛtadharmeṣu janayati saṃvegam | samadhikotsāhaṃ gacchati	sarvezu saMskRta-Darmezu janayati saMvegam | samaDika-utsAham gacCati
   buddhaprajñām | cinayati yattathāgatāprajñācintyāparimeyā mahābalāparājitā	budDa-prajQAm | cinayati yat-taTAgata-aprajQA-acintyA-parimeyA mahA-bala-aparAjitA
   prāptāpagatabhayasparśāṃ mahānagarī na ca punarāvartate duḥkhebhyo	prApta-apagata-Baya-sparSAm mahA-nagarI na ca punar-Avartate duHKeByaH-
   'prameyebhyaḥ sattvānaparitrāyate | evaṃ jānāti buddhasyāprameyāṃ praḥyāṃ	aprameyeByaH sattvAn-aparitrAyate | evam jAnAti budDasya-aprameyAm praHyAM
   paśyati saṃskṛtadharmāṇāmaparimeyadu| kāmayate gaveṣayitumanuttaraṃ	paSyati saMskRta-DarmANAm-aparimeya-du| kAmayate gavezayitum-anuttaram
   mahāyānamiti cintāmayī pajñā ||	mahAyAnam-iti cintA-mayI pajQAH ||
   6 | kā nāma bhāvanāmayī prajñetyucyate | tyajati rāgamakuśalāṃśca dharmān	6 | kA nAma BAvanA-mayI prajQA-iti-ucyate | tyajati rAgam-akuSalAn=-ca DarmAn
   | tenopajāyante 'sya vitarkavicāraprītisukhāni viśati prathamaṃ dhyānam |	| tena-upajAyante asya vitarka-vicAra-prIti-suKAni viSati praTamam DyAnam |
   kṣapayato vitarkavicāran prasannabhyantarastaikāgracittasyāvitarkavicāraḥ	kzapayataH vitarka-vicAran prasanna-ByantaraH-ta-ekAgra-cittasya-avitarka-vicAraH
   samādhirasyopajāyate saprīti śukhaṃ viśati dvitīyaṃ dhyānam | prīti	samADiH-asya-upajAyate sa-prIti SuKam viSati dvitIyam DyAnam | prIti
   parityajyopekṣāsaṃskāravān smṛtisaṃprajanyacittaḥ kāye śukhaṃ	parityajya-upekzA-saMskAravAn smRti-saMprajanya-cittaH kAye SuKam
   vedayakṣāryābhilāpepekṣārhāṃ nityamanusmaransukhāṃ vedanāṃ viśati tṛtīyaṃ	vedayakza-Arya-aBilApa-ipekzA-arhAm nityam-anusmaran-suKAm vedanAm viSati tRtIyam
   dhyānam prajahāti duḥkhaṃ prajahāti śukhaṃ niruṇaddhi śokaṃ prīti	DyAnam prajahAti duHKam prajahAti SuKam niruNadDi Sokam prIti
   viśatyaduḥkhamśukhamupekṣāsmṛtipariśūddhaṃ caturthaṃ dhyānam |	viSati-aduHKamSuKam-upekzA-smRti-pariSUdDam caturTam DyAnam |
   atyetisarvaṃ rūpalakṣaṇam | niruṇaddhi sarvaṃ pratighalakṣaṇaṃ nānusmarati	atyeti-sarvam rUpa-lakzaNam | niruNadDi sarvam pratiGa-lakzaNam na-anusmarati
   viṣabhāgalakṣaṇaṃ tena jānatyākāśamanantam | tataḥ	viza-BAga-lakzaNam tena jAnati-AkASam-anantam | tatas-
   praviśatyakāśamarūpadhyānāyatanam | atyeti sarvamākāśalakṣaṇaṃ tena jānāti	praviSati-akASam-arUpa-DyAna-Ayatanam | atyeti sarvam-AkASa-lakzaNam tena jAnAti
   vijñānamanantam | tatapraviśati vijñānamrūpadhyānāyatanam | atyeti sarvaṃ	vijQAnam-anantam | tata-praviSati vijQAnam-rUpa-DyAna-Ayatanam | atyeti sarvam
   vijñānalakṣaṇaṃ tena jānātyākiṃcanyam | tena jānan	vijQAna-lakzaNam tena jAnAti-AkiMcanyam | tena jAnan
   nevasaṃjñānāsṃjñāsparśaṃ tataḥ praviśati naiva saṃjñānāsaṃjñāyatanam |	neva-saMjQA-nAsMjQA-sparSam tatas praviSati na-eva saMjQAna-asaMjQA-Ayatanam |
   sarvadharmānkevalamanusmarañcarati na ca rajyati gaveṣayatyanuttaraṃ	sarva-DarmAn-kevalam-anusmaraQcarati na ca rajyati gavezayati-anuttaram
   mahāyānam | pūrayatyanuttarāṃ samyak sambodhimiti bhāvanāmayī praḥyā |	mahAyAnam | pUrayati-anuttarAm samyak samboDim-iti BAvanA-mayI praHyA |
   bodhisattvaḥ śrutena cintayā bhāvanayā ca saṃgṛhṇāti cittam | tataḥ	boDisattvaH Srutena cintayA BAvanayA ca saMgRhNAti cittam | tatas-
   pūrayati [ṣaḍ] abhijñā[stisro] vidyāḥ samādhi dhyānapāramitām ||	pUrayati [zax] aBijQA[H-tisro] vidyAH samADi DyAna-pAramitAm ||
   7 | dhyāyanbodhisattvaḥ punarācarati	7 | DyAyan-boDisattvaH punar-Acarati
   daśadharmāñchrāvakapratyekabuddhāveṇikān | ke deśa |	daSa-DarmAn-SrAvaka-pratyekabudDa-AveNikAn | ke deSaH |
   dhyāyannairātmyamavāpnoti tathāgatadhyānānīti prathamaḥ dhyānna ca sakto	DyAyat-nErAtmyam-avApnoti taTAgata-DyAnAni-iti praTamaH DyAn-na ca saktaH-
   na ca rakto na ca bhavati kliṣṭacitto na ca gaveṣayatyātmasukhamiti	na ca raktaH na ca Bavati klizwa-cittaH na ca gavezayati-Atma-suKam-iti
   dvitīyaḥ | dhyāyannavāpnotyuddhikarmāṇi pariḥyātuṃ sattvānāṃ	dvitIyaH | DyAyan=-avApnoti-udDi-karmANi pariHyAtum sattvAnAm
   cittacaryāmiti tṛtīyaḥ | dhyānprajānāti janakāyacittāni paritrāyate ca	citta-caryAm-iti tRtIyaH | DyAn-prajAnAti jana-kAya-cittAni paritrAyate ca
   sarvasattvāniti caturthaḥ | dhyāyānnācarati mahākaruṇāṃ chinatti sattvānāṃ	sarva-sattvAn-iti caturTaH | DyAyAt-=-a-Acarati mahA-karuNAm Cinatti sattvAnAm
   kleśagranthimiti paṃcamaḥ | dhyāyandhyānasamādhiṃ samyagjānāti	kleSa-granTim-iti paMcamaH | DyAyan-DyAna-samADim samyak-jAnAti
   prameśanirgamamatikrāmyati tridhātumiti ṣaṣṭaḥ | dhyāyannityamulabhate	prameSa-nirgamam-atikrAmyati triDAtum-iti zazwaH | DyAyan=-iti-am-ulaBate
   vaśitāmavāpnoti kuśaladharmāniti saptamaḥ | dhyāyañcitaṃ śāntaṃbhavati	vaSitAm-avApnoti kuSala-DarmAn-iti saptamaH | DyAyaQcitam SAntaMBavati
   nirvṛttaṃ yānadvayasyātikrāmyati sarvāṇi dhyānānītyaṣṭamaḥ | dhyāyannityaṃ	nirvRttam yAna-dvayasya-atikrAmyati sarvANi DyAnAni-iti-azwamaH | DyAyat-nityam
   viśati prajñāṃ lokamatikramyāvapnoti tatpadamiti navamaḥ |	viSati prajQAm lokam-atikramya-avapnoti tat-padam-iti navamaH |
   dhyāyanpratiṣṭhāpayati saddharmaṃ nirantaraṃ saṃvarddhayati triratnaṃ yena	DyAyan-pratizWApayati sadDarmam nirantaram saMvardDayati tri-ratnam yena
   bhavatyanucchinnamiti daśamaḥ | bhavati caivaṃvidhaṃ dhyāaṃ	Bavati-anucCinnam-iti daSamaH | Bavati ca-evaMviDam DyAam
   śrāvakapratyekabudhāvenīkam ||	SrAvaka-pratyekabuDa-A=-enIkam ||
   8 | jñātuṃ punaḥ sarvasattvānāṃ kliṣṭacittāni saṃgṛhṇāti	8 | jQAtum punar sarva-sattvAnAm klizwa-cittAni saMgRhNAti
   sarvadhyānasamādhidharmān cittasthairyaṃ vidhātuṃ | dhyāyānpratiṣṭhāpayati	sarva-DyAna-samADi-DarmAn citta-sTEryam viDAtum | DyAyAn-pratizWApayati
   cittasamatāmityucyate dhyānam | evaṃ samatā hyānaṃ samaṃ	citta-samatAm-iti-ucyate DyAnam | evam sama-tA hi-Anam samam
   śūnyatayākṣaṇatayāpraṇihitatayākriyayā | śūnyatā	SUnyatayA-akzaNa-tayA-praNihita-tayA-akriyayA | SUnyatA
   khalvalakṣaṇāpraṇihitākriyābhiḥ samā tena sattvā api samāḥ | yataḥ sattvāḥ	Kalva-lakzaNa-apraNihita-akriyABiH samA tena sattvAH api samAH | yatas sattvAH
   | yataḥ sattvāḥ samāstena dharmā api samāḥ | iti viśatyevaṃvidhāṃ	| yatas sattvAH samAH-tena DarmAH api samAH | iti viSati-evaMviDAm
   samatāmiti dhyānam ||	samatAm-iti DyAnam ||
   9 | punarbodhisattvo lokamanucarannapi na ca bhavati lokasaktaḥ	9 | punar-boDisattvaH lokam-anucaran=-api na ca Bavati loka-saktaH
   prajahātyaṣṭau lokadharmānvināśayati sarvagranthiṃ tyajati janāvāsaṃ	prajahAti-azwO loka-DarmAn-vinASayati sarva-granTim tyajati jana-AvAsam
   rocate 'sya viviktāyatanam | evaṃ dhyānamācarataścittaṃ saṃpratiṣṭhitaṃ	rocate asya vivikta-Ayatanam | evam DyAnam-AcarataH-cittam saMpratizWitam
   bhavati prajahāti saṃsārakarmāṇi ||	Bavati prajahAti saMsAra-karmANi ||
   10 | punarbodhisattvasya dhyānamācarata ṛddhirbhavati prajñopāyo matiḥ	10 | punar-boDisattvasya DyAnam-Acarate RdDiH-Bavati prajQA-upAyaH matiH
   kathaṃ bhavatyṛddhi kathaṃ prajñā | paśyati cedrūpalakṣaṇam śṛṇoti śabdaṃ	kaTam Bavati-RdDi kaTam prajQA | paSyati ced-rUpa-lakzaNam SRNoti Sabdam
   jānāti paracittaṃ smaratyatītaṃ prāpnoti	jAnAti para-cittam smarati-atItam prApnoti
   sarvabuddhalokadhātūntadasyārddhiḥ | rūpaṃ jānāti ced dharmasvabhāvaṃ	sarva-budDa-loka-DAtUn-tadasya-ArdDiH | rUpam jAnAti ced Darma-svaBAvam
   jānāti śabdagaṃndharasaspraṣṭavyacittasaṃskārāḥ svabhāvālakṣaṇāḥ	jAnAti Sabda-gaMnDa-rasa-sprazwavya-citta-saMskArAH svaBAva-alakzaNAH
   śāntāḥparinirvṛtāstriṣvadhvasu samā iti | ākāśalakṣaṇaṃ jānāti	SAntAH-parinirvRtAH-trizu-aDvasu samAH iti | AkASa-lakzaNam jAnAti
   buddhalokadhātumapariprāptanirodhamitiprajñā | kathamupāyaḥ kaṃtha matiḥ |	budDa-lokaDAtum-apariprApta-niroDa-miti-prajQA | kaTam-upAyaH kaMTa matiH |
   dhyānasamādhimanuviśannutpādayati mahāmaitrīṃ karuṇāṃ na jahāti	DyAna-samADim-anuviSan=-utpAdayati mahA-mEtrIm karuNAm na jahAti
   prāṇidhānaṃ vajramiva bhavati cāsya cittamavalokayanbuddhalokadhātu	prANiDAnam vajram-iva Bavati ca-asya cittam-avalokayan-budDa-lokaDAtu
   niṣpādayati bodhimārgamityupāyaḥ | cittaṃ sarvathāsyabhavati śāntam | na	nizpAdayati boDi-mArgam-iti-upAyaH | cittam sarvaTA-asi-aBavati SAntam | na
   cātmāna ca pudgala iti cintayati sarvadharmānmūlasvabhāvāvikṣepān |	ca-AtmAna ca pudgalaH iti cintayati sarva-DarmAt-mUla-svaBAva-avikzepAn |
   paśyati buddhalokadhātumākāśalakṣaṇam yanniṣpannaṃ tatpaśyati śāntaṃ	paSyati budDa-lokaDAtum-AkASa-lakzaNam yat-nizpannam tat-paSyati SAntam
   nirvāṇamiti matiḥ |	nirvANam-iti matiH |
   iti bositvaścarandhyānamṛddhi prajñāmupāyaṃ mati ca vibhajya	iti bositvaH-caran-DyAnam-RdDi prajQAm-upAyam mati ca viBajya
   caturvastūnyācaratyavāptotyanuttarāṃ samyaksambodhim | bodhisattvo	catur-vastUni-Acarati-avAptoti-anuttarAm samyaksamboDim | boDisattvaH-
   mahāsattvo dhyānamācarannopalabhate 'kuśalacittamakṣomyadharmatayā	mahAsattvaH DyAnam-Acaranna-upalaBate akuSala-cittam-akzomya-Darma-tayA
   paripūrayati dhyānapāramitām ||	paripUrayati DyAna-pAramitAm ||
   (iti bodhicittotpādasūtraśāstre dhyānapāramitā nāmāṣṭamo vargaḥ |)	(iti boDi-citta-utpAda-sUtra-SAstre DyAnapAramitA nAma-azwamaH vargaH |)
   navami vargaḥ	navami vargaH
   prajñāpāramitā	prajQApAramitA
   1 | bodhisattvaḥ kathaṃ bhāvayati prajñām | prajñā	1 | boDisattvaH kaTam BAvayati prajQAm | prajQA
   hyātmaparābhayalābhāyacedevaṃvidhā prajñā niṣpādayati bodhimārgam |	hi-Atma-parABaya-lABAyaced-evaMviDA prajQA nizpAdayati boDi-mArgam |
   bodhisattvaḥ kāmayate vinetuṃ sattvānaparhatuṃ duḥkhāni bhāvayati	boDisattvaH kAmayate vinetum sattvAn-aparhatum duHKAni BAvayati
   tasmātprajñām | bhāvayanprajñāṃ śikṣate sarvalokadhātuvastūni | prajahāti	tasmAt-prajQAm | BAvayan-prajQAm Sikzate sarva-loka-DAtu-vastUni | prajahAti
   lobhadvepamohān pratiṣṭhāpayati mahāmaitrīm | karuṇāyamāna upakaroti	loBa-dvepa-mohAn pratizWApayati mahA-mEtrIm | karuNAyamAnaH upakaroti
   sattvān | nityaṃ paritrātumicchaṃsteṣāṃ pariṇāyako bhavati | vibhajya	sattvAn | nityam paritrAtum-icCan=-tezAm pariNAyakaH Bavati | viBajya
   deśayati sadasanmārgaṃ kuśalākuśalāśca vipākāniti	deSayati sat-asat-mArgam kuSala-akuSalAH-ca vipAkAn-iti
   bodhisattvasyādiprajñācittam ||	boDisattvasya-Adi-prajQA-cittam ||
   2 || prajñābhāvanāhetoḥ prajahātyavidyām | apākurute kleśāvaraṇaṃ	2 || prajQA-BAvanA-hetoH prajahAti-avidyAm | apAkurute kleSa-AvaraNam
   jñeyāvaraṇamityasyātmalābhaḥ | vinayansattvānparisāntvayatīti paralābha|	jQeya-AvaraNam-iti-asya-Atma-lABaH | vinayan-sattvAn-parisAntvayati-iti para-lABa|
   carittvānuttarāṃ bodhiṃ sattveṣu pariṇāmyātmanā salābhinaḥ	carittvA-anuttarAm boDim sattvezu pariNAmi-AtmanA sa-lABinaH
   karotītyubhayalābhaḥ | prajñābhāvanayā prāpnoti prathamāṃ bhūmi	karoti-iti-uBaya-lABaH | prajQA-BAvanayA prApnoti praTamAm BUmi
   yāvatsarvajñatāmiti niṣpādayati bodhimārgam ||	yAvat-sarvajQa-tAm-iti nizpAdayati boDi-mArgam ||
   3 | prajñāṃ bhāvayanbodhisattvaḥkrameṇa pratiṣṭhāpayati viśati cittāni |	3 | prajQAm BAvayan-boDisattvaH-krameNa pratizWApayati viSati cittAni |
   kāni viśatiḥ | (1) kuśalakāmānutpādayato 'sya kalyāṇamitrānutsargacittam |	kAni viSatiH | (1) kuSala-kAmAn-utpAdayataH asya kalyANa-mitra-anutsarga-cittam |
   (2) madamānaṃ parityajato 'syāpramādacittam | (3) anucarataḥ sikṣāpadāni	(2) madamAnam parityajataH asya-apramAda-cittam | (3) anucarataH sikzA-padAni
   prītaṃ dharmaśravaṇacittam | (4) dharmāñchṛṇvato 'viśrāntaṃ	prItam Darma-SravaNa-cittam | (4) DarmAn-SRNvataH aviSrAntam
   kuśalacintācittam | (5) bhāvayataścaturi brahmavihārānsamyagjñānacittam |	kuSala-cintA-cittam | (5) BAvayataH-caturi brahma-vihArAn-samyak-jQAna-cittam |
   (6) paśyato 'śūcicaryāṃ tataḥ śrāmyataḥ parityāgacittam | (7) paśyata	(6) paSyataH aSUci-caryAm tatas SrAmyataH parityAga-cittam | (7) paSyata
   āryasatyāni poḍaśākāraṃ cittam | (8) paśyato dvādaśāṅgapratītyasamutpādaṃ	Arya-satyAni poxaSa-AkAram cittam | (8) paSyataH dvAdaSa-aFga-pratItyasamutpAdam
   bhāvayataḥ prajñācittam | (9) śṛṇvataḥ pāramitāḥ tatsaṃgrahakāmacittam |	BAvayataH prajQA-cittam | (9) SRNvataH pAramitAH tad-saMgraha-kAma-cittam |
   (10) anityaduḥkhānātmatāṃ paśyataḥ śāntaṃ nirvāṇaṃ cittam | (11) paśyataḥ	(10) anitya-duHKa-an-Atma-tAm paSyataH SAntam nirvANam cittam | (11) paSyataH
   śūnyamalakṣaṇamapraṇihitaṃ niṣkriyacittam | (12) paśyataḥ	SUnyam-alakzaNam-apraNihitam nizkriya-cittam | (12) paSyataH
   skandhadhātvāyatanāni bhūya ādīnavacittam (13)kleśāñjayato 'sahacaracittam	skanDa-DAtu-AyatanAni BUyas AdInavacittam (13)kleSAn-jayataH asahacara-cittam
   | (14) pālayataḥ kuśaladharmānātmasahacaracitam | (15) nivārayato	| (14) pAlayataH kuSala-Darma-an-Atma-sahacara-citam | (15) nivArayataH-
   'kuśaladharmānprahāṇacittam | (16) ācarataḥ samyagdharmaṃ vipulacittam |	akuSala-DarmAn-prahANa-cittam | (16) AcarataH samyak-Darmam vipula-cittam |
   (17) ācarato yānadvayamapi nityamupekṣācittam | (18)	(17) AcarataH yAna-dvayam-api nityam-upekzA-cittam | (18)
   śṛṇvanbodhisattvapiṭakaṃ pramodānusaraṇacittam | (19)	SRNvan-boDisattva-piwakam pramoda-anusaraNa-cittam | (19)
   svalābhaparalābhāvanusaṃvardhayataḥ sarvakuśalakarmacittam | (20) gṛhṇataḥ	sva-lABa-para-lABO=-anu-saMvarDayataH sarva-kuSala-karma-cittam | (20) gRhNataH
   sucaritaṃ sarvabuddhadharmagaveṣaṇācittam ||	su-caritam sarva-budDa-Darma-gavezaNA-cittam ||
   4 | punaḥkhalu prajñāṃ bhavayato bodhisattvasya bhavanti daśadharmāḥ	4 | punar-Kalu prajQAm Bavayatas boDisattvasya Bavanti daSa-DarmAH
   kuśalacintācittāḥ śrāvakapratyekabuddhāveṇikāḥ | ke daśa | (1)vibhajya	kuSala-cintA-cittAH SrAvaka-pratyekabudDa-AveNikAH | ke daSa | (1)viBajya
   cintayati samādhiprajñāmūlam | (2)cintayanna parityajati	cintayati samADi-prajQA-mUlam | (2)cintayan-na parityajati
   śāśvatocchedāntadvayam | (3) cintayati pratītyasamutpādadharmān | (4)	SASvata-ucCeda-anta-dvayam | (3) cintayati pratItyasamutpAda-DarmAn | (4)
   cintayati na sattvo nātmā na pudgalo na jīva iti | (5) cintayati na santi	cintayati na sattvaH na-AtmA na pudgalaH na jIvaH iti | (5) cintayati na santi
   triṣvadhsvātītānāgatapratyutpannadharmāḥ | (6) cintayatyanutpannamapi	trizu-aDsva-atIta-anAgata-pratyutpanna-DarmAH | (6) cintayati-anutpannam-api
   karma nocchinatti hetuphalam | (7) cintayam dharmān śūnyanapya	karma na-ucCinatti hetu-Palam | (7) cintayam DarmAn SUnyanapya
   kusīdaścāvaropayati kuśalam | (8) cintayatyalakṣaṇaṃ na ca pratinivartate	kusIdaH-ca-avaropayati kuSalam | (8) cintayati-alakzaNam na ca pratinivartate
   nirvāpayituṃ sattvān | (9) cintayannapyapraṇihitaṃ na jahāti gaveṣayituṃ	nirvApayitum sattvAn | (9) cintayan=-api-apraNihitam na jahAti gavezayitum
   bodhim | (10) cintayannapyakṛtaṃ na pariharati prakāśayituṃ sāṃbhogikaṃ	boDim | (10) cintayan=-api-akRtam na pariharati prakASayitum sAMBogikam
   kāyam ||	kAyam ||
   5 | punaḥ khalu bodhisattvasya dvādaśa bhavanti kuśalāvatāradharmamukhāni	5 | punar Kalu boDisattvasya dvAdaSa Bavanti kuSala-avatAra-Darma-muKAni
   (1) śūnyatādisamādhiṣvavatārakuśalo 'pi na (tān) gṛhṇāti | (2)	(1) SUnyatA-Adi-samADizu-avatAra-kuSalaH api na (tAn) gRhNAti | (2)
   dhyānasamādhiṣvavatārakuśalo 'pi na yathādhyānaṃ tatropapadyate | (3)	DyAna-samADizu-avatAra-kuSalaH api na yaTADyAnam tatra-upapadyate | (3)
   ṛddhijñāneṣvavatārakuśalo 'pi nānāsravān dharmān labhate | (4)	RdDi-jQAnezu-avatAra-kuSalaH api nAnA-sravAn DarmAn laBate | (4)
   adhyātmaparyavekṣaṇadharmeṣvavatārakuśalo 'pi na teṣu niścayamanuprāpnoti	aDyAtma-paryavekzaNa-Darmezu-avatAra-kuSalaH api na tezu niScayam-anuprApnoti
   | (5) sarvasattvaśūnyatādṭaṣṭāvavatārakuśalo 'pi nopekṣate mahāmaitrīm |	| (5) sarva-sattva-SUnyatAt-wazwO=-avatAra-kuSalaH api na-upekzate mahA-mEtrIm |
   (6) sarvasattvānātmatādṭaṣṭavavatārakuśalo 'pi nopekṣate mahākaruṇām | (7)	(6) sarva-sattvAn-Atma-tAt-wazwavavatAra-kuSalaH api na-upekzate mahA-karuNAm | (7)
   durgayupapattāvatārakuśalo 'pi na sa karmanimittaṃ tatropapadyate| (8)	durgayupapatta-avatAra-kuSalaH api na sa karma-nimittam tatra-upapadyate| (8)
   vairāgyāvatārakuśalo 'pi na vairāgyadharmān pratilabhate | (9)	vErAgya-avatAra-kuSalaH api na vErAgya-DarmAn pratilaBate | (9)
   kāmasukhaparityāgāvatārakuśalo 'pi nopekṣate dharmasukham | (10)	kAma-suKa-parityAga-avatAra-kuSalaH api na-upekzate Darma-suKam | (10)
   prapaṃcamatavādaparityāgāvatārakuśalo 'pi nopekṣate upāyadṭaṣṭīḥ | (11)	prapaMcamatavAda-parityAga-avatAra-kuSalaH api na-upekzate upAyadwazwIH | (11)
   bahvādīnavāḥ saṃskṛta dharmā ityanucintanāvatārakuśalo 'pi nopekṣate	bahu-AdInavAH saMskRta DarmAH iti-anucintana-avatAra-kuSalaH api na-upekzate
   saṃskṛtam | (12) paramapariśuddheṣvasaṃskṛtadharmeṣvavatārakuśalo	saMskRtam | (12) parama-pariSudDezu-asaMskRta-Darmezu-avatAra-kuSalaH-
   'pināsaṃskṛte pratiṣṭhito bhavati |	apinAsaMskRte pratizWitaH Bavati |
   bodhisattvaścetsarvakuśalāvatāradharmamukhānyācarati samyagjānāti śūnyatāṃ	boDisattvaH-ced-sarva-kuSala-avatAra-Darma-muKAni-Acarati samyak-jAnAti SUnyatAm
   triṣvadhvasu ba kiciditi ||	trizu-aDvasu ba kicid-iti ||
   6 | yadi caivaṃ paśyati paśyati triṣvadhvasu śūnyatāṃ prajñābalahetoḥ |	6 | yadi ca-evam paSyati paSyati trizu-aDvasu SUnyatAm prajQA-bala-hetoH |
   yadi cāvaropitāni triṣvadhvasu tathāgatairaprameyāṇi puṇyānyakhilaṃ	yadi ca-avaropitAni trizu-aDvasu taTAgatEH-aprameyANi puNyAni-aKilam
   pariṇāmayatyanuttarāyāṃ bodhau tadevaṃ bodhisattvaḥ saṃpaśyati	pariNAmayati-anuttarAyAm boDO tat-evam boDisattvaH saMpaSyati
   triṣvadhvasūpāyam|	trizu-aDvasu-upAyam|
   punarapi paśyannatītāndharmānkṣapitānanāgatānnāgatānsadaivācaratikuśalaṃ	punar-api paSyan=-atItAn-DarmAn-kzapitAn-anAgatAt-na-AgatAn-sadEvAcarati-kuSalam
   parākramate na ca kusado bhavati | anutpannānapi	parAkramate na ca kusadaH Bavati | anutpannAn-api
   paśyannagatāndharmānparākramate kāmayate bodhim | kṣaṇaṃ kṣaṇaṃ	paSyan=-agatAn-DarmAn-parAkramate kAmayate boDim | kzaNam kzaNam
   nirudhyamānānpaśyannapi pratyutyannāndharmān bodhimupagantuṃ na cāsya	niruDyamAnAn-paSyan=-api pratyutyannAn-DarmAn boDim-upagantum na ca-asya
   cittavismṛtirityevaṃ bodhisattvaḥ paśyati triṣvadhvasūpāyam |	citta-vismRtiH-iti-evam boDisattvaH paSyati trizu-aDvasu-upAyam |
   niruddhamatītaṃ nāgatamanāgatamasthiraṃ pratyutpannam | api ca	nirudDam-atItam na-Agatam-anAgatam-asTiram pratyutpannam | api ca
   paśyandharmāñcittacaittānutpadyamānānnirudhyamānānviśīryamāṇānpūyamānānnopekṣate	paSyan-Darma-aQcitta-cEttAn-utpadyamAnAt-niruDyamAnAn-viSIryamANAn-pUyamAnAt-na-upekzate
   saṃgrahītuṃkuśalamūlāni | upacarati bodhidharmānityevaṃ bodhisattvaḥ	saMgrahItuMkuSala-mUlAni | upacarati boDi-DarmAn-iti-evam boDisattvaH
   paśyati triṣvadhvasūpāmam |	paSyati trizu-aDvasUpAmam |
   7 | punaḥ khalu bodhisattvaḥ paśyati sarvaṃ	7 | punar Kalu boDisattvaH paSyati sarvam
   kuśalamakuśalamātmānamanātmānaṃ bhūtamabhūtaṃ śūnyamaśūnyaṃ saṃvṛtaṃ	kuSalam-akuSalam-AtmAnam-anAtmAnam BUtam-aBUtam SUnyam-aSUnyam saMvRtam
   paramārthaṃ samyaksamādhi mithyāsamādhi saṃskṛtamasaṃskṛtaṃ	parama-arTam samyak-samADi miTyA-samADi saMskRtam-asaMskRtam
   sāsravamanāsravaṃ kṛṣṇadharmaṃ śukladharmaṃ jātimaraṇaṃ nirvāṇaṃ	sa-asravam-anAsravam kRzNa-Darmam Sukla-Darmam jAti-maraNam nirvANam
   dharmadhātusvabhāvamekalakṣaṇamalakṣaṇam | na ca tatra dharmā ityucyate	DarmaDAtu-svaBAvam-eka-lakzaNam-alakzaNam | na ca tatra DarmAH iti-ucyate
   'lakṣaṇamiti | api nāma kaścana dharmo yohyalakṣaṇo nāmetyucyate	alakzaNam-iti | api nAma kaScana DarmaH yohya-lakzaNaH nAma-iti-ucyate
   sarvadharmamudrākṣayāmudrā | āsu mudrāsu na mudrālakṣaṇamityucyate satyaṃ	sarva-Darma-mudrA-kzayA-mudrA | Asu mudrAsu na mudrA-lakzaNam-iti-ucyate satyam
   bhūtaṃ prajñopāyaḥ prajñāpāramitā |	BUtam prajQA-upAyaH prajQApAramitA |
   utpāditabādhicettena bodhisattvenaivaṃ śikṣiotavyamevaṃ bhāvayitavyam |	utpAdita-bADicet-tena boDisattvena-evam Sikziotavyam-evam BAvayitavyam |
   evaṃ bhāvayannavāpnotyanuttarāṃ samyaksambodhim | bodhisattvasya	evam BAvayan=-avApnoti-anuttarAm samyaksamboDim | boDisattvasya
   mahāsattvasya prajñāṃ bhāvayato na cittaṃ carati dharmatāyāḥ	mahAsattvasya prajQAm BAvayataH na cittam carati DarmatAyAH
   pariśuddhatvāt | evaṃ paripūrayati prajñāpāramitām ||	pariSudDa-tvAt | evam paripUrayati prajQApAramitAm ||
   (iti bodhicittotpādasūtraśāstre prajñāpāramitā nāma navamo vargaḥ ||	(iti boDi-citta-utpAda-sUtra-SAstre prajQApAramitA nAma navamaH vargaH ||
   daśamo vargaḥ	daSamaH vargaH
   tathātādharmamukhaṃ	taTA-Ata-aDarma-muKam
   1 | kulaputreṇa kuladuhitrā vā caratā ṣaṭ pāramitā gaveṣayatānuttarāṃ	1 | kula-putreNa kula-duhitrA vA caratA zaw pAramitA gavezayatA-anuttarAm
   samyaksaṃbodhiṃ prahātavyāḥ sapta dharmāḥ | katame sapta | prathamaṃ	samyaksaMboDim prahAtavyAH sapta DarmAH | katame sapta | praTamam
   prajahātyakalpāṇamitrāṇi | akalyāṇamitrāṇi śikṣayanti parihartamanuttarāṃ	prajahAti-akalpANa-mitrANi | akalyANa-mitrANi Sikzayanti parihartam-anuttarAm
   śraddhāmudāttaṃ saṃkalpamanuttamaṃ vīryaṃ samuccetuṃ ca saṃkliṣṭācārān |	SradDAm-udAt-tam saMkalpam-anuttamam vIryam samuccetum ca saMklizwa-AcArAn |
   dvitīyaṃ prajahāti strīrūpaṃ kāmarāgaṃ pṛthagjanairvivikto	dvitIyam prajahAti strI-rUpam kAma-rAgam pRTagjanEH-viviktaH-
   bhavatyasahacaraḥ | tṛtīyaṃ paśyannātmānamābhāsaṃ prajahātyasadgrāhaṃ	Bavati-asahacaraH | tRtIyam paSyan=-AtmAnam-ABAsam prajahAti-asat-grAham
   snehabahumānānurāgāṃściraṃ sthāsyatīti | caturthaṃ prajahāti	sneha-bahu-mAna-anurAgAn=-ciram sTAsyati-iti | caturTam prajahAti
   dveṣapratidhamauddhatyaṃ mānamīrṣvāmasūyāṃ yato jayate kalahaḥ	dveza-pratiDam-OdDatyam mAnam-IrzvAmasUyAm yatas jayate kalahaH
   pratihanyate kuśalacittam | pañcamaṃ prajahāti pramādaṃ madamānaṃ	pratihanyate kuSala-cittam | paQcamam prajahAti pramAdam madamAnam
   kausīdyaṃ svakaṃ parittakuśalaṃ ca yenāvajānāti parān | ṣaṣṭhaṃ prajahāti	kOsIdyam svakam paritta-kuSalam ca yena-avajAnAti parAn | zazWam prajahAti
   tairthikāgamaṃ kāvyāni na cābuddhabhāṣitāni praśaṃsati | saptamaṃ	tErTikA-gamam kAvyAni na ca-abudDa-BAzitAni praSaMsati | saptamam
   nopagacchati mithyādṭaṣṭimasamyagdṭaṣṭim | evamime saptadharmāḥ	na-upagacCati miTyAt-wazwim-asamyak-dwazwim | evam-ime sapta-DarmAH
   prahātavyāḥ | uktaṃ bhagavatā na paśyāmi tathānyāndharmānya āvṛṇvanti	prahAtavyAH | uktam BagavatA na paSyAmi taTA-anyAn-DarmAnyaH AvRNvanti
   buddhamārgaṃ yatheme saptadharmāḥ| ataeva bodhisattvena prahātavyāḥ ||	budDa-mArgam yaTA-ime sapta-DarmAH| ataeva boDisattvena prahAtavyAH ||
   2 | aciramanuttarāṃ sambodhimabhisamboddhukāmenācaritavyāḥ saptadharmāḥ |	2 | aciram-anuttarAm samboDim-aBisambA-udDu-kAmena-AcaritavyAH sapta-DarmAH |
   ke sapta | prathamaṃbodhisattvenopagantavyāni kalpāṇa mitrāṇi |	ke sapta | praTamaMboDisattvena-upagantavyAni kalpANa mitrANi |
   kalpāṇamitrāṇi buddhā bodhisattvāśca | śrāvakā api bodhisattvaṃ	kalpANa-mitrANi budDAH boDisattvAH-ca | SrAvakAH api boDisattvam
   gambhīradharmakośe pāramitāsu saṃpratiṣṭhāpayanto bhavanti bodhisattvasya	gamBIra-Darma-koSe pAramitAsu saMpratizWApayantaH Bavanti boDisattvasya
   kalpāṇamitrāṇi | dvitīyaṃ bodhisattvenopacaritavyāḥ pravrajitā	kalpANa-mitrANi | dvitIyam boDisattvena-upacaritavyAH pravrajitA
   āraṇyakadharmāśca | mātṛgrāmaḥ prahātavyaḥ kāmarāgaśca | viviktena	AraNyaka-DarmAH-ca | mAtR-grAmaH prahAtavyaH kAmarAgaH-ca | viviktena
   bhavitavyaṃ pṛthagjanairasahacareṇa | tṛtīyaṃ bodhisattvena draṣṭavyaḥ	Bavitavyam pRTagjanEH-asahacareNa | tRtIyam boDisattvena drazwavyaH
   kāyo malabhūmivadaśucisaṃśrayaḥ kevalaṃ vātaśleṣmapittalohitakamarāgārho	kAyaH mala-BUmi-vat-aSuci-saMSrayaH kevalam vAta-Slezma-pitta-lohita-kamarAga-arhaH-
   dine dine maraṇonmukho 'nādarabuddhyā parihartavyaḥ sotsāhaṃ bhāvayitavyo	dine dine maraNa-unmuKaH anAdara-budDyA parihartavyaH sa-utsAham BAvayitavyaH-
   mārgaḥ | caturthaṃ bodhisattvena nityaṃ caritavyā śāntiḥ	mArgaH | caturTam boDisattvena nityam caritavyA SAntiH
   kṣāntirgurukaraṇīyā mṛdutāca | śikṣayitavyāḥ kṣāntau sthāpayitavyāśca	kzAntiH-guru-karaNIyAH mRdu-tAca | SikzayitavyAH kzAntO sTApayitavyAH-ca
   janāḥ | paṃcamaṃ bodhisattvenācaritavyaṃ vīryamutpādayitavyā hrīrapatrapā	janAH | paMcamam boDisattvena-Acaritavyam vIryam-utpAdayitavyA hrIH-apatrapA
   ca pūjayitavya upādhyāyaḥ karuṇāyitavyā dīnā duḥkhitāndṭaṣṭrā svakāyena	ca pUjayitavyaH upADyAyaH karuNAyitavyA dInA duHKitA-andwazwrA sva-kAyena
   parigrahītavyaṃ tadduḥkham | ṣaṣṭhaṃ bodhisattvenabhāvayitavyaṃ vipulaṃ	parigrahItavyam tad-duHKam | zazWam boDisattvena-BAvayitavyam vipulam
   mahāyānabodhisattvapiṭakaṃ grahītavyā dhārayitavyā vācayitavyā dharmmā	mahAyAna-boDisattva-piwakam grahItavyA DArayitavyA vAcayitavyA DarmmA
   buddhānuśaṃsitāḥ | saptamaṃ bodhisattvenopagantavyaṃ bhāvayitavyaṃ	budDa-anuSaMsitAH | saptamam boDisattvena-upagantavyam BAvayitavyam
   paramārthasatyam | tathāhi | bhūtalakṣaṇamekalakṣaṇamalakṣaṇam	parama-arTa-satyam | taTA-hi | BUta-lakzaNam-eka-lakzaNam-alakzaNam
   bodhisattvaścetkāmayate śīghramabhisambodhimabhyupagantavyā evamime sapta	boDisattvaH-ced-kAmayate SIGram-aBisamboDim-aByupagantavyAH evam-ime sapta
   dharmāḥ |	DarmAH |
   3 | punaḥ khalu puruṣaḥ prāptihetorutpādayati ced	3 | punar Kalu puruzaH prApti-hetoH-utpAdayati ced-
   bodhicittamaprameyamasaṃkhyeyaṃ kalpaṃ saṃgṛhṇati maitrīṃkaruṇāṃ	boDi-cittam-aprameyam-asaMKyeyam kalpam saMgRhNati mEtrIMkaruNAm
   muditāmupekṣāṃ dānaṃ śīlaṃ kṣāntiṃ vīryaṃ dhyānaṃ prajñām | jñātavyaṃ na	muditAm-upekzAm dAnam SIlam kzAntim vIryam DyAnam prajQAm | jQAtavyam na
   sa puruṣaḥ prajñahāti jātimaraṇam | na ca gacchati bodhim | tatkasya hetoḥ	sa puruzaH prajQahAti jAti-maraNam | na ca gacCati boDim | tat-kasya hetoH
   | [bodhi-]cittaprāptirapyasti prāptidṭaṣṭiḥ	| [boDi-]-citta-prAptiH-api-asti prAptidwazwiH
   skandhadhātvāyatanadṭaṣṭirātmadṭaṣṭiḥ pudgaladṭasṭiḥ sattvadṭaṣṭi	skanDa-DAtu-AyatanadwazwiH-AtmadwazwiH pudgaladwaswiH sat-tvat-wazwi
   jīrvadṭaṣṭi	jIrvat-wazwi
   maitrīkaruṇāmuditopokṣādānaśīlakṣāntivīryadhyānaprajñādidṭaṣṭiḥ |	mEtrI-karuNA-mudita-upokzA-dAna-SIla-kzAnti-vIrya-DyAna-prajQA-AdidwazwiH |
   saṃkṣepata ucyate | buddhadharmasaṃghadṭaṣṭirnirvāṇadṭaṣṭirevaṃ	saMkzepataH ucyate | budDa-Darma-saMGadwazwiH-nirvANadwazwiH-evam
   yatkiñcatprāptavyadṭaṣṭiḥ sarvameṣa āsaṅga | cittāsaṃga evocyate	yat-kiQcat-prAptavyat-wazwiH sarvam-ezaH AsaFgaH | citta-AsaMgaH eva-ucyate
   mithyādṭaṣṭiḥ | kasmāt | puruṣā mithyādṭaṣṭayaścakavatparivartante	miTyA-adwazwiH | kasmAt | puruzAH miTyAdwazwayaH-caka-vat-parivartante
   trighātau sadaiva parihīyante vimukteḥ | ayamepa āsaṃgaḥ | na caivaṃ	tri-GAtO sadA-eva parihIyante vimukteH | ayam-epaH AsaMgaH | na ca-evam
   kadāpi nirmucyate| na cāpnuvantyayanuttarāṃ samyaksambodhim ||	kadApi nirmucyate| na ca-Apnuvanti-ayanuttarAm samyaksamboDim ||
   4 | puruṣaścedutpādayati bodhicittaṃ draṣṭavyaṃ cittaṃ śūnyalakṣaṇam |	4 | puruzaH-ced-utpAdayati boDi-cittam drazwavyam cittam SUnya-lakzaNam |
   kicittaṃ kathaṃ ca śūnyalakṣaṇam | cittaṃ nāma manovijñānamevaṃ	kicittam kaTam ca SUnya-lakzaNam | cittam nAma manaH-vijQAnam-evam
   vijñānaskandho mana āyatanaṃ mano dhātuḥ | cittaṃ śūnyalakṣaṇaṃ na cittaṃ	vijQAna-skanDaH manaH Ayatanam manaH DAtuH | cittam SUnya-lakzaNam na cittam
   cittalakṣaṇaṃ na ca kartṛ| kasmāt | yā cittalakṣaṇaśūnyatā sā na ca kartrī	citta-lakzaNam na ca kartR| kasmAt | yA citta-lakzaNa-SUnyatA sA na ca kartrI
   na ca kārayitrī | yadi kaścitkarttaiva nāsti na tarhi kartṛlakṣaṇam | yadi	na ca kArayitrI | yadi kaScid-karttA-eva na-asti na tarhi kartR-lakzaNam | yadi
   bodhisattvo jānātyevaṃ dharmānsarvadharmeṣvanāsakto bhavati | anāsaktiheto	boDisattvaH jAnAti-evam DarmAn-sarva-Darmezu-anAsaktaH Bavati | anAsakti-heto
   rna jānātikuśalākuśalaphalavipāka iti ācaritāyāṃ maintryāṃ jānāti	rna jAna-ati-kuSala-akuSala-Pala-vipAkaH iti AcaritAyAm mEntryAm jAnAti
   nāstyātmā | acaritāyāṃ karuṇāyāṃ na sattvāḥ | ācaritāyāṃ muditāyāṃ na	na-asti-AtmA | acaritAyAm karuNAyAm na sattvAH | AcaritAyAm muditAyAm na
   jīvaḥ | ācaritāyāmupekṣāyāṃ na pudgalaḥ | ācarannapi dānaṃ na paśyati	jIvaH | AcaritAyAm-upekzAyAm na pudgalaH | Acaran=-api dAnam na paSyati
   dānavastu | ācarannapi śīlaṃ na paśyati cittaviśuddhim | ācarannapi	dAnavaH-tu | Acaran=-api SIlam na paSyati citta-viSudDim | Acaran=-api
   kṣāntiṃ na paśyati sattvān | ācarannapi vīryaṃ na jahāti rāgacitam |	kzAntim na paSyati sattvAn | Acaran=-api vIryam na jahAti rAga-citam |
   ācarannapi dhyānaṃ parityajati nākuśalacittam | bhāvayato 'pi prajñāṃ na	Acaran=-api DyAnam parityajati na-akuSala-cittam | BAvayataH api prajQAm na
   ca kācicittabhāvanā | sarvalaṃbanā sarvaprajñā na cāsaṅgo 'sya prajñāyām |	ca kAcicitta-BAvanA | sarva-laMbanA sarva-prajQA na ca-asaFgaH asya prajQAyAm |
   na ca prajñāvāptirna ca prajñā dṭaṣṭiḥ | ya ācaratyevamācarati prajñāṃ |	na ca prajQA-avAptiH-na ca prajQA dwazwiH | yaH Acarati-evam-Acarati prajQAm |
   na catasyācaritaṃ bhavati kiṃcita na cāpi nācaritaṃ bhavati kiṃcit | antaḥ	na catasya-Acaritam Bavati kiMcita na ca-api na-Acaritam Bavati kiMcid | antar-
   pariśuddho 'pi sa vinetuṃ sattvanācarati ṣaṭ pāramitāḥ | ya acaratyevaṃ	pariSudDaH api sa vinetum sattvanA-Acarati zaw pAramitAH | yaH acarati-evam
   bhāvayati cittaṃ kṣaṇamavaropitakuśalasyāpi tasya puṇyaphalavipāko	BAvayati cittam kzaNam-avaropita-kuSalasya-api tasya puNya-Pala-vipAkaH-
   'prameyo 'paryantaḥ | asaṃkhyeyaiḥ kalpakoṭiśatasahasrairapi na tasyāntaḥ	aprameyaH aparyantaH | asaMKyeyEH kalpa-kowi-Sata-sahasrEH-api na tasya-antar-
   | avāpnoti so 'nāyāsenānuttarāṃ samyaksambodhim ||	| avApnoti saH anAyAsena-anuttarAm samyaksamboDim ||
   (iti bodhicittotpādasūtraśāstretathatādharmamukhaṃ nāma daśamo vargaḥ ||)	(iti boDi-citta-utpAda-sUtra-SAstretaTatA-aDarma-muKam nAma daSamaH vargaH ||)
   ekadaśo vargaḥ	ekadaSaH vargaH
   śūnyālakṣaṇaṃ	SUnya-alakzaNam
   1 | ekasminsamaye bhagavānpurā viharati smaveṇuvane kalandakanivāpe mahatā	1 | ekasmin-samaye BagavAn-purA viharati sma-veNu-vane kalandaka-nivApe mahatA
   [bhikṣu]saṃghena sārddhamaprameyeṇa | atha bhagavāndeśayituṃ	[Bikzu]-saMGena sArdDam-aprameyeNa | aTa BagavAn-deSayitum
   saddharmamāmantrayati sma mahāsaṃgham | bhagavānavocat| sarvadharmā	sadDarmam-Amantrayati sma mahA-saMGam | BagavAn-avocat| sarva-DarmA
   niḥsvabhāvāḥ śūnyā niḥsārā aśraddheyāḥ sarvalokaiḥ | tatkasya hetoḥ |	niHsvaBAvAH SUnyAH niHsArAH aSradDeyAH sarva-lokEH | tat-kasya hetoH |
   rūpaṃ na bandho na mokṣaḥ | vedanā saṃjñā saṃskārāvijñānaṃ na bandho na	rUpam na banDaH na mokzaH | vedanA saMjQA saMskAra-avijQAnam na banDaH na
   mokṣaḥ | rūpalakṣaṇaṃ tyajati ca lakṣaṇam	mokzaH | rUpa-lakzaNam tyajati ca lakzaNam
   vedanāsaṃjñāsaṃskāravijñānanyalakṣaṇāni tyajanti ca kṣaṇāni |	vedanA-saMjQA-saMskAra-vijQAnanya-lakzaNAni tyajanti ca kzaNAni |
   cakṣūrūpaśrotraśabdaghrāṇagandhajihvārasakāyaspraṣṭavyamanodharmā apyevam	cakzU-rUpa-Srotra-Sabda-GrANa-ganDa-jihvA-rasa-kAyasprazwavya-manaH-DarmAH api-evam
   | na te grāhyā nopekṣyā na samalā na vimalā jagatā nānugatā na pratigatā	| na te grAhyA na-upekzyAH na sa-malA na vimalA jagatA na-anugatA na pratigatA
   nābhākharā na bhākharā na moho na prajñā na caipo 'nto na so 'nta nāpi ca	nABA-KarAH na BAKarAH na mohaH na prajQA na ca-epaH antaH na saH anta na-api ca
   madhyasrota iticocyate na bandhaḥ ||	maDyasrotaH iti-cocyate na banDaH ||
   2 | bandhābhāvācchūnyam | śūnyamucyate 'lakṣaṇam | alakṣaṇamapi	2 | banDa-aBAvAt-SUnyam | SUnyam-ucyate alakzaNam | alakzaNam-api
   śūnyamityucyate śūnyam | śūnyamucyate 'kṣaṇamakṣaṇamapi śūnyamityucyate	SUnyam-iti-ucyate SUnyam | SUnyam-ucyate akzaNam-akzaNam-api SUnyam-iti-ucyate
   śūnyam | śūnyakṣaṇamapi śūnyamityuccate śūnyam | śūnyatāyāṃna kuśakaṃ na	SUnyam | SUnya-kzaNam-api SUnyam-iti-uccate SUnyam | SUnyatAyAMna kuSakam na
   cā kuśalaṃ na cāpi śūnyalakṣaṇamityucyate śūnyam | bodhisattvo yadyevaṃ	cA kuSalam na ca-api SUnya-lakzaNam-iti-ucyate SUnyam | boDisattvaH yadi-evam
   jānāti skandhadhātvāyatanasvabhāvaṃ na cagṛhṇātītyucyate dharmakṣāntiḥ |	jAnAti skanDa-DAtu-Ayatana-svaBAvam na cagRhNAti-iti-ucyate Darma-kzAntiH |
   bodhisattva evaṃvidhakṣāntihetoḥ prāpnot vyākaraṇakṣāntim ||	boDisattvaH evaMviDa-kzAnti-hetoH prApnot vyAkaraNa-kzAntim ||
   3 | buddhaputrāstathāhi bodhisattvo likhatyākāśe tathāgatasya	3 | budDa-putrAH-taTA-hi boDisattvaH liKati-AkASe taTAgatasya
   dvādaśaṅḥapravacanāni | atīteṣvaprameyeṣu kalpeṣu parinirvṛteṣu	dvAdaSaFHa-pravacanAni | atItezu-aprameyezu kalpezu parinirvRtezu
   buddhadharmeṣu puruṣo dharmaṃ gaveṣayanna kicidapi paśyati na ca śṛṇoti	budDa-Darmezu puruzaH Darmam gavezayan-na kicid-api paSyati na ca SRNoti
   sattvā viparivartante kurvanto 'prameyāṇyakuśalāni | punaranyataḥ	sattvAH viparivartante kurvantaH aprameyANi-akuSalAni | punar-anyatas-
   pariśuddhaprajñajanāḥ karuṇāyante satveṣu gaveṣayanti buddhadharmāngatvā	pariSudDa-prajQa-janAH karuNAyante satvezu gavezayanti budDa-DarmAn-gatvA
   paśyantyākāśe likhitāni lekhaspaṣṭatayāvagacchanti vācayanti gṛhnanti	paSyanti-AkASe liKitAni leKa-spazwa-tayA-avagacCanti vAcayanti gRhnanti
   dhārayanti yathābhāṣitamācaranti vibhajya prakāśayantyupakurvanti sattvān	DArayanti yaTABAzitam-Acaranti viBajya prakASayanti-upakurvanti sattvAn
   | yaśca likhatyākāśe yaśca jānātyākāśākṣarāṇi sa nu cintayituṃ śakyo yaśca	| yaH-ca liKati-AkASe yaH-ca jAnAti-AkASa-akzarANi sa nu cintayitum SakyaH yaH-ca
   vā prakāśayati deśayatyācarati gṛhṇāti dhārayati nayāte sattvānvimocayati	vA prakASayati deSayati-Acarati gRhNAti DArayati nayAte sattvAn-vimocayati
   vandham ||	vanDam ||
   4 | buddhaputrā uktaṃ bhagavatā | atīte 'dhvani gaveṣayanvodhimārgaṃ mayā	4 | budDa-putrAH uktam BagavatA | atIte aDvani gavezayan-voDi-mArgam mayA
   labdhāni buddhakoṭitrayastriśadaṣṭānavatibuddhaśatasahasrāṇi | sarveṣāṃ	labDAni budDa-kowi-trayaH-triSat-azwAnavati-budDa-Sata-sahasrANi | sarvezAm
   kāle 'hamāsaṃ cakravarta sarve cārāgitāstepūjitāste buddhāśca	kAle aham-Asam cakravarta sarve cArAgitAH-tepU-jitAH-te budDAH-ca
   buddhaputrāśca prāptavyahetorna ca mayā prāptaṃ vyākaraṇam | punarlabdhāni	budDa-putrAH-ca prAptavyahetoH-na ca mayA prAptam vyAkaraNam | punar-labDAni
   pratyekabuddhakoṭicaturaśītiśatasahasrāṇi	pratyekabudDa-kowi-caturaSIti-Sata-sahasrANi
   pratyekabuddhanavatiśatasahasrāṇi ca | sava'pi caturbhiḥ pariṣkārai	pratyekabudDanavati-Sata-sahasrANi ca | sava-api caturBiH parizkArE
   ryāvajjīvaṃ pūjitāḥ | punaḥ khalu labdhāni dvāpaṣṭibuddhaśatasahasrāṇi	ryAvajjIvam pUjitAH | punar Kalu labDAni dvApazwi-budDa-Sata-sahasrANi
   ekaṣapṭayuttaradvādaśabuddhaśatāni ca | sarveṣāṃ kāle 'hamāsaṃ cakavartī |	eka-zapwa-yuttara-dvAdaSa-budDa-SatAni ca | sarvezAm kAle aham-Asam cakavartI |
   ārāgitāścate yāvajjivaṃ pūjitāśca te | parinirvṛteṣu teṣu kāritāḥ	ArAgitAH-cate yAvat-jivam pUjitAH-ca te | parinirvRtezu tezu kAritAH
   saptaratnamayāḥ stūpā dhṛtapūjita [buddha]śarīrāḥ | atha punarlokamāgatā	sapta-ratna-mayAH stUpAH DRta-pUjita [budDa]-SarIrAH | aTa punar-lokam-AgatA
   buddhā āmantritā mayādhyepitāḥ prāvartayandharmacakram | pūjitāścaivaṃ	budDAH AmantritAH mayA-aDyepitAH prAvartayan-Darma-cakram | pUjitAH-ca-evam
   buddhānāṃ śatāni sahasrāṇi śatasahasrāṇi śatasahasrāṇi koṭayaśca | te ca	budDAnAm SatAni sahasrANi Sata-sahasrANi Sata-sahasrANi kowayaH-ca | te ca
   tathāgatāḥ śūnyadharmeṣu dharmalakṣaṇamavocan | prāptavyaheto rna mayā	taTAgatAH SUnya-Darmezu Darma-lakzaNam-avocan | prApta-vyahetaH rna mayA
   prāptaṃ vyākaraṇam ||	prAptam vyAkaraNam ||
   5 | evaṃ viparivartamānasya me tāvajjāto dīpaṃkarastathāgataḥ | apaśyaṃ	5 | evam viparivartamAnasya me tAvat-jAtaH dIpaMkaraH-taTAgataH | apaSyan
   taṃ bhagavantamaśṛṇvaṃ dharmam | labdhā ca sarvānutpādā dharmakṣāntistadā	tam Bagavantam-aSRNvam Darmam | labDA ca sarvAn-utpAdA DarmakzAntiH-tadA
   labdhaṃ vyākaraṇam | dīpaṃkareṇa tathāgatena śūnyadharmeṣu bhāṣitaṃ	labDam vyAkaraNam | dIpaMkareNa taTAgatena SUnya-Darmezu BAzitam
   dharmalakṣaṇam | paritrātānyaprameyasattvasahasrāṇi na tathāpi bhāṣitaṃ	Darma-lakzaNam | paritrAtA-ani-aprameya-sattva-sahasrANi na taTA-api BAzitam
   kiñcinna ca paritrātaḥ kaścit | lokamāgatena lokanāyakamuninā satsvapi	kiQcid-na ca paritrAtaH kaScid | lokam-Agatena loka-nAyaka-muninA satsu-api
   śūnyadharmeṣu bhāṣitaṃ lekhitaṃ prakāśitaṃ | lokamāgatena lokanāyakamuninā	SUnya-Darmezu BAzitam leKitam prakASitam | lokam-Agatena loka-nAyaka-muninA
   satsvapi śūnyadharmeṣu bhāṣitaṃ lekhitaṃ prakāśitaṃ śikṣitamāmoditaṃ	satsu-api SUnya-Darmezu BAzitam leKitam prakASitam Sikzitam-Amoditam
   sarvaśca veditamācaritamapi ca na prakāśitaṃ nāpi veditaṃ na cāpyācaritam	sarvaH-ca veditam-Acaritam-api ca na prakASitam na-api veditam na ca-api-Acaritam
   | evaṃ dharmāḥ svabhāvalakṣaṇena śūnyāḥ lekhanamapi śūnyam | yo 'bhijānāti	| evam DarmAH svaBAva-lakzaNena SUnyAH leKanam-api SUnyam | yaH aBijAnAti
   so 'pi śūnyaḥ | yo 'bhāṣata so 'pi śūnyaḥ | yaśca janāti so 'pi śūnyaḥ |	saH api SUnyaH | yaH aBAzata saH api SUnyaH | yaH-ca janAti saH api SUnyaH |
   ādiḥ śūnyamanāgataṃ śūnyaṃ pratyutpannaṃ śūnyam | bodhisattvaḥ	AdiH SUnyam-anAgatam SUnyam pratyutpannam SUnyam | boDisattvaH
   saṃgṛhṇandaśa kuśalopāyavalasahasrāṇi sotsāho 'kusīdo puṇyaparipūrito	saMgRhNan-daSa kuSala-upAya-vala-sahasrANi sa-utsAhaH akusIdaH puNya-paripUritaH-
   labhate 'nuttarāṃ sanyaksambodhim ||	laBate anuttarAm sanyaksamboDim ||
   6 | nūnamasukaramacintyaṃ yaducyate dharmābhāve dharmābhāve dharmalakṣaṇaṃ	6 | nUnam-asukaram-acintyam yat-ucyate Darma-aBAve Darma-aBAve Darma-lakzaNam
   prāptavyābhāve prāptidharmāḥ |	prAptavya-aBAve prApti-DarmAH |
   buddhagocaramidamevaṃvastvaprameyayaitabuddhaprajñayā kevalaṃ jñātuṃśakyam	budDa-gocaram-idam-evaMvaH-tu-aprameyayA-etabudDa-prajQayA kevalam jQAtuMSakyam
   | na ca jñātuṃ śakyaṃ cintayā | acirotpāditacitto bodhisattvaḥ	| na ca jQAtum Sakyam cintayA | acira-utpAdita-cittaH boDisattvaH
   śraddhācittenānuśaṃsati bodhimārocayati ca | śraddhāhetoḥ krameṇa	SradDA-cittena-anuSaMsati boDim-Arocayati ca | SradDA-hetoH krameNa
   buddhabhāṣiteṣu viśati | kā nāma śraddhā | śraddhayā paśyati	budDa-BAzitezu viSati | kA nAma SradDA | SradDayA paSyati
   caturāryasatyāni niruṇaddhi kleśān mithyādṭaṣṭisaṃyojanāni |	catur-Arya-satyAni niruNadDi kleSAt miTyAdwazwi-saMyojanAni |
   prāpnotyarhatvam | paśyati dvādaśapratyayaṃ dvādaśāṅḥaṃ pratītyasamutpādam	prApnoti-arha-tvam | paSyati dvAdaSa-pratyayam dvAdaSa-aFHam pratItyasamutpAdam
   | nirudhyante cāsyāvidyājanitāḥ saṃskārā labhate pratyekabuddhatām |	| niruDyante ca-asya-avidyA-janitAH saMskArAH laBate pratyekabudDa-tAm |
   śraddhayā carati caturo brahmacihārān ṣaṭ pāramitāḥ prāpnotyanuttārāṃ	SradDayA carati caturaH brahma-cihArAn zaw pAramitAH prApnoti-anuttArAm
   samyaksambodhimityucyate śraddhākṣāntiḥ ||	samyaksamboDim-iti-ucyate SradDA-akzAntiH ||
   7 | sattvā anādimati jātimaraṇalakṣaṇe saktā na paśyanti dharmasvabhāvam |	7 | sattvAH anAdimati jAti-maraNa-lakzaNe saktAH na paSyanti Darma-svaBAvam |
   prathamaṃ draṣṭavyaṃ yadepa svakāyaḥ paṃcaskandhaḥ prajñāyate sattva iti |	praTamam drazwavyam yat-epa sva-kAyaH paMcaskanDaH prajQAyate sattvaH iti |
   tanna nātmā na sattvaḥ tatkasyahetoḥ tatrātmā cedātmātmavaśas tiṣṭhet |	tat-na na-AtmA na sattvaH tat-kasya-hetoH tatra-AtmA ced-AtmA-Atma-vaSaH tizWet |
   sattvāstu jātiharāvyādhimaraṇaiḥ sadākrāntā nātmavaśās tiṣṭhanti |	sattvAH-tu jAti-hara-avyADi-maraNEH sat-A-AkrAntAH na-Atma-vaSAH tizWanti |
   jñātavyaṃ tena nātmā | anātmatvānna kartā | akartṛtvānnopādātā |	jQAtavyam tena na-AtmA | anAtma-tvAt-na kartA | akartR-tva-at-na-upAdAtAH |
   dharmasvabhāvaḥ pariśuddhaḥ | nityaṃ tiṣṭhati bhūtakoṭiḥ |	Darma-svaBAvaH pariSudDaH | nityam tizWati BUtakowiH |
   evamaparipūritapratyavekṣaṇocyate 'nvayakṣāntiḥ | bodhisattvaścaritvā	evam-aparipUrita-pratyavekzaNa-ucyate anvayakzAntiH | boDisattvaH-caritvA
   śraddhākṣānti manvayakṣānti cāciraṃ purayatyanuttarāṃ dharmakṣāntim ||	SradDA-kzAnti manu-aya-kzAnti ca-aciram purayati-anuttarAm Darma-kzAntim ||
   (iti bodhicittotpādasūtraśāstre śūnyālakṣaṇaṃ nāmaikādaśo vargaḥ ||)	(iti boDi-citta-utpAda-sUtra-SAstre SUnyAlakzaNam nAma-ekAdaSaH vargaH ||)
   dvādaśo vargaḥ	dvAdaSaH vargaH
   puṇyaparigrahaḥ	puNya-parigrahaH
   1 | bodhisattvasyālakṣaṇacittamācaritasyāpi cittaṃ na karmamu pratiṣṭhitaṃ	1 | boDisattvasya-alakzaNa-cittam-Acaritasya-api cittam na karmamu pratizWitam
   bhavati | karmalakṣaṇāni jānannapi karoti karmāṇi | kuśalamūlamācarituṃ	Bavati | karma-lakzaNAni jAnan=-api karoti karmANi | kuSala-mUlam-Acaritum
   bodhimamisamboddhuṃ na parityajati saṃskṛtam | satvārthaṃ caranmahākaruṇāṃ	boDi-mami-sambodDum na parityajati saMskRtam | satva-arTam caran-mahA-karuNAm
   nādhitiṣṭhatyasaṃskṛtam | sarvabuddhasamyakprajñārthaṃ na parityajati	na-aDitizWati-asaMskRtam | sarva-budDa-samyak-prajQA-arTam na parityajati
   jātimaraṇaṃ nirvāpayitumaparyantānsattvānanupadhinirvāṇadhātau	jAti-maraNam nirvApayitum-aparyantAn-sattvAn-anupaDi-nirvANa-DAtO
   nādhitiṣṭhati nirvāṇamityucyate bodhisattvasya mahāsattvasya gambhīraṃ	na-aDitizWati nirvANam-iti-ucyate boDisattvasya mahAsattvasya gamBIram
   cittamabhisamboddhamanuttarāṃ samyaksambodhim ||	cittam-aBisamba-udDam-anuttarAm samyaksamboDim ||
   2 | buddhaputrā bodhisattvaḥ paripūrati daśa dharmānna ca pratyāvartate	2 | budDa-putrAH boDisattvaH paripUrati daSa DarmAt-na ca pratyAvartate
   'nuttarāyāḥ samyaksambodheḥ | katame daśa | pathamaṃ bodhisattvo	anuttarAyAH samyaksamboDeH | katame daSa | paTamam boDisattvaH-
   gambhīramutpādayati bodhicittaṃ sattvānapi śikṣayatyutpādayituṃ cittam |	gamBIram-utpAdayati boDi-cittam sattvAn-api Sikzayati-utpAdayitum cittam |
   dvitīyaṃ nityamabhinandantathāgataṃ priyadānena pūjayati gambhīraṃ	dvitIyam nityam-aBinandan-taTAgatam priya-dAnena pUjayati gamBIram
   cavaropayati kuśalamūlam | tṛtīyaṃ dharmāngaveṣayituṃ gauravacittena	cavaropayati kuSala-mUlam | tRtIyam DarmAn-gavezayitum gOrava-cittena
   pūjayati dharmagurūndharmaḥ śṛṇvanna ca pariśrāgyati | caturthaṃ	pUjayati Darma-gurUn-DarmaH SRNvan-na ca pariSrAgyati | caturTam
   paśyanbhikṣusaṃghaṃ bhinnaṃ dvidhāvibhaktaṃ paramparaṃ vivadamānaṃ	paSyan-Bikzu-saMGam Binnam dviDA-viBaktam paramparam vivadamAnam
   bhaṇḍanaṃ kurvāṇaṃ gavepayatyupāyaṃ saṃgamayati ca | pañcamaṃ paśyannāṣṭre	BaNxanam kurvANam gavepayati-upAyam saMgamayati ca | paQcamam paSyat-nAzwre
   vardhamānānyaśubhāni kṣīyamāṇānbuddhadharmāndeśayati tathā vācayati	varDamAnAni-aSuBAni kzIyamANAn-budDa-DarmAn-deSayati taTA vAcayati
   yāvadekāmapi gāthāṃ yenānucchinno bhavati dharmaḥ | ekacittaṃ paripālayati	yAvat-ekAm-api gATAm yena-anucCinnaH Bavati DarmaH | ekacittam paripAlayati
   dharmaṃ na ca gaṇayati kāyajīvitam | ṣaṣṭhaṃ paritrāyate	Darmam na ca gaNayati kAya-jIvitam | zazWam paritrAyate
   sattvānpaśyanmītānduḥkhitāndadāti cābhayam | saptamaṃ janayati caryotsāhaṃ	sattvAn-paSyan-mItAn-duHKitAn-dadAti ca-aBayam | saptamam janayati caryA-utsAham
   gaveṣayati caivaṃ mahāyāanaṃ vaipulyamatigambhīraṃ sūtradharmaṃ	gavezayati ca-evam mahA-yAanam vEpulyam-ati-gamBIram sUtra-Darmam
   bodhisattvapiṭakam | aṣṭamaṃ labdhvemāndharmāndhārayati vācayati	boDisattva-piwakam | azwamam labDvA-imAn-DarmAn-DArayati vAcayati
   paryavāpnotiyathābhāṣitamācarati yathābhāṣitamavatiṣṭhate | navamaṃ	paryavApnoti-yaTA-BAzitam-Acarati yaTABAzitam-avatizWate | navamam
   dharmamadhitiṣṭhannutsāhayati bahutarasattvānpraveṣṭuṃ dharme | daśamaṃ	Darmam-aDitizWan=-utsAhayati bahutara-sattvAn-pravezwum Darme | daSamam
   dharme praveśya prakāśayansaṃdarśayaṃllābhaprāmodyavavodhayati sattvān |	Darme praveSya prakASayan-saMdarSayan=-lABa-prAmodi-avavoDayati sattvAn |
   bodhisattvaḥ paripūryemāndāśadharmānanuttarāyā bodhe rna pratinivartate ||	boDisattvaH paripUryemAndASa-DarmAn-anuttarAyAH boDe rna pratinivartate ||
   3 | bodhisattvenācaritavyamevamidaṃsūtram | acintyaṃ khalvevaṃvidhaṃ	3 | boDisattvena-Acaritavyam-evam-idaMsUtram | acintyam Kalu-evaMviDam
   sūtraṃ yajjanayati sarvamahāmaitrīkaruṇābījam | idaṃ sūtraṃ	sUtram yat-janayati sarva-mahA-mEtrI-karuNA-bIjam | idam sUtram
   cittamutpādayituṃ nayati cāvabodhayati ca baddhasattvān | idaṃ	cittam-utpAdayitum nayati ca-avaboDayati ca badDa-sattvAn | idam
   sūtramutpādahetu rbodhimabhisaṃprasthitānām | ida sūtraṃ paripūrakaṃ	sUtram-utpAda-hetu rboDim-aBisaMprasTitAnAm | ida sUtram paripUrakam
   sarvabodhisattvānāmakṣomyacaryāyāḥ | idaṃ	sarva-boDisattvAnAm-akzomya-caryAyAH | idam
   sūtramatītānāgatapratyutpannabuddhairanuparigṛhītam | kulaputrāḥ	sUtram-atIta-anAgata-pratyutpanna-budDEH-anuparigRhItam | kula-putrAH
   kuladuhitaraścetkāmayante saṃgrahītumanuttarāṃ bodhi deśayitavyamevaṃ	kula-duhitaraH-ced-kAmayante saMgrahItum-anuttarAm boDi deSayitavyam-evam
   rūpaṃ sūtraṃ | jaṃbūdvīpe 'nucchedāya [buddhadharmāṇāṃ] aprayeyā	rUpam sUtram | jaMbUdvIpe anucCedAya [budDa-DarmANAn] aprayeyA
   aparyantāḥ sattvāḥ śṛṇvantvidaṃ sūtram | kulaputrāḥ	aparyantAH sattvAH SRNvantu-idam sUtram | kula-putrAH
   kuladuhitaraścecchṛṇvantīdaṃ sūtraṃ labhante 'cintyamatītīkṣṇaṃ	kula-duhitaraH-ced-SRNvanti-idam sUtram laBante acintyamatItIkzNam
   mahāprajñāvyūhamaprameyaṃ ca puṇyaphalavipākam | tat kasya hetoḥ | idaṃ	mahA-prajQA-vyUham-aprameyam ca puNya-Pala-vipAkam | tat kasya hetoH | idam
   sūtraṃ vivṛṇotyaprameyaṃ supariśuddhaṃ prajñānennaṃ karoti buddhavijaṃ	sUtram vivRNoti-aprameyam su-pariSudDam prajQAna-innam karoti budDa-vijam
   nirantaramanucchinnam | paripālayati sattvānaprameyaduḥkhaduḥkhitān |	nirantaram-anucCinnam | paripAlayati sattvAn-aprameya-duHKa-duHKitAn |
   avabhāsayati sarvamavidyāmohāndhakāram | bhinatti caturo mārānmārakarmāṇi	avaBAsayati sarvam-avidyA-moha-anDakAram | Binatti caturaH mArAn-mAra-karmANi
   ca | nāśāyati sarva tīrthikāṇāṃ mithyādṭaṣṭim | nirvāpayati sarvaṃ	ca | nASAyati sarva tIrTikANAm miTyAt-wazwim | nirvApayati sarvam
   kleśamahājvanalam | apanayati [avidyā-]pratyayajanitānsaṃskārān | chinatti	kleSa-mahA-jvanalam | apanayati [avidyA-]pratyaya-janitAn-saMskArAn | Cinatti
   lobhaṃ mātsaryaṃ śīlabhedaṃ dveṣaṃ kausīdyaṃ vikṣepaṃ mūḍhatāṃ (ca) ṣaḍ	loBam mAtsaryam SIlaBedam dvezam kOsIdyam vikzepam mUXa-tAm (ca) zaz-
   guruvyādhīn | apanayati karmāvaraṇaṃ vipakāvaraṇaṃ kleśāvaraṇaṃ	guru-vyADIn | apanayati karma-AvaraNam vipaka-AvaraNam kleSa-AvaraNam
   dṭaṣṭyāvaraṇamavidyāvaraṇaṃ jñānāvaraṇaṃbhāvānāvaraṇaṃ | saṃkṣepata ucyate	dwazwi-AvaraNam-avidyA-AvaraNam jQAna-AvaraNaMBAvAn-AvaraNam | saMkzepataH ucyate
   | idaṃ sūtraṃ nirvāpayati niravaśeṣaṃ sarvākuśaladharmān | samedhayati	| idam sUtram nirvApayati niravaSezam sarva-akuSala-DarmAn | sameDayati
   sarvakuśaladharmāgniskandham | kulaputrāḥ kuladuhitaraścetsūtramidaṃ	sarva-kuSala-Darma-agni-skanDam | kula-putrAH kula-duhitaraH-ced-sUtram-idam
   śrutvārocayantyanumodayantyāścaryacittamutpādayanti jñātavyaṃ taiḥ pūjitā	SrutvA-Arocayanti-anumodayanti-AScarya-cittam-utpAdayanti jQAtavyam tEH pUjitA
   aprameyā buddhāḥ | gambhīramavaropitaṃ kuśalamūlam | tatkasya hetoḥ asya	aprameyAH budDAH | gamBIram-avaropitam kuSala-mUlam | tat-kasya hetoH asya
   sūtrasya triṣvadhvasu buddhairācaritatvādyaḥ khalu (mārgā-)vacaraḥ śṛṇoti	sUtrasya trizu-aDvasu budDEH-Acarita-tvAt-yaH Kalu (mArga-a-)vacaraH SRNoti
   cedaṃ sūtraṃ svātmānaṃ dhanyaṃ manyate | labhate ca mahākuśalalābham | yaḥ	ca-idam sUtram sva-AtmAnam Danyam manyate | laBate ca mahA-kuSala-lABam | yaH
   kaścillikhatīdaṃ vācayatīdaṃ sūtraṃ jñātavyaṃ sa puruṣaḥ	kaScid-liKati-idam vAcayati-idam sUtram jQAtavyam sa puruzaH
   prāpnotyaprameyamaparyantaṃ puṇyaphalavipākam | tatkasya hetoḥ | asya	prApnoti-aprameyam-aparyantam puNya-Pala-vipAkam | tat-kasya hetoH | asya
   sūtrasyāparyantā	sUtrasya-aparyantA
   lambanatvādapramayamahāpraṇidhānotpādakatvātsarvasattvānugrāhakatvādanuttarasambodhiniṣpādakatvāllabdhaḥ	lambana-tvAt-apramaya-mahA-praNiDAna-utpAdaka-tvAt-sarva-sattva-anugrAhaka-tvAt-anuttara-samboDi-nizpAdaka-tvAt-labDaH
   puṇyaphalavipāko 'pyevayameyaḥ | yadi kaścidavabudhyārthaṃ tathācarati	puNya-Pala-vipAkaH api-evayameyaH | yadi kaScid-avabuDya-arTam taTA-Acarati
   yathā sarvabuddhairasaṃkhyeyeṣu kalpeṣvakṣayaprajñayā bhāṣitaṃ tasya	yaTA sarva-budDEH-asaMKyeyezu kalpezu-akzaya-prajQayA BAzitam tasya
   puṇyaphalavipāko 'pyakṣayo bhavati | yasminpradeśe dharmaśāstā deśayatīdaṃ	puNya-Pala-vipAkaH api-akzayaH Bavati | yasmin-pradeSe Darma-SAstA deSayati-idam
   sūtraṃ jñātavyaṃ tasminpradeśe stūpaḥ kārayitavyaḥ | kasmāt |	sUtram jQAtavyam tasmin-pradeSe stUpaH kArayitavyaH | kasmAt |
   samyagdharmasya tatra janitatvāt | edaṃ sūtraṃ yasmindeśe nagarai grāme	samyak-Darmasya tatra janita-tvAt | edam sUtram yasmin-deSe nagarEH grAme
   vihāre kuṭayāṃ vā bhavati jñātavyaṃ tatra bhavati [3 tathāgatasya]	vihAre kuwayAm vA Bavati jQAtavyam tatra Bavati [3 taTAgatasya]
   dharmakāyaḥ | yadi puruṣaḥ pūjayati gandhapuṣpaiḥ saṃgītena vitānena	Darma-kAyaH | yadi puruzaH pUjayati ganDa-puzpEH saMgItena vitAnena
   camaracchatrairgītaiḥ stautrairnamaskāraiḥ jñātavyaṃ sa puruṣa buddhabījaṃ	camara=-CatrEH-gItEH stOtrEH-namaskArEH jQAtavyam sa puruza budDa-bIjam
   bahulikaroti ki punarvaktavyaṃ yo niravaśeṣaṃ gṛhṇati dhārayati sūtramidam	bahulikaroti ki punar-vaktavyam yaH niravaSezam gRhNati DArayati sUtram-idam
   | sa puruṣaḥ pūrayati puṇyaprajñāniṣpattimanāgate 'dhvani labhate	| sa puruzaH pUrayati puNya-prajQA-nizpattim-anAgate aDvani laBate
   vyākaraṇaṃ prāpnityanuttarāṃ samyaksambodhim ||	vyAkaraNam prApniti-anuttarAm samyaksamboDim ||
   (iti bodhicittotpādasūtraśāstre puṇyaparigraho nāma dvādaśo vargaḥ ||)	(iti boDi-citta-utpAda-sUtra-SAstre puNyaparigrahaH nAma dvAdaSaH vargaH ||)
   pariniṣṭhitaṃ bodhicittotpādasūtraśāstram ||	parinizWitam boDi-citta-utpAda-sUtra-SAstram ||
