   (Matsumura 186)	(MatsumuraH 186)
   uddānam* //	uddAnam* //
   sāketena hi kasyacid vitaritaṃ marditaṃ (276r1 = GBM 6.864) ca kālena	sAketena hi kasyacid vitaritam marditam (276r1  GBm 6.864) ca kAlena
   pudgalo mātṛkāpadāny akṛtena viṃśatiḥ karaṇīyena dvādaśikā	pudgalaH mAtRkA-padAni akRtena viMSatiH karaNIyena dvAdaSikA
   (Matsumura 187)	(MatsumuraH 187)
   sāketena varṣopagatā śāstur darśanakāmyayā .	sAketena varza-upagatA SAstuH darSana-kAmyayA .
   kardame uṣṇena klāntānāṃ cīvaraṃ tatra sammatam* // //	kardame uzNena klAntAnAm cIvaram tatra sammatam* // //
   Kaṭhina-v 1. buddho bhagavāṃ śrāvastyāṃ varṣā upagato jetavane	KaWina-u 1. budDaH BagavAm SrAvastyAm varzAH upagataH jetavane
   'nāthapiṇḍadasyārāme / tena khalu samayena saṃbahulā bhikṣavaḥ sākete	anATapiNxadasya-ArAme / tena Kalu samayena saMbahulA BikzavaH sAkete
   varṣopagatās trayāṇāṃ vārṣikāṇāṃ māsānām atyayāt kṛtacīvarā	varza-upagatAH trayANAm vArzikANAm mAsAnAm atyayAt kRta-cIvarA
   niṣṭhitacīvarāḥ samādāya pātracīvaraṃ bahutṛṇe bahukardame uṣṇena	nizWita-cIvarAH samAdAya pAtra-cIvaram bahu-tRNe bahu-kardame uzNena
   klāmyantaḥ svedaparyākulīkṛtaśarīrā yena śrāvastīṃ tena cārikāṃ carantaḥ	klAmyantaH sveda-paryAkulIkRta-SarIrAH yena SrAvastIm tena cArikAm carantaH
   śrāvastīm anuprāptāḥ atha saṃbahulā bhikṣavaḥ pātracīvaraṃ pratiśamayya	SrAvastIm anuprAptAH aTa saMbahulA BikzavaH pAtra-cIvaram pratiSamayya
   pādau prakṣālya yena bhagavāṃs tenopasaṃkrāntā upasaṃkramya bhagavataḥ	pAdO prakzAlya yena BagavAn tena-upasaMkrAntAH upasaMkramya BagavataH
   pādau śirasā vanditvā ekānte niṣaṇṇāḥ	pAdO SirasA vanditvA ekAnte nizaNNAH
   (Matsumura 188)	(MatsumuraH 188)
   Kaṭhina-v 2. dharmatā khalu buddhā bhagavanta āgantukān bhikṣūn anayā	KaWina-u 2. DarmatA Kalu budDAH BagavantaH AgantukAn BikzUn anayA
   pratisaṃmodanayā pratisaṃmodante / kuto yūyaṃ bhikṣava etarhy āgacchata :	pratisaMmodanayA pratisaMmodante / kutas yUyam BikzavaH etarhi AgacCata :
   kutra vā stha varṣā uṣitā iti pratisaṃmodate bhagavān āgantukān bhikṣūn	kutra vA sTa varzAH uzitAH iti pratisaMmodate BagavAn AgantukAn BikzUn
   anayā pratisaṃmodanayā sukhaṃ sparśaṃ varṣā nayā kuto yūyaṃ bhikṣava	anayA pratisaMmodanayA suKam sparSam varzA nayA kutas yUyam Bikzava
   etarhy āgacchatha kutra vā stha varṣā uṣitāḥ te kathayaṃti sāketād vayaṃ	etarhi AgacCaTa kutra vA sTa varzAH uzitAH te kaTayaMti sAketAt vayam
   bhadant'; etarhy āgacchāma sākete vā sma varṣā uṣitāḥ kaccid yūyaṃ	Badant-a; etarhi AgacCAma sAkete vA sma varzAH uzitAH kaccit yUyam
   bhikṣavaḥ sākete sukhaṃ sparśaṃ varṣā uṣitā na vā stha klāntāḥ piṇḍakena	BikzavaH sAkete suKam sparSam varzAH uzitAH na vA sTa klAntAH piNxakena
   tathyaṃ vayaṃ bhadanta (Matsumura 189) sāketa sukhaṃ sparśaṃ varṣā uṣitā	taTyam vayam Badanta (MatsumuraH 189) sAketa suKam sparSam varzA uzitA
   na vā smaḥ klāntāḥ piṇḍakenāpi tu vayaṃ samādāya pātracīvaraṃ bahutṛṇe	na vA smaH klAntAH piNxakena-api tu vayam samAdAya pAtra-cIvaram bahu-tRNe
   bahukardame uṣṇena klāmyantaḥ svedaparyākulīkṛtaśarīrā janapadacārikāṃ	bahu-kardame uzNena klAmyantaH sveda-paryAkulIkRta-SarIrAH janapada-cArikAm
   carantaḥ kṛcchreṇehānuprāptāḥ	carantaH kRcCreNa-iha-anuprAptAH
   Kaṭhina-v 3. bhagavān saṃlakṣayati / klāmyanti bata me śrāvakāḥ samādāya	KaWina-u 3. BagavAn saMlakzayati / klAmyanti bata me SrAvakAH samAdAya
   pātracīvaraṃ bahutṛṇe bahukardame uṣṇena klāmyanti	pAtra-cIvaram bahu-tRNe bahu-kardame uzNena klAmyanti
   svedaparyākulīkṛtaśarīrā janapadacārikāṃ caranto yanv ahaṃ bhikṣūṇāṃ	sveda-paryAkulIkRta-SarIrAH janapada-cArikAm carantaH yanu aham BikzUNAm
   sparśavihārārthaṃ dātrīṇāṃ ca deyadharmaparibhogārthaṃ bhikṣūṇāṃ kaṭhinam	sparSa-vihAra-arTam dAtrINAm ca deya-Darma-pariBoga-arTam BikzUNAm kaWinam
   anujānīyaṃ / yasmāt paṃcānuśaṃsāḥ kaṭhināstare na daśāhaparamaṃ na	anujAnIyam / yasmAt paMca-anuSaMsAH kaWina-Astare na daSa-Aha-paramam na
   māsaparamaṃ na rātrivipravāsāḥ sāntarottareṇa cīvareṇa janapadacārikāṃ	mAsa-paramam na rAtri-vipra-vAsAH sa-antara-uttareNa cIvareNa janapada-cArikAm
   (Matsumura 190) prakramaṇaṃ yāvadaptaṃ vikalpitacīvaradhāraṇam iti / apare	(MatsumuraH 190) prakramaNam yAvat-aptam vikalpita-cIvara-DAraNam iti / apare
   'pi paṃcānuśaṃsāḥ / na gaṇabhojanaṃ na (Matsumura 191) paraṃparabhojanaṃ	api paMca-anuSaMsAH / na gaNa-Bojanam na (MatsumuraH 191) paraMpara-Bojanam
   na kuleṣv ānimantritacārikā yāvadāptaṃ cīvaraparyeṣaṇaṃ (Matsumura 192)	na kulezu Ani-mantrita-cArikA yAvat-Aptam cIvara-paryezaNam (MatsumuraH 192)
   kārtikān māsād yāvat phālguno māso atrāntarāt sāstṛtakaṭhinānāṃ lābha iti	kArtikAn mAsAt yAvat PAlgunaH mAsaH atra-antarAt sa-AstRta-kaWinAnAm lABaH iti
   viditvā bhikṣūn āmantrayate sma / tasmāt tarhi bhikṣavo 'nujānāmi	viditvA BikzUn Amantrayate sma / tasmAt tarhi BikzavaH anujAnAmi
   bhikṣūṇāṃ sparśavihārārthaṃ dātrīṇāṃ ca deyadharmaparibhogārthaṃ	BikzUNAm sparSa-vihAra-arTam dAtrINAm ca deya-Darma-pariBoga-arTam
   varṣoṣitair bhikṣubhiḥ kaṭhinam āstartavyaṃ yasmāt paṃcānuśaṃsāḥ kaṭhine	varza-uzitEH BikzuBiH kaWinam Astartavyam yasmAt paMca-anuSaMsAH kaWine
   na daśāhaparamaṃ pūrvavad yāvad āstṛtakaṭhinānāṃ lābha iti	na daSa-aha-paramam pUrvavat yAvat AstRta-kaWinAnAm lABaH iti
   Kaṭhina-v 4. uktaṃ bhagavatā kaṭhinam āstartavyam iti bhikṣavo na jānate	KaWina-u 4. uktam BagavatA kaWinam Astartavyam iti BikzavaH na jAnate
   katham (Matsumura 193) āstartavyam iti / bhagavān āha / yad varṣoṣitasya	kaTam (MatsumuraH 193) Astartavyam iti / BagavAn Aha / yat varza-uzitasya
   saṃghasya cīvaralābhaḥ saṃpadyate tasmād āstartavyaṃ evaṃ ca punar	saMGasya cIvara-lABaH saMpadyate tasmAt Astartavyam evam ca punar-
   āstartavyaṃ pūrvavat* sāmagryam ārocayitavyaṃ idaṃ cīvaraṃ varṣoṣitasya	Astartavyam pUrvavat* sAmagryam Arocayitavyam idam cIvaram varza-uzitasya
   saṃghasya cīvaralābhaḥ saṃpannaḥ yadi saṃghasyābhirucitam anena cīvareṇa	saMGasya cIvara-lABaH saMpannaH yadi saMGasya-aBirucitam anena cIvareNa
   saṃghasya kaṭhinam (276v1 = GBM 6.865) āstariṣyati / tataḥ paścād	saMGasya kaWinam (276v1  GBm 6.865) Astarizyati / tatas paScAt-
   aparasmin divase śayanāsanaprajñaptiṃ kṛtvā gaṇḍīm ākoṭya pṛṣtavācikayā	aparasmin divase Sayana-Asana-prajQaptim kRtvA gaNxIm Akowya pRzta-vAcikayA
   bhikṣūṃ (Matsumura 194) samanuyujya sarvasaṃghe sanniṣaṇṇe sannipatite	BikzUm (MatsumuraH 194) samanuyujya sarva-saMGe sannizaNNe sannipatite
   ekena bhikṣuṇā jñaptiṃ kṛtvā karma kartavyam .	ekena BikzuNA jQaptim kRtvA karma kartavyam .
   Kaṭhina-v 5. śṛṇotu bhadantāḥ saṃgha idaṃ cīvaraṃ varṣoṣitasya saṃghasya	KaWina-u 5. SRNotu BadantAH saMGaH idam cIvaram varza-uzitasya saMGasya
   cīvaralābhaḥ saṃpannaḥ saṃghasya kaṭhinam abhirucitaṃ anena cīvareṇa	cIvara-lABaH saMpannaH saMGasya kaWinam aBirucitam anena cIvareNa
   kaṭhinam āstarituṃ / yenāstīrṇakaṭhinād āvāsāt prakrāmantaḥ (Matsumura	kaWinam Astaritum / yena-AstIrNa-kaWinAt AvAsAt prakrAmantaH (Matsumura
   195) purāṇacīvarāṇāṃ apy avipravāso bhaviṣyati prāg eva navakānāṃ sacet	195) purANa-cIvarANAm api avipravAsaH Bavizyati prAk eva navakAnAm saced-
   saṃghasya prāptakālaṃ kṣametānujānīyāt saṃgho yat saṃghaḥ idaṃ cīvaraṃ	saMGasya prApta-kAlam kzameta-anujAnIyAt saMGaH yat saMGaH idam cIvaram
   kaṭhinārthaṃ saṃmanyetānena cīvareṇa saṃghasya kaṭhinam āstariṣyati	kaWina-arTam saMmanyeta-anena cIvareNa saMGasya kaWinam Astarizyati
   yenāstīrṇakaṭhinād āvāsāt* prakrāmantaḥ purāṇacīvarāṇām apy avipravāso	yena-AstIrNa-kaWinAt AvAsAt* prakrAmantaH purANa-cIvarANAm api avipravAsaH-
   bhaviṣyati prāg eva navakānām ity eṣā jñaptiḥ // evaṃ ca karma kartavyaṃ	Bavizyati prAk eva navakAnAm iti ezA jQaptiH // evam ca karma kartavyam
   Kaṭhina-v 6. śṛṇotu bhadantāḥ saṃgha idaṃ cīvaraṃ varṣoṣitasya saṃghasya	KaWina-u 6. SRNotu BadantAH saMGaH idam cIvaram varza-uzitasya saMGasya
   cīvaralābhaḥ saṃpannaḥ saṃghasya cābhirucitaṃ kaṭhinaṃ kartuṃ tat saṃgha	cIvara-lABaH saMpannaH saMGasya ca-aBirucitam kaWinam kartum tat saMGa
   idaṃ cīvaraṃ kaṭhinārthaṃ saṃmanyate anena cīvareṇa saṃghasya kaṭhinam	idam cIvaram kaWina-arTam saMmanyate anena cIvareNa saMGasya kaWinam
   āstariṣyati yenāstīrṇakaṭhinād āvāsāt prakrāmataḥ purāṇacīvarakāṇām apy	Astarizyati yena-AstIrNa-kaWinAt AvAsAt prakrAmataH purANa-cIvarakANAm api-
   avipravāso bhaviṣyati prāg eva navakānāṃ (Matsumura 196) yeṣām āyuṣmatāṃ	avipravAsaH Bavizyati prAk eva navakAnAm (MatsumuraH 196) yezAm AyuzmatAm
   kṣamate idaṃ cīvaraṃ kaṭhinārthaṃ saṃmantum anena cīvareṇa saṃghasya	kzamate idam cIvaram kaWina-arTam saMmantum anena cIvareNa saMGasya
   kaṭhinam āstariṣyati yenāstīrṇakaṭhinād āvāsāt prakramataḥ	kaWinam Astarizyati yena-AstIrNa-kaWinAt AvAsAt prakramataH
   purāṇacīvarakāṇām apy avipravāso bhaviṣyati prāg eva navakānāṃ sa tūṣṇīṃ	purANa-cIvarakANAm api avipravAsaH Bavizyati prAk eva navakAnAm sa tUzNIm
   na kṣamate bhāṣantāṃ saṃmataḥ saṃghena idaṃ cīvaraṃ kaṭhinārtham anena	na kzamate BAzantAm saMmataH saMGena idam cIvaram kaWina-arTam anena
   cīvareṇa saṃghasya kaṭhinam āstariṣyati yenāstīrṇakaṭhinād āvāsāt*	cIvareNa saMGasya kaWinam Astarizyati yena-AstIrNa-kaWinAt AvAsAt-*
   prakrāmataḥ purāṇacīvarakāṇām apy avipravāso bhaviṣyati prāg eva navakānāṃ	prakrAmataH purANa-cIvarakANAm api avipravAsaH Bavizyati prAk eva navakAnAm
   kṣāntam anujñātaṃ saṃghena yasmāt tūṣṇīṃ evam etad dhārayāmi	kzAntam anujQAtam saMGena yasmAt tUzNIm evam etat DArayAmi
   Kaṭhina-v 7. tataḥ paścāt kaṭhināstārako bhikṣuḥ saṃmantavyaḥ paṃcabhir	KaWina-u 7. tatas paScAt kaWinAH-tArakaH BikzuH saMmantavyaH paMcaBiH-
   dharmaiḥ samanvāgataḥ kaṭhināstārako bhikṣur asaṃmato na saṃmantavyaḥ	DarmEH samanvAgataH kaWinAH-tArakaH BikzuH asaMmataH na saMmantavyaH
   saṃmataś cāvakāśayitavyaḥ katamaiḥ paṃcabhiḥ avarṣiko varṣachinnakaḥ	saMmataH ca-avakASayitavyaH katamEH paMcaBiH avarzikaH varza-CinnakaH
   (Matsumura 197) paścimakāṃ varṣām upagato anyatra varṣoṣitaḥ śikṣādattakaḥ	(MatsumuraH 197) paScimakAm varzAm upagataH anyatra varza-uzitaH SikzAdattakaH
   apare api paṃca na saṃmantavyāḥ pārivāsika mūlapārivāsika mānāpya	apare api paMca na saMmantavyAH pArivAsika mUla-pArivAsika mAnApi-a
   mūlamānāpyacāra utkṣiptakaḥ apare paṃca na saṃmantavyā cchandād gacchati	mUla-mAnA-api-acAraH utkziptakaH apare paMca na saMmantavyA cCandAt gacCati
   dveṣāṃ mohād bhayād gacchati āstṛtaṃ cānāstṛtaṃ kaṭhinaṃ na jānāti :	dvezAm mohAt BayAt gacCati AstRtam ca-anAstRtam kaWinam na jAnAti :
   paṃcabhis tu dharmaiḥ samanvāgataḥ kaṭhināstārako bhikṣur asaṃmataś ca	paMcaBiH tu DarmEH samanvAgataH kaWinAH-tArakaH BikzuH asaMmataH ca
   saṃmantavyaḥ saṃmataś ca nāvakāśayitavyaḥ katamaiḥ paṃcabhiḥ na cchandād	saMmantavyaH saMmataH ca na-avakASayitavyaH katamEH paMcaBiH na cCandAd
   gacchati na dveṣān na mohān na bhayād gacchati āstṛtānāstṛtaṃ ca kaṭhinaṃ	gacCati na dvezAt na mohAt na BayAt gacCati AstRta-anAstRtam ca kaWinam
   jānāti	jAnAti
   Kaṭhina-v 8. evaṃ ca punaḥ saṃmantavyaḥ śayanāsanaprajñaptiṃ kṛtvā	KaWina-u 8. evam ca punar saMmantavyaH Sayana-Asana-prajQaptim kRtvA
   pūrvavad (Matsumura 198) yāvad utsāhayitavyaḥ utsahase tvam evaṃnāmā	pUrvavat (MatsumuraH 198) yAvat utsAhayitavyaH utsahase tvam evaMnAmA
   saṃghasya kaṭhinam āstartum iti saced utsahate tena vaktavyaṃ utsahed iti	saMGasya kaWinam Astartum iti saced utsahate tena vaktavyam utsahet iti
   / tataḥ paścād ekena bhikṣuṇā jñaptiṃ kṛtvā karma kartavyam*	/ tatas paScAt ekena BikzuNA jQaptim kRtvA karma kartavyam*
   Kaṭhina-v 9a. śṛṇotu bhadantāḥ saṃgha ayam evaṃnāmā kaṭhināstārako bhikṣur	KaWina-u 9a. SRNotu BadantAH saMGa ayam evaMnAmA kaWinAH-tArakaH BikzuH-
   utsahate saṃghasya kaṭhinam āstartuṃ sacet saṃghasya prāptakālaṃ	utsahate saMGasya kaWinam Astartum saced saMGasya prApta-kAlam
   kṣametānujānīyāt saṃgho (277r1 = GBM 6.866) yat saṃghaḥ evaṃnāmānaṃ	kzameta-anujAnIyAt saMGaH (277r1  GBm 6.866) yat saMGaH evaMnAmAnam
   kaṭhināstārakaṃ saṃmanyeta evaṃnāmā kaṭhināstarakaḥ saṃghasya kaṭhinam	kaWinAH-tArakam saMmanyeta evaMnAmA kaWina-AstarakaH saMGasya kaWinam
   āstariṣyatīti eṣā jñaptiḥ evaṃ ca karma kartavyaṃ	Astarizyati-iti ezA jQaptiH evam ca karma kartavyam
   (Matsumura 199)	(MatsumuraH 199)
   Kaṭhina-v 9b. śṛṇotu bhadantāḥ saṃghaḥ ayam evaṃnāmā kaṭhināstāraka utsahe	KaWina-u 9b. SRNotu BadantAH saMGaH ayam evaMnAmA kaWinAH-tArakaH utsahe
   saṃghasya kaṭhinam āstartuṃ tat saṃgha evaṃnāmānaṃ kaṭhināstārakaṃ	saMGasya kaWinam Astartum tat saMGaH evaMnAmAnam kaWinAH-tArakam
   saṃmanyeta ayam evaṃnāmā kaṭhināstarakaḥ saṃghasya kaṭhinam āstariṣyati	saMmanyeta ayam evaMnAmA kaWina-AstarakaH saMGasya kaWinam Astarizyati
   yeṣām āyuṣmatāṃ kṣamate evaṃnāmānaṃ kaṭhināstārakaṃ saṃmantuṃ evaṃnāmā	yezAm AyuzmatAm kzamate evaMnAmAnam kaWinAH-tArakam saMmantum evaMnAmA
   kaṭhināstārakaḥ saṃghasya kaṭhinam āstariṣyati te tūṣṇīṃ na kṣamate	kaWinAH-tArakaH saMGasya kaWinam Astarizyati te tUzNIm na kzamate
   bhāṣantāṃ saṃmataḥ saṃghena evaṃnāmā kaṭhināstārakaḥ saṃghasya kaṭhinam	BAzantAm saMmataH saMGena evaMnAmA kaWinAH-tArakaH saMGasya kaWinam
   āstariṣyati kṣāntam anujñātaṃ saṃghena yasmāt tuṣṇīm evam etad dhārayāmi	Astarizyati kzAntam anujQAtam saMGena yasmAt tuzNIm evam etat DArayAmi
   Kaṭhina-v 10. tataḥ kaṭhināstārakasya bhikṣor jñaptyā kaṭhinaṃ	KaWina-u 10. tatas kaWinAH-tArakasya BikzoH jQaptyA kaWinam
   āstaritavyaṃ (Matsumura 200) śṛṇotu bhadantāḥ saṃgha idaṃ cīvaraṃ saṃghena	Astaritavyam (MatsumuraH 200) SRNotu BadantAH saMGaH idam cIvaram saMGena
   kaṭhinārthaṃ saṃmatam ayaṃ caivaṃnāmā kaṭhināstārako bhikṣuḥ saṃmataḥ	kaWina-arTam saMmatam ayam ca-evaMnAmA kaWinAH-tArakaH BikzuH saMmataH
   sacet saṃghasya prāptakālaṃ kṣametānujānīyāt saṃgho yat saṃghaḥ idaṃ	saced saMGasya prApta-kAlam kzameta-anujAnIyAt saMGaH yat saMGaH idam
   cīvaraṃ kaṭhinārtham evaṃnāmno bhikṣor anupradadyād ity eṣā jñaptiḥ	cIvaram kaWina-arTam evaMnAmnaH BikzoH anupradadyAt iti ezA jQaptiH
   Kaṭhina-v 11. kaṭhināstārakasyāhaṃ bhikṣor āsamudācārikāṃ dharmāṃ	KaWina-u 11. kaWinAH-tArakasya-aham BikzoH AsamudAcArikAm DarmAm
   prajñapayiṣyāmi kaṭhināstārakena bhikṣuṇā kaṭhinena sarvatra pūrvaṃgamena	prajQapayizyAmi kaWinAH-tArakena BikzuNA kaWinena sarvatra pUrvaMgamena
   bhavitavyam* dhāvatā vitaratā cchindatā sīvatā raṃjayatā antato dvau trayo	Bavitavyam* DAvatA vitaratA cCindatA sIvatA raMjayatA antatas dvO trayaH-
   vā sūcīpadakā dātavyā dvau trayo vā cittotpādā utpādayitavyaḥ	vA sUcIpadakAH dAtavyAH dvO trayaH vA citta-utpAdAH utpAdayitavyaH
   Kaṭhina-v 12. tataḥ paścād āśvayujamāse śuklapakṣapaṃcadaśyāṃ	KaWina-u 12. tatas paScAt ASvayujamAse Sukla-pakza-paMcadaSyAm
   ārocayitavyam* : (Matsumura 201) śvo 'ham āyuṣmantaḥ kaṭhinam āstariṣyāmi	Arocayitavyam* : (MatsumuraH 201) Svas aham AyuzmantaH kaWinam AstarizyAmi
   / yuṣmābhiḥ svakasvakāni cīvarāṇi pratyuddhartavyāni iti tataḥ	/ yuzmABiH sva-ka-svakAni cIvarANi pratyudDartavyAni iti tatas-
   kaṭhināstārakeṇa (Matsumura 202) bhikṣuṇā kaṭhinaṃ gandhapuṣpānvitaṃ	kaWinAH-tArakeNa (MatsumuraH 202) BikzuNA kaWinam ganDa-puzpa-anvitam
   surabhidhūpadhūpitaṃ kṛtvā śayanāsanaprajñaptiṃ kṛtvā gaṇḍīm ākoṭya	suraBi-DUpa-DUpitam kRtvA Sayana-Asana-prajQaptim kRtvA gaNxIm Akowya
   pṛṣtavācikayā bhikṣūn samanuyujya sarvasaṃghe sanniṣaṇṇe sannipatite	pRzta-vAcikayA BikzUn samanuyujya sarva-saMGe sannizaNNe sannipatite
   vṛddhānte sthāpayitavyaṃ tato vṛddhānte sthivā kaṭhinaṃ gṛhītvā vaktavyaṃ	vRdDAnte sTApayitavyam tatas vRdDAnte sTivA kaWinam gRhItvA vaktavyam
   Kaṭhina-v 13. śṛṇotu bhadantāḥ saṃgha idaṃ cīvaraṃ saṃghena kaṭhinaṃ	KaWina-u 13. SRNotu BadantAH saMGaH idam cIvaram saMGena kaWinam
   saṃmatam ahaṃ caivaṃnāmā bhikṣuḥ kaṭhināstārakaḥ so 'ham evaṃnāmā	saMmatam aham ca-evaMnAmAH BikzuH kaWinAH-tArakaH saH aham evaMnAmA
   kaṭhināstārakas tena cīvareṇa saṃghasya kaṭhinam āstariṣyāmīti / evaṃ dvir	kaWinAH-tArakaH tena cIvareNa saMGasya kaWinam AstarizyAmi-iti / evam dvis-
   api tṛr api tata āstīrya saṃghasthavirasya purastāt sthitvā evaṃ vaktavyaṃ	api tRH api tatas AstIrya saMGa-sTavirasya purastAt sTitvA evam vaktavyam
   samanvāhara sthavira idaṃ cīvaraṃ saṃghena kaṭhinaṃ (Matsumura 203)	samanvAhara sTaviraH idam cIvaram saMGena kaWinam (MatsumuraH 203)
   saṃmatam ahaṃ caivaṃnāmā kaṭhināstārakas tan mayā anena cīvareṇa saṃghasya	saMmatam aham ca-evaMnAmA kaWinAH-tArakaH tat mayA anena cIvareNa saMGasya
   kaṭhinam āstṛtam iti	kaWinam AstRtam iti
   Kaṭhina-v 14. tena vaktavyaṃ sādhv āstṛtaṃ suṣṭhv āstṛtaṃ yo 'tra lābhas	KaWina-u 14. tena vaktavyam sADu AstRtam suzWu AstRtam yaH atra lABas
   cānuśaṃsaś ca so 'smākam iti evaṃ dvir api tṛr api yāvat saṃghanavakasya	ca-anuSaMsaH ca saH asmAkam iti evam dvis api tRH api yAvat saMGanavakasya
   sarvair vaktavyaṃ sādhv āstṛtaṃ suṣṭhv āstṛtaṃ yo 'tra lābhaś cānuśaṃsaś	sarvEH vaktavyam sADu AstRtam suzWu AstRtam yaH atra lABaH ca-anuSaMsaH-
   ca so 'smākam iti .	ca saH asmAkam iti .
   Kaṭhina-v 15. kaṭhināstārakeṇa bhikṣuṇā kaṭhinaṃ gṛhītvā na prasrāvakuṭiṃ	KaWina-u 15. kaWinAH-tArakeNa BikzuNA kaWinam gRhItvA na prasrAva-kuwim
   na varcaskuṭiṃ na dhūmāgāraṃ praveṣṭavyaṃ nābhyavakāśe sthātavyaṃ na	na varcaskuwim na DUma-AgAram pravezwavyam na-aByavakASe sTAtavyam na
   bahiḥsīmāṃ gantavyaṃ saced gacchati na tasyāṃ vastavyaṃ (Matsumura 204)	bahis-si-imAm gantavyam saced gacCati na tasyAm vastavyam (MatsumuraH 204)
   kaṭhināstārako bhikṣur yathāprajñaptān āsamudācārikāṃ dharmān na samādāya	kaWinAH-tArakaH BikzuH yaTA-prajQaptAn AsamudAcArikAm DarmAt na samAdAya
   vartate sātisāro bhavati	vartate sa-atisAraH Bavati
   Kaṭhina-v 16. tataḥ kaṭhināstārakena bhikṣuṇā phālgunamāse	KaWina-u 16. tatas kaWinAH-tArakena BikzuNA PAlguna-mAse
   śuklapakṣapaṃcadaśyāṃ punar ārocayitavyaṃ śvā āyuṣmantaḥ kaṭhinam	Sukla-pakza-paMcadaSyAm punar Arocayitavyam SvAH AyuzmantaH kaWinam
   uddhariṣyāmi yūyaṃ svakasvakāni cīvarāṇy adhitiṣṭhateti / yaś ca tatra	udDarizyAmi yUyam sva-ka-svakAni cIvarANi aDitizWata-iti / yaH ca tatra
   lābhaḥ saṃpannaḥ sa saṃghena bhājayitavyaḥ //	lABaH saMpannaH sa saMGena BAjayitavyaH //
   Kaṭhina-v 17. āyuśmān upālī buddhaṃ bhagavantaṃ pṛcchati / katīnāṃ	KaWina-u 17. AyuSmAn upAlI budDam Bagavantam pRcCati / katInAm
   bhadanta kaṭhinam anāstṛtaṃ pañcānām upāliṃ avarṣikasya varṣācchinnakasya	Badanta kaWinam anAstRtam paQcAnAm upAlim avarzikasya varzAt-Cinnakasya
   paścimakāṃ (277v1 = GBM 6.867) varṣāṃ upagatasya anyatra varṣopagatasya	paScimakAm (277v1  GBm 6.867) varzAm upagatasya anyatra varza-upagatasya
   tasmiṃ kaṭhina āstīryamāṇe asaṃmukhībhūtasya / apareṣām api paṃcānām	tasmim kaWinaH AstIryamANe asaMmuKIBUtasya / aparezAm api paMcAnAm
   anāstṛtaṃ pārivāsikasya paryuṣitaparivāsasya mānāpyacārikasya	anAstRtam pArivAsikasya paryuzita-parivAsasya mAna-api-acArikasya
   caritamānāpyasya śikṣādattakasya ca	caritam-AnA-apyasya SikzAdattakasya ca
   (Matsumura 205)	(MatsumuraH 205)
   Kaṭhina-v 18. katīnāṃ bhadantaiva lābho nānuśaṃsā / pañcānām upālin	KaWina-u 18. katInAm Badanta-eva lABaH na-anuSaMsA / paQcAnAm upAlin
   avarṣikasya varṣācchinnakasya paścimakāṃ varṣām upagatasyānyatra	avarzikasya varzAt-Cinnakasya paScimakAm varzAm upagatasya-anyatra
   varṣopagatasya tasmiṃ kaṭhina astīryamāṇa saṃmukhībhūtasya / apareṣām api	varza-upagatasya tasmim kaWina astIryamANa saMmuKIBUtasya / aparezAm api
   pañcānāṃ pārivāsikasya paryuṣitaparivāsasya mānāpyacārikasya	paQcAnAm pArivAsikasya paryuzita-parivAsasya mAna-api-acArikasya
   caritamānāpyasya śikṣādattakasya ca .	caritam-AnA-apyasya SikzAdattakasya ca .
   Kaṭhina-v 19. kātīnāṃ bhadanta naiva lābho nānuśaṃsaḥ paṃcānām upāliṃ	KaWina-u 19. kAtInAm Badanta na-eva lABaH na-anuSaMsaH paMcAnAm upAlim
   adarśanāyotkṣiptakasya apratikarmaṇāyotkṣiptakasya apratinisṛṣṭe / pāpake	adarSanAya-utkziptakasya apratikarmaNAya-utkziptakasya apratinisRzwe / pApake
   dṛṣṭigate utkṣiptakasya anyatra varṣoṣitasya bhinne ca saṃghe adharme	dRzwi-gate utkziptakasya anyatra varza-uzitasya Binne ca saMGe aDarme
   pākṣikasya	pAkzikasya
   (Matsumura 206)	(MatsumuraH 206)
   Kaṭhina-v 20. saṃbahulā bhikṣavo janapadacārikāṃ carantaḥ corair muṣitās	KaWina-u 20. saMbahulAH BikzavaH janapada-cArikAm carantaH corEH muzitAH-
   te 'nupūrveṇa śrāvastīm anuprāptā bhikṣubhir dṛṣṭāḥ svāgataṃ svāgataṃ	te anupUrveNa SrAvastIm anuprAptAH BikzuBiH dRzwAH svAgatam svAgatam
   āyuṣmantaḥ kaccit sukhacaryā / kīdṛśī āyuṣmantaḥ sukhacaryā corair muṣitāḥ	AyuzmantaH kaccit suKa-caryA / kIdRSI AyuzmantaH suKa-caryA corEH muzitAH
   smaḥ / asmākam āyuṣmantaḥ prabhūto lābhaḥ saṃpannaḥ yadi kaṭhinam	smaH / asmAkam AyuzmantaH praBUtaH lABaH saMpannaH yadi kaWinam
   uddhriyate cīvarair yuṣmākaṃ saṃvibhāgaṃ kurma iti / etat prakaraṇaṃ	udDriyate cIvarEH yuzmAkam saMviBAgam kurmaH iti / etat prakaraNam
   bhikṣavo bhagavata ārocayanti bhagavān āha / tasmād anujānāmi corair	BikzavaH BagavataH Arocayanti BagavAn Aha / tasmAt anujAnAmi corEH-
   muṣitakānāṃ bhikṣūṇām arthāya kaṭhinam uddhartavyaṃ evaṃ ca punar	muzitakAnAm BikzUNAm arTAya kaWinam udDartavyam evam ca punar-
   uddhartavyaṃ śayanāsanaprajñaptiṃ kṛtvā gaṇḍīm ākoṭya pṛṣtavācikayā	udDartavyam Sayana-Asana-prajQaptim kRtvA gaNxIm Akowya pRzta-vAcikayA
   bhikṣūn samanuyujya sarvasaṃghe sanniṣaṇṇe sannipatite ekena bhikṣuṇā	BikzUn samanuyujya sarva-saMGe sannizaNNe sannipatite ekena BikzuNA
   jñaptiṃ kṛtvā karma kartavyam*	jQaptim kRtvA karma kartavyam*
   Kaṭhina-v 21. śṛṇotu bhadantāḥ saṃgha yāvad evāsminn āvāse samagreṇa	KaWina-u 21. SRNotu BadantAH saMGa yAvat eva-asmin AvAse samagreNa
   saṃghena kaṭhinam āstṛtaṃ saṃbahulāś ca bhikṣavaḥ corair muṣitā āgatāḥ	saMGena kaWinam AstRtam saMbahulAH ca BikzavaH corEH muzitAH AgatAH
   sacet saṃghasya prāptakālaṃ kṣametānujānīyāt saṃgho yat saṃghaś corair	saced saMGasya prApta-kAlam kzameta-anujAnIyAt saMGaH yat saMGaH corEH-
   muṣitakānāṃ bhikṣūṇām arthāya kaṭhinam uddhared ity eṣā jñaptiḥ evaṃ ca	muzitakAnAm BikzUNAm arTAya kaWinam udDaret iti ezA jQaptiH evam ca
   karma kartavyam*	karma kartavyam*
   (Matsumura 207)	(MatsumuraH 207)
   Kaṭhina-v 22a. śṛṇotu bhadantāḥ saṃgha yāvad evāsminn āvāse samagreṇa	KaWina-u 22a. SRNotu BadantAH saMGa yAvat eva-asmin AvAse samagreNa
   saṃghena kaṭhinam āstṛtaṃ saṃbahulāś ca bhikṣavaś corair muṣitakā āgatās	saMGena kaWinam AstRtam saMbahulAH ca BikzavaH corEH muzitakAH Agata-as
   tat saṃghaś corair muṣitakānāṃ bhikṣūṇām arthāya kaṭhinam uddharati yeṣām	tat saMGaH corEH muzitakAnAm BikzUNAm arTAya kaWinam udDarati yezAm
   āyuṣmatāṃ kṣamate coramuṣitakānāṃ bhikṣūṇām arthāya kaṭhinam uddharituṃ te	AyuzmatAm kzamate cora-muzitakAnAm BikzUNAm arTAya kaWinam udDaritum te
   tūṣṇīṃ na kṣamate bhāṣantāṃ uddhṛtaṃ saṃghena coramuṣitakānāṃ bhikṣūṇām	tUzNIm na kzamate BAzantAm udDRtam saMGena cora-muzitakAnAm BikzUNAm
   arthāya kaṭhinaṃ kṣāntam anujñātaṃ saṃghena yasmāt tūṣṇīm evam etad	arTAya kaWinam kzAntam anujQAtam saMGena yasmAt tUzNIm evam etat-
   dhārayāmi /	DArayAmi /
   Kaṭhina-v 22b. tasmād yo lābhaḥ saṃpannaḥ sa bhājayitavyaḥ bhājite	KaWina-u 22b. tasmAt yaH lABaH saMpannaH sa BAjayitavyaH BAjite
   yasyābhipretan tena svakāt pratyaṃśāc cauramuṣitakānāṃ bhikṣūṇāṃ	yasya-aBipretan tena svakAt pratyaMSAt cOra-muzitakAnAm BikzUNAm
   saṃvibhāgaḥ kartavyaḥ // //	saMviBAgaH kartavyaH // //
   uddānam* //	uddAnam* //
   vitaritaṃ vilikhitaṃ ca dhuṭī gaṇḍūṣapaṭṭikā .	vitaritam viliKitam ca DuwI gaNxUza-pawwikA .
   upadhipariṣaṇḍo ca purāṇasannihitaphupphusam* // //	upaDi-parizaNxaH ca purANa-sannihita-PupPu-sam* // //
   Kaṭhina-v 23. āyuṣmān upālī buddhaṃ bhagavantaṃ pṛcchati / labhyaṃ	KaWina-u 23. AyuzmAn upAlI budDam Bagavantam pRcCati / laByam
   bhadanta vitaritena cīvarakeṇa kaṭhinam āstartum* na labhyam upālin*	Badanta vitaritena cIvarakeNa kaWinam Astartum* na laByam upAlin*
   labhyaṃ (Matsumura 208) bhadanta vilikhitena dakaśāṭikācīvareṇa	laByam (MatsumuraH 208) Badanta viliKitena daka-SAwikA-cIvareNa
   gaṇḍūṣacīvareṇa paṭṭikācīvareṇa plotikācīvareṇa pariṣaṇḍācīvareṇa	gaNxUza-cIvareNa pawwikA-cIvareNa plotikA-cIvareNa parizaNxAcIvareNa
   purāṇacīvareṇa (Matsumura 209) sannihitacīvareṇa phupphusacīvareṇa	purANa-cIvareNa (MatsumuraH 209) sannihita-cIvareNa PupPusa-cIvareNa
   kaṭhinam āstartuṃ na labhyam upālin* // //	kaWinam Astartum na laByam upAlin* // //
   (Matsumura 210)	(MatsumuraH 210)
   uddānam* // //	uddAnam* // //
   marditaṃ cāpy akālena pudgalasya tṛcīvaram*	marditam ca-api akAlena pudgalasya tRcIvaram*
   akalpikam asaṃcchanaṃ na kuryād ūnapaṃcakam*	akalpikam asaMcCanam na kuryAt Una-paMcakam*
   asaṃmatam anāstṛtaṃ bahiḥsīme na rohati // //	asaMmatam anAstRtam bahis-si-ime na rohati // //
   Kaṭhina-v 24. āyuṣmān (278r1 = GBM 6.868) upālī buddhaṃ bhagavantaṃ	KaWina-u 24. AyuzmAn (278r1  GBm 6.868) upAlI budDam Bagavantam
   pṛcchati labhyaṃ bhadanta marditena cīvareṇa kaṭhinam āstartuṃ na labhyam	pRcCati laByam Badanta marditena cIvareNa kaWinam Astartum na laByam
   upālin* labhyaṃ bhadanta akālacīvareṇa paudgalikayā saṃghāṭyā (Matsumura	upAlin* laByam Badanta akAla-cIvareNa pOdgalikayA saMGAwyA (Matsumura
   211) uttarāsaṃgena antarvāsena akalpikena cīvareṇa acchinakena	211) uttarA-saMgena antar-vAsena akalpikena cIvareNa acCinakena
   ūnapaṃcakena asammatena cīvareṇa asammatena (Matsumura 212)	UnapaMcakena asammatena cIvareNa asammatena (MatsumuraH 212)
   kaṭhināstārakena bahiḥsīmāsammatena kaṭhinacīvareṇa bahiḥsīmāsaṃmatena	kaWinAH-tArakena bahis-sImA-sammatena kaWina-cIvareNa bahis-sIm-A-saMmatena
   kaṭhināstārakena kaṭhinam āstartuṃ na labhyam upālin* // //	kaWinAH-tArakena kaWinam Astartum na laByam upAlin* // //
   (Matsumura 213)	(MatsumuraH 213)
   uddānam* // //	uddAnam* // //
   kālikaṃ cāpi traimāsyam ahantaṃ caiva kalpikam*	kAlikam ca-api trEmAsyam ahantam ca-eva kalpikam-*
   ātyayikaṃ pailotikaṃ pudgalasya tṛcīvaram* // //	Atyayikam pElotikam pudgalasya tRcIvaram* // //
   Kaṭhina-v 25. labhyaṃ bhadanta kālikena cīvareṇa saṃghasya kaṭhinam	KaWina-u 25. laByam Badanta kAlikena cIvareNa saMGasya kaWinam
   āstartuṃ labhyaṃ upālin* yo bhadanta traimāsyātyayāt saṃghasya	Astartum laByam upAlin* yaH Badanta trEmAsya-atyayAt saMGasya
   cīvaralābhaḥ saṃpadyate tena labhyaṃ kaṭhinam āstartuṃ labhyam upāliṃ	cIvara-lABaH saMpadyate tena laByam kaWinam Astartum laByam upAlim
   ahatacīvareṇa labhyaṃ ahatakalpitena labhyaṃ ātyayikacīvareṇa labhyaṃ	ahata-cIvareNa laByam ahata-kalpitena laByam Atyayika-cIvareNa laByam
   paulotikacīvareṇa labhyaṃ paulotikayā (Matsumura 214) saṃghāṭyā na labhyaṃ	pOlotika-cIvareNa laByam pOlotikayA (MatsumuraH 214) saMGAwyA na laByam
   labhyaṃ bhadanta paudgalikayā saṃghāṭyā kaṭhinam āstartuṃ labhyam upālin	laByam Badanta pOdgalikayA saMGAwyA kaWinam Astartum laByam upAlin
   sacet saṃghe nisṛṣṭā bhavati evam uttarāsaṃgenāntarvāsena // //	saced saMGe nisRzwA Bavati evam uttarAsaMgena-antar-vAsena // //
   (Matsumura 215)	(MatsumuraH 215)
   uddānam* // //	uddAnam* // //
   paudgalikaṃ gārhāpatakaṃ paṃcakaṃ sādhikapaṃcikaṃ	pOdgalikam gArhApatakam paMcakam sADika-paMcikam
   saṃmatam āstṛtaṃ caiva antaḥsīme ca rohau // //	saMmatam AstRtam ca-eva antar-sIme ca rohO // //
   Kaṭhina-v 26. labhyaṃ bhadanta paudgalikena cīvareṇa kaṭhinam āstartuṃ na	KaWina-u 26. laByam Badanta pOdgalikena cIvareNa kaWinam Astartum na
   labhyam upāliṃ labhyaṃ sacet saṃghe nisṛṣṭaṃ bhavati gṛhapaticīvareṇa na	laByam upAlim laByam saced saMGe nisRzwam Bavati gRhapati-cIvareNa na
   labhyaṃ labhyaṃ sacet saṃghe nisṛṣṭaṃ (Matsumura 216) bhavati paṃcakena	laByam laByam saced saMGe nisRzwam (MatsumuraH 216) Bavati paMcakena
   labhyaṃ sādhikena paṃcakena labhyaṃ sammatena kaṭhinacīvareṇa	laByam sADikena paMcakena laByam sammatena kaWina-cIvareNa
   kaṭhināstārakena labhyaṃ antaḥsīmāsammatena kaṭhinacīvareṇa labhyaṃ	kaWinAH-tArakena laByam antar-sImA-sammatena kaWina-cIvareNa laByam
   antaḥsīmāsammatena kaṭhināstārakena labhyaṃ	antar-sImA-sammatena kaWinAH-tArakena laByam
   Kaṭhina-v 27. aṣṭau mātṛkāpadāni kaṭhinoddhārāya saṃvartante katame 'ṣṭau	KaWina-u 27. azwO mAtRkA-padAni kaWina-udDArAya saMvartante katame azwO
   prakramaṇaṃ niṣṭhāpanaṃ sanniṣṭhāpanaṃ nāśanaṃ śravaṇaṃ sīmātikrāntaṃ	prakramaNam nizWApanam sannizWApanam nASanam SravaNam sImA-atikrAntam
   (Matsumura 217) āśācchedakaṃ kaṭhinoddhāram evāṣṭamam* prakramaṇāntikaḥ	(MatsumuraH 217) ASAcCedakam kaWina-udDAram eva-azwamam* prakramaNa-antikaH
   kaṭhinoddhārā niṣṭhāpanāntikaḥ sanniṣṭhāpanāntikaḥ nāśanāntikaḥ	kaWina-udDArA nizWA-apana-antikaH sannizWApana-antikaH nASana-antikaH
   śravaṇāntikaḥ sīmātikrāntikaḥ āśācchedakaḥ kaṭhinoddhāram evāṣṭamam*	SravaNa-antikaH sImA-atikrAntikaH ASAt-CedakaH kaWina-udDAram eva-azwamam*
   Kaṭhina-v 28. prakramaṇāntikaḥ kaṭhinoddhāraḥ katamaḥ yathāpi tad bhikṣur	KaWina-u 28. prakramaNa-antikaH kaWina-udDAraH katamaH yaTA-api tat BikzuH-
   āstīrṇakaṭhinād āvāsāt* akṛtacīvaro 'niṣṭhitacīvaraḥ samādāya pātracīvaraṃ	AstIrNa-kaWinAt AvAsAt* akRta-cIvaraH anizWita-cIvaraH samAdAya pAtra-cIvaram
   bahiḥsīmāṃ prakramaty apunarāgamanāya tasya prakramaṇāntikaḥ	bahis-si-imAm prakramati apunarAgamanAya tasya prakramaNa-antikaH
   kaṭhinoddhāraḥ	kaWina-udDAraH
   (Matsumura 218)	(MatsumuraH 218)
   Kaṭhina-v 29. niṣṭhāpanāntikaḥ kaṭhinoddhāraḥ katamaḥ yathāpi tad bhikṣur	KaWina-u 29. nizWApana-antikaH kaWina-udDAraH katamaH yaTA-api tat BikzuH-
   āstīrṇakaṭhinād āvāsād akṛtacīvaro 'niṣṭhitacīvaraḥ bahiḥsīmāṃ prakrāmati	AstIrNa-kaWinAt AvAsAt akRta-cIvaraH anizWita-cIvaraH bahis-si-imAm prakrAmati
   pratyeṣyāmi cīvaraṃ kariṣyāmīti tasyaivaṃ bhavati na haiva pratyeṣyāmy api	pratyezyAmi cIvaram karizyAmi-iti tasya-evam Bavati na ha-eva pratyezyAmi api
   tu cīvaraṃ kariṣyāmīti tasya niṣṭhāpanāntikaḥ kaṭhinoddhāraḥ	tu cIvaram karizyAmi-iti tasya nizWApana-antikaH kaWina-udDAraH
   Kaṭhina-v 30. sanniṣṭhāpanāntikaḥ kaṭhinoddhāraḥ katamaḥ yathāpi tad	KaWina-u 30. sannizWApana-antikaH kaWina-udDAraH katamaH yaTA-api tat-
   bhikṣur (Matsumura 219) āstīrṇakaṭhinād āvāsād akṛtacīvaro	BikzuH (MatsumuraH 219) AstIrNa-kaWinAt AvAsAt akRta-cIvaraH-
   'niṣṭhitacīvaraḥ bahiḥsīmāṃ prakrāmati pratyeṣyāmi cīvaraṃ kariṣyāmīti /	anizWita-cIvaraH bahis-si-imAm prakrAmati pratyezyAmi cIvaram karizyAmi-iti /
   tasyaivaṃ bhavati na haiva pratyeṣyāmi nāpi cīvaraṃ kariṣyāmīti tasya	tasya-evam Bavati na ha-eva pratyezyAmi na-api cIvaram karizyAmi-iti tasya
   sanniṣṭhāpanāntikaḥ kaṭhinoddhāraḥ //	sannizWApana-antikaH kaWina-udDAraH //
   Kaṭhina-v 31. nāśanāntikaḥ kaṭhinoddhāraḥ katamaḥ yathāpi tad bhikṣur	KaWina-u 31. nASana-antikaH kaWina-udDAraH katamaH yaTA-api tat BikzuH-
   āstīrṇakaṭhinād (Matsumura 220) āvāsād akṛtacīvaro 'niṣṭhitacīvaraḥ	AstIrNa-kaWinAt (MatsumuraH 220) AvAsAt akRta-cIvaraH anizWita-cIvaraH
   bahiḥsīmāṃ prakrāmati pratyeṣyāmi (278v1 = GBM 6.869) cīvaraṃ kariṣyāmi /	bahis-si-imAm prakrAmati pratyezyAmi (278v1  GBm 6.869) cIvaram karizyAmi /
   tasyaivaṃ bhavati na haiva pratyeṣyāmi api tu cīvaraṃ kariṣyāmīti sa tad	tasya-evam Bavati na ha-eva pratyezyAmi api tu cIvaram karizyAmi-iti sa tat-
   ārabhate ārabdhaṃ tu naśyati tasya nāśanāntikaḥ kaṭhinoddhāraḥ	AraBate ArabDam tu naSyati tasya nASana-antikaH kaWina-udDAraH
   Kaṭhina-v 32. śravaṇāntikaḥ kaṭhinoddhāraḥ katamaḥ yathāpi tad bhikṣuḥ	KaWina-u 32. SravaNa-antikaH kaWina-udDAraH katamaH yaTA-api tat BikzuH
   āstīrṇakaṭhinād āvāsād akṛtacīvaro 'niṣṭhitacīvaraḥ bahiḥsīmāṃ prakrāmati	AstIrNa-kaWinAt AvAsAt akRta-cIvaraH anizWita-cIvaraH bahis-si-imAm prakrAmati
   pratyeṣyāmi cīvaraṃ kariṣyāmi samagreṇa ca saṃghena kaṭhinam uddhṛtaṃ sa	pratyezyAmi cIvaram karizyAmi samagreNa ca saMGena kaWinam udDRtam sa
   śṛṇoti samagreṇa saṃghena kaṭhinam uddhṛtam iti śrutvā cābhyanumodate	SRNoti samagreNa saMGena kaWinam udDRtam iti SrutvA ca-aByanumodate
   sādhūddhṛtaṃ suṣṭhūddhṛtam iti / tasya śravaṇāntikaḥ kaṭhinoddhāraḥ	sADu-udDRtam suzWu-udDRtam iti / tasya SravaNa-antikaH kaWina-udDAraH
   (Matsumura 221)	(MatsumuraH 221)
   Kaṭhina-v 33. sīmātikrāntikaḥ kaṭhinoddhāraḥ katamaḥ yathāpi tad bhikṣur	KaWina-u 33. sImA-atikrAntikaH kaWina-udDAraH katamaH yaTA-api tat BikzuH-
   āstīrṇakaṭhinād āvāsād akṛtacīvaro 'niṣṭhitacīvaro bahiḥsīmāṃ prakrāmati	AstIrNa-kaWinAt AvAsAt akRta-cIvaraH anizWita-cIvaraH bahis-si-imAm prakrAmati
   pratyeṣyāmi na pratyeṣyāmīti sīmāṃ cātikrāmati tasya sīmātikrāntikaḥ	pratyezyAmi na pratyezyAmi-iti sImAm ca-atikrAmati tasya sImA-atikrAntikaH
   kaṭhinoddhāraḥ	kaWina-udDAraH
   Kaṭhina-v 34. āśācchedakaḥ kaṭhinoddhāraḥ katamaḥ yathāpi tad bhikṣur	KaWina-u 34. ASAt-CedakaH kaWina-udDAraH katamaH yaTA-api tat BikzuH-
   āstīrṇakaṭhinād āvāsād akṛtacīvaro 'niṣṭhitacīvaro bahiḥsīmāṃ prakrāmati	AstIrNa-kaWinAt AvAsAt akRta-cIvaraH anizWita-cIvaraH bahis-si-imAm prakrAmati
   pratyeṣyāmi cīvaraṃ kariṣyāmīti tasya yā sā cīvarapratyāśā sā sarveṇa	pratyezyAmi cIvaram karizyAmi-iti tasya yA sA cIvara-pratyASA sA sarveNa
   sarvaṃ samucchidyate tasyāśācchedakaḥ kaṭhinoddhāraḥ	sarvam samucCidyate tasya-ASAcCedakaH kaWina-udDAraH
   Kaṭhina-v 35. kaṭhinoddhāra evāṣṭamaḥ katamaḥ yathāpi tad bhikṣur	KaWina-u 35. kaWina-udDAraH eva-azwamaH katamaH yaTA-api tat BikzuH-
   āstīrṇakaṭhinād (Matsumura 222) āvāsād akṛtacīvaro 'niṣṭhitacīvaro	AstIrNa-kaWinAt (MatsumuraH 222) AvAsAt akRta-cIvaraH anizWita-cIvaraH-
   bahiḥsīmāṃ prakrāmati cāgatya kaṭhinoddhāraḥ pratyanubhavati tasya	bahis-si-imAm prakrAmati ca-Agatya kaWina-udDAraH pratyanuBavati tasya
   kaṭhinodhāra evāṣṭamaḥ // //	kaWinoDAraH eva-azwamaH // //
   uddānam* //	uddAnam* //
   akṛtena hi viṃśati vikṛtena hi viṃśati .	akRtena hi viMSati vikRtena hi viMSati .
   āśayā viṃśatiṃ kuryād anāsayā caiva viṃśikām* // //	ASayA viMSatim kuryAt anAsayA ca-eva viMSi-kAm* // //
   Kaṭhina-v 36. yathāpi tad bhikṣur āstīrṇakaṭhinād āvāsād akṛtacīvaro	KaWina-u 36. yaTA-api tat BikzuH AstIrNa-kaWinAt AvAsAt akRta-cIvaraH-
   'niṣṭhitacīvaraḥ bahiḥsīmāṃ prakrāmati pratyeṣyāmi cīvaraṃ kariṣyāmīti /	anizWita-cIvaraH bahis-si-imAm prakrAmati pratyezyAmi cIvaram karizyAmi-iti /
   tasyaivaṃ bhavati na haiva pratyeṣyāmi api tu cīvaraṃ kariṣyāmīti tasya	tasya-evam Bavati na ha-eva pratyezyAmi api tu cIvaram karizyAmi-iti tasya
   niṣṭhāpanāntikaḥ kaṭhinoddhāraḥ	nizWApana-antikaH kaWina-udDAraH
   Kaṭhina-v 37. yathāpi tad bhikṣur āstīrṇakaṭhinād āvāsād akṛtacīvaro	KaWina-u 37. yaTA-api tat BikzuH AstIrNa-kaWinAt AvAsAt akRta-cIvaraH-
   'niṣṭhitacīvaro bahiḥsīmāṃ prakrāmati pratyeṣyāmi cīvaraṃ kariṣyāmi /	anizWita-cIvaraH bahis-si-imAm prakrAmati pratyezyAmi cIvaram karizyAmi /
   tasyaivaṃ bhavati na haiva pratyeṣyāmi nāpi cīvaraṃ kariṣyāmīti tasya	tasya-evam Bavati na ha-eva pratyezyAmi na-api cIvaram karizyAmi-iti tasya
   sanniṣṭhāpanāntikaḥ kaṭhinoddhāraḥ	sannizWApana-antikaH kaWina-udDAraH
   (Matsumura 223)	(MatsumuraH 223)
   Kaṭhina-v 38. yathāpi tad bhikṣur āstīrṇakaṭhinād āvāsād akṛtacīvaro	KaWina-u 38. yaTA-api tat BikzuH AstIrNa-kaWinAt AvAsAt akRta-cIvaraH-
   'niṣṭhitacīvaraḥ bahiḥsīmāṃ prakrāmati pratyeṣyāmi cīvaraṃ kariṣyāmīti /	anizWita-cIvaraH bahis-si-imAm prakrAmati pratyezyAmi cIvaram karizyAmi-iti /
   sa tad ārabhate ārabdhaṃ cāsya naśyati tasya nāśanāntikaḥ kaṭhinoddhāraḥ /	sa tat AraBate ArabDam ca-asya naSyati tasya nASana-antikaH kaWina-udDAraH /
   Kaṭhina-v 39. yathāpi tad bhikṣur āstīrṇakaṭhinād āvāsād akṛtacīvaro	KaWina-u 39. yaTA-api tat BikzuH AstIrNa-kaWinAt AvAsAt akRta-cIvaraH-
   'niṣṭhitacīvaro bahiḥsīmāṃ prakrāmati pratyeṣyāmi cīvarakaṃ kariṣyāmīti /	anizWita-cIvaraH bahis-si-imAm prakrAmati pratyezyAmi cIvarakam karizyAmi-iti /
   samagreṇa ca saṃghena kaṭhinam uddhṛtaṃ sa śṛṇoti samagreṇa saṃghena	samagreNa ca saMGena kaWinam udDRtam sa SRNoti samagreNa saMGena
   kaṭhinam uddhṛtam iti śrutvā cābhyanumodate sādhūddhṛtaṃ suṣṭhūddhṛtam iti	kaWinam udDRtam iti SrutvA ca-aByanumodate sADu-udDRtam suzWu-udDRtam iti
   / tasya śravaṇāntikaḥ kaṭhinoddhāra-m-iti //	/ tasya SravaNa-antikaH kaWina-udDAra-m-iti //
   Kaṭhina-v 40. yathāpi tad bhikṣur āstīrṇakaṭhinād āvāsād akṛtacīvaro	KaWina-u 40. yaTA-api tat BikzuH AstIrNa-kaWinAt AvAsAt akRta-cIvaraH-
   'niṣṭhitacīvaro bahiḥsīmāṃ prakrāmati / pratyeṣyāmi cīvaraṃ kariṣyāmi	anizWita-cIvaraH bahis-si-imAm prakrAmati / pratyezyAmi cIvaram karizyAmi
   tasya tatra gatasyaivaṃ bhavati na haiva pratyeṣyāmy api tu cīvaraṃ	tasya tatra gatasya-evam Bavati na ha-eva pratyezyAmi api tu cIvaram
   kariṣyāmīti tasya niṣṭhāpanāntikaḥ kaṭhinoddhāraḥ //	karizyAmi-iti tasya nizWApana-antikaH kaWina-udDAraH //
   Kaṭhina-v 41. yathāpi tad bhikṣur āstīrṇakaṭhinād āvāsād akṛtacīvaro	KaWina-u 41. yaTA-api tat BikzuH AstIrNa-kaWinAt AvAsAt akRta-cIvaraH-
   'niṣṭhitacīvaro bahiḥsīmāṃ prakrāmati pratyeṣyāmi cīvaraṃ kariṣyāmi /	anizWita-cIvaraH bahis-si-imAm prakrAmati pratyezyAmi cIvaram karizyAmi /
   tasya tatra gatasyaivaṃ bhavati (279r1 = GBM 6.870) na haiva pratyeṣyāmi	tasya tatra gatasya-evam Bavati (279r1  GBm 6.870) na ha-eva pratyezyAmi
   nāpi cīvaraṃ kariṣyāmīti tasya sanniṣṭhāpanāntikaḥ kaṭhinoddhāraḥ	na-api cIvaram karizyAmi-iti tasya sannizWApana-antikaH kaWina-udDAraH
   Kaṭhina-v 42. yathāpi tad bhikṣur āstīrṇakaṭhinād āvāsād akṛtacīvaro	KaWina-u 42. yaTA-api tat BikzuH AstIrNa-kaWinAt AvAsAt akRta-cIvaraH-
   'niṣṭhitacīvaro bahiḥsīmāṃ prakrāmati pratyeṣyāmi cīvaraṃ kariṣyāmīti sa	anizWita-cIvaraH bahis-si-imAm prakrAmati pratyezyAmi cIvaram karizyAmi-iti sa
   tatra gata ārabhate ārabdhaṃ cāsya naśyati tasya nāśanāntikaḥ	tatra gataH AraBate ArabDam ca-asya naSyati tasya nASana-antikaH
   kaṭhinoddhāraḥ	kaWina-udDAraH
   (Matsumura 224)	(MatsumuraH 224)
   Kaṭhina-v 43. yathāpi tad bhikṣur āstīrṇakaṭhinād āvāsād akṛtacīvaro	KaWina-u 43. yaTA-api tat BikzuH AstIrNa-kaWinAt AvAsAt akRta-cIvaraH-
   'niṣṭhitacīvaraḥ bahiḥsīmāṃ prakrāmati pratyeṣyāmi cīvaraṃ kariṣyāmīti	anizWita-cIvaraH bahis-si-imAm prakrAmati pratyezyAmi cIvaram karizyAmi-iti
   samagreṇa ca saṃghena kaṭhinam uddhṛtaṃ sa śṛṇoti samagreṇa saṃghena	samagreNa ca saMGena kaWinam udDRtam sa SRNoti samagreNa saMGena
   kaṭhinam uddhṛtam iti / sa śrutvā cābhyanumodate sādhūddhṛtaṃ	kaWinam udDRtam iti / sa SrutvA ca-aByanumodate sADu-udDRtam
   suṣṭhūddhṛtam iti tasya śrāvaṇāntikaḥ kaṭhinoddhāraḥ //	suzWu-udDRtam iti tasya SrAvaNa-antikaH kaWina-udDAraH //
   Kaṭhina-v 44. yathāpi tad bhikṣur āstīrṇakaṭhinād āvāsād akṛtacīvaro	KaWina-u 44. yaTA-api tat BikzuH AstIrNa-kaWinAt AvAsAt akRta-cIvaraH-
   'niṣṭhitacīvaraḥ paligodhasantati bahiḥsīmāṃ prakrāmati pratyeṣyāmi	anizWita-cIvaraH pali-goDasantati bahis-si-imAm prakrAmati pratyezyAmi
   cīvaraṃ kariṣyāmīti tasyaivaṃ bhavati na haiva pratyeṣyāmy api tu cīvaraṃ	cIvaram karizyAmi-iti tasya-evam Bavati na ha-eva pratyezyAmi api tu cIvaram
   kariṣyāmīti / tasya niṣṭhāpanāntikaḥ kaṭhinoddhāraḥ //	karizyAmi-iti / tasya nizWApana-antikaH kaWina-udDAraH //
   Kaṭhina-v 45. yathāpi tad bhikṣur āstīrṇakaṭhinād āvāsād akṛtacīvaro	KaWina-u 45. yaTA-api tat BikzuH AstIrNa-kaWinAt AvAsAt akRta-cIvaraH-
   'niṣṭhitacīvaraḥ paligodhasantatiḥ bahiḥsīmāṃ prakrāmati pratyeṣyāmi	anizWita-cIvaraH pali-goDa-santatiH bahis-si-imAm prakrAmati pratyezyAmi
   cīvaraṃ kariṣyāmīti / tasyaivaṃ bhavati na haiva pratyeṣyāmi nāpi cīvaraṃ	cIvaram karizyAmi-iti / tasya-evam Bavati na ha-eva pratyezyAmi na-api cIvaram
   kariṣyāmīti tasya sanniṣṭhāpanāntikaḥ kaṭhinoddhāraḥ // 10 //	karizyAmi-iti tasya sannizWApana-antikaH kaWina-udDAraH // 10 //
   Kaṭhina-v 46. yathāpi tad bhikṣur āstīrṇakaṭhinād āvāsād akṛtacīvaro	KaWina-u 46. yaTA-api tat BikzuH AstIrNa-kaWinAt AvAsAt akRta-cIvaraH-
   'niṣṭhitacīvaraḥ paligodhasantati bahiḥsīmāṃ prakrāmati pratyeṣyāmi	anizWita-cIvaraH pali-goDasantati bahis-si-imAm prakrAmati pratyezyAmi
   cīvaraṃ kariṣyāmīti / sa tad ārabhate ārabdhaṃ cāsya naśyati tasya	cIvaram karizyAmi-iti / sa tat AraBate ArabDam ca-asya naSyati tasya
   nāśanāntikaḥ kaṭhinoddhāraḥ //	nASana-antikaH kaWina-udDAraH //
   Kaṭhina-v 47. yathāpi tad bhikṣur āstīrṇakaṭhinād āvāsād akṛtacīvaro	KaWina-u 47. yaTA-api tat BikzuH AstIrNa-kaWinAt AvAsAt akRta-cIvaraH-
   'niṣṭhitacīvaraḥ (Matsumura 225) paligodhasantatir bahiḥsīmāṃ prakrāmati	anizWita-cIvaraH (MatsumuraH 225) pali-goDa-santatiH bahis-si-imAm prakrAmati
   pratyeṣyāmi cīvaraṃ kariṣyāmīti / samagreṇa ca saṃghena kaṭhinam uddhṛtam*	pratyezyAmi cIvaram karizyAmi-iti / samagreNa ca saMGena kaWinam udDRtam*
   sa śṛṇoti samagreṇa saṃghena kaṭhinam uddhṛtam iti śrutvā cābhyanumodate /	sa SRNoti samagreNa saMGena kaWinam udDRtam iti SrutvA ca-aByanumodate /
   sādhūddhṛtaṃ suṣṭhūddhṛtam iti // tasya śrāvaṇāntikaḥ kaṭhinoddhāraḥ //	sADu-udDRtam suzWu-udDRtam iti // tasya SrAvaNa-antikaH kaWina-udDAraH //
   Kaṭhina-v 48. yathāpi tad bhikṣur āstīrṇakaṭhinād āvāsād akṛtacīvaro	KaWina-u 48. yaTA-api tat BikzuH AstIrNa-kaWinAt AvAsAt akRta-cIvaraH-
   'niṣṭhitacīvaraḥ paligodhasaṃtati bahiḥsīmāṃ prakrāmati pratyeṣyāmi	anizWita-cIvaraH pali-goDa-saMtati bahis-si-imAm prakrAmati pratyezyAmi
   cīvaraṃ kariṣyāmīti / tasya tatra gatasyaivaṃ bhavati na haiva pratyeṣyāmi	cIvaram karizyAmi-iti / tasya tatra gatasya-evam Bavati na ha-eva pratyezyAmi
   api tu cīvarakaṃ kariṣyāmīti tasya niṣṭhāpanāntikaḥ kaṭhinoddhāraḥ //	api tu cIvarakam karizyAmi-iti tasya nizWApana-antikaH kaWina-udDAraH //
   Kaṭhina-v 49. yathāpi tad bhikṣur āstīrṇakaṭhinād āvāsād akṛtacīvaro	KaWina-u 49. yaTA-api tat BikzuH AstIrNa-kaWinAt AvAsAt akRta-cIvaraH-
   'niṣṭhitacīvaraḥ paligodhasantatir bahiḥsīmāṃ prakrāmati pratyeṣyāmi	anizWita-cIvaraH pali-goDa-santatiH bahis-si-imAm prakrAmati pratyezyAmi
   cīvaraṃ kariṣyāmīti / tasya gatasyaivaṃ bhavati na haiva pratyeṣyāmi nāpi	cIvaram karizyAmi-iti / tasya gatasya-evam Bavati na ha-eva pratyezyAmi na-api
   cīvaraṃ kariṣyāmīti / tasya sanniṣṭhāpanāntikaḥ kaṭhinoddhāraḥ //	cIvaram karizyAmi-iti / tasya sannizWApana-antikaH kaWina-udDAraH //
   Kaṭhina-v 50. yathāpi tad bhikṣur āstīrṇakaṭhinād āvāsād akṛtacīvaro	KaWina-u 50. yaTA-api tat BikzuH AstIrNa-kaWinAt AvAsAt akRta-cIvaraH-
   'niṣṭhitacīvaraḥ paligodhasaṃtatiḥ bahiḥsīmāṃ prakrāmati pratyeṣyāmi	anizWita-cIvaraH pali-goDa-saMtatiH bahis-si-imAm prakrAmati pratyezyAmi
   cīvaraṃ kariṣyāmīti / sa tatra gatā ārabhate ārabdhaṃ cāsya naśyati /	cIvaram karizyAmi-iti / sa tatra gatAH AraBate ArabDam ca-asya naSyati /
   tasya nāśanāntikaḥ kaṭhinoddhāraḥ //	tasya nASana-antikaH kaWina-udDAraH //
   Kaṭhina-v 51. yathāpi tad bhikṣur āstīrṇakaṭhinād āvāsād akṛtacīvaro	KaWina-u 51. yaTA-api tat BikzuH AstIrNa-kaWinAt AvAsAt akRta-cIvaraH-
   'niṣṭhitacīvaraḥ paligodhasantatir bahiḥsīmāṃ prakrāmati (279v1 = GBM	anizWita-cIvaraH pali-goDa-santatiH bahis-si-imAm prakrAmati (279v1  GBm
   6.871) pratyeṣyāmi cīvaraṃ kariṣyāmīti / samagreṇa saṃghena kaṭhinam	6.871) pratyezyAmi cIvaram karizyAmi-iti / samagreNa saMGena kaWinam
   uddhṛtam* sa śṛṇoti samagreṇa saṃghena kaṭhinam uddhṛtam iti śrutvā	udDRtam* sa SRNoti samagreNa saMGena kaWinam udDRtam iti SrutvA
   cābhyanumodate / sādhūddhṛtaṃ suṣṭhūddhṛtam iti // tasya śrāvaṇāntikaḥ	ca-aByanumodate / sADu-udDRtam suzWu-udDRtam iti // tasya SrAvaNa-antikaH
   kaṭhinoddhāraḥ //	kaWina-udDAraH //
   Kaṭhina-v 52. yathāpi tad bhikṣur āstīrṇakaṭhinād āvāsād akṛtacīvaro	KaWina-u 52. yaTA-api tat BikzuH AstIrNa-kaWinAt AvAsAt akRta-cIvaraH-
   (Matsumura 226) 'niṣṭhitacīvaraḥ vicikitsāsantatir bahiḥsīmāṃ prakrāmati	(MatsumuraH 226) anizWita-cIvaraH vicikitsA-santatiH bahis-si-imAm prakrAmati
   kin nu pratyeṣyāmi āhosvin na pratyeṣyāmīti tasyaivaṃ bhavati na haiva	kin nu pratyezyAmi Ahosvit na pratyezyAmi-iti tasya-evam Bavati na ha-eva
   pratyeṣyāmy api tu cīvaraṃ kariṣyāmīti tasya niṣṭhāpanāntikaḥ	pratyezyAmi api tu cIvaram karizyAmi-iti tasya nizWApana-antikaH
   kaṭhinoddhāraḥ //	kaWina-udDAraH //
   Kaṭhina-v 53. yathāpi tad bhikṣur āstīrṇakaṭhinād āvāsād akṛtacīvaro	KaWina-u 53. yaTA-api tat BikzuH AstIrNa-kaWinAt AvAsAt akRta-cIvaraH-
   'niṣṭhitacīvaraḥ vicikitsāsantatir bahiḥsīmāṃ prakrāmati kin nu	anizWita-cIvaraH vicikitsA-santatiH bahis-si-imAm prakrAmati kid nu
   pratyeṣyāmi āhosvin na pratyeṣyāmīti tasyaivaṃ bhavati na haiva	pratyezyAmi Ahosvit na pratyezyAmi-iti tasya-evam Bavati na ha-eva
   pratyeṣyāmy nāpi cīvaraṃ kariṣyāmīti tasya sanniṣṭhāpanāntikaḥ	pratyezyAmi na-api cIvaram karizyAmi-iti tasya sannizWApana-antikaH
   kaṭhinoddhāraḥ //	kaWina-udDAraH //
   Kaṭhina-v 54. yathāpi tad bhikṣur āstīrṇakaṭhinād āvāsād akṛtacīvaro	KaWina-u 54. yaTA-api tat BikzuH AstIrNa-kaWinAt AvAsAt akRta-cIvaraH-
   'niṣṭhitacīvaraḥ vicikitsāsantatir bahiḥsīmāṃ prakrāmati / kin nu	anizWita-cIvaraH vicikitsA-santatiH bahis-si-imAm prakrAmati / kid nu
   pratyeṣyāmy āhosvin na pratyeṣyāmīti sa tad ārabhate ārabdhaṃ cāsya	pratyezyAmi Ahosvit na pratyezyAmi-iti sa tat AraBate ArabDam ca-asya
   naśyati tasya nāśanāntikaḥ kaṭhinoddhāraḥ //	naSyati tasya nASana-antikaH kaWina-udDAraH //
   Kaṭhina-v 55. yathāpi tad bhikṣur āstīrṇakaṭhinād āvāsād akṛtacīvaro	KaWina-u 55. yaTA-api tat BikzuH AstIrNa-kaWinAt AvAsAt akRta-cIvaraH-
   'niṣṭhitacīvaraḥ vicikitsāsantatir bahiḥsīmāṃ prakrāmati / kin nu	anizWita-cIvaraH vicikitsA-santatiH bahis-si-imAm prakrAmati / kid nu
   (Matsumura 227) pratyeṣyāmi āhosvin na pratyeṣyāmīti samagreṇa saṃghena	(MatsumuraH 227) pratyezyAmi Ahosvit na pratyezyAmi-iti samagreNa saMGena
   kaṭhinam uddhṛtam* sa śṛṇoti samagreṇa saṃghena kaṭhinam uddhṛtam iti	kaWinam udDRtam* sa SRNoti samagreNa saMGena kaWinam udDRtam iti
   śrutvā cābhyanumodate sādhūddhṛtaṃ suṣṭhūddhṛtam iti tasya śrāvaṇāntikaḥ	SrutvA ca-aByanumodate sADu-udDRtam suzWu-udDRtam iti tasya SrAvaNa-antikaH
   kaṭhinoddhāraḥ //	kaWina-udDAraH //
   Kaṭhina-v 56. yathāpi tad bhikṣur āstīrṇakaṭhinād āvāsād akṛtacīvaro	KaWina-u 56. yaTA-api tat BikzuH AstIrNa-kaWinAt AvAsAt akRta-cIvaraH-
   'niṣṭhitacīvaraḥ bahiḥsīmāṃ prakrāmati / pratyeṣyāmi cīvaraṃ kariṣyāmīti	anizWita-cIvaraH bahis-si-imAm prakrAmati / pratyezyAmi cIvaram karizyAmi-iti
   tasyaivaṃ bhavati na haiva pratyeṣyāmy api tu cīvaraṃ kariṣyāmīti tasya	tasya-evam Bavati na ha-eva pratyezyAmi api tu cIvaram karizyAmi-iti tasya
   niṣṭhāpanāntikaḥ kaṭhinoddhāraḥ	nizWApana-antikaH kaWina-udDAraH
   pūrvasyāṃ viṃśikāyāṃ akṛtacīvaro 'niṣṭhitacīvara ity atrāniṣṭhitacīvara	pUrvasyAm viMSikAyAm akRta-cIvaraH anizWita-cIvaraH iti atra-anizWita-cIvara
   ity apanīya viprakṛtacīvara iti datvā nānākāreṇāparā viṃśati karyā / // //	iti apanIya viprakRta-cIvaraH iti datvA nAnA-AkAreNa-aparA viMSati karyA / // //
   Kaṭhina-v 57. yathāpi tad bhikṣur āstīrṇakaṭhinād āvāsād akṛtacīvaro	KaWina-u 57. yaTA-api tat BikzuH AstIrNa-kaWinAt AvAsAt akRta-cIvaraH-
   'niṣṭhitacīvaro bahiḥsīmāṃ prakrāmaty āśayā pratyeṣyāmi cīvaraṃ	anizWita-cIvaraH bahis-si-imAm prakrAmati ASayA pratyezyAmi cIvaram
   kariṣyāmīti tasyaivaṃ bhavati / na haiva pratyeṣyāmy api tu cīvaraṃ	karizyAmi-iti tasya-evam Bavati / na ha-eva pratyezyAmi api tu cIvaram
   kariṣyāmīti tasya niṣṭhāpanāntikaḥ kaṭhinoddhāraḥ	karizyAmi-iti tasya nizWApana-antikaH kaWina-udDAraH
   āśayety anena viśeṣeṇa pūrvavad aparā viṃśikā kāryā //	ASaya-iti anena viSezeNa pUrvavat aparA viMSikA kAryA //
   (Matsumura 228)	(MatsumuraH 228)
   Kaṭhina-v 58. yathāpi tad bhikṣur āstīrṇakaṭhinād āvāsād akṛtacīvaro	KaWina-u 58. yaTA-api tat BikzuH AstIrNa-kaWinAt AvAsAt akRta-cIvaraH-
   'niṣṭhitacīvaraḥ bahiḥsīmāṃ prakrāmaty anāśayā pratyeṣyāmi cīvaraṃ	anizWita-cIvaraH bahis-si-imAm prakrAmati anASayA pratyezyAmi cIvaram
   kariṣyāmīti / tasyaivaṃ bhavati na haiva pratyeṣyāmy api tu cīvaraṃ	karizyAmi-iti / tasya-evam Bavati na ha-eva pratyezyAmi api tu cIvaram
   kariṣyāmīti / tasya niṣṭhāpanāntikaḥ kaṭhinoddhāraḥ	karizyAmi-iti / tasya nizWApana-antikaH kaWina-udDAraH
   anāśayety anena viśeṣeṇāparā viṃśikā kāryā // //	anASaya-iti anena viSezeNa-aparA viMSikA kAryA // //
   uddānam* //	uddAnam* //
   karaṇīyena dvādaśikā paryeṣaṇatayā tathā .	karaNIyena dvAdaSikA paryezaNa-tayA taTA .
   deśena paṃcikāṃ kṛtvā āvāsena ca paṃcikā // //	deSena paMcikAm kRtvA AvAsena ca paMcikA // //
   Kaṭhina-v 59. yathāpi tad bhikṣur āstīrṇakaṭhinād āvāsād akṛtacīvaro	KaWina-u 59. yaTA-api tat BikzuH AstIrNa-kaWinAt AvAsAt akRta-cIvaraH-
   'niṣṭhitacīvaro bahiḥsīmāṃ prakrāmati karaṇīyena pratyeṣyāmi cīvaraṃ	anizWita-cIvaraH bahis-si-imAm prakrAmati karaNIyena pratyezyAmi cIvaram
   kariṣyāmīti / tasyaivaṃ bhavati na haiva pratyeṣyāmy api tu cīvaraṃ (280r1	karizyAmi-iti / tasya-evam Bavati na ha-eva pratyezyAmi api tu cIvaram (280r1
   = GBM 6.872) kariṣyāmīti tasya niṣṭhāpanāntikaḥ kaṭhinoddhāraḥ	 GBm 6.872) karizyAmi-iti tasya nizWApana-antikaH kaWina-udDAraH
   Kaṭhina-v 60. yathāpi tad bhikṣur āstīrṇakaṭhinād āvāsād akṛtacīvaro	KaWina-u 60. yaTA-api tat BikzuH AstIrNa-kaWinAt AvAsAt akRta-cIvaraH-
   'niṣṭhitacīvaraḥ bahiḥsīmāṃ prakrāmati karaṇīyena pratyeṣyāmi cīvaraṃ	anizWita-cIvaraH bahis-si-imAm prakrAmati karaNIyena pratyezyAmi cIvaram
   kariṣyāmīti tasyaivaṃ bhavati na haiva pratyeṣyāmy nāpi cīvarakaṃ	karizyAmi-iti tasya-evam Bavati na ha-eva pratyezyAmi na-api cIvarakam
   kariṣyāmīti / tasya sanniṣṭhāpanāntikaḥ kaṭhinoddhāraḥ //	karizyAmi-iti / tasya sannizWApana-antikaH kaWina-udDAraH //
   Kaṭhina-v 61. yathāpi tad bhikṣur āstīrṇakaṭhinād āvāsād akṛtacīvaro	KaWina-u 61. yaTA-api tat BikzuH AstIrNa-kaWinAt AvAsAt akRta-cIvaraH-
   'niṣṭhitacīvaraḥ bahiḥsīmāṃ prakrāmati karaṇīyena pratyeṣyāmi cīvaraṃ	anizWita-cIvaraH bahis-si-imAm prakrAmati karaNIyena pratyezyAmi cIvaram
   kariṣyāmīti (Matsumura 229) sa tad ārabhate ārabdhaṃ cāsya naśyati tasya	karizyAmi-iti (MatsumuraH 229) sa tat AraBate ArabDam ca-asya naSyati tasya
   nāśanāntikaḥ kaṭhinoddhāraḥ //	nASana-antikaH kaWina-udDAraH //
   Kaṭhina-v 62. yathāpi tad bhikṣur āstīrṇakaṭhinād āvāsād akṛtacīvaro	KaWina-u 62. yaTA-api tat BikzuH AstIrNa-kaWinAt AvAsAt akRta-cIvaraH-
   'niṣṭhitacīvaraḥ bahiḥsīmāṃ prakrāmati karaṇīyena pratyeṣyāmi cīvaraṃ	anizWita-cIvaraH bahis-si-imAm prakrAmati karaNIyena pratyezyAmi cIvaram
   kariṣyāmīti / samagreṇa ca saṃghena kaṭhinam uddhṛtaṃ sa śṛṇoti samagreṇa	karizyAmi-iti / samagreNa ca saMGena kaWinam udDRtam sa SRNoti samagreNa
   saṃghena kaṭhinam uddhṛtam iti śrutvā cābhyanumodate sādhūddhṛtaṃ	saMGena kaWinam udDRtam iti SrutvA ca-aByanumodate sADu-udDRtam
   suṣṭhūddhṛtam iti / tasya śrāvaṇāntikaḥ kaṭhinoddhāraḥ //	suzWu-udDRtam iti / tasya SrAvaNa-antikaH kaWina-udDAraH //
   Kaṭhina-v 63. yathāpi tad bhikṣur āstīrṇakaṭhinād āvāsād akṛtacīvaro	KaWina-u 63. yaTA-api tat BikzuH AstIrNa-kaWinAt AvAsAt akRta-cIvaraH-
   'niṣṭhitacīvaraḥ bahiḥsīmāṃ prakrāmati karaṇīyena pratyeṣyāmi cīvaraṃ	anizWita-cIvaraH bahis-si-imAm prakrAmati karaNIyena pratyezyAmi cIvaram
   kariṣyāmīti / tasya tatra gatasyaivaṃ bhavati na haiva pratyeṣyāmy api tu	karizyAmi-iti / tasya tatra gatasya-evam Bavati na ha-eva pratyezyAmi api tu
   cīvaraṃ kariṣyāmīti tasya niṣṭhāpanāntikaḥ kaṭhinoddhāraḥ //	cIvaram karizyAmi-iti tasya nizWApana-antikaH kaWina-udDAraH //
   yathāpi tatra gatasyety anena viśeṣeṇa niṣṭhāpanāntika uktaḥ evaṃ	yaTA-api tatra gatasya-iti anena viSezeNa nizWA-apana-antikaH uktaH evam
   sanniṣṭhāpanāntikaḥ // 6 //	sannizWApana-antikaH // 6 //
   nāśanāntikaḥ // 7 //	nASana-antikaH // 7 //
   śrāvaṇāntikaḥ // 8 //	SrAvaNa-antikaH // 8 //
   Kaṭhina-v 64. yathāpi tad bhikṣur āstīrṇakaṭhinād āvāsād akṛtacīvaro	KaWina-u 64. yaTA-api tat BikzuH AstIrNa-kaWinAt AvAsAt akRta-cIvaraH-
   'niṣṭhitacīvaraḥ vicikitsāsaṃtatir bahiḥsīmāṃ prakrāmati karaṇīyena kiṃ nu	anizWita-cIvaraH vicikitsA-saMtatiH bahis-si-imAm prakrAmati karaNIyena kim nu
   pratyeṣyāmi āhosvin na pratyeṣyāmīti tasyaivaṃ bhavati na haiva	pratyezyAmi Ahosvit na pratyezyAmi-iti tasya-evam Bavati na ha-eva
   pratyeṣyāmy api tu cīvaraṃ kariṣyāmīti tasya niṣṭhāpanāntikaḥ	pratyezyAmi api tu cIvaram karizyAmi-iti tasya nizWApana-antikaH
   kaṭhinoddhāraḥ // 9 //	kaWina-udDAraH // 9 //
   yathā vicikitsāsantatir ity anena viśeṣeṇa niṣṭhāpanāntika uktaḥ // evaṃ	yaTA vicikitsA-santatiH iti anena viSezeNa nizWA-apana-antikaH uktaH // evam
   sanniṣṭhāpanāntikaḥ // 10 //	sannizWApana-antikaH // 10 //
   nāśanāntikaḥ // 11//	nASana-antikaH // 11//
   (Matsumura 230)	(MatsumuraH 230)
   śravaṇāntikaḥ // 12 //	SravaNa-antikaH // 12 //
   Kaṭhina-v 65. yathāpi tad bhikṣur āstīrṇakaṭhinād āvāsād akṛtacīvaro	KaWina-u 65. yaTA-api tat BikzuH AstIrNa-kaWinAt AvAsAt akRta-cIvaraH-
   'niṣṭhitacīvaraḥ bahiḥsīmāṃ prakrāmati paryeṣaṇāya pratyeṣyāmi cīvaraṃ	anizWita-cIvaraH bahis-si-imAm prakrAmati paryezaNAya pratyezyAmi cIvaram
   kariṣyāmīti / tasyaivaṃ bhavati na haiva pratyeṣyāmy api tu cīvaraṃ	karizyAmi-iti / tasya-evam Bavati na ha-eva pratyezyAmi api tu cIvaram
   kariṣyāmīti tasya niṣṭhāpanāntikaḥ kaṭhinoddhāraḥ	karizyAmi-iti tasya nizWApana-antikaH kaWina-udDAraH
   paryeṣanāyety anena viśeṣeṇa pūrvavad aparā dvādaśikā : // //	paryezanAya-iti anena viSezeNa pUrvavat aparA dvAdaSikA : // //
   Kaṭhina-v 66. yathāpi tad bhikṣur āstīrṇakaṭhinād āvāsād akṛtacīvaro	KaWina-u 66. yaTA-api tat BikzuH AstIrNa-kaWinAt AvAsAt akRta-cIvaraH-
   'niṣṭhitacīvaraḥ bahiḥsīmāṃ prakrāmati deśānuprekṣī apunarāgamanāya tasya	anizWita-cIvaraH bahis-si-imAm prakrAmati deSa-anuprekzI apunarAgamanAya tasya
   prakramaṇāntikaḥ kaṭhinoddhāraḥ //	prakramaNa-antikaH kaWina-udDAraH //
   Kaṭhina-v 67.i. yathāpi tad bhikṣur āstīrṇakaṭhinād āvāsād akṛtacīvaro	KaWina-u 67.i. yaTA-api tat BikzuH AstIrNa-kaWinAt AvAsAt akRta-cIvaraH-
   'niṣṭhitacīvaraḥ vicikitsāsantati deśānuprekṣī bahiḥsīmāṃ prakrāmati kin	anizWita-cIvaraH vicikitsA-Asantati deSa-anuprekzI bahis-si-imAm prakrAmati kin
   nu pratyeṣyāmi āhosvin na pratyeṣyāmīti tasyaivaṃ bhavati na haiva	nu pratyezyAmi Ahosvit na pratyezyAmi-iti tasya-evam Bavati na ha-eva
   pratyeṣyāmy api tu cīvaraṃ kariṣyāmīti tasyaiva niṣṭhāpanāntikaḥ	pratyezyAmi api tu cIvaram karizyAmi-iti tasya-eva nizWApana-antikaH
   kaṭhinoddhāraḥ // 2 //	kaWina-udDAraH // 2 //
   evaṃ sanniṣṭhāpanāntikaḥ // 3 //	evam sannizWApana-antikaH // 3 //
   nāśanāntikaḥ // 4 //	nASana-antikaH // 4 //
   śrāvaṇāntikaḥ // 5 //	SrAvaNa-antikaH // 5 //
   Kaṭhina-v 67.ii. yathā deśānuprekṣaṇapaṃcikā evam āvāsaprekṣaṇapaṃcikā //	KaWina-u 67.ii. yaTA deSa-anuprekzaNa-paMcikA evam AvAsa-prekzaNa-paMcikA //
   kaṭhinavastu samāpta : // //	kaWina-vastu samApta : // //
