   dvitīyaḥ paricchedaḥ	dvitIyaH paricCedaH
   vākyasvarūpamāha--	vAkya-svarUpam-Aha--
        ************* COMMENTARY *************	************* SOMMENTa-aRY *************
        Locanā:	LocanA:
        (lo, a) samprati kāvyalakṣaṇayorvākyarasayoḥ svarūpajijñāsāyāṃ	(lo, a) samprati kAvya-lakzaNayoH-vAkya-rasayoH svarUpa-jijQAsAyAm
   prathamoddiṣṭaṃ vākyaṃ dvitīyaparicchedena saparikaraṃ nirūpayitukāmaḥ tat	praTama-uddizwam vAkyam dvitIya-paricCedena sa-parikaram nirUpayitu-kAmaH tat-
   sāmānyatakṣaṇapratipādikāṃ kārikāmavatārayati--vākyasvarūpamiti /	sAmAnya-takzaNa-pratipAdikAm kArikAm-avatArayati--vAkya-svarUpam-iti /
        svamasādhāraṇaṃ rūpaṃ svarūpam; itaravyāvartako dharmaḥ /	svam-asa-ADAraNam rUpam svarUpam; itara-vyAvartakaH DarmaH /
        ********** END OF COMMENTARY **********	********** END OF SOMMENTa-aRY **********
   vākyaṃ syādyogyatākāṅkṣāsattiyuktaḥ padoccayaḥ /	vAkyam syAt-yogya-tA-kAFkzA-satti-yuktaH pada-uccayaH /
   yogyatā padārthānāṃ parasparasaṃbandhe bādhābhāvaḥ /	yogya-tA padArTAnAm paraspara-saMbanDe bADA-BAvaH /
   padoccayasyaitadabhāve 'pi vākyatve "vahninā siñciti" ityādyapi vākyaṃ	pada-uccayasya-etat-aBAve api vAkya-tve "vahninA siQciti" ityAdi-api vAkyam
   syāt /	syAt /
        ************* COMMENTARY *************	************* SOMMENTa-aRY *************
        Vijñapriyā:	VijQa-priyA:
        (vi, ka) vākyaṃ rasātmakaṃ kāvyamityuktatvāt vākyalakṣaṇaṃ	(vi, ka) vAkyam rasa-Atmakam kAvyam-iti-ukta-tvAt vAkya-lakzaNam
   vaktumāha---vākyasvarūpamiti /	vaktum-Aha-----vAkya-svarUpam-iti /
        bādhābhāvo bādhamātrābhāvatve bādhajñānābhāvaḥ, tu bādhite bādhājñāne	bADA-BAvaH bADa-mAtra-aBAva-tve bADa-jQAna-aBAvaH, tu bADite bADA-jQAne
   śābdabodhānupapatteḥ /	SAbda-boDa-anupapatteH /
        vahninā siñcatītyanvayabodhanakasyaiva vākyatvaṃ, sekaṃ prati vanheḥ	vahninA siQcati-iti-anvaya-boDanakasya-eva vAkya-tvan, sekam prati vanheH
   karaṇatānvayabādhānnānvayabodhaḥ /	karaNa-tA-anvaya-bADAt-na-anvaya-boDaH /
        nanvevamanvayabodhajanakatvameva lakṣaṇamiti vācyam ?	nanu-evam-anvaya-boDa-janaka-tvam-eva lakzaNam-iti vAcyam ?
   anvayabodhajanakasāmagrīpradarśanārthaṃ tadghaṭitalakṣaṇakaraṇāt /	anvaya-boDa-janaka-sAmagrI-pradarSana-arTam tad-Gawita-lakzaNa-karaNAt /
        ********** END OF COMMENTARY **********	********** END OF SOMMENTa-aRY **********
   ākāṅkṣā pratītiparyavasānavirahaḥ /	AkAFkzA pratIti-paryavasAna-virahaH /
   sa ca śroturjijñāsārūpaḥ /	sa ca SrotuH-jijQAsA-rUpaH /
        ************* COMMENTARY *************	************* SOMMENTa-aRY *************
        Vijñapriyā:	VijQa-priyA:
        (vi, kha) ākaṅkṣeti---pratītiparyyavasānavirahameva vyācaṣṭhe saceti	(vi, Ka) AkaFkza-iti----pratIti-paryyavasAna-viraham-eva vyAcazWe sacA-iti
        jijñāsā ca pratītapadārthātiraktapadārthaḥ; sā ca	jijQAsA ca pratIta-padArTa-atirakta-padArTaH; sA ca
   prathamapratītapadārthānvayabādhārthamutthitā bodhyā, tena gauraśva	praTama-pratIta-padArTa-anvaya-bADa-arTam-utTitAH boDyA, tena gOH-aSva
   ityādau daivādaśveti jijñāsāsattve 'pi nākāṅkṣā /	ityAdO dEvAdaSva-iti jijQAsA-sattve api na-AkAFkzAH /
        caitrasya bhrātā gṛhaṃ gacchatītyādau caitrasya na gṛhe ākāṅkṣā udeti	cEtrasya BrAtA gRham gacCati-ityAdO cEtrasya na gRhe AkAFkzAH udeti
   bhrātari janitānvayabodhāt /	BrAtari janita-anvaya-boDAt /
        tena caitrasya gṛhamiti na bodhaḥ /	tena cEtrasya gRham-iti na boDaH /
        "vimalaṃ jalaṃ nadyāḥ kacche mahiṣaścarati"itya; vimalajale 'nvitāyā	"vimalam jalam nadyAH kacCe mahizaH-carati-"itya; vimala-jale anvitAya-a
   api nadyāḥ kacchasya sambandhikatvenopasthiteḥ nadīrūpe sambandhini	api nadyAH kacCasya sambanDika-tvena-upasTiteH nadI-rUpe sambanDini
   tātparyyaśāt kacchānvayārthamapi kacche jijñāsa udeti iti na tatrāvyāptiḥ	tAtparyyaSAt kacCa-anvaya-arTam-api kacCe jijQAsaH udeti iti na tatra-avyAptiH
        vahninā siñcatītyatra tu karaṇatāyāḥ kāryaṃ vitā anupapattyā seke tat	vahninA siQcati-iti-atra tu karaNa-tAyAH kAryam vitA anupapattyA seke tat-
   kāryye udeti eva ākāṅkṣā iti bodhyam /	kAryye udeti eva AkAFkzAH iti boDyam /
        evaṃ cākāṅkṣitaparasparasambandhe bādhaviraha eva yogyatā, anyathā	evam ca-AkAFkzita-paraspara-sambanDe bADa-virahaH eva yogyatA, anyaTA
   anākāṅkṣitasya kālikasambandhasya vahnikaraṇatāsekayorapi sattvād yogyatā	anAkAFkzitasya kAlika-sambanDasya vahni-karaNa-tA-sekayoH-api sattvAt yogyatA
   syāt /	syAt /
        Locanā:	LocanA:
        (lo, ā) vākyaṃ syāditi /	(lo, A) vAkyam syAt-iti /
        etad vivṛṇoti /	etat vivRNoti /
        yogyateti /	yogyatA-iti /
        padārthānāmiti /	padArTAnAm-iti /
        padānāṃ gaurityādīnāmarthāḥ padārthaḥ /	padAnAm gOH-iti-AdInAm-arTAH padArTaH /
        etadabhāve yogyatāyā abhāve 'pi gaurityādīnāṃ	etad-aBAve yogyatAyAH aBAve api gOH-ityAdInAm
   parasparamākāṅkṣāvirahiṇāṃ padānāṃ pratītiparyyavasānaviraha ityeva	parasparam-AkAFkzA-virahiNAm padAnAm pratIti-paryyavasAna-virahaH iti-eva
   viśādayatiśroturjijñāsā iti /	viSAda-yati-SrotuH-jijQAsA iti /
        ākāṅkṣā ātmadharmaḥ śroturjijñāsārūpatvena icchāsmatvāt /	AkAFkzAH Atma-DarmaH SrotuH-jijQAsA-rUpa-tvena icCA-asma-tvAt /
        yogyatār'thadharmaḥ sphuṭa eva /	yogyatAr-aTa-DarmaH sPuwaH eva /
        etadabhāvāt gauraśvaḥ puruṣo hastītyatra ca nānvayabodhaḥ /	etad-aBAvAt gOH-aSvaH puruzaH hastI-iti-atra ca na-anvaya-boDaH /
        sākāṅkṣāvākye 'pi anvayabodhānantaraṃ nirākāṅkṣatvavyavahārāt /	sa-AkAFkzA-vAkye api anvaya-boDa-anantaram nirAkAFkza-tva-vyavahArAt /
        prakṛtānvayabodhasamānākāraśābdabodhābhāvo 'pi ākāṅkṣāntaram /	prakRta-anvaya-boDa-samAna-AkAra-SAbda-boDa-aBAvaH api AkAFkza-antaram /
        ato "ghaṭamānaya'; iti vākyam ekadā anvayabodhejanite na	atas "Gawam-Anaya-a; iti vAkyam ekadA anvaya-boDejanite na
   anvayabodhāntarajanakam (kā-pra-ṭīdṛviśvanātha) /	anvaya-boDa-antara-janakam (kA--pra-wI-dRviSvanATa) /
        pratītīti-pratīteḥ paryyavasānam (samāptiḥ) tasyaḥ virahaḥ (abhāvaḥ)	pratIti-iti--pratIteH paryyavasAnam (samAptiH) tasyaH virahaH (aBAvaH)
   kevalaṃ kriyāśravaṇe bodhābhāvocca kārakasya (prathamaṃ karttuḥ tataḥ	kevalam kriyA-SravaNe boDa-aBAva-ucca kArakasya (praTamam karttuH tatas-
   karmaprabhṛtīnāṃ) jijñāsā svata evodeti /	karma-praBRtInAn) jijQAsA svatas eva-udeti /
        ********** END OF COMMENTARY **********	********** END OF SOMMENTa-aRY **********
   nirākāṅkṣasya vākyatve "gauraśvaḥ puruṣo istī" ityādīnāmapa vākyatvaṃ syāt	nirAkAFkzasya vAkya-tve "gOH-aSvaH puruzaH istI" ityAdInAm-apa vAkya-tvam syAt-
        ************* COMMENTARY *************	************* SOMMENTa-aRY *************
        Vijñapriyā:	VijQa-priyA:
        (vi, ga) gauraśva ityādi /	(vi, ga) gOH-aSvaH ityAdi /
        atra cākāṅkṣābhāvādeva ākāṅkṣitasambandhe bādhaviraharūpā yogyataiva	atra ca-akAFkza-aBAvAt-eva AkAFkzita-sambanDe bADa-viraha-rUpA yogyatA-eva
   nāsti; ityākāṅkṣāyā evābhāvānna vākyatvam /	nAsti; iti-AkAFkzAyAH eva-aBAvAt-na vAkya-tvam /
        ākāṅkṣābhāvaśca prathamāntapadārthasya prathamāntapadārthāntare	AkAFkzA-BAvaH-ca praTama-anta-padArTasya praTama-anta-padArTa-antare
   bhedenānvayārthaṃ jijñāsānudayasyānubhāvikatvādeva; abhedānvayetu, bādha	Bedena-anvaya-arTam jijQAsA-anudayasya-anuBAvika-tvAt-eva; aBeda-anvayetu, bADa
   eva	eva
        ********** END OF COMMENTARY **********	********** END OF SOMMENTa-aRY **********
   āsattirbuddhyavicchedaḥ /	AsattiH-budDi-avicCedaH /
   buddhivicchede 'pi vākyatve idānīmuccāritasya devadattaśabdasya dinātnaro	budDi-vicCede api vAkya-tve idAnIm-uccAritasya devadatta-Sabdasya dina-atnaraH-
   ccāritena gacchatīti padena saṅgatiḥ syāt /	ccAritena gacCati-iti padena saFgatiH syAt /
        ************* COMMENTARY *************	************* SOMMENTa-aRY *************
        Vijñapriyā:	VijQa-priyA:
        (vi, gha) āsattilakṣaṇamāha--yat padabuvdyavyavadhānena yat	(vi, Ga) Asatti-lakzaNam-Aha--yat pada-buvdya-vyavaDAnena yat-
   padabuddhistenaiva saha tasyāsattirityarthaḥ /	pada-budDiH-tena-eva saha tasya-asattiH-iti-arTaH /
        avyavadhānaṃ ca tadanvayānupayuktārthakasārthakapadāntareṇa,	avyavaDAnam ca tad-anvaya-anupayukta-arTaka-sArTaka-pada-antareNa,
   cirakālena vā bodhyam /	cira-kAlena vA boDyam /
        tena kāṣṭhaiḥ sthālyādipadārthānāṃ tadanvayopayogitvāt /	tena kAzWEH sTAlI-Adi-padArTAnAm tad-anvaya-upayogi-tvAt /
        nirarthakena vyavadhāne tu astyevā'sattiḥ--yathā"sa vai	nirarTakena vyavaDAne tu asti-evA-asattiH--yaTA"-sa vE
   gacchati"ityatra vaikārastu nirarthako 'pi prāmāṇikaprayukta eva bodhyaḥ /	gacCati"-iti-atra vEkAraH-tu nirarTakaH api prAmANika-prayuktaH eva boDyaH /
        natu cakārādiḥ /	na-tu cakAra-AdiH /
        tena tadanvayānupayuktārthakena prāmāṇikāprayuktanirarthakena	tena tad-anvaya-anupayukta-arTakena prAmANikA-prayukta-nirarTakena
   cāvyavadhānamarthaḥ /	ca-avyavaDAnam-arTaH /
        girirbhuktamāgnimān devadattena ityatra tu	giriH-Buktam-AgnimAn devadattena iti-atra tu
   giryyagnimatpadayornāsattaḥ /	giryyagnimat-padayoH-na-asattaH /
        tidanvayānupayuktabhuktapadena vyavadhānāt /	tidanvayA-anupayukta-Bukta-padena vyavaDAnAt /
        kālavyavadhāne tu kālasya ciratvaṃ,	kAla-vyavaDAne tu kAlasya cira-tvaM,
   tatpadabuddhidhārālopādhikaraṇatvameva /	tad-pada-budDi-DArA-lopa-aDikaraNa-tvam-eva /
        tatrāsattyabhāvaṃ darśayati--buddhivicchede 'pīti--naca tatra	tatra-asatti-aBAvam darSayati--budDi-vicCede api-iti--naca tatra
   pūrvoccāritapadārthasmṛtiryadyasti tadeṣvata eva tatra vākyatvaṃ,	pUrva-uccArita-padArTa-smRtiH-yadi-asti tat-ezu-atas eva tatra vAkya-tvaM,
   nacaitadabhāvādeva śābdabodhānutpattyā vākyatvābhāva iti vācyam,	na-ca-etad-aBAvAt-eva SAbda-boDa-anutpattyA vAkya-tva-aBAvaH iti vAcyam,
   śabdabodhajanakatvasyāsattilakṣaṇe 'praveśena tatpadasmṛtyabhāvena	Sabda-boDa-janaka-tvasya-asatti-lakzaNe apraveSena tad-pada-smRti-aBAvena
   śābdabodhājanakatayā vākye tatrātivyāptipradarśanasya aucityādeva /	SAbda-boDa-ajanaka-tayA vAkye tatra-ati-vyApti-pradarSanasya OcityAt-eva /
        ********** END OF COMMENTARY **********	********** END OF SOMMENTa-aRY **********
   atrākāṅkṣāyogyatayorātmārthadharmatve 'pi padoccayadharmatvamapacārāt /	atra-akAFkzA-yogya-tayoH-Atma-arTa-Darma-tve api pada-uccaya-Darma-tvam-apacArAt /
        ************* COMMENTARY *************	************* SOMMENTa-aRY *************
        Vijñapriyā:	VijQa-priyA:
        (vi, ṅa) nanu bādhajñānābhāvarūpāyā yogyatāyā jijñāsārūpāyā	(vi, Fa) nanu bADa-jQAna-aBAva-rUpAyAH yogyatAyAH jijQAsA-rUpAyAH-
   ākāṅkṣāyāścātmārthavṛttitvāt kathaṃ padoccayasya tadyuktatvam ityata	AkAFkzAyAH-ca-Atma-arTa-vRtti-tvAt kaTam pada-uccayasya tad-yukta-tvam iti-ata
   āha--ākāṅkṣāyogyatayoriti---upacāro viṣayatāsambandhena vṛttiḥ /	Aha--A-kAFkzA-yogyatayoH-iti---upacAraH vizaya-tA-sambanDena vRttiH /
        sā ca bādhavirahasya pratiyogino bāghajñānasya viṣaye padoccaye tad	sA ca bADa-virahasya pratiyoginaH bAGa-jQAnasya vizaye pada-uccaye tat-
   viṣayatā sākṣādeva /	vizaya-tA sAkzAt-eva /
        ********** END OF COMMENTARY **********	********** END OF SOMMENTa-aRY **********
   vākyoccayo mahāvākyam	vAkya-uccayaH mahA-vAkyam
   yogyatākāṅkṣāsattiyukta ityeva /	yogyatA-kAFkzA-satti-yuktaH iti-eva /
   itthaṃ vākyaṃ dvidhā matam // VisSd_2.1 //	itTam vAkyam dviDA matam // VisSd-_2.1 //
   itthamiti vākyatvena mahāvākyatvena ca /	itTam-iti vAkya-tvena mahA-vAkya-tvena ca /
   uktaṃ ca tantravārtike--	uktam ca tantra-vArtike--
   "svārthabodhasamāptānāmaṅgāṅgitvavyapekṣayā /	"sva-arTa-boDa-samAptAnAm-aFga-aFgi-tva-vyapekzayA /
   vākyānāmekavākyatvaṃ punaḥ saṃhatya jāyate" //	vAkyAnAm-eka-vAkya-tvam punar saMhatya jAyate" //
   iti /	iti /
        ************* COMMENTARY *************	************* SOMMENTa-aRY *************
        Locanā:	LocanA:
        (lo, i) mahāvākyasyāpi kāvyatve ācāryyasampatiṃ	(lo, i) mahA-vAkyasya-api kAvya-tve AcAryya-sampatim
   darśayati---taduktamiti /	darSayati---tat-uktam-iti /
        aṅgaṅgitvena prabandheṣu viśakalitānyapi vākyāni, anyo	aFgaFgi-tvena prabanDezu viSakalitAni-api vAkyAni, anyaH-
   'nyamaṅgāṅgibhāvaṃ vinā tu vātulapralāpavadasambandhatāṃ bhajante /	anyam-aFga-aFgi-BAvam vinA tu vAtula-pralApa-vat-asambanDa-tAm Bajante /
        saṃhatya sametya vākyamahāvākyayorityādiṣu pratyekaṃ vyavaccheda	saMhatya sametya vAkya-mahA-vAkyayoH-iti-Adizu pratyekam vyavacCeda
   ityanvayaḥ /	iti-anvayaH /
        sākāṅkṣāni anekapadāni, yathā devadatto daṇḍena gām /	sa-AkAFkzAni aneka-padAni, yaTA devadattaH daNxena gAm /
        anekavākyāni ca saṃhatya samuditārthabodhānārtham itaravākyasāpekṣāṇi	aneka-vAkyAni ca saMhatya samudita-arTa-boDAna-arTam itara-vAkya-sa-apekzANi
   prabandheṣu prasiddhani /	prabanDezu prasidDani /
        tathābhūtānāṃ hi padānāṃ vākyānāṃ ca viśakalitānekārthabodhana eva	taTABUtAnAm hi padAnAm vAkyAnAm ca viSakalita-aneka-arTa-boDanaH eva
   bhaṭṭamate sāmarthyaṃ natvekārthabodhane /	Bawwa-mate sAmarTyam na-tu-eka-arTa-boDane /
        ********** END OF COMMENTARY **********	********** END OF SOMMENTa-aRY **********
   tatra vākyaṃ yathā--"śūnyaṃ vāsagṛham-'ityādi (22 pṛ.) /	tatra vAkyam yaTA--"-SUnyam vAsa-gRham--aityAdi (22 pR.) /
        ************* COMMENTARY *************	************* SOMMENTa-aRY *************
        Vijñapriyā:	VijQa-priyA:
        (vi, ca) vākyasya dvaividhyamāha---vākyoccaya iti /	(vi, ca) vAkyasya dvEviDyamAha-----vAkya-uccayaH iti /
        kvacit vākyamātrasya kvacicca mahāvākyasya vākyatvena, dvayorapi	kvacid vAkya-mAtrasya kvacid-ca mahA-vAkyasya vAkya-tvena, dvayoH-api
   lakṣaṇakathane ākāṅkṣāsattvāt mahāvākyalakṣaṇe 'pi yogyatādikaṃ	lakzaNa-kaTane AkAFkzA-sattvAt mahA-vAkya-lakzaNe api yogyatA-Adikam
   viśeṣaṇamityāha---yogyatākāṅkṣeti /	viSezaNam-iti-Aha---yogya-tA-kAFkzA-iti /
        tatrārdrakāṣṭhe vahnirjvalati tena siñcitītyatra mahāvākyatvāpattyā	tatra-Ardra-kAzWe vahniH-jvalati tena siQciti-iti-atra mahA-vAkya-tva-ApattyA
   tadvāraṇāya yogyatāyāḥ, caitraḥ pacati, maitrau gacchati, ityetad	tad-vAraNAya yogyatAyAH, cEtraH pacati, mEtrO gacCati, iti-etat-
   vāraṇāyākāṅkṣāyāḥ, dināntaroccāritavākyadvayasya virodhivākyavyavahitayoḥ	vAraNAya-akAFkzAyAH, dina-antara-uccArita-vAkya-dvayasya viroDi-vAkya-vyavahitayoH
   sākāṅkṣayogyavākyayorvāraṇāyā'satterupādānam /	sa-AkAFkza-yogya-vAkyayoH-vAraNAyAH-asat-teH-upAdAnam /
        sūnyaṃ vāsagṛhamityādi---atra sarvapadārthānāmeva uttaratra	sUnyam vAsagRham-ityAdi----atra sarva-padArTAnAm-eva uttaratra
   sākāṅkṣatvena kasyāpi svārthabodhasamāptyabhāvāt na mahāvākyatvam /	sa-AkAFkza-tvena kasya-api sva-arTa-boDa-samApti-aBAvAt na mahA-vAkya-tvam /
        ********** END OF COMMENTARY **********	********** END OF SOMMENTa-aRY **********
   mahāvākyaṃ yathā--	mahA-vAkyam yaTA--
   rāmāyaṇa-mahābhārata-raghuvaṃśādi /	rAmAyaNa--mahABArata-raGu-vaMSa-Adi /
   padoccayo vākyamityuktam /	pada-uccayaH vAkyam-iti-uktam /
   tatra kiṃ padalakṣaṇamityata āha--	tatra kim pada-lakzaNam-iti-atas Aha--
   varṇāḥ padaṃ prayogārhānanvitekārthabodhakāḥ /	varNAH padam prayoga-arhAn-anviteka-arTa-boDakAH /
        ************* COMMENTARY *************	************* SOMMENTa-aRY *************
        Vijñapriyā:	VijQa-priyA:
        (vi, cha)---varṇṇāḥ padamiti---prayogārhāśca te	(vi, Ca)---varNNAH padam-iti----prayoga-arhAH-ca te
   'nanvitaikārthabodhakāśceti karmadhārayaḥ /	ananvita-eka-arTa-boDakAH-ca-iti karmaDArayaH /
        ekārthabodhakā ityatra ekaikārthabodhakā ityarthaḥ /	eka-arTa-boDakAH iti-atra eka-eka-arTa-boDakAH iti-arTaH /
        tena vākyasthapadeṣu milanena anekārthabodhakeṣu nāvyāptiḥ /	tena vAkya-sTa-padezu milanena aneka-arTa-boDakezu na-avyAptiH /
        ekaikārthavattvaṃ hi svasamasaṃkhyārthatvam; arthasya ekaikatvasya	ekEka-arTavat-tvam hi sva-sama-saMKyA-arTa-tvam; arTasya ekEka-tvasya
   vaktumaśakyatvāt /	vaktum-aSakyatvAt /
        na trividhā surā ityatra ekasurāśabdasya	na triviDA surAH iti-atra eka-surA-Sabdasya
   gauḍīpaiṣṭhīmādhvītrayabodhakatvāttatrāvyāptiriti vācyam, tatra gauḍī surā	gOxI-pEzWI-mADvI-traya-boDaka-tvAt-tatra-avyAptiH-iti vAcyam, tatra gOxI surA
   paiṣṭhī surāmādhvī surā ityevamāvṛttyaivānvayabodhasvīkaraṇe	pEzWI surA-mADvI surAH iti-evam-AvRttyA-eva-anvaya-boDa-svIkaraNe
   surāpadatrayasya svasamasaṃkhyārthabodhakatvenāvyaptyabhāvāt /	surA-pada-trayasya sva-sama-saMKya-arTa-boDaka-tvena-avyapti-aBAvAt /
        na ca taitra-maitra-devadattāḥ sundarā ityatra ekasundarapadena	na ca tEtra--mEtra--devadattAH sundarAH iti-atra eka-sundara-padena
   sundaratritayābodhanāt tatrāvyāptiriti vācyam;	sundara-tritaya-AboDanAt tatra-avyAptiH-iti vAcyam;
   arthapadasyārthatāvacchedekaparatvena saundaryyasyaikatvādeva /	arTa-padasya-arTa-tA-avacCedeka-paratvena sOndaryyasya-eka-tvAt-eva /
        na ca tathāpi trividhā surā ityatrāvyāptiriti vācyam	na ca taTA-api triviDA surAH iti-atra-avyAptiH-iti vAcyam
   arthatāvacchedakānekatve āvṛttereva svīkārāt /	arTa-tA-avacCedakAn-eka-tve AvRtteH-eva svIkArAt /
        ********** END OF COMMENTARY **********	********** END OF SOMMENTa-aRY **********
   yathā--ghaṭa. /	yaTA--Gawa. /
   prayogārheti prātipadikasya vyavacchedaḥ /	prayoga-arhA-iti prAtipadikasya vyavacCedaH /
        ************* COMMENTARY *************	************* SOMMENTa-aRY *************
        Vijñapriyā:	VijQa-priyA:
        (vi, ja) pratipadikasyeti---tanmātrasāyetyarthaḥ /	(vi, ja) pratipadikasya-iti----tanmAtra-sAya-iti-arTaH /
        vibhaktyantasyaiva padatvasvīkārāt, nahi vibhaktiṃ vinā	viBakti-antasya-eva padatva-svIkArAt, na-hi viBaktim vinA
   suddhapratipadikasya prayogārhatā /	sudDa-pratipadikasya prayoga-arhatA /
        nacānanvitaikārthapade naiva padvāraṇamiti vācyam; abhihitānvayavāde	nacAn-anvita-eka-arTa-pade na-eva pad-vAraNam-iti vAcyam; aBihita-anvaya-va-Ade
   tasyānanvitābhidhāyitvādeva /	tasya-ananvita-aBiDAyi-tvAt-eva /
        ********** END OF COMMENTARY **********	********** END OF SOMMENTa-aRY **********
   ananviteti vākyamahāvākyayoḥ /	ananvitA-iti vAkya-mahA-vAkyayoH /
        ************* COMMENTARY *************	************* SOMMENTa-aRY *************
        Vijñapriyā:	VijQa-priyA:
        (vi, jha) vākyamahāvākyayoriti---vyavaccheda ityatrānvayaḥ /	(vi, Ja) vAkya-mahA-vAkyayoH-iti---vyavacCedaH iti-atra-anvayaH /
        tayoḥ parasparamanvitārthabodhakatvādeva /	tayoH parasparam-anvita-arTa-boDaka-tvAt-eva /
        atra ca vākyasyāśvitānekārthabodhakatvādekārthabodhakatvenaiva	atra ca vAkyasya-aSvita-aneka-arTa-boDaka-tvAt-eka-arTa-boDaka-tvena-eva
   tadvāraṇasambhave 'pi tad viśeṣaṇadānamanvitābhidhānavādo	tad-vAraNa-samBave api tat viSezaNa-dAnam-anvita-aBiDAna-vAdaH-
   'smabhirnādriyate ityabhiprayasūcanāyaiva ityavadheyam /	asmaBiH-na-Adriyate iti-aBipraya-sUcanAya-eva iti-avaDeyam /
        ********** END OF COMMENTARY **********	********** END OF SOMMENTa-aRY **********
   eketi sākāṅkṣānekapadavākyānām /	ekA-iti sa-AkAFkza-aneka-pada-vAkyAnAm /
        ************* COMMENTARY *************	************* SOMMENTa-aRY *************
        Vijñapriyā:	VijQa-priyA:
        (vi, ña) sākāṅkṣāneketi---sākāṅkṣāni anekāni padāni yatra	(vi, Qa) sa-AkAFkza-aneka-iti----sa-AkAFkzAni anekAni padAni yatra
   tādṛśavākyānāṃ vyavaccheda ityarthaḥ /	tAdRSa-vAkyAnAm vyavacCedaH iti-arTaH /
        atra ca vākyānāmityeva vivakṣitaṃ;	atra ca vAkyAnAm-iti-eva vivakzitaM;
   vākyatvenaivānekapadatvaparasparasākāṅkṣatvayoḥ prāpteḥ /	vAkya-tvena-eva-aneka-pada-tva-paraspa-rasa-AkAFkza-tvayoH prApteH /
        svarūpākhyānaparatvādeva tayorupādanasya, na	svarUpa-AKyAna-paratvAt-eva tayA-UH-upAdanasya, na
   cānanvitārthabodhakatvaviśeṣaṇādevānvitārthabodhakavākyāvṛttiriti vācyam;	ca-ananvita-arTa-boDaka-tva-viSezaNAt-eva-anvitA-arTa-boDaka-vAkya-AvRttiH-iti vAcyam;
   parasparanvitārthakavākyadvayasya militvā padatvāpattivāraṇaparatvādeva	parasparanvitA-arTaka-vAkya-dvayasya militvA padatva-Apatti-vAraNa-paratvAt-eva
   vākyānāmityukteḥ /	vAkyAnAm-iti-ukteH /
        ananvitārthetyādinā tu ekaikavākyasyaiva vāraṇam /	ananvita-arTa-ityAdinA tu ekEka-vAkyasya-eva vAraNam /
        ********** END OF COMMENTARY **********	********** END OF SOMMENTa-aRY **********
   arthabodhakā iti kacaṭatapetyādīnām /	arTa-boDakAH iti kacawatapa-iti-AdInAm /
   varṇā iti bahuvacanamavivakṣitam /	varNAH iti bahuvacanam-avivakzitam /
        ************* COMMENTARY *************	************* SOMMENTa-aRY *************
        Vijñapriyā:	VijQa-priyA:
        (vi, ṭa) ka-ca-ṭa-ta-petyādīnāmiti---nanu prayogārhetyatra prayogo	(vi, wa) ka-ca-wa-ta-pa-iti-AdInAm-iti---nanu prayoga-arhA-iti-atra prayogaH-
   noccaraṇamātraṃ, tadā pratipadikavāraṇāpatteḥ /	na-uccaraNa-mAtraM, tadA pratipadika-vAraNa-ApatteH /
        kintu arthabodhanārthamuccāraṇamevāvaśyaṃ vācyam /	kintu arTa-boDana-arTam-uccAraNam-eva-avaSyam vAcyam /
        pratipadikamātrasya tadarthamanuccāraṇāt /	pratipadika-mAtrasya tad-arTam-anuccAraNAt /
        tathā ca prayogārhapadādeva nirarthaka-ka-ca-ṭa-ta-pādīnāṃ vāraṇaṃ	taTA ca prayoga-arha-padAt-eva nirarTa-ka-ka-ca-wa-ta-pa-AdInAm vAraNam
   sāyaditi cet, satyam /	sAyat-iti cet, satyam /
        arthabodhakatvānupādāner'thaviśeṣaṇasyānanvitetyasyānupādānamanāyatyaiva	arTa-boDaka-tva-anupAdAner-aTa-viSezaNasya-ananvitA-iti-asya-anupAdAnam-anAyati-A-eva
   paryyavasyati /	paryyavasyati /
        tataśca tadanupādāne vākyamahāvākyayorativyāptyāpattyā	tatas-ca tad-anupAdAne vAkya-mahA-vAkyayoH-ati-vyApti-ApattyA
   tadvāraṇāyānanvitetyasya dānāvaśmyabhāve tadanurodhena tadviśeṣasyārthasya	tad-vAraNAya-ananvitA-iti-asya dAna-avaSmi-aBAve tad-anuroDena tad-viSezasya-arTasya
   bodhakatvamupādeyam /	boDaka-tvam-upAdeyam /
        ata eva ka-ca-ṭa-ta-pityāderapi vāraṇamityabhiprāyāt /	atas eva ka-ca-wa-ta-piti-AdeH-api vAraNam-iti-aBiprAyAt /
        kacaṭatapadāyaśca padaikadeśavarṇṇā ityatra	kacawa-tapadAyaH-ca pada-eka-deSa-varNNAH iti-atra
   bahutvāvivakṣāmāha---varṇṇā iti /	bahu-tva-avivakzAmAha----varNNAH iti /
        Locanā:	LocanA:
        (lo, ī) varṇā iti /	(lo, I) varNAH iti /
        bahuvacanamavivakṣitaṃ tenaikasya varṇāsya dvayorapi ca parigrahaḥ	bahuvacanam-avivakzitam tena-ekasya varNa-asya dvayoH-api ca parigrahaH
   evaṃ ca mayi sānugraho bhavetyatra akārasya ekavarṇasya	evam ca mayi sa-anugrahaH Bava-iti-atra akArasya eka-varNasya
   vāsudevasambandhoktasya na padatvahāniḥ /	vAsudeva-sambanDa-uktasya na padatva-hAniH /
        tatreti--yathāsambhavaṃ padavākyayoḥ /	tatra-iti--yaTA-samBavam pada-vAkyayoH /
        ********** END OF COMMENTARY **********	********** END OF SOMMENTa-aRY **********
   artho vācyaśva lakṣyaśca vyaṅgyaśceti tridhā mataḥ // VisSd_2.2 //	arTaH vAcyaSva lakzyaH-ca vyaFgyaH-ca-iti triDA mataH // VisSd-_2.2 //
   eṣāṃ svarūpamāha--	ezAm svarUpam-Aha--
   vācyor'tho 'bhidhayā bodhyo lakṣyo lakṣaṇayā mataḥ /	vAcyor-aTaH aBiDayA boDyaH lakzyaH lakzaNayA mataH /
   vyaṅgyo vyañjanayā tāḥ syustistraḥ śabdasya śaktayaḥ // VisSd_2.3 //	vyaFgyaH vyaQjanayA tAH syuH-tistraH Sabdasya SaktayaH // VisSd-_2.3 //
        ************* COMMENTARY *************	************* SOMMENTa-aRY *************
        Vijñapriyā:	VijQa-priyA:
        (vi, ṭha) yogyatākāṅkṣayorarthaghaṭitatvena arthasya	(vi, Wa) yogyatA-kAFkzayoH-arTa-Gawita-tvena arTasya
   prabhedamāha---artha ityādi /	praBedam-Aha---arTaH ityAdi /
        svarūpaṃ lakṣaṇam /	svarUpam lakzaNam /
        śaktayo vṛttayaḥ /	SaktayaH vRttayaH /
        Locanā:	LocanA:
        (lo, u) tatrābhihitānvayavādināṃ mate vākyārtho 'pi padabhidheya iti	(lo, u) tatra-aBihita-anvaya-vAdinAm mate vAkya-arTaH api pad-aBiDeyaH iti
   vakṣyeta /	vakzyeta /
        ānvatābhidhānavādināṃ mate ca vākyābhidheyaḥ, lakṣyaśca	Anvata-aBiDAna-vAdinAm mate ca vAkya-aBiDeyaH, lakzyaH-ca
   padamātrasyārthaḥ /	pada-mAtrasya-arTaH /
        vyaṅgyaśca varṇapadavākyādīnām /	vyaFgyaH-ca varNa-pada-vAkya-AdInAm /
        ye cānvitādayo lakṣye vākyārthe iti ūcuḥ tanmate tatparyyavṛttireva	ye ca-anvita-AdayaH lakzye vAkya-arTe iti UcuH tad-mate tad-paryya-vRttiH-eva
   vākyārthabodhikā, dvitīyalakṣaṇetyaparaṃ nāma /	vAkya-arTa-boDikA, dvitIya-lakzaNA-iti-aparam nAma /
        nanu tatra gaṅgāyāṃ ghoṣa ityādau taṭārthabodhikā vakṣyamāṇalakṣaṇā	nanu tatra gaFgAyAm GozaH ityAdO tawa-arTa-boDikA vakzyamANa-lakzaNA
   vṛttiḥ /	vRttiH /
        gauṇyāśca lakṣaṇāyāmantarbhāvanīyatvādeva gauṇārthasya na	gONyAH-ca lakzaNAyAm-antar-BAvanIya-tvAt-eva gONa-arTasya na
   pṛthaṅnirdeśaḥ /	pRTak-nirdeSaH /
        iha vyañjanāyā abhidhālakṣaṇayoḥ sāhacaryyakathanaprastāvāt	iha vyaQjanAyAH aBiDA-lakzaNayoH sAhacaryya-kaTana-prastAvAt
   śabdamātraśaktitvavacanamupalakṣaṇam /	Sabda-mAtra-Sakti-tva-vacanam-upalakzaNam /
        vyañjanāprastāve lakṣaṇāprastāve tu bhaṭṭamate "sā vṛttirvyañjanā	vyaQjana-aprastAve lakzaNa-aprastAve tu Bawwa-mate "sA vRttiH-vyaQjanA
   nāma śabdasyārthādikasya ca'; iti vakṣyati /	nAma Sabdasya-arTa-Adikasya ca-a; iti vakzyati /
        ********** END OF COMMENTARY **********	********** END OF SOMMENTa-aRY **********
   tā abhidhādyāḥ /	tAH aBiDAdyAH /
   tatra saṃketitārthasya bodhanādagrimābhidhā /	tatra saMketita-arTasya boDanAt-agrima-aBiDA /
        ************* COMMENTARY *************	************* SOMMENTa-aRY *************
        Vijñapriyā:	VijQa-priyA:
        (vi, ḍa) tatrābhidhālakṣaṇamāha--tatra saṃketitārthasyeti /	(vi, xa) tatra-aBiDA-lakzaNam-Aha--tatra saMketita-arTasya-iti /
        abhidheti abhidhīyate bodhyate iti yogārtha eva lakṣaṇam; tatra	aBiDA-iti aBiDIyate boDyate iti yoga-arTaH eva lakzaNam; tatra
   kasyārthasya bodhanāttādṛśo yogārtha ityatrāha saṃketiteti /	kasya-arTasya boDanAt-tAdRSaH yoga-arTaH iti-atra-Aha saMketitA-iti /
        saṃketo vṛttirna tvabhidhā, ātmāśrayāpatteḥ /	saMketaH vRttiH-na tu-aBiDA, Atma-ASraya-ApatteH /
        tatastad grahārthe kāritam /	tatas-tat graha-arTe kAritam /
        tatra karmaṇi ktapratyayena gṛhītavṛttikasyārthasyetyarthaḥ /	tatra karmaNi kta-pratyayena gRhIta-vRttikasya-arTasya-iti-arTaH /
        evaṃ cāgṛhītavṛttikārthabodhikā vyañjanā kathaṃ vāriteti vācyam /	evam ca-agRhIta-vRttika-arTa-boDikA vyaQjanA kaTam vAritA-iti vAcyam /
        gṛhītatadvṛttikasyotyarthātaḥ tataśca lakṣaṇāyamativyāptiḥ syādityata	gRhIta-tad-vRttikasya-utyarTAtas tatas-ca lakzaNAyam-ati-vyAptiH syAt-iti-ata
   āha---agnimeti /	Aha---agnim-eti /
        prathamagṛhītetyarthaḥ /	praTama-gRhIta-iti-arTaH /
        lakṣaṇā tu śaktigrahottaraṃ bādhāvatāre satyeva gṛhyate /	lakzaNA tu Sakti-graha-uttaram bADa-avatAre sati-eva gRhyate /
        ata eva vyākhyāsyati--śattyantarānantariteti /	atas eva vyAKyAsyati---Satti-antarA-anantaritA-iti /
        kecittu tisṝṇāṃ vṛttīnām agroktetyagrimapadārthaṃ vyācakṣate /	kecid-tu tisLNAm vRttInAm agroktA-iti-agrima-padArTam vyAcakzate /
        tanna /	tat-na /
        tadbhaṅgyābhidhābhidhetyevamananvayāpatteḥ; śaktyantarānantariteti	tad-BaFgyA-aBiDA-aBiDA-iti-evam-ananvaya-ApatteH; Sakti-antarA-anantaritA-iti
   vyākhyānupapatteśca /	vyAKyA-anupapatteH-ca /
        ********** END OF COMMENTARY **********	********** END OF SOMMENTa-aRY **********
   uttamavṛddhena madhyamavṛddhamuddiśya "gāmānaya" ityukte taṃ	uttama-vRdDena maDyama-vRdDam-uddiSya "gAmAnaya" iti-ukte tam
   gavānayanapravṛttamupalabhya bālo 'sya vākyasya	gavAnayana-pravRttam-upalaBya bAlaH asya vAkyasya
   "sāsnādimatpiṇḍānayanamarthaḥ" iti prathamaṃ pratipadyate, anantaraṃ ca	"sAsnAdimad-piNxa-Anayanam-arTaH" iti praTamam pratipadyate, anantaram ca
   "gāṃ badhāna" "aśvamānaya" ityādāvāvāpodvāpābhyāṃ gośabdasya	"gAm baDAna" "aSvamAnaya" iti-AdO=-AvApa-udvApAByAm go-Sabdasya
   "sāsnādimānarthaḥ" ānayanapadasya ca "āharaṇamarthaḥ" iti	"sA-asnAdi-mAnarTaH" Anayana-padasya ca "AharaNam-arTaH" iti
   saṃketamavadhārayati /	saMketam-avaDArayati /
        ************* COMMENTARY *************	************* SOMMENTa-aRY *************
        Vijñapriyā:	VijQa-priyA:
        (vi, ḍha) tatra vṛddhavyavahāradarśanārthaḥ saṃketagrahaḥ; tat	(vi, Xa) tatra vRdDa-vyavahAra-darSana-arTaH saMketa-grahaH; tat-
   prakāraṃ darśayati--uttameti /	prakAram darSayati--uttama-iti /
        matamāśritya vyācaṣṭhe--uttameti /	matam-ASritya vyAcazWe--uttama-iti /
        ṇadhyamaṃ vṛddham /	NaDyamam vRdDam /
        bālo vyutpisuḥ /	bAlaH vyutpisuH /
        vākyasyākhaṇḍasyetyarthaḥ /	vAkyasya-aKaNxasya-iti-arTaH /
        sāstrādimat piṇḍānayanamasya khaṇḍārthaḥ /	sa-astra-Adimat piNxa-Anayanam-asya KaNxa-arTaH /
        natu pratyekaṃ gośabdasya sāstrādimān, piṇḍaḥ /	na-tu pratyekam go-Sabdasya sa-astra-AdimAn, piNxaH /
        ānayanasya āharaṇamiti pratipadyate jānāti /	Anayanasya AharaNam-iti pratipadyate jAnAti /
        asya vākyasyeti /	asya vAkyasya-iti /
        anena prathamaṃ vākyavākyārthayoḥ śaktigraho darśitaḥ /	anena praTamam vAkya-vAkya-arTayoH Sakti-grahaH darSitaH /
        āvāpaḥ pratijñā, udvāpaḥ uddhāraḥ /	AvApaH pratijQA, udvApaH udDAraH /
        āvāpodvāpau śrutapadatyāgena tatsthāne padāntaraśrutiḥ /	AvApa-udvApO Sruta-pada-tyAgena tad-sTAne pada-antara-SrutiH /
        Locanā:	LocanA:
        (lo, ū) krameṇābhidhādīnāṃ svarūpamāha-tatrapi etat	(lo, U) krameNa-aBiDa-AdInAm svarUpam-Aha-tatrapi etat-
   kārikārthamanvitābhidhānaayamarthaḥ-śabdatadarthayorvācyavācakatve	kArikA-arTam-anvita-aBiDAna-ayamarTaH--Sabda-tad-arTayoH-vAcya-vAcaka-tve
   vyutpannānāmeva vākyārthapratītiḥ, vyutpattiśca vṛddhaprayogādeva, sa ca	vyutpannAnAm-eva vAkya-arTa-pratItiH, vyutpattiH-ca vRdDa-prayogAt-eva, sa ca
   vākyarūpa eva, vākyaṃ cānvitabodhaniyatam /	vAkya-rUpaH eva, vAkyam ca-anvita-boDa-niyatam /
        tataścopadeśakale 'nvita eva sambandhagrahaṇamiti /	tatas-ca-upadeSa-kale anvitaH eva sambanDa-grahaNam-iti /
        nanu tarhi vākyabhāgarūpeṣu padeṣu padārthabodhavyatirekeṇa	nanu tarhi vAkya-BAga-rUpezu padezu padArTa-boDa-vyatirekeNa
   bhinnavākyaniṣṭeṣu padeṣu kathamarthāvabodha ityata āha---anantaraṃ ceti /	Binna-vAkya-nizwezu padezu kaTam-arTa-avaboDaH iti-atas Aha---anantaram ca-iti /
        ayamāśayaḥ---yadyapi vṛddhavyavahārapūrvikaiva sarvā vyutpattiḥ,	ayam-ASayaH---yadi-api vRdDa-vyavahAra-pUrvikA-eva sarvA vyutpattiH,
   vṛddhavyavahāraśca vākyenaiva, tathāpi yasya padarūpasya vākyabhāgasya	vRdDa-vyavahAraH-ca vAkyena-eva, taTA-api yasya pada-rUpasya vAkya-BAgasya
   bodhe yasyārthabhāgasyāvāpaḥ, yaduddhāre coddhārastasmen padārthe tasya	boDe yasya-arTa-BAgasya-AvApaH, yat-udDAre ca-udDAraH-tasmet padArTe tasya
   padasya śaktirāvāpoddharadarśanenaivānugṛhītatayār'thāpattyāvagamyata iti	padasya SaktiH-AvApa-udDara-darSanena-eva-anugRhIta-tayAr-aTa-ApattyA-avagamyate iti
        evaṃ cātra pakṣe pratyayānumānārthāpattibhiḥ pramāṇaiḥ saṃketagraha	evam ca-atra pakze pratyaya-anumAna-arTApattiBiH pramANEH saMketa-graha
   iti sūcitam /	iti sUcitam /
        yadāhuḥ---	yat-AhuH---
        "śabdavṛddhābhidheyāṃśca pratyakṣeṇātra paśyati /	"Sabda-vRdDa-aBiDeyAn=-ca pratyakzeNa-atra paSyati /
        śrotuśca pratipannatvamanumānena ceṣṭayā //	SrotuH-ca pratipanna-tvam-anumAnena cezwayA //
        anyathānupapattyā ca bodhacchaktiṃ dvayātmikām /	anyaTA-anupapattyA ca boDat-Saktim dvaya-AtmikAm /
        arthāpattyā ca budhyeta sambandhaṃ tripramāṇakam" //	arTa-ApattyA ca buDyeta sambanDam tri-pramANa-kam" //
        iti /	iti /
        asya hyarthaḥ--śabdo gāmānaya ityādivākyam, vṛddhau	asya hi-arTaH---SabdaH gAm-AnayaH ityAdi-vAkyam, vRdDO
   prayojakaprayojyau, abhidheyo gavānayanādiḥ /	prayojaka-prayojyO, aBiDeyaH gavAnayana-AdiH /
        tān śrotā pratyakṣeṇa paśyati jānāti /	tAn SrotA pratyakzeNa paSyati jAnAti /
        anumiti śarīraṃ ca-yeyaṃ prayojya vṛddhasya pravṛttiḥ sā	anum-iti SarIram ca-yA-iyam prayojya vRdDasya pravRttiH sA
   etadanuguṇabuddhi pūrvikā; pravṛttitvāt; madīyaivaṃvidhapravṛttivat /	etad-anuguNa-budDi pUrvikA; pravRtti-tvAt; madIya-evaMviDa-pravRtti-vat /
        sā ca pravṛttiretatprayogajanyā; etadanvayavyatirekānuvidhānāditi	sA ca pravRttiH-etad-prayoga-janyA; etad-anvayavi-atireka-anuviDAnAt-iti
   dvayamāśrayabhūtasya vākyasya vācakatvaniyamanaṃ, viṣayabhūtasya	dvayam-ASraya-BUtasya vAkyasya vAcakatva-niyamanan, vizaya-BUtasya
   vācyatvaniyamanam ātmā-svarūpaṃ yasyāḥ tathābhūtāṃ	vAcya-tva-niyamanam AtmA--svarUpam yasyAH taTABUtAm
        śaktiṃ vācakavācyatvarūpaṃ sambandham anyathānupapattyā arthāt	Saktim vAcaka-vAcya-tva-rUpam sambanDam anyaTA-anupapattyA arTAt-
   prayojakavṛddhapravṛtterjānāti /	prayojaka-vRdDa-pravRtteH-jAnAti /
        nanvevaṃ bhinnavākyayogāt prativākyaṃ vyutpattirevekṣaṇīyā, sāvācyā	nanu-evam Binna-vAkya-yogAt prativAkyam vyutpattiH-eva-IkzaNIyA, sA-avAcyA
   durupapādyeti śabdavyavahārecchede ityata āha--arthāpattyā ca iti /	durupapAdya-iti Sabda-vyavahAra-icCede iti-atas Aha--arTa-ApattyA ca iti /
        atra cakāreṇa bodhe tu śaktiṃ dūyātmikāmityasyā parāmarśaḥ /	atra cakAreNa boDe tu Saktim dUyAtmikAm-iti-asyA parAmarSaH /
        avabudhyate iti pāṭhe tvarthata eva tat parāmarśaḥ /	avabuDyate iti pAWe tu-arTataH eva tat parAmarSaH /
        evaṃ cāyamarthaḥ; gṛhītasaṃketavākyabhāgarūpasya tadarthadvayātmikāṃ	evam ca-ayam-arTaH; gRhIta-saMketa-vAkya-BAga-rUpasya tad-arTa-dvaya-AtmikAm
   śaktiṃ vācyavācakasambaddhām avāpoddhāradarśanānugṛhītatayā arthāpattyā	Saktim vAcya-vAcaka-sambadDAm avApa-udDAra-darSana-anugRhIta-tayA arTApattyA
   jānātīti /	jAnAti-iti /
        arthastu vākyavākyārthayoḥ vācyavācakatvasambandhini bodhane	arTaH-tu vAkya-vAkya-arTayoH vAcya-vAcaka-tva-sambanDini boDane
   ekārthāpattiḥ /	eka-arTa-ApattiH /
        padatadarthayoścāpareti dvayorapyarthāpattyoḥ sāmānyata	padatad-arTayoH-ca-apara-iti dvayoH-api-arTApattyoH sAmAnyata
   ekatayāgaṇanam /	ekatayA-gaNanam /
        ********** END OF COMMENTARY **********	********** END OF SOMMENTa-aRY **********
   kvacicca prasīddhapadasamabhivyāharāt, yathā--	kvacid-ca prasIdDa-pada-samaBivyAha-rAt, yaTA--
   "iha prabhinnakamalodare madhūni madhukaraḥ pibati" ityatra /	"iha praBinna-kamala-udare maDUni maDukaraH pibati" iti-atra /
   kvacidāptopadeśāt, yathā--	kvacid-Apta-upadeSa-at, yaTA--
   "ayamaśvaśabdavācyaḥ" ityatra /	"ayam-aSva-Sabda-vAcyaH" iti-atra /
        ************* COMMENTARY *************	************* SOMMENTa-aRY *************
        Vijñapriyā:	VijQa-priyA:
        (lo, ṛ) kvacidekenaivopamānena pramāṇena saṃketagrahaṃ	(lo, R) kvacid-ekena-eva-upamAnena pramANena saMketa-graham
   darśayati-kvacicceti /	darSa-yati-kvacid-ca-iti /
        ayamarthaḥ--tridhā khalu upamānapramāṇavyavasthitiḥ;	ayam-arTaH--triDA Kalu upamAna-pramANa-vyavasTitiH;
   yadāhuḥ--"sādṛśyaṃ dharmamātraṃ ca vaisādṛśyaṃ ca bhedataḥ"iti; tatra	yat-AhuH---"sAdRSyam Darma-mAtram ca vEsAdRSyam ca BedataH"iti; tatra
   sādṛśye gosadṛśo gavayaḥ /	sAdRSye go-sadRSaH gavayaH /
        vaisādṛśye kākavisadṛśaḥ kokilaḥ /	vEsAdRSye kAka-visadRSaH kokilaH /
        dharmamātre prakṛtameva /	Darma-mAtre prakRtam-eva /
        upādeyādyudāharaṇam--atra hi prabhinnakamalodare	upAdeya-Adi-udAharaNam---atra hi praBinna-kamala-udare
   madhupātṛtvadharmapratipādakaiḥ pūrvāvadhāritasaṃketatayā prasiddhaiḥ	maDu-pAtR-tva-Darma-pratipAdakEH pUrva-avaDArita-saMketatayA prasidDEH
   padaiḥ samabhivyāhārat madhukarapadārtho bhramara iti saṅketamavadhārayati	padEH samaBivyAhArat maDukara-padArTaH BramaraH iti saFketam-avaDArayati
        etacca upalakṣaṇaṃ; tena gosadṛśo gavayaḥ kākavisadṛśaḥ kokila	etat-ca upalakzaNan; tena go-sadRSaH gavayaH kAka-visadRSaH kokila
   ityanayorupamānapramāṇena saṅketagrahaḥ sūcitaḥ kvacit śabdapramāṇa ityata	iti-anayoH-upamAna-pramANena saFketa-grahaH sUcitaH kvacid Sabda-pramANaH iti-ata
   āha---kvaciditi /	Aha----kvacid-iti /
        āpto viśvastaḥ, sa ca nirddhāritavacanaḥ /	AptaH viSvastaH, sa ca nirdDArita-vacanaH /
        tenāyamaśvaśabdavācya ityukto 'pyaśvārthaṃ saṃketaṃ gṛhṇāti /	tena-ayam-aSva-Sabda-vAcyaH iti-uktaH api-aSva-arTam saMketam gRhNAti /
        ********** END OF COMMENTARY **********	********** END OF SOMMENTa-aRY **********
   taṃ ca saṅketitamarthaṃ bodhayantī śabdasya śaktyantarānantaritā	tam ca saFketitam-arTam boDayantI Sabdasya Sakti-antarA-anantaritA
        ************* COMMENTARY *************	************* SOMMENTa-aRY *************
        Vijñapriyā:	VijQa-priyA:
        (lo, ṝ) agrimeti--kārikāpadārthaḥ śaktyantarānantariteti /	(lo, L) agrimA-iti---kArikA-padArTaH Sakti-antarA-anantaritA-iti /
        tena lakṣaṇāvyañjanayorasya vaiparītyaṃ sūcitam /	tena lakzaNa-avyaQjanayoH-asya vEparItyam sUcitam /
        lakṣaṇā hi abhidhāntaritaiva; vyañjanā yatra lakṣaṇā nāsti	lakzaNAH hi aBiDA-antaritA-eva; vyaQjanAH yatra lakzaNAH na-asti
   tatrābhidhāntaritā /	tatra-aBiDa-antaritA /
        taddvitīyāntaritā, yad vā, agrimetyanena yannāmā yatra caitrādiḥ	tad-dvitIya-antaritA, yat vA, agrimA-iti-anena yat-nAmA yatra cEtra-AdiH
   tannāmāviṣayatayāpi sa ityuktaprakārādāśrita caitretyādinānnā viṣayoderiva	tad-nAma-avizaya-tayA-api saH iti-ukta-prakArAt-ASrita cEtra-ityAdinA-annAH vizaya-udeH-iva
   sāntarāyasaṃketitādvaitalakṣaṇaṃ sūcitam /	sa-antarAya-saMketitA-dvEta-lakzaNam sUcitam /
        ********** END OF COMMENTARY **********	********** END OF SOMMENTa-aRY **********
   śaktirabhidhā nāma /	SaktiH-aBiDA nAma /
        ************* COMMENTARY *************	************* SOMMENTa-aRY *************
        Vijñapriyā:	VijQa-priyA:
        (vi, ṇa) kvacicceti---samabhivyāhāro 'nvayitvenaikavākye nirddeśaḥ /	(vi, Na) kvacid-ca-iti---samaBivyAhAraH anvayitvena-eka-vAkye nirddeSaH /
        prabhinneti-- atra madhupadaṃ pibatipadaṃ ca prasiddham /	praBinna-iti- atra maDu-padam pibatipadam ca prasidDam /
        kenāpi kṛtopyagṛhītaśaktikasya	kena-api kRta-upya-gRhIta-Saktikasya
   madhukarapadasyasamabhivyāhṛtamadhupānānvayitvāt bhramare śaktirgṛhyate /	maDukara-padasyasamaBivyAhRta-maDu-pAna-anvayitvAt Bramare SaktiH-gRhyate /
        taṃ ca saṅketitamiti--tattadgrāhakagṛhītavṛttikamityarthaḥ /	tam ca saFketitam-iti--tad-tad-grAhaka-gRhIta-vRttikam-iti-arTaH /
        śaktyantarānantariteti--śaktivṛttistadgrahānantaritetyarthaḥ /	Sakti-antarA-anantaritA-iti---Sakti-vRttiH-tad-graha-anantaritA-iti-arTaH /
        iyam āgrimapadavyākhyā /	iyam Agrima-pada-vyAKyA /
        ********** END OF COMMENTARY **********	********** END OF SOMMENTa-aRY **********
   saṅketo gṛhyate jātau guṇadravyakriyāsu ca // VisSd_2.4 //	saFketaH gRhyate jAtO guNa-dravya-kriyAsu ca // VisSd-_2.4 //
   jātirgopiṇḍādiṣu gotvādikā /	jAtiH-go-piNxa-Adizu go-tva-AdikAH /
   guṇo viśeṣādhānahetuḥ siddho vastudharmaḥ /	guNaH viSeza-ADAna-hetuH sidDaH vastu-DarmaH /
   śuklādayo hi gavādiraṃ sajātīyebhyaḥ kṛṣṇagavādibhyo vyāvartayanti /	Sukla-AdayaH hi gavAdiram sajAtIyeByaH kRzNa-gava-AdiByaH vyAvartayanti /
   dravyaśabdā ekavyaktivācino harihara-ḍitthaḍavitthādayaḥ /	dravya-SabdAH eka-vyakti-vAcinaH hari-hara-xitTa-xavitTa-AdayaH /
   kriyāḥ sādhyarūpā vastudharmāḥ pākādayaḥ /	kriyAH sADya-rUpAH vastu-DarmAH pAka-AdayaH /
   eṣu hi adhiśrayaṇāvaśrayaṇāntādipūrvāparībhūto vyāpārakalāpaḥ	ezu hi aDiSrayaNa-avaSrayaNa-anta-Adi-pUrva-aparIBUtaH vyApAra-kalApaH
   pākādiśabdavācyaḥ /	pAka-Adi-Sabda-vAcyaH /
   eṣveva hi vyakterupādhiṣu saṃketo gṛhyate, na vyaktauḥ	ezu-eva hi vyakteH-upADizu saMketaH gRhyate, na vyaktOH
   ānantyavyabhicāradoṣāpātāt /	Anantya-vyaBicAra-doza-ApAtAt /
        ************* COMMENTARY *************	************* SOMMENTa-aRY *************
        Vijñapriyā:	VijQa-priyA:
        (vi, ta) nanu saṃketitor'thaḥ kiṃ dharmo dharmo vā	(vi, ta) nanu saMketitor-aTaH kim DarmaH DarmaH vA
   ityatrāha--saṅketiteti /	iti-atra-aha---saFketitA-iti /
        śabdabhedena saṃketagrahaviṣayor'tho bhinna ityuktakrameṇa /	Sabda-Bedena saMketa-graha-vizayor-aTo BinnaH iti-ukta-krameNa /
        viśeṣādhānamitarato vailakṣaṇyabodhajanakam; etad rūpo yo	viSeza-ADAnam-itaratas vElakzaNya-boDa-jana-kam; etat rUpaH yaH-
   vastudharmaḥ sa siddho nitya ityāha--siddho vastudharma iti---etanmeta	vastu-DarmaH sa sidDaH nityaH iti-Aha---sidDaH vastu-DarmaH iti---etat-meta
   guṇā api nityā eva---utpattivināśapratītistvāvirbhāvatirobhāvarūpaiva /	guNAH api nityAH eva---utpatti-vinASa-pratItiH-tu-AvirBAva-tiroBAva-rUpA-eva /
        guṇānāṃ viśeṣādhānaṃ grāhayati--suklādayohi iti--vyāvarttayanti	guNAnAm viSeza-ADAnam grAhayati--suklAdayohi iti--vyAvarttayanti
   vilakṣaṇatayā bodhayanti harihareti /	vilakzaNa-tayA boDayanti hariharA-iti /
        idaṃ ca bālyādyavasthābhedena vyaktibhedānaṅgīkāre /	idam ca bAlya-Adi-avasTA-Bedena vyakti-Beda-anaFgIkAre /
        tadaṅgīkarttṝṇāṃ mate tu ayamapi jātiśabda eva /	tad-aFgIkarttLNAm mate tu ayam-api jAti-SabdaH eva /
        ākāśavindhyamandarādiśabdā ekaikavyaktidravyavācakā bodhyāḥ /	AkASa-vinDya-mandara-Adi-SabdAH ekEka-vyakti-dravya-vAcakAH boDyAH /
        kriyā iti--sādhyarūpāḥ janyarūpā mahāpralaye paramāṇūnāmapi	kriyAH iti---sADya-rUpAH janya-rUpA mahApralaye paramANUnAm-api
   niṣkriyatvena kriyāyā na nityatvam, atastasyā	nizkriya-tvena kriyAyAH na nitya-tvam, atas-tasyAH-
   janyatvamevetyatastasyānāvirbhāvatirobhāvakalpanā /	janya-tvam-eva-iti-atas-tasya-anAvirBAva-tiroBAva-kalpanA /
        apākajarūpāṇi paramāṇuvṛttīni--nityānyeva	apAkaja-rUpANi parama-aNu-vRttI-ni---nityAni-eva
   ityatastadvṛttipadārthavibhājakopādhikattvarūpaṃ nityatvaṃ	iti-atas-tad-vRtti-padArTa-viBAja-kopa-aDikattva-rUpam nitya-tvam
   sarvaguṇānāmevetyabhiprāyaḥ /	sarva-guNAnAm-eva-iti-aBiprAyaH /
        eṣveveti--eṣu kriyārūpavastudharmeṣu bodhyeṣu pākādiśabdavācyo	ezu-eva-iti--ezu kriyA-rUpa-vastu-Darmezu boDyezu pAka-Adi-Sabda-vAcyaH-
   'dhiśrayaṇāvaśrayaṇāntādikriyākalāpa ityarthaḥ /	aDiSrayaNa-avaSrayaNa-anta-Adi-kriyA-kalApaH iti-arTaH /
        anyathānekakriyāghaṭitapāke kā kriyāpadadhātvarthaḥ syāditi bhāvaḥ /	anyaTA-aneka-kriyA-Gawita-pAke kA kriyA-pada-DAtu-arTaH syAt-iti BAvaH /
        eṣveveti--dravyaṃvinā eṣu vyakterupādhiṣuityarthaḥ /	ezu-eva-iti--dravyaMvinA ezu vyakteH-upADizuiti-arTaH /
        ānantyeti---gavādivyaktīnām ānantyena tatra sarvatra	Anantya-iti---gavAdi-vyaktInAm Anantyena tatra sarvatra
   śaktigrahāsambhavādityarthaḥ /	Sakti-grahAsamBavAt-iti-arTaH /
        yadi ca ekavyaktāveva saṃketagraha ityucyate tadāha---vyabhicāreti /	yadi ca eka-vyaktO=-eva saMketa-grahaH iti-ucyate tat-Aha----vyaBicAra-iti /
        yadvyaktau saṃketo gṛhītastatabhinnastatsajātīyavyaktāvapi	yat-vyaktO saMketaH gRhItaH-tata-BinnaH-tad-sajAtIya-vyaktO=-api
   svarūpodbodhāt kāraṇaṃ śaktigrahaṃ vināpi kāryyabodhād vyabhicārajoṣa	svarUpa-udboDAt kAraNam Sakti-graham vinA-api kAryya-boDAt vyaBicAra-joza
   ityarthaḥ /	iti-arTaH /
        Locanā:	LocanA:
        (lo, ḷ) iha kecidāhuḥ; jātireva padārthaḥ, kecit jātivyaktī, kecid	(lo, ?) iha kecid-AhuH; jAtiH-eva padArTaH, kecid jAti-vyaktI, kecid-
   vyaktyākṛtijātaya ityādīni matāntarāṇi parihṛtya sarveṣāṃ vāṅmayānā	vyakti-AkRti-jAtayaH ityAdIni mata-antarANi parihRtya sarvezAm vAc-mayAnA
   vyākaraṇamūlatvāt alaṅkāraprantheṣu ca prāyeṇa tadanugatatvenaiva	vyAkaraNa-mUla-tvAt alaFkAra-pranTezu ca prAyeNa tad-anugata-tvena-eva
   vyavahārācca mahābhāṣyakāramatamāśrityāha---saṅketa iti /	vyavahArAt-ca mahABAzya-kAra-matamASritya-aha----saFketaH iti /
        guṇapadārthaṃ vivṛṇoti--guṇa iti /	guNa-padArTam vivRNoti--guNaH iti /
        viśeṣādhānaheturiti jātervyavacchedaḥ /	viSeza-ADAna-hetuH-iti jAteH-vyavacCedaH /
        siddha iti kriyāyāḥ /	sidDaH iti kriyAyAH /
        guṇānāṃ viśeṣādhānahetutvopapattimāha--śuklādaya iti /	guNAnAm viSeza-ADAna-hetutva-upapatti-mAha---Sukla-AdayaH iti /
        gavādikaṃ jātyā labdhagovyavahārayogyatākam /	gavA-Adikam jAtyA labDa-go-vyavahAra-yogya-tAkam /
        dravyetyādi /	dravya-ityAdi /
        hetuṃ vināpi ayaṃ ḍitthaḥ ḍavittha ityādirūpeṇaṃ śṛṅgagrāhikayā	hetum vinA-api ayam xitTaH xavitTaH iti-Adi-rUpeNam SRFga-grAhikayA
   vaktṛsaṃketena vyaktiṣu sānniveśitaḥ /	vaktR-saMketena vyaktizu sAnniveSitaH /
        sajātīyaśūnye ḍitthādyarthopasthāpakaḥ śabdaḥ saṃketasya viṣaya iti /	sajAtIya-SUnye xitTa-Adi-arTa-upasTApakaH SabdaH saMketasya vizayaH iti /
        pūrvāparībhūtaḥ pradhānakriyāyā avayavarūpatayā kāryyakāraṇabhūtena	pUrva-aparIBUtaH praDAna-kriyAyAH avayava-rUpa-tayA kAryya-kAraNa-BUtena
   santānībhūtaḥ /	santAnIBUtaH /
        eṣveveti---eṣu jātyādiṣu /	ezu-eva-iti---ezu jAti-Adizu /
        iha ca dravyasyopādhiviṣayatvāsambhave 'pi tatsaṃjñāyāḥ upādhitvena	iha ca dravyasya-upADi-vizaya-tva-asamBave api tad-saMjQAyAH upADi-tvena
   tattvamupacārāt /	tattvam-upacArAt /
        ḍitthādyarthe cānantyavyabhicārābhāvāt upādhiṃ vinaiva sambhavati	xitTa-Adi-arTe ca-Anantya-vyaBicAra-aBAvAt upADim vinA-eva samBavati
   vācyavācakasambandhasamayagraha iti nopādhirapekṣyate /	vAcya-vAcaka-sambanDa-samaya-grahaH iti na-upADiH-apekzyate /
        vaktṛsvecchākalpitasya saṃjñāśabdasya svapravṛttāvupādhyupagame	vaktR-sva-icCA-kalpitasya saMjQA-Sabdasya sva-pravRttO=-upADi-upagame
   punarātmāśrayadoṣaḥ /	punar-Atma-ASraya-dozaH /
        tathāpi dravyasaṃjñāyā apyupādhitvaṃ pratītyanurodhenoktam /	taTA-api dravya-saMjQAyAH api-upADi-tvam prati-iti-anuroDena-uktam /
        ata eva guṇadravyakiyāsu ceti dravyakiyāsu ceti dravyasya	atas eva guNa-dravya-kiyAsu ca-iti dravya-kiyAsu ca-iti dravyasya
   saṃketaviṣayatvamuktaṃ, tatrānantyavyabicāradoṣāpātābhāvāt /	saMketa-vizaya-tvam-uktaM, tatra-Ananti-a-vyabicAra-doza-apAta-aBAvAt /
        ānantyeti-vyaktīnāmanantatvāt pratyekaṃ ca	Anantya-iti-vyaktInAm-ananta-tvAt pratyekam ca
   rekhoparekhādisaṃsthānaviśeṣasya ca bhinnatvāt tatrāśakyaḥ sabhayagraha	reKA-upareKA-Adi-saMsTAna-viSezasya ca Binna-tvAt tatra-aSakyaH sa-Baya-graha
   iti /	iti /
        nanvevaṃ gavādipadena saṃketitatvāt jātāvantarhitāyāṃ kathaṃ	nanu-evam gavA-Adi-padena saMketita-tvAt jAtO=-antarhitAyAm kaTam
   vyaktipratītiḥ /	vyakti-pratItiH /
        avinābhāvasyānusandhānamantareṇākṣepakatvābhāvāt /	avinABO=-asya-anusanDAnam-antareNa-Akzepaka-tva-aBAvAt /
        yathā vā dhūmādigatasya vahnyāderavinābhāvānusandhānaṃ	yaTA vA DUma-Adi-gatasya vahni-AdeH-avinA-aBAva-anusanDAnam
   cātrānupalabdhibādhitaṃ; tatrānupayogitayā vyakteḥ śabdabodhitatvaṃ vinā	ca-atra-anupalabDi-bADitaM; tatra-anupayogi-tayA vyakteH Sabda-boDita-tvam vinA
   śābde 'nvaye praveśāsambhava iti jātyabhidhāyake śabde tadbonārthaṃ	SAbde anvaye praveSa-asamBavaH iti jAti-aBiDAyake Sabde tad-bona-arTam
   vyañjanaiva vṛttirūpāsitumuciteti rahasyam /	vyaQjanA-eva vRtti-rUpa-asitum-ucitA-iti rahasyam /
        evaṃ ca jātimātrasaṅketapakṣe ca nirvivādam /	evam ca jAti-mAtra-saFketa-pakze ca nirvivAdam /
        kiṃ ca saṃśayāpagamārtham upāttāni padāni saṃsargasya mukhyāṅgaṃ	kim ca saMSaya-apagama-arTam upAttAni padAni saMsargasya muKya-aFgam
   saṃsṛjyamānaṃ vyaktirūpaṃ sākṣānna bodhayanti, bahiraṅgantu	saMsRjyamAnam vyakti-rUpam sAkzAt-na boDayanti, bahis-aFgantu
   tadupādhibhūtaṃ sāmānyameva bodhayanti, ityasaṅgatam /	tad-upADi-BUtam sAmAnyam-eva boDayanti, iti-asaFgatam /
        ye tvāhuḥ, "vyaktisadhrīcīnāyāmeva jātau saṅketa'; iti tairapi	ye tu-AhuH, "vyakti-saDrIcInAyAm-eva jAtO saFketa-a; iti tEH-api
   prakṛtasya lakṣaṇasyāsaṅketitatvāt saṅketitabhedānāmabhāvāt,	prakRtasya lakzaNasya-asaFketita-tvAt saFketita-BedAnAm-aBAvAt,
   prakṛtasaṃsargayogyavyaktipratītau śaktyantaramavaśyamabhyupeyam /	prakRta-saMsarga-yogya-vyakti-pratItO Sakti-antaram-avaSyam-aByupeyam /
        sāmānyasya sarvaviśeṣatvāṅgīkārāt saṅketena sarvaviśeṣyajñāne tu	sAmAnyasya sarva-viSeza-tva-aFgIkArAt saFketena sarva-viSezya-jQAne tu
   sarvasyāpi sarvajñatvāpattiḥ /	sarvasya-api sarvajQatva-ApattiH /
        prathamoddeśakāle tu sarvavyaktīnāṃ sāmmukhyāṅgīkāratayā	praTama-uddeSa-kAle tu sarva-vyaktInAm sAmmuKya-aFgIkAratayA
   sāmānyaliṅgitayā pratyaṅgīkāre punarādhunikasyāpi svalakṣaṇasya	sAmAnya-liFgitayA pratyaFgIkAre punar-ADunikasya-api sva-lakzaNasya
   prathamopadeśakālavat sammukhīkāreṇaiva pratītiḥ syāt /	praTama-upadeSa-kAla-vat sammuKIkAreNa-eva pratItiH syAt /
        tataścānvayopapādikāyāḥ sākṣāt pratīteḥ padasya śaktyantaraṃ vinā kiṃ	tatas-ca-anvaya-upapAdikAyAH sAkzAt pratIteH padasya Sakti-antaram vinA kim
   bījabhityalaṃ bahunā /	bIja-Biti-alam bahunA /
        ********** END OF COMMENTARY **********	********** END OF SOMMENTa-aRY **********
   atha lakṣaṇā--	aTa lakzaNA--
   mukhyārthabādhe tadyukto yayānyor'thaḥ pratīyate /	muKya-arTa-bADe tad-yuktaH yayAnyor-aTaH pratIyate /
   rūḍheḥ prayojanādvāsau lakṣaṇā śaktirarpitā // VisSd_2.5 //	rUXeH prayojanAt-vA-asO lakzaNA SaktiH-arpitAH // VisSd-_2.5 //
        ************* COMMENTARY *************	************* SOMMENTa-aRY *************
        Vijñapriyā:	VijQa-priyA:
        (vi, tha) lakṣyo lakṣaṇayā grāhyaḥ ityuktatvāllakṣaṇāyā	(vi, Ta) lakzyaH lakzaNayA grAhyaH iti-ukta-tvAt-lakzaNAyAH-
   lakṣaṇamāha---mukhyārtheti /	lakzaNam-Aha----muKya-arTa-iti /
        mukhyārthaḥ śakyārthaḥ, tatrāparapadārthasyānvayabādhe jñāte	muKya-arTaH Sakya-arTaH, tatra-apara-padArTasya-anvaya-bADe jQAte
   satītyarthaḥ /	sati-iti-arTaH /
        gaṅgāyāṃ ghoṣa ityādau mukhyārthasya gaṅgāyā abādhāt; kintu	gaFgAyAm GozaH iti-AdO muKya-arTasya gaFgAyAH abADAt; kintu
   aparapadārthasya ghoṣānvayasyaiva bādhāt /	apara-padArTasya Goza-anvayasya-eva bADAt /
        tadyuktomukhyārthasambaddhaḥ anyo mukhyārthādanyaḥ /	tad-yuktaH-muKyA-arTa-sambadDaH anyaH muKya-arTAt-anyaH /
        yathā vṛtyā jñātayā iti śeṣaḥ /	yaTA vRtyA jQAtayA iti SezaH /
        na kevalaṃ mukhyārthabādhajñānādhīnaṃ tajjñānaṃ, api tu rūḍheḥ	na kevalam muKya-arTa-bADa-jQAna-aDInam tat-jQAnaM, api tu rUXeH
   prayojanād vāpīti /	prayojanAt vApi-iti /
        ---rūḍhiḥ bhūrikālaprayogaḥ /	---rUXiH BUri-kAla-prayogaH /
        tathā ca etattritayajñāpitayā yā vṛttyā mukhyārthādanyo	taTA ca etad-tritayajQA-pitayA yA vRttyA muKya-arTAt-anyaH-
   mukhyārthasambaddhor'thaḥ pratīyate asau śaktirvṛttirlakṣaṇetyarthaḥ /	muKya-arTa-sambadDoH-aTaH pratIyate asO SaktiH-vRttiH-lakzaNA-iti-arTaH /
        sā cārpitā vaktṛpuruṣeṇa lakṣyārthaviṣayatayā-janitetyarthaḥ, tathā	sA ca-arpitA vaktR-puruzeNa lakzya-arTa-vizaya-tayA-a-janitA-iti-arTaH, taTA
   ca vaktṛtātparyyatmikaiva sā bodhyā /	ca vaktR-tAt-paryyatmikA-eva sA boDyA /
        natu naiyāyikoktaśakyasambandharūpā; tasyā vavatrānyena	na-tu nEyAyika-ukta-Sakya-sambanDa-rUpA; tasyAH vavatra-anyena
   vārpitatvābhāvāt /	vA-arpita-tva-aBAvAt /
        yā tu vyaṅgyārthe tātparyyakhyā vṛttirdhvanikenoktā yā ca	yA tu vyaFgya-arTe tAtparyyaKyA vRttiH-Dvanikena-uktA yA ca
   padārthadvayasaṃsarge tātparyyākhyā vṛttiḥ prācīvanaiyāyikairuktā sā	padArTa-dvaya-saMsarge tAtparyya-AKyA vRttiH prAcIva-nEyAyikEH-uktA sA
   naitāttritaya-jñāpitā; ityato bhinnaiva sā /	na-etAt-tritaya--jQApitA; iti-atas BinnA-eva sA /
        mukhyārthe 'parapadārthānvayabodhe 'pi tātparyyaviṣayasya	muKya-arTe apara-padArTa-anvaya-boDe api tAtparyya-vizayasya
   tādṛśānvayasya mukhyatāvacchedakarūpeṇa bodhānupapattireva; tena chatriṇo	tAdRSa-anvayasya muKya-tAvacCedaka-rUpeNa boDa-anupapattiH-eva; tena CatriNaH-
   gacchanti kuntāḥ praviśantītyatra mukhyārthayoḥ chatrikuntayoḥ	gacCanti kuntAH praviSanti-iti-atra muKya-arTayoH Catri-kuntayoH
   gamanapraveśānvayasattve 'pi niruktamukhyārthabādhasattvānnāvyāptiḥ /	gamana-praveSa-anvaya-sattve api nirukta-muKya-arTa-bADa-sattvAt-na-avyAptiH /
        chatrisārthavāhitvena kintitvena ca rūpeṇānvayasya tātparyyaviṣayasya	Catri-sArTavAhi-tvena kinti-tvena ca rUpeNa-anvayasya tAtparyya-vizayasya
   mukhyatāvacchedakacchatritvakuntatvābhyāmanupapatteḥ /	muKya-tA-avacCeda-kacCatri-tva-kunta-tvAByAm-anupapatteH /
        atra ca tātparyyaviṣayatvānupādāne tu	atra ca tAtparyya-vizaya-tva-anupAdAne tu
   chatrikuntayorgamanapraveśānvayasya mukhyatāvacchedakaccha	Catri-kuntayoH-gamana-praveSa-anvayasya muKya-tA-avacCeda-kacCa
   tritvakuntābhyāmutpadyamānatvāt--tatrāvyāptyāpatteḥ /	tri-tva-kuntAByAm-utpadyamAna-tva-at---tatra-avyApti-ApatteH /
        evaṃ mukhyatāvacchedrakarūpeṇa ityanupādāne 'pi tayorevāvyāptiḥ syāt	evam muKya-tAvacCedraka-rUpeNa iti-anupAdAne api tayoH-eva-avyAptiH syAt-
        tātparyyaviṣayasya chatrisārthavāhino gamanānvayasya kuntinaḥ	tAtparyya-vizayasya Catri-sArTavAhinaH gamana-anvayasya kuntinaH
   praveśānvayasya ca	praveSa-anvayasya ca
   lakṣatāvacchedakacchatrisārthavāhitvakuntitvābhyāmupapatteḥ /	lakza-tA-avacCeda-kacCatri-sArTavAhi-tva-kunti-tvAByAm-upapatteH /
        anyor'tha ityatrāpi mukhyatāvacchedakānyadharmāvācchinna ityarthaḥ /	anyor-aTa iti-atra-api muKya-tA-avacCedakAni-aDarma-a=-AcCinnaH iti-arTaH /
        tena ghaṭapadasya nīlaghaṭe lakṣaṇāyāṃ tasya ghaṭanyatvābhāve 'pi	tena Gawa-padasya nIla-Gawe lakzaNAyAm tasya Gawa-nyatva-aBAve api
   nāvyāptiḥ /	na-avyAptiH /
        mukhyatāvacchedakaghaṭatvānyanīlaghaṭatvāvacchinnatvāt /	muKya-tAvacCedaka-Gawa-tva-ani-anIla-Gawa-tva-avacCinna-tvAt /
        Locanā:	LocanA:
        (lo, e) atheti-athābhidhānantaraṃ lakṣaṇoddeśakramaprāptā lakṣaṇā	(lo, e) aTa-iti-aTa-aBiDA-anantaram lakzaNa-uddeSa-krama-prAptA lakzaNA
   nirūṇyata iti śeṣaḥ /	nirUNyate iti SezaH /
        mukhyārtheti---mukhyārtho gaṅgādiśabdasya jalamayādiḥ tasya ca	muKya-arTa-iti----muKya-arTaH gaFgA-Adi-Sabdasya jala-maya-AdiH tasya ca
   ādheyapadārthāntare 'nvayānupapattau, na ca yataḥ kutaścit yadeva tadeva	ADeya-padArTa-antare anvaya-anupapattO, na ca yatas kutaScid yat-eva tat-eva
   lakṣyate-atiprasaṅgādityata āha---tadyukta iti /	lakzyate-ati-prasaFgAt-iti-atas Aha---tad-yuktaH iti /
        tena mukhyārthena yena kenacit sambandhena sambaddhaḥ anyor'thaḥ	tena muKya-arTena yena kenacid sambanDena sambadDaH anyor-aTaH
   taṭādiḥ yayā śabdaśaktyā pratīyate bodhyate; na ca sambandhamātrādapi	tawa-AdiH yayA Sabda-SaktyA pratIyate boDyate; na ca sambanDa-mAtrAt-api
   lakṣyārthapratītiḥ api prasaṅgādeva ityāha--rūḍheḥ prayojanād vā /	lakzya-arTa-pratItiH api prasaFgAt-eva iti-Aha--rUXeH prayojanAt vA /
        kvacid rūḍheḥ anādivṛddhavyavahāraprasiddheḥ kvacit	kvacid rUXeH anAdi-vRdDa-vyavahAra-prasidDeH kvacid-
   pāvanatvādyatiśayaṃ prayojanamuddiśya /	pAvana-tva-Adi-atiSayam prayojanam-uddiSya /
        arpitapadārthaśca vṛttāveva suvyaktaḥ /	arpita-padArTaH-ca vRttO=-eva su-vyaktaH /
        evaṃ cātra lakṣaṇāyāṃ hetutrayaṃ mukhyārthabādaḥ; ca tat sambandhaḥ,	evam ca-atra lakzaNAyAm hetu-trayam muKya-arTa-bAdaH; ca tat sambanDaH,
   kvacit rūḍhiḥ kvacit prayojanaṃ ceti /	kvacid rUXiH kvacid prayojanam ca-iti /
        ********** END OF COMMENTARY **********	********** END OF SOMMENTa-aRY **********
   "kaliṅgaḥ sāhasikaḥ" ityādau kaliṅgādiśabdo deśaviśeṣādirūpe svārthe /	"kaliFgaH sAhasikaH" ityAdO kaliFga-Adi-SabdaH deSa-viSeza-Adi-rUpe sva-arTe /
   ñasaṃbhavan yayā śabdaśaktyā svasaṃyuktān puruṣādīn pratyāyayati, yayā ca	Qa-saMBavan yayA Sabda-SaktyA sva-saMyuktAn puruza-AdIn pratyAyayati, yayA ca
   "gaṅgāyāṃ ghoṣaḥ" ityādau gaṅgādiśabdo jalamayādirūpārthavācakatvātprakṛte	"gaFgAyAm GozaH" ityAdO gaFgA-Adi-SabdaH jala-maya-Adi-rUpa-arTa-vAcaka-tvAt-prakRte
   'saṃbhavan svasya sāmīpyādisaṃbandhasaṃbandhinaṃ taṭādiṃ bodhayati, sā	asaMBavan svasya sAmIpya-Adi-saMbanDa-saMbanDinam tawAdim boDayati, sA
   śabdasyārpitā svābhaviketarā īśvarānudbhāvitā vā śaktirlakṣaṇā nāma /	Sabdasya-arpitA svABavikA-itarAH ISvarAn-udBAvitA vA SaktiH-lakzaNA nAma /
   pūrvatra hetū rūḍhiḥ prasiddhireva /	pUrvatra hetuH rUXiH prasidDiH-eva /
   uttaratra "gaṅgātaṭe ghoṣaḥ" iti pratipādanālabhyasya	uttaratra "gaFgA-tawe GozaH" iti pratipAdana-AlaByasya
   śītatvapāvanatvātiśayasya bodhanarūpaṃ prayojanam /	SIta-tva-pAvanatva-atiSayasya boDana-rUpam prayojanam /
   hetuṃ vināpi yasya kasyacitsaṃbandhino lakṣaṇo 'tiprasaṅgaḥ syāt,	hetum vinA-api yasya kasyacid-saMbanDinaH lakzaNaH ati-prasaFgaH syAt-,
   ityuktam--	iti-uktam---
   "rūḍheḥ prayojanādvāsau" iti /	"rUXeH prayojanAt-vAsO" iti /
        ************* COMMENTARY *************	************* SOMMENTa-aRY *************
        Vijñapriyā:	VijQa-priyA:
        (vi, da) vyācaṣṭe---kaliṅga iti /	(vi, da) vyAcazwe---kaliFgaH iti /
        svābhāviketareti /	svABAvika-itara-iti /
        gavādiśabdasya svabhāvasiddhā vṛttiḥ śaktistadbhinnā /	gavA-Adi-Sabdasya svaBAva-sidDA vRttiH SaktiH-tad-BinnA /
        svābhāvikasyāpi	svABAvikasya-api
   punaruktatvagauravādāha---īśvaramātraniyamitetaretyarthaḥ /	punarukta-tva-gOrava-AdAha----ISvara-mAtra-niyamita-itarA-iti-arTaH /
        mātragarbhatvākaraṇe vaktṛtātparyyayāpi īśvaraniyatatvāttasya ca	mAtra-garBa-tva-akaraNe vaktR-tAt-paryyayA-api ISvara-niyata-tvAt-tasya ca
   tadbhinnatvānupapatteḥ /	tat-Binna-tva-anupapatteH /
        īśvarānaṅgīkarttṛmīmāṃsakamate tu	ISvara-anaFgIkarttR-mImAMsaka-mate tu
   śaktirūpādatiriktapadārthāntarāditaretyarthaḥ /	Sakti-rUpAt-atirikta-padArTa-antarAditarA-iti-arTaH /
        śaktirvṛttiḥ /	SaktiH-vRttiH /
        pūrvatreti--kaliṅgaḥ sāhaska ityatretyarthaḥ /	pUrvatra-iti--kaliFgaH sAhaskaH iti-atra-iti-arTaH /
        prasiddhirati bhūrikālaprayoga ityarthaḥ /	prasidDiH-ati BUri-kAla-prayogaH iti-arTaH /
        atiprasaṅga iti-iyaṃ kaviprayogārhā lakṣaṇā vyutpādyate /	atiprasaFgaH iti-iyam kavi-prayoga-arhA lakzaNA vyutpAdyate /
        rūḍhiprayojanaśūnyā, lakṣaṇā tu neyārtha iti vakṣyate, sā ca kāvye	rUXi-prayojana-SUnyA, lakzaNA tu neya-arTaH iti vakzyate, sA ca kAvye
   doṣa eva /	dozaH eva /
        tatrāti prasaṅgaḥ syādityarthaḥ /	tatra-ati prasaFgaH syAt-iti-arTaH /
        Locanā:	LocanA:
        (lo, ai) udāharaṇadarśanapūrvakaṃ kārikārthaṃ vṛttyā	(lo, E) udAharaNa-darSana-pUrvakam kArikA-arTam vRttyA
   viśadayati--kaliṅga iti /	viSada-yati---kaliFgaH iti /
        svārthe vācyarūpe 'sambhavan deśaviśeṣādirūpārthasyācetanatayā	sva-arTe vAcya-rUpe asamBavan deSa-viSeza-Adi-rUpa-arTasya-acetana-tayA
   sāhasikādyarthenānvayānupapattyānupapadyamānaprayogaḥ kuta	sAhasikA-Adi-arTena-anvayAn-upapattyA-anupapadyamAna-prayogaH kuta
   ityāha--jalamayādirūpārthasya vācakatvāt /	iti-Aha---jala-maya-Adi-rUpa-arTasya vAcaka-tvAt /
        ayamarthaḥ--gaṅgadiśabdo yasmāt jalamayādirūpamevārthaṃ	ayam-arTaH--gaFga-di-SabdaH yasmAt jala-maya-Adi-rUpam-eva-arTam
   samayasmaraṇākātaraḥ san smārayati, tasmād vācyarūpasya jalādyarthasya	samaya-smaraNa-akAtaraH san smArayati, tasmAt vAcya-rUpasya jala-Adi-arTasya
   ghoṣādyarthena sahānvayānupapattyā prakṛte vācakatvena tasya prayogo na	Goza-Adi-arTena saha-anvaya-anupapattyA prakRte vAcaka-tvena tasya prayogaH na
   ghaṭata iti /	GawataH iti /
        svasyātmīyasya vākyādyarthasya jalamayādeḥ,	svasya-AtmIyasya vAkya-Adi-arTasya jala-maya-AdeH,
   tasyākṣepamākṛṣyopanayanam /	tasya-Akzepam-AkRzya-upanayanam /
        sambandhasyānvayasya, taddhi taṭaśabdārthaṃ yayā bodhayatīti	sambanDasya-anvayasya, tat-hi tawa-Sabda-arTam yayA boDayati-iti
   sambandhaḥ /	sambanDaH /
        bhaṭṭamate svābhāvikī abhidhā, tadanyā padasya śaktirvyāpāraḥ,	Bawwa-mate svABAvikI aBiDA, tad-anyA padasya SaktiH-vyApAraH,
   teṣāmīśvarānādarāt saṃketasyānādivyavahārapravṛttisvīkārāt /	tezAm-ISvara-anAdarAt saMketasya-anAdi-vyavahAra-pravRtti-svIkArAt /
        īśvarānudbhāviteti naiyāyikamatam /	ISvarAn-udBAvitA-iti nEyAyika-matam /
        tadanayorekatarā svābhāvikī, itarā īśvarānudbhāviteti dvidhā	tad-anayoH-ekatarA svABAvikI, itarA ISvarAn-udBAvitA-iti dviDA
   vyākhyātam /	vyAKyAtam /
        pūrvatra kaliṅgaḥ sāhasika ityatra, uttaratra gaṅgāyāṃ ghoṣa ityādau	pUrvatra kaliFgaH sAhasikaH iti-atra, uttaratra gaFgAyAm GozaH iti-AdO
        gaṅgātaṭa ityādau taṭasya gaṅgāśabdena pratipādanāt	gaFgA-tawaH iti-AdO tawasya gaFgA-Sabdena pratipAdanAt-
   gaṅgātādātmyapratīteḥ gaṅgārthaniṣṭānāṃ naṭārthaniṣṭhātiśayitānāṃ	gaFgA-tAdAtmya-pratIteH gaFgA-arTa-nizwAnAm nawa-arTa-nizWAti-SayitAnAm
   śītatvapāvanatvādīnāṃ pratītirlakṣaṇāyāḥ phalamityarthaḥ /	SIta-tva-pAvana-tva-AdInAm pratItiH-lakzaNAyAH Palam-iti-arTaH /
        ********** END OF COMMENTARY **********	********** END OF SOMMENTa-aRY **********
   kecittu "karmaṇi kuśalaḥ" iti rūḍhāvudāharanti /	kecid-tu "karmaNi kuSalaH" iti rUXO=-udAharanti /
   teṣāmayamabhiprāyaḥ--	tezAm-ayam-aBiprAyaH--
   kuśāṃllātīti vyutpattilabhyaḥ kuśagrāhirūpo mukhyor'thaḥ prakṛte	kuSAn=-lAti-iti vyutpatti-laByaH kuSagrAhi-rUpaH muKyor-aTaH prakRte
   'saṃbhavan vivecakatvādisādharmyasambandhasambandhinaṃ dakṣarūpamarthaṃ	asaMBavan vivecaka-tva-Adi-sADarmya-sambanDa-sambanDinam dakza-rUpam-arTam
   bodhayati /	boDayati /
   tadanye na manyante /	tad-anye na manyante /
   kuśagrāhirūpārthasya vyutpattilabhyatve 'pi dakṣarūpasyaiva mukhyārthatvāt	kuSa-grAhi-rUpa-arTasya vyutpatti-laBya-tve api dakza-rUpasya-eva muKya-arTa-tvAt
   anyaddhi śabdānāṃ vyutpattinimittamanyacca pravṛttinimittam /	anyat-hi SabdAnAm vyutpatti-nimittam-anyat-ca pravRtti-nimittam /
   vyutpattilabhyasya mukhyārthatve "gauḥ śete" ityatrāpi lakṣaṇā syāt /	vyutpatti-laByasya muKya-arTa-tve "gOH Sete" iti-atra-api lakzaNA syAt /
   "gamerḍeḥ" (uṇādi--2-67) iti gamadhatorḍepratyayena vyutpāditasya	"gamerxeH" (uNAdi--2-67) iti gamaDatorxe-pratyayena vyutpAditasya
   gośabdasya śayanakāle prayogāt /	go-Sabdasya Sayana-kAle prayogAt /
        ************* COMMENTARY *************	************* SOMMENTa-aRY *************
        Vijñapriyā:	VijQa-priyA:
        (vi, dha) kāvyaprakāśakṛduktaṃ rūḍhilakṣaṇodāharaṇaṃ	(vi, Da) kAvya-prakASa-kRt-uktam rUXi-lakzaNa-udAharaNam
   dūṣayitumutthāpayati--kecittu iti /	dUzayitum-utTApayati--kecid-tu iti /
        prakṛte asambhavanniti--karmaṇītyasya laukikakarmaparatvena	prakRte asamBavan=-iti--karmaNi-iti-asya lOkika-karma-paratvena
   tannimittaṃ kuśagrahaṇamasambhavadityarthaḥ /	tad-nimittam kuSa-grahaNam-asamBavat-iti-arTaH /
        dakṣasyaiva mukhyārthatvāditi---bhūriprayogeṇa dakṣatvasya laghutvena	dakzasya-eva muKya-arTa-tvAt-iti---BUri-prayogeNa dakza-tvasya laGu-tvena
   ca tadacchinnasyaiva śakyatvena mukhyatvādityarthaḥ /	ca tat-acCinnasya-eva Sakya-tvena muKya-tvAt-iti-arTaH /
        anyaddhi iti---vyutpattiryogārthabādhaḥ /	anyat-hi iti----vyutpattiH-yoga-arTa-bADaH /
        pravṛttiḥ prayogaḥ /	pravRttiH prayogaH /
        tathā ca tenaiva nimittena śabdasya pravṛttestadavacchinna eva	taTA ca tena-eva nimittena Sabdasya pravRtteH-tad-avacCinnaH eva
   mukhyārtha ityarthaḥ /	muKya-arTaH iti-arTaH /
        lakṣyārthe kvacit prayogastu tātparyyaviśeṣasatve eva; yathā dakṣe	lakzya-arTe kvacid prayogaH-tu tAtparyya-viSeza-satve eva; yaTA dakze
   śaktasya kuśalapadasya gṛhaviśeṣe śaktasya maṇḍapapadasya ca daivakarmaṇi	Saktasya kuSala-padasya gRha-viSeze Saktasya maNxapa-padasya ca dEva-karmaNi
   kuśala iti rogī maṇḍapa iti ca tayodavakarmarogipadasamabhivyāharasya	kuSalaH iti rogI maNxapaH iti ca tayA-udava-karma-rogi-pada-samaBivyAharasya
   tātparyyagrāhakatvāt /	tAtparyya-grAhaka-tvAt /
        gauḥ śete ityatra śete iti suptagoḥ- pradarśanārthameva /	gOH Sete iti-atra Sete iti supta-goH pradarSana-arTam-eva /
        gaurastīti suptagavi prayoge 'pi lakṣaṇā syāditi bodhyam /	gOH-asti-iti supta-gavi prayoge api lakzaNA syAt-iti boDyam /
        ayaṃ ca pratibandhaḥ na sarvasammataḥ /	ayam ca pratibanDaH na sarva-sammataH /
        uṇādipratyayānāṃ vyutpatteḥ prāyikatvena tayā prayogābhāvāt /	uNAdi-pratyayAnAm vyutpatteH prAyika-tvena tayA prayoga-aBAvAt /
        ata eva cintāmaṇikṛtoktaṃ "pañcapādikālabhyān uṇādipratyayān"ekenaiva	atas eva cintAmaNi-kRta-uktam "paQcapAdi-ka-AlaByAn uNAdi-pratyayAn-"ekena-eva
   "uṇādayo bahulam'; iti sūtreṇa vadataḥ pāṇineḥ ayamabhiprāyo	"uNa-AdayaH bahulam-a; iti sUtreNa vadataH pANineH ayam-aBiprAyaH-
   yaduṇādipratyayānāṃ prāyikyeva vyutpattiriti, tathā ca na tayā prayogaḥ /	yaduNAdi-pratyayAnAm prAyikI-a-iva vyutpattiH-iti, taTA ca na tayA prayogaH /
        tathā ca gotvenaiva rūpeṇa rūḍhiśaktyā gopadaṃ svapadagacchad	taTA ca go-tvena-eva rUpeNa rUXi-SaktyA go-padam sva-pada-gacCat-
   gosādhāraṇyena prayujyate, na uṇādi-pratyayavyutpattyā iti /	go-sADa-araNyena prayujyate, na uNa-Adi-pratyaya-vyutpattyA iti /
        ********** END OF COMMENTARY **********	********** END OF SOMMENTa-aRY **********
   tadbhedānāha--	tad-BedAn-Aha--
        ************* COMMENTARY *************	************* SOMMENTa-aRY *************
        Locanā:	LocanA:
        (lo, o) kecittviti---prakṛte karmaṇi kuśala ityanenāpi	(lo, o) kecid-tu-iti----prakRte karmaNi kuSalaH iti-anena-api
   arthatayāsambhavan anupapattirbādhitaḥ /	arTa-tayA-samBavan anupapattiH-bADitaH /
        vivecakarūpasya mukhyārthatvādityanena mukhyārthabādhābhāvādatra	vivecaka-rUpasya muKya-arTa-tvAt-iti-anena muKya-arTa-bADa-aBAvAt-atra
   kathaṃ lakṣaṇetyarthaḥ /	kaTam lakzaNa-iti-arTaH /
        gośabdo yadyapi gamanārtho vyutpattinimittaṃ tathāpi	go-SabdaH yadi-api gamana-arTaH vyutpatti-nimittam taTA-api
   gotvāpattikiyaiva pravṛttinimittam ata eva gacchatyāgacchati gavi	go-tva-Apatti-kiyA-eva pravRtti-nimittam atas eva gacCati-AgacCati gavi
   gośabdaprayogaḥ /	go-Sabda-prayogaH /
        yadāha, ghaṭaśabdaprasaṃge"ghaṭaṃna ca tadātmatvāpattirūpā kiyā	yat-A-aha, Gawa-Sabda-prasaMge"-GawaMna ca tad-Atma-tva-Apatti-rUpA kiyA
   matā'; iti /	matA-a; iti /
        tadbhedāniti;--tayoḥ rūḍhiprayojanābhyāṃ dvidhoktayorlakṣaṇayorbhedān	tad-Beda-aniti;--tayoH rUXi-prayojanAByAm dviDA-uktayoH-lakzaNayoH-BedAn
   viśeṣān bhidyate 'nena iti bheda iti vyutpattyā /	viSezAn Bidyate anena iti BedaH iti vyutpattyA /
        ********** END OF COMMENTARY **********	********** END OF SOMMENTa-aRY **********
   mukhyārthasyetarākṣepo vākyārthe 'nvayasiddhaye /	muKya-arTasya-itara-AkzepaH vAkya-arTe anvaya-sidDaye /
   syādātmano 'pyupādānādeṣopādānalakṣaṇā // VisSd_2.6 //	syAt-AtmanaH api-upAdAnAdeza-upAdAna-lakzaNAH // VisSd-_2.6 //
        ************* COMMENTARY *************	************* SOMMENTa-aRY *************
        Vijñapriyā:	VijQa-priyA:
        (vi, na) tadbhedānāha---mukhyārthasyeti /	(vi, na) tad-Beda-AnAha----muKya-arTasya-iti /
        vākyārthe bodhye, mukhyārthasya tātparyyaviṣayānvayasiddhaye itarasya	vAkya-arTe boDye, muKya-arTasya tAtparyya-vizaya-anvaya-sidDaye itarasya
   amukhyārthasyākṣepaḥ pratyāyanamityarthaḥ /	amuKya-arTasya-AkzepaH pratyAyanam-iti-arTaH /
        anvayavākyārthayorabhedāt vākyārthe mukhyārthasyānvayasiddhaye iti	anvaya-vAkya-arTayoH-aBedAt vAkya-arTe muKya-arTasya-anvaya-sidDaye iti
   nānvayaḥ /	na-anvayaH /
        atrāpi yayaiti śeṣaḥ /	atra-api yayA-eti SezaH /
        asyā upādānasaṃjñāvyutpattimāha---syādātmano 'pīti /	asyAH upAdAna-saMjQA-vyutpattim-Aha---syAt-AtmanaH api-iti /
        ātmano mukhyārthasyāpi /	AtmanaH muKya-arTasya-api /
        atra tātparyyaviṣayatvaṃ yadi anvayaviśeṣaṇaṃ na kriyate tadā	atra tAtparyya-vizaya-tvam yadi anvaya-viSezaNam na kriyate tadA
   chatriṇe gacchanti kuntāḥ praviśanti ityādiṣu avyāptiḥ syāt; atra	CatriNe gacCanti kuntAH praviSanti ityAdizu avyAptiH syAt; atra
   tātparyyāviṣayasya śuddhaśakyārthasyānvayasiddhisambhavena	tAtparyyA-vizayasya SudDa-Sakya-arTasya-anvaya-sidDi-samBavena
   tadarthamitireṣāmacchatrikuntādīnāmanākṣepāt /	tad-arTa-mitiH-ezAm-acCa-tri-kunta-AdI-nAm-anAkzepAt /
        itarasāhityenānvaye tātparyyavaśādeva śuddhamukhyānvayasya bādho	itarasA-ahityena-anvaye tAtparyya-vaSAt-eva SudDa-muKya-anvayasya bADo
   'vadheyaḥ /	avaDeyaH /
        tadbādho 'pi mukhyatāvacchedakarūpeṇāsambhavarūpa eva;	tad-bADaH api muKya-tAvacCedaka-rUpeNa-asamBava-rUpaH eva;
   lakṣatāvacchedakarūpeṇa tu nāsambhava iti bodhyam /	lakza-tA-avacCedaka-rUpeNa tu na-asamBavaH iti boDyam /
        ********** END OF COMMENTARY **********	********** END OF SOMMENTa-aRY **********
   rūḍhāvupādānalakṣaṇā yathā--	rUXO=-upAdAna-lakzaNAH yaTA--
   "śveto dhāvati" /	"SvetaH DAvati" /
   prayojane yathā--	prayojane yaTA--
   "kuntāḥ praviśanti" /	"kuntAH praviSanti" /
   anayorhi śvetādibhiḥ kuntādibhiścācetanatayā	anayoH-hi Sveta-AdiBiH kunta-AdiBiH-ca-acetana-tayA
   kevalairdhāvanapraveśanakriyayoḥ kartṛtayānvayamalabhamānairetatsiddhaye	kevalEH-DAvana-praveSana-kriyayoH kartR-tayA-anvayam-alaBamAnEH-etat-sidDaye
   ātmasambandhino 'śvādayaḥ puruṣāda yaścākṣipyante /	Atma-sambanDinaH aSva-AdayaH puruzAda yaH-ca-Akzipyante /
        ************* COMMENTARY *************	************* SOMMENTa-aRY *************
        Vijñapriyā:	VijQa-priyA:
        (vi, pa) lakṣaṇasāmānyalakṣaṇoktaṃ	(vi, pa) lakzaNa-sAmAnya-lakzaNa-uktam
   rūḍhiprayojanānyatarahetukatvamatra ghaṭayannudāharati---rūḍhāvupādāneti /	rUXi-prayojana-anyatara-hetuka-tvam-atra Gawayan=-udAharati---rUXO=-upAdAnA-iti /
        śvetaḥ śvetaguṇavān /	SvetaH Sveta-guNavAn /
        kuntā iti kuntavanta ityarthaḥ anayormukhyārthānvayabādhaṃ darśayati	kuntAH iti kuntavantaH iti-arTaH anayoH-muKyA-arTa-anvaya-bADam darSayati
        anayoriti /	anayoH-iti /
        śvetādibhirityādipadāt nīlādiguṇānāṃ kuntādibhirityādi padāt	Sveta-AdiBiH-iti-Adi-padAt nIla-Adi-guNAnAm kunta-AdiBiH-ityAdi padAt-
   astrāntarāṇāṃ ca parigrahaḥ /	astra-antarANAm ca parigrahaH /
        acetanatayeti /	acetana-tayA-iti /
        idametadudāharaṇābhiprāyeṇaivoktam /	idam-etat-udAharaNa-aBiprAyeNa-eva-uktam /
        vastutastu chatriṇo gacchanti ityatra chatriṇaścetanatve 'pi	vastutas-tu CatriNaH gacCanti iti-atra CatriNaH-cetana-tve api
   tātparyyaviṣayacchatryanvayattyālābha eva sarvasādhāraṇo mukhyārthabādho	tAtparyya-vizaya=-Catri-anvayat-ti-AlABaH eva sarva-sADAraNaH muKya-arTa-bADo
   bodhyaḥ /	boDyaH /
        aśvādaya ityādipadacchvetagavādeḥ, puruṣādayaḥ ityādipadāt	aSva-AdayaH ityAdi-pada=-Sveta-gava-AdeH, puruza-AdayaH ityAdi-padAt
   kuntadhārivat itarasya parigrahaḥ /	kunta-DAri-vat itarasya parigrahaH /
        ********** END OF COMMENTARY **********	********** END OF SOMMENTa-aRY **********
   pūrvatra prayojanābhāvādrūḍhiḥ, uttaratra tu kuntādīnāmatigahanatvaṃ	pUrvatra prayojana-aBAvAt-rUXiH, uttaratra tu kunta-AdInAm-ati-gahana-tvam
   prayojanam /	prayojanam /
   atra ca mukhyārthasyātmano 'pyupādānam /	atra ca muKya-arTasya-AtmanaH api-upAdAnam /
   lakṣaṇalakṣaṇāyāṃ tu parasyaivopalakṣaṇamityanayorbhedaḥ /	lakzaNa-lakzaNAyAm tu parasya-eva-upalakzaNam-iti-anayoH-BedaH /
   iyamevājahatsvārthetyucyate /	iyam-eva-ajahatsva-arTA-iti-ucyate /
        ************* COMMENTARY *************	************* SOMMENTa-aRY *************
        Vijñapriyā:	VijQa-priyA:
        (vi, pha) prayojanābhāvāditi--rūḍhisattvādena prayojanānanusandhānāt	(vi, Pa) prayojana-aBAva-aditi--rUXi-sattva-At-ena prayojana-ananusanDAnAt
   tadabhāvaḥ /	tad-aBAvaH /
        prayojanaṃ prayojanībhūtajñānaviṣayaḥ /	prayojanam prayojanI-BUta-jQAna-vizayaH /
        evaṃ rītyaiva pāvanatvādirapi pyojanapadārtho bodhyaḥ /	evam rItyA-eva pAvana-tva-AdiH-api pyojana-padArTaH boDyaH /
        lakṣaṇalakṣaṇāyāmiti---vakṣyamāṇāyāmiti śeṣaḥ /	lakzaNa-lakzaNAyAm-iti---vakzyamANAyAm-iti SezaH /
        parasyaiveti evakārānmukhyārthavyavacchedaḥ /	parasya-eva-iti eva-kArAn-muKya-arTa-vyavacCedaH /
        upalakṣaṇamupasthāpanam /	upalakzaNam-upasTApanam /
        Locanā:	LocanA:
        (lo, au) mukhyārtheti---mukhyābhidheyor'thaḥ tasya itaraḥ	(lo, O) muKya-arTa-iti----muKya-aBiDeyor-aTaH tasya itaraH
   prakṛtanirvāhaupāyikaḥ, tasyākṣepaḥ ākṛṣya upanayanam /	prakRta-nirvAha-OpAyikaH, tasya-AkzepaH AkRzya upanayanam /
        anvayasambandhasya siddhaye nirvāhāya /	anvaya-sambanDasya sidDaye nirvAhAya /
        ātmano 'pyupādānāt, ayamarthaḥ, iha khalvabhidhayā bodhitasyāpi	AtmanaH api-upAdAnAt, ayam-arTaH, iha Kalu-aBiDayA boDitasya-api
   śvetakuntādyarthasya punaḥ puruṣāderviśeṣaṇatayā lakṣaṇīyatvena	Sveta-kunta-Adi-arTasya punar puruza-AdeH-viSezaNa-tayA lakzaNIya-tvena
   upādānamiti /	upAdAnam-iti /
        atigahanatvaṃ-kuntayuktāḥ puruṣāḥ praviśantīti abhidhānālabhyam /	ati-gahana-tvaM-kunta-yuktAH puruzAH praviSanti-iti aBiDAna-AlaByam /
        ucyate-parairiti śeṣaḥ /	ucyate--parEH-iti SezaH /
        ********** END OF COMMENTARY **********	********** END OF SOMMENTa-aRY **********
   arpaṇaṃ svasya vākyārthe parasyānvayasiddhaye /	arpaNam svasya vAkya-arTe parasya-anvaya-sidDaye /
   upalakṣaṇahetutvādeṣā lakṣaṇalakṣaṇā // VisSd_2.7 //	upalakzaNa-hetu-tvAt-ezA lakzaNa-lakzaNAH // VisSd-_2.7 //
        ************* COMMENTARY *************	************* SOMMENTa-aRY *************
        Vijñapriyā:	VijQa-priyA:
        (vi, ba) lakṣaṇalakṣaṇāmāha--arpaṇamiti /	(vi, ba) lakzaNa-lakzaNAm-Aha--arpaNam-iti /
        atra arpaṇamityatra paratraiveti śeṣaḥ, svasya paramātraviṣayatā	atra arpaNam-iti-atra paratra-eva-iti SezaH, svasya para-mAtra-vizaya-tA
   ityarthaḥ /	iti-arTaH /
        natu mukhyārthaviṣayatāpītyarthaḥ /	na-tu muKya-arTa-vizaya-tA-api-iti-arTaH /
        upādānalakṣaṇāyāṃ tu mukhyārthasyāpi viṣayatā iti bhedaḥ /	upAdAna-lakzaNAyAm tu muKya-arTasya-api vizaya-tA iti BedaH /
        svasyetyatra yasyā iti śeṣaḥ /	svasya-iti-atra yasyAH iti SezaH /
        tathā ca vākyārthe bodhye parasya amukhyārthasya anvayasiddhaye	taTA ca vAkya-arTe boDye parasya amuKya-arTasya anvaya-sidDaye
   anvayabodhāya yasyā lakṣaṇāyāḥ svasya arpaṇaṃ paramātraviṣayatā; eṣā	anvaya-boDAya yasyAH lakzaNAyAH svasya arpaNam para-mAtra-vizaya-tA; ezA
   lakṣaṇalakṣaṇetyarthaḥ /	lakzaNa-lakzaNa-iti-arTaH /
        vākyārthanvayayorabhedādvākyārthe parasyānvayasiddhaye iti tu	vAkya-arTa-nvayayoH-aBedAt-vAkya-arTe parasya-anvaya-sidDaye iti tu
   nānvayaḥ /	na-anvayaH /
        tādṛśasaṃjñāvyutpattimāha---upalakṣaṇeti /	tAdRSa-saMjQA-vyutpattim-Aha---upalakzaNa-iti /
        mukhyārthaṃ vihāyāmukhyārthamātrabodhanam upalakṣaṇaṃ svasya	muKya-arTam vihAya-amuKya-arTa-mAtra-boDanam upalakzaNam svasya
   taddhetutvādityarthaḥ /	tad-hetu-tvAt-iti-arTaH /
        ********** END OF COMMENTARY **********	********** END OF SOMMENTa-aRY **********
   rūḍhiprayojanayorlakṣaṇalakṣaṇā yathā--	rUXi-prayojanayoH-lakzaNa-lakzaNAH yaTA--
   "kaliṅgaḥ sāhasikaḥ" "gaṅgāyāṃ ghoṣaḥ" iti ca /	"kaliFgaH sAhasikaH" "gaFgAyAm GozaH" iti ca /
   anayorhi puruṣataṭayorvākyārthe 'nvayasiddhaye	anayoH-hi puruza-tawayoH-vAkya-arTe anvaya-sidDaye
   kaliṅgagaṅgāśabdāvātmānamarpayataḥ /	kaliFga-gaFgA-SabdO=-AtmAnam-arpayataH /
        ************* COMMENTARY *************	************* SOMMENTa-aRY *************
        Vijñapriyā:	VijQa-priyA:
        (vi, bha) atra rūḍhiprayojanahetukatve	(vi, Ba) atra rUXi-prayojana-hetuka-tve
   yathāsaṃkhyamudāharaṇadvayamāha---kaliṅga ityādi /	yaTA-saMKyam-udAharaNa-dvayam-Aha---kaliFgaH ityAdi /
        atra kaliṅgaḥ sāhasika iti na pāṭhaḥ /	atra kaliFgaH sAhasikaH iti na pAWaH /
        kintu kaliṅgaḥ sāhasaṃ karoti ityeva pāṭhaḥ /	kintu kaliFgaH sAhasam karoti iti-eva pAWaH /
        sādhyavasānālakṣaṇāyā udāharaṇaprasaṅge vyaktirbhāviṣyatītyarthaḥ /	sADyavasAna-alakzaNAyAH udAharaNa-prasaFge vyaktiH-BAvizyati-iti-arTaH /
        ubhayatraiva mukhyārthaṃ kaliṅgarūpaṃ deśaṃ pravāharūpāṃ saṅgā ca	uBayatra-eva muKya-arTam kaliFga-rUpam deSam pravAha-rUpAm saFgA ca
   vihāya taddeśasthapuruṣatattīrayoḥ parayoranvayaprabodhāya	vihAya tad-deSa-sTa-puruza-tad-tIrayoH parayoH-anvaya-praboDAya
   puruṣatari-rūpa-mātra-viṣayatā lakṣaṇāyāḥ /	puruza-tari--rUpa--mAtra--vizaya-tA lakzaNAyAH /
        taddarśayati---anayorheti /	tad-darSa-yati---anayoH-ha-iti /
        vākyārtha bodhye puruṣataṭayoranvayasiddhaye ityanvayaḥ /	vAkya-arTa boDye puruza-tawayoH-anvaya-sidDaye iti-anvayaH /
        samarpayata ityatra paramātra iti śeṣaḥ /	samarpayate iti-atra para-mAtra iti SezaH /
        paramātraṃ ---viṣayīkuruta ityarthaḥ /	para-mAtram ---vizayIkurutaH iti-arTaH /
        kaliṅgagaṅgāśabdau ityatra kaliṅgagaṅgāśabādapadaṃ	kaliFga-gaFgA-SabdO iti-atra kaliFga-gaFgA-SabAda-padam
   tanniṣṭhalakṣaṇādvayaparaṃ yathā vyākhyātārthanusāreṇa bodhyam /	tad-nizWa-lakzaNA-dvaya-param yaTA vyAKyAta-arTa-nu-sAreNa boDyam /
        evamuttaratrapi vyākhyeyam /	evam-uttaratrapi vyAKyeyam /
        Locanā:	LocanA:
        (lo, a) arpaṇaṃ svasya gaṅgādeḥ /	(lo, a) arpaNam svasya gaFgA-AdeH /
        parasyāṅgasya taṭādirūpalakṣaṇahetutvāt sambandhamātrasya ityarthaḥ /	parasya-aFgasya tawa-Adi-rUpa-lakzaNa-hetu-tvAt sambanDa-mAtrasya iti-arTaH /
        ********** END OF COMMENTARY **********	********** END OF SOMMENTa-aRY **********
   yathā vā--	yaTA vA--
   "apakṛtaṃ bahu tatra kimucyate sujanatā prathitā bhavatā param /	"apakRtam bahu tatra kim-ucyate su-janatA praTitA BavatA param /
   vidadhadīdṛśameva sadā sakhe ! sukhitamāssva tataḥ śaradāṃ śatam" //	vidaDat-IdRSam-eva sadA saKe ! suKitam-Assva tatas SaradAm Satam" //
   atrāpakārādīnāṃ vākyārthe 'nvayasiddhaye upakṛtādayaḥ śabdā	atra-apakAra-AdInAm vAkya-arTe anvaya-sidDaye upakRta-AdayaH SabdA
   ātmānamarpayanti /	AtmAnam-arpayanti /
   apakāriṇaṃ pratyupakārādipratipādanānmukhyārthabādho vaiparītyalakṣaṇaḥ	apakAriNam pratyupakAra-Adi-pratipAdanAt-muKya-arTa-bADaH vEparItya-lakzaNaH
   sambandhaḥ, phalamapyapakārātiśayaḥ /	sambanDaH, Palam-api-apakAra-atiSayaH /
   iyameva jahatsvārthetyucyate /	iyam-eva jahatsva-arTa-iti-ucyate /
        ************* COMMENTARY *************	************* SOMMENTa-aRY *************
        Vijñapriyā:	VijQa-priyA:
        (vi, ma) prayojanahetukatve udāharaṇāntaramāha-yathā vā-upakṛtamiti /	(vi, ma) prayojana-hetuka-tve udAharaNa-antaram-Aha-yaTA vA-upakRtam-iti /
        apakāritvena anyato jñātaṃ pratīyamuktiḥ /	apakAri-tvena anyatas jQAtam pratIya-muktiH /
        tvayā bahu upakṛtaṃ tatra kimucyata ityarthaḥ /	tvayA bahu upakRtam tatra kim-ucyate iti-arTaH /
        yatreti pāṭhe tu tatreti pūraṇīyam /	yatra-iti pAWe tu tatra-iti pUraNIyam /
        apakārādīnāmiti--atrādipadād durjanatāduḥ khitayoḥ parigrahaḥ /	apakAra-AdInAm-iti--atra-Adi-padAt durjana-tAduH KitayoH parigrahaH /
        phalam apakāradyatiśaya iti phalībhūtajñānaviṣaya ityarthaḥ /	Palam apakAra-di-atiSayaH iti PalIBUta-jQAna-vizayaH iti-arTaH /
        evamuttarottaramapi bodhyam /	evam-uttarottaram-api boDyam /
        idaṃ ca na ruciramuktam /	idam ca na ruciram-uktam /
        lakṣyārthātiśayasya prayojanatve rūḍhilakṣaṇāyāmapi tatsambhavāt	lakzya-arTa-atiSayasya prayojana-tve rUXi-lakzaNAyAm-api tad-samBavAt
   viśeṣābhāvāpatteḥ /	viSeza-aBAva-ApatteH /
        kintu apakāradurjanatvalakṣaṇayoḥ phalaṃ sambodhyasya kauṭilyaṃ duḥ	kintu apakAra-durjana-tva-lakzaNayoH Palam samboDyasya kOwilyam duH
   khitalakṣaṇāyāstu kauṭilyaphalatvam /	Kita-lakzaNAyAH-tu kOwilya-Pala-tvam /
        Locanā:	LocanA:
        (lo, ā) apakārārdānāmityādiśabdena durjanatvaduḥ khitatve	(lo, A) apakAra-ardAnAm-ityAdi-Sabdena durjana-tvaduH Kita-tve
   upakṛtādayaṃ ityādiśabdena sujanatvasukhitatve /	upakRtAdayam ityAdi-Sabdena su-jana-tu-a-suKita-tve /
        apakārādyatiśayaḥ-svaśabdābhidhānālabhyaḥ /	apakAra-Adi-atiSayaH-sva-Sabda-aBiDAna-AlaByaH /
        ********** END OF COMMENTARY **********	********** END OF SOMMENTa-aRY **********
   āropādhyavasānābhyāṃ pratyekaṃ tā api dvidhā /	Ara-upADyavasAnAByAm pratyekam tAH api dviDA /
        ************* COMMENTARY *************	************* SOMMENTa-aRY *************
        Vijñapriyā:	VijQa-priyA:
        (vi, ya) upādānalakṣaṇalakṣaṇādvayaṃ rūḍhiprayojanadvayahetukatvena	(vi, ya) upAdAna-lakzaNa-lakzaNAH-dvayam rUXi-prayojana-dvaya-hetuka-tvena
   caturvidhamuktam /	caturviDam-uktam /
        adhunātaccatuṣṭayasya dvaiguṇyenāṣṭavidhamāha---āropeti /	aDunA-tad-catuzwayasya dvEguNyena-azwaviDam-Aha---Aropa-iti /
        lakṣyārthe prathamataḥ śakyārthābhedāropa āropaḥ /	lakzya-arTe praTamatas Sakya-arTa-aBedAropaH AropaH /
        tasyāropasya utkaṭatvamadhyavasānam /	tasya-Aropasya utkawa-tva-maDyavasAnam /
        ********** END OF COMMENTARY **********	********** END OF SOMMENTa-aRY **********
   tāḥ pūrvoktāścaturbhedalakṣaṇāḥ /	tAH pUrva-uktAH-catur-Beda-lakzaNAH /
   viṣayasyānigīrṇasyānyatādātmyapratītikṛta // VisSd_2.8 //	vizayasya-anigIrNasya-anya-tAdAtmya-pratIti-kRtaH // VisSd-_2.8 //
   sāropā syānnigīrṇasya matā sādhyavasānikā /	sAropA syAt-nigIrNasya matA sADyavasAnikAH /
   viṣayiṇā anigīrṇasya viṣayasya tenaiva saha tādātmyapratītikṛtsāropā /	vizayiNA anigIrNasya vizayasya tena-eva saha tAdAtmya-pratIti-kRt-sAra-upAH /
   iyameva rūpakālaṅkārasya bījam /	iyam-eva rUpaka-alaFkArasya bIjam /
        ************* COMMENTARY *************	************* SOMMENTa-aRY *************
        Vijñapriyā:	VijQa-priyA:
        (vi, ra) te kīdṛśatve bhavata ityatrāha---viṣayasyeti /	(vi, ra) te kIdRSa-tve BavataH iti-atra-Aha----vizayasya-iti /
        viṣaya āropādhikaraṇaṃ lakṣyārthaḥ /	vizayaH Aropa-aDikaraNam lakzya-arTaH /
        tasya anigārṇṇasya anācchāditasya arthāt svavācakanāmapadena uktasya	tasya anigArNNasya anAcCAditasya arTAt sva-vAcaka-nAma-padena uktasya
   anyatādātmyaṃ śakyārthābhedaḥ /	anya-tAdAtmyam Sakya-arTa-aBedaH /
        tatpratītikṛllakṣaṇa sāropā syādityarthaḥ /	tad-pratIti-kRt-lakzaNa sAropA syAt-iti-arTaH /
        nigīrṇṇasya viśiṣya svāvācaka-nāmapadena anuktasya tu sādhyavasānikā	nigIrNNasya viSizya sva-avAcaka-nAma-padena anuktasya tu sADyavasAnikA
   matetyarthaḥ /	matA-iti-arTaH /
        anyatādātmyapratītiśca lakṣaṇajñānataḥ pūrvaṃ bodhyā /	anya-tAdAtmya-pratItiH-ca lakzaNa-jQAnataH pUrvam boDyA /
        tatpratītikṛcca yadyapi samānavibhaktikapadadvayameva, na tu lakṣaṇā;	tad-pratIti-kRt-ca yadi-api samAna-viBaktika-pada-dvayam-eva, na tu lakzaNA;
   tathāpyanyatādātmyapratītipūrvakapratitikṛdityevānyatādātmyapratītikṛd	taTA-api-anya-tAdAtmya-pratIti-pUrvaka-pratitikRt-iti-eva-anya-tAdAtmya-pratIti-kRt-
   ityasyārthaḥ /	iti-asya-arTaH /
        na ca sādhyavasānāyāṃ svāvācakanāmapadenānirddeśe	na ca sADyavasAnAyAm svAvAcaka-nAma-padena-anirddeSe
   samānavibhaktyantapadābhāvāt, kathaṃ tādātmyapratītikṛditi vācyam,	samAna-viBakti-anta-pada-aBAva-at, kaTam tAdAtmya-pratIti-kRt-iti vAcyam,
   ākhyātena lakṣyārthasyoktau tat pratīteḥ; taccāgre darśayiṣyate /	AKyAtena lakzya-arTasya-uktO tat pratIteH; tat-ca-agre darSayizyate /
        Locanā:	LocanA:
        (lo, i) evaṃ caturvidhāpi lakṣaṇā pratyekaṃ sāropā sādhyavasānā	(lo, i) evam caturviDA-api lakzaNA pratyekam sAropA sADyavasAnA
   ityaṣṭavidhetyāha--āropeti /	iti-azwaviDA-iti-Aha---Aropa-iti /
        anigīrārṇasvarūpasāmānyatādātmyapratītirāropaḥ /	anigIra-arNa-svarUpa-sAmAnya-tAdAtmya-pratItiH-AropaH /
        viṣayanigaraṇe 'bhedapratipattirviṣayiṇo 'dhyavasānam /	vizaya-nigaraNe aBeda-pratipattiH-vizayiNaH aDyavasAnam /
        evaṃ svaśabdārthanāmnā gatārthe 'pi sphuṭīkaraṇāya lakṣaṇena	evam sva-Sabda-arTa-nAmnA gata-arTe api sPuwIkaraNAya lakzaNena
   nirddiśati--viṣayasyeti /	nirddiSati---vizayasya-iti /
        ********** END OF COMMENTARY **********	********** END OF SOMMENTa-aRY **********
   rūḍhāvupādānalakṣaṇā sāropā yathā--	rUXO=-upAdAna-lakzaNA sAra-upA yaTA--
   "aśvaḥ śveto dhāvati" /	"aSvaH SvetaH DAvati" /
   atra hi śvetaguṇavānaśvo 'nigīrṇasvarūpaḥ svasamavetaguṇatādātmyena	atra hi Sveta-guNavAn-aSvaH anigIrNa-svarUpaH sva-samaveta-guNa-tAdAtmyena
   pratīyate /	pratIyate /
   prayojane yathā--	prayojane yaTA--
   "ete kuntāḥ praviśanti" /	"ete kuntAH praviSanti" /
   atra sarvanāmnā kuntadhāripuruṣanirdeśāt /	atra sarva-nAmnA kunta-DAri-puruza-nirdeSAt /
        ************* COMMENTARY *************	************* SOMMENTa-aRY *************
        Vijñapriyā:	VijQa-priyA:
        (vi, la) aśvaḥśveta iti---atra śvetaguṇavānaśvaḥ lakṣyār'tho	(vi, la) aSvaH-SvetaH iti---atra Sveta-guNavAn-aSvaH lakzyAr-aTo
   'nigārṇṇo 'śvaśabdenaivoktatvāt /	anigArNNaH aSva-Sabdena-eva-ukta-tvAt /
        śvetaguṇaśvayoḥ samānavibhaktyā tādātmyapratītiḥ /	Sveta-guNa-SvayoH samAna-viBaktyA tAdAtmya-pratItiH /
        prayojane yathā--iti upadānalakṣaṇeti śeṣaḥ /	prayojane yaTA--iti upadAna-lakzaNa-iti SezaH /
        ete kuntā iti; kuntānāmaviralatvamatra prayojanam /	ete kuntA iti; kuntAnAm-avirala-tvam-atra prayojanam /
        kuntavān lakṣyārthaḥ /	kuntavAn lakzya-arTaH /
        etat padenoktatvāt anigīrṇṇaḥ /	etat padena-ukta-tvAt anigIrNNaH /
        atra sarvanāmneti---kāvyaprakāśe tu sarvanāmnā lakṣyārthanirddeśe	atra sarva-nAmnA-iti---kAvya-prakASe tu sarva-nAmnA lakzya-arTa-nirddeSe
   viśiṣya svāvācakakuntādipadenānupādānāt sādhyavasānaiva setyuktam /	viSizya svAvAcaka-kunta-Adi-padena-anupAdAnAt sADyavasAnA-eva sA-iti-uktam /
        viśiṣya svāvācakapadanirddeśa eva sāropatvāt /	viSizya svAvAcaka-pada-nirddeSaH eva sAra-upatvAt /
        Locanā:	LocanA:
        (lo, ī) aśva āropaviṣayaḥ /	(lo, I) aSvaH AropavizayaH /
        svasamaveta ityanena samavāyarūpasya lakṣaṇāhetoḥ svasambandhasya	sva-samavetaH iti-anena samavAya-rUpasya lakzaNA-hetoH sva-sambanDasya
   nigaraṇaṃ śvetaguṇa āropyamāṇaḥ /	nigaraNam Sveta-guNaH AropyamANaH /
        prayojana ityanantaraṃ pūrvoktā upādānalakṣaṇā sāropeti anuṣajyate /	prayojanaH iti-anantaram pUrva-uktAH upAdAna-lakzaNA sAropa-iti anuzajyate /
        evamuttarodāharaṇeṣvapi /	evam-uttara-udAharaNezu-api /
        sarvanāmnā etat	sarva-nAmnA etat-
        ********** END OF COMMENTARY **********	********** END OF SOMMENTa-aRY **********
   rūḍhau lakṣaṇalakṣaṇā sāropā yathā--	rUXO lakzaNa-lakzaNA sAra-upA yaTA--
   "kaliṅgaḥ puruṣo yudhyate" /	"kaliFgaH puruzaH yuDyate" /
   atra kaliṅga puruṣayorādhārādheyabhāvaḥ sambandhaḥ /	atra kaliFga puruzayoH-ADAra-ADeya-BAvaH sambanDaH /
   prayojane yathā--	prayojane yaTA--
   "āyurghṛtam" /	"a-AyuH-GRtam" /
   atrāyuṣkāraṇamapi ghṛtaṃ kāryakāraṇabhāvasambandhasambandhyāyustādātmyena	atra-AyuzkAraNam-api GRtam kArya-kAraNa-BAva-sambanDa-sambanDyAyuH-tAdAtmyena
   pratīyate /	pratIyate /
   anyavailakṣaṇyenāvyabhicāreṇāyuṣkaratvaṃ prayojanam /	anya-vElakzaNyena-avyaBicAreNa-Ayuzkara-tvam prayojanam /
   yathā vā--	yaTA vA--
   rājakīye puruṣe gacchati "rājāsau gacchati" iti /	rAjakIye puruze gacCati "rAjA-asO gacCati" iti /
   atra svasvāmibhāvalakṣaṇaḥ sambandhaḥ /	atra sva-svAmi-BAva-lakzaNaH sambanDaH /
   yathā vā--	yaTA vA--
   agramātre 'vayavabhāge "hasto 'yam" /	agra-mAtre avayava-BAge "hastaH ayam" /
   atrāvayavāvayavi bhāvalakṣaṇasambandhaḥ /	atra-avayava-a=-ayavi BAva-lakzaNa-sambanDaH /
   "brāhmaṇo 'pi takṣāsau" /	"brAhmaNaH api takza-asO" /
   atra tātkarmyalakṣaṇaḥ /	atra tAtkarmyalakzaNaH /
   indrārthāsu sthūṇāsu "amī indrāḥ" /	indra-arTAsu sTUNAsu "amI indrAH" /
   atra tādarthyalakṣaṇaḥ sambandhaḥ /	atra tAdarTya-lakzaNaH sambanDaH /
   evamanyatrāpi /	evam-anyatra-api /
        ************* COMMENTARY *************	************* SOMMENTa-aRY *************
        Vijñapriyā:	VijQa-priyA:
        (vi, va) kaliṅgaḥ puruṣa iti---atra puruṣapadena lakṣyārthopādānāt	(vi, va) kaliFgaH puruzaH iti---atra puruza-padena lakzya-arTa-upAdAnAt
   anigīrṇṇatvam /	anigIrNNa-tvam /
        kaliṅgatvena lakṣaṇā /	kaliFga-tvena lakzaNA /
        prayojane yatheti---lakṣaṇalakṣaṇeti śeṣaḥ /	prayojane yaTA-iti----lakzaNa-lakzaNa-iti SezaH /
        anyavailakṣaṇyenāvyabhicāreṇeti, avyabhicāraḥ anyavelakṣaṇyaṃ ca	anya-vElakzaNyena-avyaBicAreNa-iti, avyaBicAraH anya-velakzaNyam ca
   heturuktaḥ /	hetuH-uktaH /
        kāvyaprakāśe tu āyurghṛtamiti sāropāyamanyavailakṣaṇyam /	kAvya-prakASe tu AyuH-GRtam-iti sAra-upAyam-anya-vElakzaNyam /
        āyuridamiti sādhyavasānāyamavyabhicāra iti dvayoḥ pṛthak	AyuH-idam-iti sADyavasAnAyam-avyaBicAraH iti dvayoH pRTak-
   prayojanadvayamuktam /	prayojana-dvayam-uktam /
        kāryyakāraṇabhāvarūpasambandhena sāropāṃ lakṣaṇāmuktvā	kAryya-kAraNa-BAva-rUpa-sambanDena sAropAm lakzaNAm-uktvA
   sambandhāntarairapi tāṃ darśayati---rājarkāyetīti /	sambanDa-antarEH-api tAm darSayati----rAjarkAya-iti-iti /
        atra asāvitipadena lakṣyārthe puruṣe nirddiṣṭe rājño 'bhedāropāt	atra asO=-iti-padena lakzya-arTe puruze nirddizwe rAjQaH aBeda-AropAt
   sāropā /	sAropAH /
        evamubhayatrāpi sarvanāmnā lakṣyārthanirddaśe tathātvāṃ bodhyam /	evam-uBayatra-api sarva-nAmnA lakzya-arTa-nirddaSe taTAtvAm boDyam /
        sthūṇāḥ stambhā indradhvajarūpāḥ tādarthyalakṣaṇaḥ	sTUNAH stamBAH indra-Dvaja-rUpAH tAdarTya-lakzaNaH
   tatpūjārthatālakṣaṇaḥ, atra indravat pūjyatvaṃ prayojanam /	tad-pUjA-arTa-tA-lakzaNaH, atra indra-vat pUjya-tvam prayojanam /
        ********** END OF COMMENTARY **********	********** END OF SOMMENTa-aRY **********
   nigīrṇasya punaviṣayasyānyatādātmyapratītikṛtsādhyavasānā /	nigIrNasya puna-vizayasya-anya-tAdAtmya-pratIti-kRt-sADyavasAnA /
   asyāścaturṣu bhedeṣu pūrvodāharaṇānyeva /	asyAH-caturzu Bedezu pUrva-udAharaNAni-eva /
   tadevamaṣṭaprakārā lakṣaṇā /	tat-evam-azwa-prakArAH lakzaNA /
        ************* COMMENTARY *************	************* SOMMENTa-aRY *************
        Vijñapriyā:	VijQa-priyA:
        (vi, śa) itthaṃ sāropāmuktvā "nigīrṇṇasya matā sādhyavasānikā'; iti	(vi, Sa) itTam sAra-upAmuktvA "nigIrNNasya matA sADyavasAnikA-a; iti
   kārikāñcalaṃ vyācaṣṭe-nigīrṇṇasya punariti /	kArikA-aQcalam vyAcazwe--nigIrNNasya punar-iti /
        asyāścaturṣviti rūḍhiprayojanadvaye upādānalakṣaṇādvayaṃ taddvaye	asyAH-caturzu-iti rUXi-prayojana-dvaye upAdAna-lakzaNAH-dvayam tad-dvaye
   lakṣaṇalakṣaṇādvayaṃ ceti sādhyavasānāyaścatvārobhedāḥ /	lakzaNa-lakzaNAdvayam ca-iti sADyavasAnAyaH-catvAraH-BedAH /
        pūrvodāharaṇānyeveti rūḍhāvupādānalakṣaṇāyāḥ---"śveto dhāvati'; iti	pUrva-udAharaNAni-eva-iti rUXO=-upAdAna-lakzaNAyAH---"Svetas DAvati-a; iti
   prayojane upādānalakṣaṇāyāḥ "kuntāḥ praviśanti'; iti yaddvayamudāhṛtaṃ	prayojane upAdAna-lakzaNAyAH "kuntAH praviSanti-a; iti yat-dvayam-udAhRtam
   rūḍhau lakṣaṇalakṣaṇāyāḥ "kaliṅgaḥ sāhasaṃ karoti'; iti prayojane	rUXO lakzaNa-lakzaNAyAH "kaliFgaH sAhasam karoti-a; iti prayojane
   lakṣaṇalakṣaṇāyāṃ tu rājakīye puruṣe gacchati "rājāsau gacchati'; iti	lakzaNa-lakzaNAyAm tu rAjakIye puruze gacCati "rAjA-asO gacCati-a; iti
   yadudāhṛtaṃ tatra idaṃ padatyāgena udāharaṇamityata etāni catvāri	yat-udAhRtam tatra idam pada-tyAgena udAharaNam-iti-atas etAni catvAri
   sādhyavasānāyā udāharaṇānītyarthaḥ /	sADyavasAnAyAH udAharaNAni-iti-arTaH /
        rājā gacchatītyatra rājavat paricārakaveṣṭitatvaṃ prayojanam /	rAjA gacCati-iti-atra rAja-vat paricAraka-vezwita-tvam prayojanam /
        eteṣu caturṣu hi kartryā khyātenaiva kartṛlakṣyārthasya upasthāpanāt	etezu caturzu hi kartryA KyAtena-eva kartR-lakzya-arTasya upasTApanAt-
   nāmapadena tu anupasthānānnigīrṇṇatā /	nAma-padena tu anupasTAnAt-nigIrNNa-tA /
        tasmiṃśca prathamaṃ śakyārthatādamyāropāt sādhyavasānatvamiti bodhyam	tasmin=-ca praTamam Sakya-arTa-tAdami-AropAt sADyavasAna-tvam-iti boDyam
        prathamāntoktakārake prathamāntapadārthasyābhedānvayatyutpatteḥ /	praTama-anta-ukta-kArake praTama-anta-padArTasya-aBeda-anvayati-utpatteH /
        gaṅgāyāṃ ghoṣa iti tu lakṣaṇalakṣaṇodāharaṇaṃ yaddarśetaṃ tattu na	gaFgAyAm GozaH iti tu lakzaNa-lakzaNa-udAharaNam yat-darSetam tat-tu na
   sādhyavasānodāharaṇam /	sADyavasAna-udAharaNam /
        tatra lakṣyārthe tīre pravāhatādātmyānāropāt /	tatra lakzya-arTe tIre pravAha-tAdAtmya-an-AropAt /
        evaṃ ca rūḍhau lakṣaṇalakṣaṇedāharaṇaṃ kaliṅga ityādikaṃ yaduktaṃ	evam ca rUXO lakzaNa-lakzaNet-AharaNam kaliFgaH iti-Adikam yat-uktam
   tatra sāhasika iti prāmādikaḥ pāṭhaḥ /	tatra sAhasikaH iti prAmAdikaH pAWaH /
        nāmapadena sāhasika ityanena lakṣyārthasya puruṣasyopādānāt	nAma-padena sAhasikaH iti-anena lakzya-arTasya puruzasya-upAdAnAt
   sāropatvena sādhyavasānatvābhāvāt /	sAra-upatvena sADya-vasAna-tva-aBAvAt /
        kintu kaliṅgaḥ sāhasaṃ karoti ityeva tatra pāṭhaḥ /	kintu kaliFgaH sAhasam karoti iti-eva tatra pAWaH /
        itthamupādānalakṣaṇālakṣaṇalakṣaṇayoḥ rūḍhiprayojanahetukatvena	itTam-upAdAna-lakzaNa-alakzaNa-lakzaNayoH rUXi-prayojana-hetuka-tvena
   caturvidhayoḥ sāropāsādhyavasānikārūpatvena dvaiguṇyāt aṣṭavidhatvam /	caturviDayoH sAra-upAsADyavasAnikA-rUpatvena dvEguNyAt azwaviDa-tvam /
        Locanā:	LocanA:
        (lo, u) evamārope rūḍhiprayojanayorudāharaṇe catuṣṭayaṃ darśayitvā	(lo, u) evam-Arope rUXi-prayojanayoH-udAharaNe catuzwayam darSayitvA
   viṣayavyāptyarthaṃ sambandhabhedena udāharaṇānyāha--yathā	vizaya-vyApti-arTam sambanDa-Bedena udAharaNAni-Aha--yaTA
   vetyādi---rājāsau ityatra pūrvavat adaḥ śabdena viṣayaprakaṭanam /	vA-ityAdi----rAjA-asO iti-atra pUrvavat adaH Sabdena vizaya-prakawanam /
        agreti /	agrA-iti /
        atra hastāvayave 'gre 'pi hastaśabdaprayogaḥ, ekadeśadāhe 'pi grāmo	atra hasta-avayave agre api hasta-Sabda-prayogaH, eka-deSa-dAhe api grAmaH-
   dagdha iti vat /	dagDaH iti vat /
        atra idaṃśabdo rājā asau ityatra ca adaḥ śabdavat /	atra idaMSabdaH rAjA asO iti-atra ca adaH Sabda-vat /
        sādhyavasānālakṣaṇaṃ vivṛṇoti--nigīrārṇasyeti--pūrvodāharaṇāni	sADyavasAna-alakzaNam vivRNoti---nigIra-arNasya-iti---pUrva-udAharaNAni
   śvetodhāvati, kuntāḥ praviśanti, kaliṅgaḥ	SvetoDAvati, kuntAH praviSanti, kaliFgaH
        sāhasikaḥ, gaṅgayāṃ ghoṣaḥ /	sAhasikaH, gaFgayAm GozaH /
        ********** END OF COMMENTARY **********	********** END OF SOMMENTa-aRY **********
   sādṛśyetarasaṃbandhāḥ śuddhāstāḥ sakalā api // VisSd_2.9 //	sAdRSya-itara-saMbanDAH SudDAH-tAH sakalAH api // VisSd-_2.9 //
   sādṛśyāttu matā gauṇyastena ṣoḍaśa bheditāḥ /	sAdRSyAt-tu matAH gONyaH-tena zoxaSa BeditAH /
        ************* COMMENTARY *************	************* SOMMENTa-aRY *************
        Vijñapriyā:	VijQa-priyA:
        (vi, ṣa) ṣoḍaśabhedānāha---sādṛśyetareti /	(vi, za) zoxaSa-Beda-AnAha----sAdRSya-itara-iti /
        sādṛśyetarasambandhāḥ kāryyakāraṇabhāvādirūpāḥ pūrvadarśitāḥ sakalā	sAdRSya-itara-sambanDAH kAryya-kAraNa-BAva-Adi-rUpAH pUrva-darSitAH sakalA
   aṣṭavidhā api suddhāḥ śuddhaparibhāṣitāḥ /	azwaviDAH api sudDAH SudDa-pariBAzitAH /
        sādṛśyasambandhāttu tā aṣṭavidhā gauṇyaḥ	sAdRSya-sambanDAt-tu tAH azwaviDAH gONyaH
   sādṛśyaghaṭakarūpaśakyaguṇayogarūpayogārthena gauṇyo gauṇīparibhāṣitā	sAdRSya-Gawaka-rUpa-Sakya-guNa-yoga-rUpa-yoga-arTena gONyaH gONI-pariBAzitA
   ityarthaḥ /	iti-arTaH /
        ṣoḍaśabheditā aṣṭadvaiguṇyāt /	zoxaSa-BeditAH azwadvEguNyAt /
        Locanā:	LocanA:
        (lo ū) evamaṣṭavidhāpi lakṣaṇā pratyekaṃ śuddhā gauṇī ceti	(laH U) evam-azwaviDA-api lakzaNA pratyekam SudDA gONI ca-iti
   ṣoḍaśaprakāreti darśayati---sādṛśyetareti /	zoxaSa-prakAra-iti darSayati----sAdRSya-itara-iti /
        vṛttau spaṣṭo lakṣaṇārthaḥ /	vRttO spazwaH lakzaNa-arTaH /
        ********** END OF COMMENTARY **********	********** END OF SOMMENTa-aRY **********
   tāḥ pūrvoktā aṣṭabhedā lakṣaṇāḥ /	tAH pUrva-uktAH azwa-BedAH lakzaNAH /
   sādṛśyetarasaṃbandhāḥ kāryakāraṇabhāvādayaḥ /	sAdRSya-itara-saMbanDAH kArya-kAraNa-BAva-AdayaH /
   atra śuddhānāṃ pūrvodāharaṇānyeva /	atra SudDAnAm pUrva-udAharaNAni-eva /
        ************* COMMENTARY *************	************* SOMMENTa-aRY *************
        Vijñapriyā:	VijQa-priyA:
        (vi, sa) pūrvoktodāharaṇānyeva iti---śveto dhāvatītyādīni, indrārthā	(vi, sa) pUrva-ukta-udAharaNAni-eva iti---SvetaH DAvati-ityAdIni, indra-arTA
   sthūṇā ityantāni sakalāni eva /	sTUNAH iti-antAni sakalAni eva /
        teṣu ekatrāpi sādṛśyasambandhābhāvāt /	tezu ekatra-api sAdRSya-sambanDa-aBAvAt /
        ********** END OF COMMENTARY **********	********** END OF SOMMENTa-aRY **********
   rūḍhāvupādānalakṣaṇā sārepā gauṇī yathā--	rUXO=-upAdAna-lakzaNA sArepA gONI yaTA--
   etāni tailāni hemante sukhāni" /	etAni tElAni hemante suKAni" /
   atra tailaśabdastilabhavasneharūpaṃ mukhyārthamupādāyaiva sārṣapādiṣu	atra tEla-SabdaH-tila-Bava-sneha-rUpam muKya-arTam-upAdAya-eva sArzapa-Adizu
   sneheṣu vartate /	snehezu vartate /
        ************* COMMENTARY *************	************* SOMMENTa-aRY *************
        Locanā:	LocanA:
        (lo, ṛ) etānīti---atra tailaśabdasya tilabhavastrehamātravācakatvāt	(lo, R) etAni-iti---atra tEla-Sabdasya tila-BavaH-tra-iha-mAtra-vAcaka-tvAt
   prakṛte tasya kevalasya sukhamayatvādivivakṣaṇat mukhyārthabādaḥ;	prakRte tasya kevalasya suKa-maya-tva-Adi-vivakzaNat muKya-arTa-bAdaH;
   prayojanābhāvāt rūḍiḥ upādānalakṣaṇātvaṃ mukhyārthamupādāyaiva iti vṛttyā	prayojana-aBAvAt rUxiH upAdAna-lakzaNAtvam muKya-arTam-upAdAya-eva iti vRttyA
   smāritam /	smAritam /
        streheṣu varttata ityanena ubhayoḥ streharūpatvāt sādṛśyalakṣaṇaḥ	strehezu varttate iti-anena uBayoH streha-rUpa-tvAt sAdRSya-lakzaNaH
   sambandhaḥ /	sambanDaH /
        etānīti sarvānamnā sāropātvam, evamuttarodāharaṇeṣvapi boddhavyam /	etAni-iti sarva-AnamnA sAropAtvam, evam-uttara-udAharaNezu-api bodDavyam /
        ********** END OF COMMENTARY **********	********** END OF SOMMENTa-aRY **********
   prayojane yathā--	prayojane yaTA--
   rājakumāreṣu tatsadṛśeṣu ca gacchatsu"ete rājakumārā gacchanti" /	rAja-kumArezu tad-sadRSezu ca gacCat-su"ete rAja-kumArA gacCanti" /
        ************* COMMENTARY *************	************* SOMMENTa-aRY *************
        Vijñapriyā:	VijQa-priyA:
        (vi, ha) tilabhavasneharūpaṃ mukhyārthamiti /	(vi, ha) tila-Bava-sneha-rUpam muKya-arTam-iti /
        tilasyedamiti yogārthavaśāttasya mukhyārthatvaṃ, tasya	tilasya-idam-iti yoga-arTa-vaSAt-tasya muKya-arTa-tvan, tasya
   cikkaṇatākāritvena sādṛśyāśrayaṃ śakyalakṣyobhayamevātra taila śabdārtha	cikkaNa-tA-kAri-tvena sAdRSya-ASrayam Sakya-lakzya-uBayam-eva-atra tEla Sabda-arTa
   ityato mukhyopādānam /	iti-atas muKya-upAdAnam /
        ete rājakumārā iti /	ete rAja-kumArAH iti /
        atra rājakumāratulyaśobhāvattvaṃ prayojanam--tulyavayaskatvaṃsādṛśyam	atra rAja-kumAra-tulya-SoBAvat-tvam prayojanam---tulya-vayaska-tvaMsAdRSyam
        ubhayatraiva etāni ete iti sarvanāmapadena lakṣyārthopādānāt tatra	uBayatra-eva etAni ete iti sarvanAma-padena lakzya-arTa-upAdAnAt tatra
   śakyārthatādātmyāropācca sāropā lakṣaṇā /	Sakya-arTa-tAdAtmya-AropAt-ca sAropA lakzaNA /
        ********** END OF COMMENTARY **********	********** END OF SOMMENTa-aRY **********
   rūḍhāvupādānalakṣaṇā sādhyavasānā gauṇī yathā--	rUXO=-upAdAna-lakzaNA sADyavasAnA gONI yaTA--
   "tailāni hemante sukhāni" /	"tElAni hemante suKAni" /
   prayojane yathā--	prayojane yaTA--
   "rājakumārā gacchanti"	"rAja-kumArAH gacCanti"
        ************* COMMENTARY *************	************* SOMMENTa-aRY *************
        Vijñapriyā:	VijQa-priyA:
        (vi, kṣa) sādṛśyāt sādhyavasānāmāha---tailānīti /	(vi, kza) sAdRSyAt sADyavasAnAm-Aha----tElAni-iti /
        atra sarvanāmapadena lakṣyārthānupasthāpanānna sāropā, kintu	atra sarvanAma-padena lakzya-arTa-anupasTApanAt-na sa-AropA, kintu
   śakyārthāvyāvarttakena śakyalakṣyasādhāraṇyena sukhapadena	Sakya-arTa-avyAvarttakena Sakya-lakzya-sADa-araNyena suKa-padena
   lakṣyārthopasthāpanāttasyācchādanarūpā nigīrṇṇatā /	lakzya-arTa-upasTApanAt-tasya-AcCAdana-rUpA nigIrNNa-tA /
        tataḥ śakyārthatādātmyāropāt sādhyavasānā /	tatas Sakya-arTa-tAdAtmya-AropAt sADyavasAnA /
        rājakumāra iti /	rAja-kumAraH iti /
        atrākhyātenaiva karttṝṇāṃ lakṣyārthānā mupasthāpanātteṣāṃ nigīrṇṇatā	atra-AKyAtena-eva karttLNAm lakzya-arTAnA mupasTApanAt-tezAm nigIrNNa-tA
        tatra śakyarājakumāratādātmyāropaśceti sādhyavasānā /	tatra Sakya-rAja-kumAra-tAdAtmya-AropaH-ca-iti sADyavasAnA /
        tulyaśobhāvattvaṃ prayojanam, tulyavayaskatvaṃ sāṃdṛśyam /	tulya-SoBAvat-tvam prayojanam, tulya-vayaska-tvam sAMdRSyam /
        ********** END OF COMMENTARY **********	********** END OF SOMMENTa-aRY **********
   rūḍhau lakṣaṇalakṣaṇā sārepā gauṇī yathā--	rUXO lakzaNa-lakzaNA sArepA gONI yaTA--
   "rājā gauḍendraṃ kaṇṭakaṃ śodhayati" /	"rAjA gOxa-indram kaNwakam SoDayati" /
        ************* COMMENTARY *************	************* SOMMENTa-aRY *************
        Vijñapriyā:	VijQa-priyA:
        (vi, ka) rājā gauḍendramiti /	(vi, ka) rAjA gOxa-indram-iti /
        atra duḥ khadāyitvena kaṇṭakasadṛśaḥ gauḍendro lakṣyārthaḥ	atra duH KadAyi-tvena kaNwaka-sadRSaH gOxa-indraH lakzya-arTaH
   svaśabdenaivopāttaḥ /	sva-Sabdena-eva-upAttaH /
        atra kaṇṭakatādātmyāropāt sāropā /	atra kaNwaka-tAdAtmya-AropAt sAra-upAH /
        ********** END OF COMMENTARY **********	********** END OF SOMMENTa-aRY **********
   prayojane yathā--	prayojane yaTA--
   "gaurvāhīkaḥ" rūḍhau lakṣaṇalakṣaṇā sādhyavasānā gauṇī yathā--	"gOH-vAhIkaH" rUXO lakzaNa-lakzaNA sADyavasAnA gONI yaTA--
   "rājā kaṇṭakaṃ śodhayati" /	"rAjA kaNwakam SoDayati" /
   prayojane yathā--gaurjalpati" /	prayojane yaTA--gOH-jalpati" /
        ************* COMMENTARY *************	************* SOMMENTa-aRY *************
        Vijñapriyā:	VijQa-priyA:
        (vi, kha) gaurvāhīka iti /	(vi, Ka) gOH-vAhIkaH iti /
        vāhīko halāvāhakaḥ /	vAhIkaH halAvAhakaH /
        sa ca svaśabdenaivopāttaḥ /	sa ca sva-Sabdena-eva-upAttaH /
        ajñatvadharmeṇa sādṛśyam /	ajQa-tva-DarmeNa sAdRSyam /
        jāḍyamāndyādikam avaidagdhyaṃ vā prayojanam /	jAxya-mAndya-Adikam avEdagDyam vA prayojanam /
        rājā kaṇṭakamityarthaparamparālikhitaḥ prāmādika eva pāṭhaḥ /	rAjA kaNwakam-iti-arTa-paramparA-AliKitaH prAmAdikaH eva pAWaH /
        takṣyārthasya kenāpi padena anupasthāpanāt, prathamaṃ tatra	takzya-arTasya kena-api padena anupasTApanAt, praTamam tatra
   śakyatādātmyāropānupapatteḥ /	Sakya-tAdAtmya-Aropa-anupapatteH /
        kintu rājñā kaṇṭakaṃ śodhyate, ityeva pāṭhaḥ /	kintu rAjQA kaNwakam SoDyate, iti-eva pAWaH /
        tatra karmākhyātenopasthāpite śodhye karmaṇi vaurīṇi	tatra karma-AKyAtena-upasTApite SoDye karmaNi vOrINi
   prathamāntakaṇṭapadaśakyārthasya tādātmyāropāt /	praTama-anta-kaNwapada-SakyA-arTasya tAdAtmya-AropAt /
        gaurjalpatītyatrāpi gaurjalpakatvāsambhavādākhyātenopasthāpite	gOH-jalpati-iti-atra-api gOH-jalpakatva-asamBavAt-AKyAtena-upasTApite
   jalpake nigīrṇṇe gotādātmyāropāt sādhyavasānā /	jalpake nigIrNNe go-tAdAtmya-AropAt sADyavasAnA /
        govad vaidagdhyaṃ prayojanam, jaḍatvādinā sādṛśyam /	go-vat vEdagDyam prayojanam, jaxa-tva-AdinA sAdRSyam /
        Locanā:	LocanA:
        (lo, ṝ) prayojana ityanantaram upādānalakṣaṇā sāropā	(lo, L) prayojanaH iti-anantaram upAdAna-lakzaNA sAropA
   gauṇītyanuṣajyate, evamuttaratrāpyudāharaṇe pūrvoktā vṛttiḥ /	gONI-iti-anuzajyate, evam-uttaratra-api-udAharaNe pUrva-uktA vRttiH /
        ete iti /	ete iti /
        atra rājakumārasadṛśeṣu rājakumāraprayogāt mukhyārthabādaḥ /	atra rAja-kumAra-sadRSezu rAja-kumAra-prayogAt muKya-arTa-bAdaH /
        śauryyasaundaryyaparicchadādibhiḥ sādṛśyaṃ sambandhaḥ /	SOryya-sOndaryya-paricCada-AdiBiH sAdRSyam sambanDaH /
        prayojanameṣāmatiśayaḥ /	prayojanam-ezAm-atiSayaH /
        lājeti--gauḍendre kaṇṭakaśabdasya prayoge prayojanābhāvādrūḍhiḥ /	lAjA-iti--gOxa-indre kaNwaka-Sabdasya prayoge prayojana-aBAva-at-rUXiH /
        kṣudraduḥ khadāyitvaṃ sādṛśyaṃ sambandhaḥ /	kzudraduH Ka-dAyi-tvam sAdRSyam sambanDaH /
        kaṇṭakaśabdasya prakṛte svārthaparityāgāt lakṣaṇalakṣaṇā,	kaNwaka-Sabdasya prakRte sva-arTa-parityAgAt lakzaNa-lakzaNA,
   gauḍendrasya viṣayasyānigaraṇāt sāropātvam /	gOxa-indrasya vizayasya-anigaraNAt sAropAtvam /
        gaurvāhīka ityādietasmin udāharaṇe yathā prayojane lakṣaṇalakṣaṇā	gOH-vAhIkaH ityAdietasmin udAharaNe yaTA prayojane lakzaNa-lakzaNA
   sāropā gauṇī /	sAra-upA gONI /
        tathā vṛttāvevāgre sphuṭībhaviṣyati /	taTA vRttO=-eva-agre sPuwIBavizyati /
        evaṃ gaurjalpatītyatrāpi prayojane lakṣaṇalakṣaṇā sādhyavasānā gauṇī	evam gOH-jalpati-iti-atra-api prayojane lakzaNa-lakzaNA sADyavasAnA gONI
        ********** END OF COMMENTARY **********	********** END OF SOMMENTa-aRY **********
   atra kecidāhuḥ--gausahacāriṇo guṇā jāḍyamāndyādayo lakṣyante /	atra kecid-AhuH---gOsahacAriNaH guNAH jAxya-mAndya-AdayaH lakzyante /
   te ca gośabdasya vāhīkārthābhidhāne nimittībhavanti /	te ca go-Sabdasya vAhIka-arTa-aBiDAne nimittIBavanti /
   tadayuktam--	tat-ayuktam---
   gośabdasyāgṛhītasaṅketaṃ vāhīkārthamabhidhātumaśakyatvād	go-Sabdasya-agRhIta-saFketam vAhIka-arTam-aBiDAtum-aSakya-tvAt-
   gośabdārthamātrabodhanācca /	go-Sabda-arTa-mAtra-boDanAt-ca /
   abhidhāyā viratatvād viratāyāśca punarutthānābhāvāt /	aBiDAyAH virata-tvAt viratAyAH-ca punar-utTAna-aBAvAt /
        ************* COMMENTARY *************	************* SOMMENTa-aRY *************
        Vijñapriyā:	VijQa-priyA:
        (vi, ga) atra keciditi---svārtho gotvaṃ tatsahacāriṇa ityarthaḥ /	(vi, ga) atra kecid-iti---sva-arTaH go-tvam tad-sahacAriNaH iti-arTaH /
        vāhīkārthābhidhāne iti---abhidhayā pratipādane ityarthaḥ /	vAhIka-arTa-aBiDAne iti---aBiDayA pratipAdane iti-arTaH /
        nimittībhavantīti---śakyatāvcchedakībhavantītyarthaḥ /	nimittIBavanti-iti----Sakya-tA-avcCedakIBavanti-iti-arTaH /
        tathā ca jaḍatvena rūpeṇa vāhīkaḥ śaktyaiva, jaḍo vāhīka iti	taTA ca jaxa-tvena rUpeNa vAhIkaH SaktyA-eva, jaxaH vAhIkaH iti
   pratītiriti tatsiddhāntaḥ /	pratItiH-iti tad-sidDAntaH /
        tadayuktamiti /	tat-ayuktam-iti /
        ayaṃ ca doṣaḥ tat siddhāntānavakalenādeva dharme lakṣaṇayā eva	ayam ca dozaH tat sidDAntAnava-kalena-Adeva Darme lakzaNayA eva
   dharmiṇi śaktigrāhakatvasya taiḥ siddhāntitatvāt /	DarmiNi Sakti-grAhaka-tvasya tEH sidDAntita-tvAt /
        gośabdārtheti---sakṛduccāritasya śabdasya sakṛdarthabodhanena	go-Sabda-arTa-iti----sakRt-uccAritasya Sabdasya sakRt-arTa-boDanena
   śabdavirityā abhidhāyā api virateriti bhāvaḥ /	Sabda-virityAH aBiDAyAH api virateH-iti BAvaH /
        Locanā:	LocanA:
        (lo, ḷ) samprati pūrvapakṣanirāsapūrvakaṃ gauṇyā	(lo, ?) samprati pUrva-pakza-nirAsa-pUrvakam gONyA
   vṛtterlakṣaṇāyāmantarbhāvaṃ darśayan ekatrāpi udāharaṇe	vRtteH-lakzaNAyAm-antarBAvam darSayan ekatra-api udAharaNe
   vipratipattinirāsena sarvamapi sāmañjasyaṃ bhaviṣyatītyāha--atreti /	vipratipatti-nirAsena sarvam-api sAmaQjasyam Bavizyati-iti-Aha--atra-iti /
        gaurvāhīka ityatra svārtho gauḥ; lakṣyante lakṣaṇayā bodhyante te	gOH-vAhIkaH iti-atra sva-arTaH gOH; lakzyante lakzaNayA boDyante te
   tatra lakṣitā guṇāḥ; cakāreṇa na khalu teṣāṃ lakṣitatvamātreṇa	tatra lakzitAH guNAH; cakAreNa na Kalu tezAm lakzita-tva-mAtreNa
   viśrantiriti, vāhīkārthasyābhidhāne 'bhidhayā bodane nimittībhavanti /	viSrantiH-iti, vAhIka-arTasya-aBiDAne aBiDayAH bodane nimittIBavanti /
        punarutthānābhāvāt śabdabuddhikarmmaṇāṃ viramya vyāpārābhāva iti	punar-utTAna-aBAvAt Sabda-budDi-karmmaNAm viramya vyApAra-aBAvaH iti
   nyāyāt, abhidhāntarakalpane kalpanāgauravamityāśayaḥ /	nyAyAt, aBiDA-antara-kalpane kalpanA-gOravam-iti-ASayaH /
        ********** END OF COMMENTARY **********	********** END OF SOMMENTa-aRY **********
   anye ca punargauśabdena vāhīkārtho nābhidhīyate, kintu	anye ca punar-gOSabdena vAhIka-arTaH na-aBiDIyate, kintu
   svārthasahacāriguṇasājātyena vāhīkārthagatā guṇā eva lakṣyante /	sva-arTa-sahacAri-guNa-sAjAtyena vAhIka-arTa-gatAH guNAH eva lakzyante /
   tadapyanye na manyante /	tat-api-anye na manyante /
        ************* COMMENTARY *************	************* SOMMENTa-aRY *************
        Vijñapriyā:	VijQa-priyA:
        (vi, gha) guṇā eva lakṣyanta iti---vāhīkapratītistvākṣepāditi bhāvaḥ	(vi, Ga) guNAH eva lakzyante iti---vAhIka-pratItiH-tu-AkzepAt-iti BAvaH
        Locanā:	LocanA:
        (lo, e) matāntaramāha--anya iti /	(lo, e) mata-antaram-Aha--anyaH iti /
        nābhidhīyate uktādeva nyāyāt /	na-aBiDIyate uktAt-eva nyAyAt /
        svārtho gauḥ /	sva-arTaH gOH /
        sājātyena sambandhena vāhīkagatā guṇā jāḍyamāndyādaya eva ;	sAjAtyena sambanDena vAhIka-gatAH guNAH jAxya-mAndya-AdayaH eva ;
   atraivakāreṇa guṇino vyavacchedaḥ /	atra-evakAreNa guNinaH vyavacCedaH /
        lakṣyante lakṣaṇayā bodhyante tat samanantaroktaṃ matāntaramapi /	lakzyante lakzaNayA boDyante tat samanantara-uktam mata-antaram-api /
        ********** END OF COMMENTARY **********	********** END OF SOMMENTa-aRY **********
   tathāhi--	taTA-hi--
   atra gośabdādvāhīkārthaḥ pratīyate, na vā ? ādye gośabdādeva vā ?	atra go-SabdAt-vAhIka-arTaH pratIyate, na vA ? Adye go-SabdAt-eva vA ?
   lakṣitādvā guṇād ? avinābhāvādvā ? tatra, na prathamaḥ, vāhīkārthe	lakzitAt-vA guNAt ? avinA-aBAvAt-vA ? tatra, na praTamaH, vAhIka-arTe
   'syāsaṅketitvāt /	asya-asaFketi-tvAt /
        ************* COMMENTARY *************	************* SOMMENTa-aRY *************
        Locanā:	LocanA:
        (lo, ai) atra pakṣe ādye pratītipakṣe /	(lo, E) atra pakze Adye pratIti-pakze /
        lakṣitāt guṇāt svaniṣṭajāḍyamāndyādeḥ /	lakzitAt guNAt sva-nizwa-jAxya-mAndya-AdeH /
        avinābhāvo 'vyabhicārasambandhaḥ taddrārā tadvalenākṣepādibhāvaḥ /	avinA-aBAvaH avyaBicAra-sambanDaH tad-drArA tad-valena-Akzepa-Adi-BAvaH /
        prathamaḥ gauśabdamātrāt vāhīkasya pratītipakṣeḥ /	praTamaH gOSabda-mAtrAt vAhIkasya pratIti-pakzeH /
        pratītiścābhidhayā bodhitā /	pratItiH-ca-aBiDayA boDitA /
        ********** END OF COMMENTARY **********	********** END OF SOMMENTa-aRY **********
   na dvitīyaḥ,--	na dvitIyaH,--
   avinābhāvalabhyasyārthasya śābde 'nvaye praveśāsaṃbhavāt /	avinA-aBO=-alaByasya-arTasya SAbde anvaye praveSa-asaMBavAt /
   śābdī hyākāṅkṣā śabdenaiva pūryate /	SAbdI hi-AkAFkzA Sabdena-eva pUryate /
   na dvitīyaḥ,--	na dvitIyaH,--
   yadi hi gośabdādvāhīkārtho na pratīyate, tadāsya vāhīkaśabdasya ca	yadi hi go-SabdAt-vAhIka-arTaH na pratIyate, tadA-asya vAhIka-Sabdasya ca
   sāmānādhikaraṇyamasamañjasaṃ syāt /	sAmAnADikaraNyam-asamaQjasam syAt /
        ************* COMMENTARY *************	************* SOMMENTa-aRY *************
        Vijñapriyā:	VijQa-priyA:
        (vi, ṅa) ādye 'pīti--gośabdād vāhīkapratītipakṣe ityarthaḥ /	(vi, Fa) Adye api-iti---go-SabdAt vAhIka-pratIti-pakze iti-arTaH /
        na prathamaityanena taddūṣaṇam /	na praTama-eti-anena tad-dUzaNam /
        asaṃketitatvāditi---etaduddhāraśca tanmate darśita eva, ityavadheyam	asaMketita-tvAt-iti---etat-udDAraH-ca tad-mate darSitaH eva, iti-avaDeyam
        na dvitīyo--lakṣitaguṇāvinābhāvenākṣepāt pratītipakṣaḥ /	na dvitIyaH---lakzita-guNa-avinA-BAvena-AkzepAt pratIti-pakzaH /
        śābde 'nvaye praveśāsambhavāditi--idaṃ ca	SAbde anvaye praveSa-asamBavAt-iti--idam ca
   svasiddhāntābhiprāyeṇaivoktam /	sva-sidDAnta-aBiprAyeNa-eva-uktam /
        vastutastu jātiśaktivāde jātyavinābhāvalabhyāyā vyakteḥ	vastutas-tu jAti-Sakti-vAde jAtya-vinABO=-alaByAyAH vyakteH
   śābdabodhapraveśavadatrāpi tathātve bādhakābhāvāt /	SAbda-boDa-praveSavat-atra-api taTA-tve bADaka-aBAvAt /
        na tṛtīya iti--gośabdāt vāhīkapratītyabhāvapakṣe /	na tRtIyaH iti--go-SabdAt vAhIka-pratItyaBAva-pakze /
        sāmānādhikaraṇyamiti---svārthayorabhedabodhakatvaniyataṃ	sAmAnADikaraNyam-iti---sva-arTayoH-aBeda-boDaka-tva-niyatam
   samānavibhaktikatvamityarthaḥ /	samAna-viBaktika-tvam-iti-arTaH /
        Locanā:	LocanA:
        (lo, o) avinābhāvalabhyasya na tu śabdabodhitasyetyarthaḥ /	(lo, o) avinA-aBO=-alaByasya na tu Sabda-boDitasya-iti-arTaH /
        ācāryyasammatimāha--śābdītyādi--hi yasmāt śabdenaiva na	AcAryya-sammati-mAha--SAbdI-ityAdi--hi yasmAt Sabdena-eva na
   tvāvinābhāvādilabhyārthena /	tvAvinABAva-Adi-laBya-arTena /
        tṛtīyo na pratītepakṣaḥ /	tRtIyaH na pratItepakzaH /
        ********** END OF COMMENTARY **********	********** END OF SOMMENTa-aRY **********
   tasmādatra gośabdo mukhyayāvṛttyā vāhīkaśabdena sahānvayamalabhamāno	tasmAt-atra go-SabdaH muKyayA-AvRttyA vAhIka-Sabdena saha-anvayam-alaBamAnaH-
   'jñatvādisādharmyasaṃbandhādvāhīkārthaṃ lakṣayati /	ajQa-tva-Adi-sADarmya-saMbanDAt-vAhIka-arTam lakzayati /
   vāhīkasyājñatvādyatiśayabodhanaṃ prayojanam /	vAhIkasya-ajQa-tva-Adi-atiSaya-boDanam prayojanam /
        ************* COMMENTARY *************	************* SOMMENTa-aRY *************
        Vijñapriyā:	VijQa-priyA:
        (vi, ca) tathā hi gośabdasya vāhīkagatajāḍyamāndyādi guṇor'thaḥ /	(vi, ca) taTA hi go-Sabdasya vAhIka-gata-jAxya-mAndya-Adi guNoH-aTaH /
        vāhīkaśabdasya halavāhikor'thaḥ /	vAhIka-Sabdasya hala-vAhikor-aTaH /
        vāhīkārthaṃ lakṣayatīti--gosadṛśatvena rūpeṇeti śeṣaḥ /	vAhIka-arTam lakzayati-iti--go-sadRSa-tvena rUpeNa-iti SezaH /
        Locanā:	LocanA:
        (lo, au) tat kā gatirityākāṅkṣāyāṃ svamatamāha-tasmāditi /	(lo, O) tat kA gatiH-iti-AkAFkzAyAm sva-matam-Aha-tasmAt-iti /
        yasmādevamanyā gatirnāsti ityarthaḥ /	yasmAt-evam-anyA gatiH-na-asti iti-arTaH /
        gośabdo gośabdārthaḥ /	go-SabdaH go-Sabda-arTaH /
        śabdatadarthayorabhedopacārāt /	Sabda-tad-arTayoH-aBeda-upacArAt /
        evamanyatrāpyevaṃvidhasthale boddhavyam /	evam-anyatra-api-evaMviDa-sTale bodDavyam /
        mukhyā vṛttirabhidhāprayojanam /	muKyAH vRttiH-aBiDA-prayojanam /
        vāhīko 'jña iti svaśabdapratipādanālabhyam, etasyā gauṇyākhyāyā	vAhIkaH ajQaH iti sva-Sabda-pratipAdana-AlaByam, etasyAH gONI-a-AKyAyA
   vṛttermukhyārthabādhāditritayahetukatvāt lakṣaṇāyāmantarbhāvaḥ sphuṭa eva	vRtteH-muKyA-arTa-bADa-Adi-tritaya-hetuka-tvAt lakzaNAyAm-antarBAvaH sPuwaH eva
   ityāśayaḥ /	iti-ASayaH /
        iha ca gaṅgataṭayostādātmyapratītyā taṭe śītatvādyatiśayaḥ /	iha ca gaFga-tawayoH-tAdAtmya-pratItyA tawe SIta-tva-Adi-atiSayaH /
        gaurvāhīka ityatra govāhīkaśabdayostādātmyapratītyā vāhīke	gOH-vAhIkaH iti-atra go-vAhIka-SabdayoH-tAdAtmya-pratItyA vAhIke
   jāḍyādyatiśayaḥ pratīyate iti vyartho 'yamupacāro lakṣaṇāyāsaḥ	jAxya-Adi-atiSayaH pratIyate iti vyarTaH ayam-upacAraH lakzaNa-AyAsaH
   kāvyaprakāśakārasyeti caṇḍīdāsapaṇḍitānāmavicāritābhidhānam /	kAvya-prakASa-kArasya-iti caNxI-dAsa-paNxitAnAm-avicArita-aBiDAnam /
        tathāhi sādṛśyasambandhinoriva taditarasambandhinorna	taTA-hi sAdRSya-sambanDinoH-iva tad-itara-sambanDinoH-na
   sambandhaudāsīnyena vṛttiḥ; ata evānyairuktasambandhāntaraṃ	sambanDa-OdAsInyena vRttiH; atas eva-anyEH-ukta-sambanDa-antaram
   lakṣyalakṣyakayoḥ sākṣāt sambandhena, sādṛśyaṃ tu	lakzya-lakzyakayoH sAkzAt sambanDena, sAdRSyam tu
   gaurvāhīkāditaddharmasājātyarūpaṃ, na tatheti, ata eva kvacit taṭādau	gOH-vAhIkAdi-tad-DarmasAjAtya-rUpaM, na taTA-iti, atas eva kvacid tawa-AdO
   gaṅgadisambandhāt kiñcit śetyādikamastvevaṃ, kintu gaṅgāśabdena	gaFgadi-sambanDAt kiQcid Seti-Adi-kamaH-tu-evaM, kintu gaFgA-Sabdena
   pratipādane gaṅgātvapratītau tatśaityādikamādhikaṃ pratīyate /	pratipAdane gaFgA-tva-pratItO tad-SEtya-Adi-kama-aDikam pratIyate /
        vāhīke punargoniṣṭānāṃ guṇānāṃ kadācinna sambhavaḥ, kintu	vAhIke punar-gonizwAnAm guNAnAm kadAcid-na samBavaH, kintu
   tatsajātīyānām /	tad-sajAtIyAnAm /
        kiñca gaurvāhīka ityukte 'pi pratipattuḥ sarvathā nābhedapratipattiḥ,	kiQca gOH-vAhIkaH iti-ukte api pratipattuH sarvaTA nABeda-pratipattiH,
   kintu sāmānādhikaraṇyaprayogāt tasyāḥ sthaganamātram /	kintu sAmAnADikaraNya-prayogAt tasyAH sTagana-mAtram /
        taduktaṃ śārīrikamīmāṃsāvyākhyāne vācaspatimiśraiḥ---"api ca	tat-uktam SArIrikamImAMsA-vyAKyAne vAcaspati-miSrEH---"api ca
   paraśabdaḥ paratra lakṣyamāṇaguṇayogena varttata'; iti yatra	para-SabdaH paratra lakzyamANa-guNa-yogena varttata-a; iti yatra
   prayoktṛpratipattroḥ sampratipattiḥ sa gauṇaḥ, saca bhedapratyayapuraḥ	prayoktR-pratipattroH sampratipattiH sa gONaH, saca Beda-pratyaya-puras-
   sara iti /	saraH iti /
        ********** END OF COMMENTARY **********	********** END OF SOMMENTa-aRY **********
   iyaṃ ca guṇayogādrauṇītyucyate /	iyam ca guNa-yoga-at-rONI-iti-ucyate /
   pūrvā tūpacārāmiśraṇācchuddhā /	pUrvA tu-upacAra-AmiSraNAt-SudDA /
   upacāro hi nāmātyantaṃ viśakalitayoḥ śabdayoḥ sādṛśyātiśayamahimnā	upacAraH hi nAma-atyantam viSakalitayoH SabdayoH sAdRSya-atiSaya-mahimnA
   bhedapratītisthaganamātram /	Beda-pratIti-sTagana-mAtram /
   yathā--agrimāṇavakayoḥ" /	yaTA--agrimANavakayoH" /
   śuklapaṭayostu nātyantaṃ bhedapratītiḥ, tasmādevamādiṣu śuddhaiva lakṣaṇā	Sukla-pawayoH-tu na-atyantam Beda-pratItiH, tasmAt-evamAdizu SudDA-eva lakzaNA
        ************* COMMENTARY *************	************* SOMMENTa-aRY *************
        Vijñapriyā:	VijQa-priyA:
        (vi, cha)	(vi, Ca)
   guṇayogāditi---śakyagoniṣṭhajāṅyādiguṇasajātīyajāḍyādiguṇayogādityarthaḥ /	guNa-yoga-aditi----Sakya-gonizWa-ja-aFya-Adi-guNa-sajAtIya-jAxya-Adi-guNa-yogAt-iti-arTaH /
        pūrvā tviti--suklapaṭaḥ, āyurghṛtamityādiketyarthaḥ /	pUrvA tu-iti--suklapawaH, AyuH-GRtam-iti-AdikA-iti-arTaH /
        nanu tatrāpi samānavibhaktikatvavaśādāyurghṛtayoḥ prathamabhedopacāro	nanu tatra-api samAna-viBaktikatva-vaSAt-AyuH-GRtayoH praTama-Beda-upacAraH-
   'steyeva ityata āha---upacāro hīti /	asteya-iva iti-atas Aha---upacAraH hi-iti /
        samānavibhaktikatvābhidhānena upacāreṇāmiśraṇaṃ na	samAna-viBaktika-tva-aBiDAnena upacAreNa-AmiSraNam na
   śauddhatvaprayojakaṃ, kintu tatraiva sādṛśyasattve eveti bhāvaḥ /	SOdDa-tva-prayojakaM, kintu tatra-eva sAdRSya-sattve eva-iti BAvaH /
        śuklapaṭayostviti--āyurghṛtayoścetyapi bodhyam /	Sukla-pawayoH-tu-iti--AyuH-GRtayoH-ca-iti-api boDyam /
        Locanā:	LocanA:
        (lo, a) etadabhipretya uktaprakāreṇa	(lo, a) etat-aBipretya ukta-prakAreNa
   lakṣaṇāviśeṣaṇayorgauṇaśuddhayorbhedaṃ darśayatiiyaṃ ceti /	lakzaNA-viSezaNayoH-gONa-SudDayoH-Bedam darSayatiiyam ca-iti /
        iyaṃ sādṛśyasaṃbandhahetukā guṇayogāt natu sākṣātsambandhāt /	iyam sAdRSya-saMbanDa-hetukA guNa-yogAt na-tu sAkzAt-sambanDAt /
        upacāro nāma atyantaṃ viśakalitayorityanena sambandhasya	upacAraH nAma atyantam viSakalitayoH-iti-anena sambanDasya
        sākṣāttvaṃ darśitam /	sAkzAt-tvam darSitam /
        sthaganamātraṃ natu sarvathābhāvaḥ /	sTagana-mAtram na-tu sarvaTABAvaH /
        nātyantaṃ bhedapratītaḥ uktanayena sambandhasya sākṣāttvāt /	na-atyantam Beda-pratItaH ukta-nayena sambanDasya sAkzAt-tvAt /
        ********** END OF COMMENTARY **********	********** END OF SOMMENTa-aRY **********
   vyaṅgyasya gūḍhāgūḍhatvāddvidhā syuḥ phalalakṣaṇāḥ // VisSd_2.10 //	vyaFgyasya gUXa-agUXa-tvAt-dviDA syuH Pala-lakzaNAH // VisSd-_2.10 //
   prayojane yā aṣṭabhedā lakṣaṇā daśitāstāḥ prayojanarūpavyaṅgyasya	prayojane yAH azwa-BedAH lakzaNAH daSitAH-tAH prayojana-rUpa-vyaFgyasya
   gūḍhāgūḍhatayā pratyekaṃ dvidhā bhūtvā ṣoḍhaśa bhedāḥ /	gUXa-agUXa-tayA pratyekam dviDA BUtvA zoXaSa BedAH /
   tatra gūḍhaḥ, kāvyārthabhāvanāparipakvabuddhivibhavamātravedyaḥ /	tatra gUXaH, kAvya-arTa-BAvanA-paripakva-budDi-viBava-mAtra-vedyaH /
   yathā--	yaTA--
   "upakṛtaṃ bahu tatra-" iti /	"upakRtam bahu tatra-" iti /
   agūḍhaḥ, atisphuṭatayā sarvajanasaṃvedyaḥ /	agUXaH, ati-sPuwa-tayA sarva-jana-saMvedyaH /
   yathā--	yaTA--
   upadiśatiṃ kāminīnāṃ yauvanamada eva lalitāni" //	upadiSatim kAminInAm yOvana-madaH eva lalita-ani" //
   atra"upadiśati" ityanena "āviṣkaroti" iti lakṣyate /	atra"upadiSati" iti-anena "Avizkaroti" iti lakzyate /
   āviṣkāratiśayaścābhidheyavatsphuṭa pratīyate /	AvizkAra-tiSayaH-ca-aBiDeya-vat-sPuwa pratIyate /
        ************* COMMENTARY *************	************* SOMMENTa-aRY *************
        Vijñapriyā:	VijQa-priyA:
        (vi, ja) phalalakṣaṇāḥ prayojanavatyo lakṣaṇāḥ /	(vi, ja) Pala-lakzaNAH prayojanavatyaH lakzaNAH /
        prayojane yā aṣṭabhedā darśitā iti ṣoḍaśasu rūḍhāvaṣṭau prayojane	prayojane yAH azwa-BedAH darSitAH iti zoxaSasu rUXO=-azwO prayojane
   tvaṣṭāviti darśatatvāt /	tu-azwO=-iti darSata-tvAt /
        paripakvabuddhaiḥ dṛḍhasaṃskārajā buddhiḥ /	paripakva-budDEH dRXa-saMskAra-jA budDiH /
        upakṛtamiti---atra granthakṛnmate 'pakāradyatiśayaḥ, anyamate	upakRtam-iti---atra granTakRt-mate apakAra-di-ati-SayaH, anya-mate
   tvapakāriṇaḥ kauṭilyādikaṃ prayojanaṃ, vyaṅgyavidagdhaikagamam /	tu-apakAriNaH kOwilya-Adikam prayojanaM, vyaFgya-vidagDa-eka-gamam /
        solluṇṭhanārthasyāvidagdhāvedyatvāt /	sa-ulluNWana-arTasya-avidagDa-Avedya-tvAt /
        āviṣkarotīti--upadeśakatvasya gurudharmatvena yauvanamade tadbādhāt	Avizkaroti-iti--upadeSaka-tvasya guru-Darma-tvena yOvana-made tad-bADAt-
   iti bhāvaḥ /	iti BAvaH /
        āviṣkārātiśayaśceti--idaṃ tu nānubhāvikamuktam /	AvizkAra-atiSayaH-ca-iti--idam tu na-anuBAvikam-uktam /
        kāvyaprakāśe tu śikṣādānameva lakṣyārthastatrānāyāsa eva	kAvya-prakASe tu SikzA-dAnam-eva lakzya-arTaH-tatra-anAyAsaH eva
   prayojanamabhidheyavat sarvajanavedyam /	prayojanam-aBiDeya-vat sarva-jana-vedyam /
        taddhi prayonajamupadeśasya vākyārthasya dharmo lakṣyārthe śikṣādāne	tat-hi prayona-jam-upadeSasya vAkya-arTasya DarmaH lakzya-arTe SikzA-dAne
   pratīyate---upadeśāt śikṣāyāṃ cānāyāsaḥ sarvajanavedya eva iti	pratIyate---upadeSAt SikzAyAm ca-anAyAsaH sarva-jana-vedyaH eva iti
   tadabhiprāyaḥ /	tad-aBiprAyaH /
        Locanā:	LocanA:
        (lo, ā) samprati vyaṅgyavaicitryaiṇaiva lakṣaṇābhedān darśayati,	(lo, A) samprati vyaFgya-vEcitrya-eNa-eva lakzaNa-aBedAn darSayati,
   vyaṅgayasyetiphalaṃ prayojanaṃ, tadyuktā lakṣaṇā /	vyaFgayasya-itiPalam prayojanaM, tad-yuktA lakzaNA /
        lalitāni ceṣṭitāni /	lalitAni cezwitAni /
        ābhyāmeva vyaṅgyasya gūḍhāgūḍhatvābhyāṃ dhvaniguṇībhūtavyaṅgyākhyau	AByAm-eva vyaFgyasya gUXa-agUXa-tvAByAm Dvani-guNIBUta-vyaFgyA-AKyO
   kāvyaprakāraviśeṣau vakṣyete /	kAvya-prakAra-viSezO vakzyete /
        ********** END OF COMMENTARY **********	********** END OF SOMMENTa-aRY **********
   dharmidharmagatatvena phalasyaitā api dvidhā /	Darmi-Darma-gata-tvena Palasya-etAH api dviDA /
   etā anantaroktāḥ ṣoḍaśabhedā lakṣaṇāḥ phalasya dharmigatatvena	etAH anantara-uktAH zoxaSa-BedAH lakzaNAH Palasya Darmi-gata-tvena
   dharmagatatvena ca pratyekaṃ dvidhā bhūtvā dvātriṃśadbhedāḥ /	Darma-gata-tvena ca pratyekam dviDA BUtvA dvAtriMSat-BedAH /
   diṅmātraṃ yathā--	diS-mAtram yaTA--
   "strigdhaśyāmalakāntiliptaviyato velladvalākā ghanā vātāḥ śīkariṇaḥ	"H-trigDaSyAmala-kAnti-lipta-viyataH vellat-valAkAH GanAH vAtAH SIkariNaH
   payodasuhṛdāmānandakekāḥ kalāḥ /	payoda-suhRdAm-Ananda-kekAH kalAH /
   kāmaṃ santu dṛḍhaṃ kaṭhorahṛdayo rāmo 'smi sarvaṃ sahe vaidehī tu kathaṃ	kAmam santu dRXam kaWora-hRdayaH rAmaH asmi sarvam sahe vEdehI tu kaTam
   bhaviṣyati hahā hā devi dhīrā bhava" //	Bavizyati hahA hA devi DIrAH Bava" //
        ************* COMMENTARY *************	************* SOMMENTa-aRY *************
        Vijñapriyā:	VijQa-priyA:
        (vi, jha) ṣoḍaśabhedā iti---gūḍhāgūḍhaprayojanarūpā ityarthaḥ /	(vi, Ja) zoxaSa-BedAH iti---gUXA-gUXa-prayojana-rUpAH iti-arTaH /
        dharmidhamargatatveneti; dharmo lakṣyārthaḥ /	DarmiDamargata-tvena-iti; DarmaH lakzya-arTaH /
        dharmastu lakṣyārthaniṣṭhapadārthaḥ strigdhaśyāmaleti---prāvṛṭkāle	DarmaH-tu lakzya-arTa-nizWa-padArTaH strigDa-SyAma-la-iti-----prAvRz-kAle
   upasthite sītāvirahiṇo rāmasyeyamuktiḥ /	upasTite sItA-virahiNaH rAmasya-iya-muktiH /
        vellantī cañcalā valākā yatra tādṛśāḥ /	vellantI caQcalAH valAkAH yatra tAdRSAH /
        payodasuhṛdāṃmayūrāṇām ete virahoddīpakāḥ kāmaṃ svācchandyena santu	payoda-suhRdAMmayUrANAm ete viraha-uddIpakAH kAmam svAcCandyena santu
   tathāpi māṃ mārayituṃ na śaktā ityarthaḥ /	taTA-api mAm mArayitum na SaktAH iti-arTaH /
        yato rāmo 'smi, duḥ khasahiṣṇurasmi, tathātve hetumāhakaṭhoreti /	yatas rAmaH asmi, duH Ka-sahizNuH-asmi, taTA-tve hetumAha-kaWorA-iti /
        ata uktaṃ ghanādikaṃ sarvamahaṃ sahe ityarthaḥ /	atas uktam Gana-Adikam sarvam-aham sahe iti-arTaH /
        vaidehī tu anīdṛśī /	vEdehI tu anIdRSI /
        kathaṃ bhaviṣyati, kiprakārā bhaviṣyatītyarthaḥ /	kaTam Bavizyati, kiprakArA Bavizyati-iti-arTaH /
        hāhā khede /	hAhA Kede /
        tasmāddevi vaidehi ! dhīrā bhava---duḥ khasahiṣṇurbhavetyarthaḥ /	tasmAt-devi vEdehi ! DIrAH Bava---duH Ka-sahizNuH-Bava-iti-arTaH /
        ********** END OF COMMENTARY **********	********** END OF SOMMENTa-aRY **********
   atrātyantaduḥkhasahiṣṇurūpe rāme dharmiṇi lakṣye tasyaivātiśayaḥ phalam /	atra-atyanta-duHKa-sahizNu-rUpe rAme DarmiNi lakzye tasya-eva-atiSayaH Palam /
   "gaṅgāyāṃ ghoṣaḥ" ityatra taṭe śītatvapāvanatvarūpadharmasyātiśayaḥ phalam	"gaFgAyAm GozaH" iti-atra tawe SIta-tva-pAvana-tva-rUpa-Darmasya-atiSayaH Palam
        ************* COMMENTARY *************	************* SOMMENTa-aRY *************
        Vijñapriyā:	VijQa-priyA:
        (vi, ña) rāme lakṣye iti---ghanādyuddīpakasaharāmatvasya	(vi, Qa) rAme lakzye iti---Gana-Adi-uddIpaka-saharAma-tvasya
   prayojakatvādduḥ khasahiṣṇutvarūpeṇa rāmo lakṣyata ityarthaḥ /	prayojaka-tvAt-duH Ka-sahizNu-tva-rUpeNa rAmaH lakzyate iti-arTaH /
        tasyaivātiśaya iti tasyaiva duḥ khasahiṣṇo rāmasyātiśayaḥ	tasya-eva-atiSayaH iti tasya-eva duH Ka-sahizNoH rAmasya-atiSayaH
   vipralambharūpaḥ, nacātra duḥ khasahiṣṇutvasyāpyatiśayaḥ pratīyata eva /	vipralamBa-rUpaH, na-ca-atra duH Ka-sahizNu-tvasya-api-atiSayaH pratIyate eva /
        tat kathamidaṃ dharmagatasyodāharaṇaṃ na darśitamiti vācyam /	tat kaTam-idam Darma-gatasya-udAharaNam na darSitam-iti vAcyam /
        vivakṣitārthāvivekena tasyāpi dharmigatvādeva; tathāhi duḥ	vivakzita-arTa-avivekena tasya-api Darmi-ga-tvAt-eva; taTA-hi duH
   khasahiṣṇutvaṃ tāvadduḥ khadveṣābhāvastasya	Ka-sahizNu-tvam tAvat-duH Ka-dveza-aBAvaH-tasya
   cābhāvarūpasyātiśayāntarābhāvadveṣasāmānyābhāvarūpatvamevatiśayaḥ /	ca-aBAva-rUpasya-atiSaya-antara-aBAva-dveza-sAmAnya-aBAva-rUpa-tvam-evatiSayaH /
        sa ca nātiriktapadārthaḥ /	sa ca na-atirikta-padArTaH /
        kintu abhāvasvarūpa eva /	kintu aBAva-svarUpaH eva /
        tasya ca rāmarūpadharmigatatvādeva /	tasya ca rAma-rUpa-Darmi-gata-tvAt-eva /
        śītatvapāvanatvātiśayasyeti---atiśayasyātiśayāntarābhāvādatiśayitaśītatvapāvanatvayorityarthaḥ	SIta-tva-pAvana-tva-atiSayasya-iti---atiSayasya-atiSaya-antara-aBAvAt-atiSayita-SIta-tva-pAvana-tvayoH-iti-arTaH
        atra cātiśayitāṃśo nātiprayojanaḥ sampātāyāta eva bodhyaḥ nanvatra	atra ca-atiSayita-aMSaH na-ati-prayojanaH sampAta-AyAtaH eva boDyaH nanu-atra
   dharmigate śītatvapāvanatve eva prayojane kiṃ na syāditicenna /	Darmi-gate SIta-tva-pAvana-tve eva prayojane kim na syAt-iti-ced-na /
        gaṅgasambandhavaśāttaṭasya śīkatvapāvanatve vāstave eva /	gaFga-sambanDa-vaSAt-tawasya SIka-tva-pAvana-tve vAstave eva /
        tataśca lakṣaṇayā taṭapratītau tatsambandhinoḥ tayoḥ smaraṇasyaivaṃ	tatas-ca lakzaNayA tawa-pratItO tad-sambanDinoH tayoH smaraNasya-evam
   sambhavena vyaṅgyatvaniyamarahitayostayoratiśaya eva	samBavena vyaFgya-tva-niyama-rahitayoH-tayoH-atiSayaH eva
   prayojanamityabhiprāyāt /	prayojanam-iti-aBiprAyAt /
        Locanā:	LocanA:
        (lo, i) snigdheti--vellanaṃ calanaṃ; payodasuhṛdāṃ mayūrāṇām;	(lo, i) snigDA-iti---vellanam calanan; payoda-suhRdAm mayUrANAm-;
   ānandena kekāḥ dhvanayaḥ kalā madhurāsphuṭāḥ /	Anandena kekAH DvanayaH kalAH maDura-asPuwAH /
        atreti--ayamarthaḥ; rāmo 'haṃ sarvaṃ saha ityatra rāmasya	atra-iti--ayam-arTaH; rAmaH aham sarvam saha iti-atra rAmasya
   sarvaṃsahatvasyāprasiddheḥ; mukhyārthabādhāt rāmasyātyantaduḥ	sarvaMsahatvasya-aprasidDeH; muKya-arTa-bADAt rAmasya-atyanta-duH
   khasahiṣṇutvarūpoviśeṣo lakṣyate /	Ka-sahizNu-tva-rUpaH-viSezaH lakzyate /
        tena phalāt atyantaduḥ khasahiṣṇū rāmo 'smi iti śabdābhidhānālabhyaṃ	tena PalAt atyanta-duH Ka-sahizNuH rAmaH asmi iti Sabda-aBiDAna-AlaByam
   tathābhūtarāmaviśeṣasya evātiśayastanniṣṭameva prayojanamiti /	taTABUtarAma-viSezasya eva-atiSayaH-tat-nizwam-eva prayojanam-iti /
        ********** END OF COMMENTARY **********	********** END OF SOMMENTa-aRY **********
   tadevaṃ lakṣaṇābhedāścatvāriṃśanmatā budhaiḥ // VisSd_2.11 //	tat-evam lakzaNa-aBedAH-catvAriMSat-matA buDEH // VisSd-_2.11 //
   rūḍhāvaṣṭau phale dvātriṃśaditi catvāriśallakṣaṇābhedāḥ /	rUXO=-azwO Pale dvAtriMSat-iti catvAri-Sat-lakzaNa-aBedAH /
   kiñca--	kiQca--
   padavākyagatatvena pratyekaṃ tā api dvidhā /	pada-vAkya-gata-tvena pratyekam tAH api dviDA /
   tā anantaroktāśca tvāriṃśadbhedāḥ /	tAH anantara-uktAH-ca tvAriMSat-BedAH /
   tatra padagatatve yathā--	tatra pada-gata-tve yaTA--
   "gaṅgāyāṃ ghoṣaḥ" /	"gaFgAyAm GozaH" /
   vākyagatatve yathā--	vAkya-gata-tve yaTA--
   "upakṛtaṃ bahu tatra'iti /	"upakRtam bahu tatra-aiti /
   evamaśītiprakārā lakṣaṇā /	evam-aSIti-prakArA lakzaNA /
        ************* COMMENTARY *************	************* SOMMENTa-aRY *************
        Vijñapriyā:	VijQa-priyA:
        (vi, ṭa) phale dvātriṃśaditi--pūrvoktāṣṭavidhaprayojanasya	(vi, wa) Pale dvAtriMSat-iti---pUrva-ukta-azwaviDa-prayojanasya
   gūḍhāgūḍhatvābhyāṃ draiguṇyena ṣoḍaśavidhasya dharmidharmagatatvena	gUXa-agUXa-tvAByAm drEguNyena zoxaSaviDasya Darmi-Darma-gata-tvena
   dvaiguṇyād dvātriṃśadityarthaḥ /	dvEguNyAt dvAtriMSat-iti-arTaH /
        padavākyagatatvena vyaṅgyatvena /	pada-vAkya-gata-tvena vyaFgya-tvena /
        gaṅgāyāmiti--nanvidamapi ghoṣanvayavaśāt vākyameva yadi ca	gaFgAyAm-iti--nanu-idam-api Goza-nvaya-vaSAt vAkyam-eva yadi ca
   vākyasthaikapadasyaiva lākṣaṇikatvāttadvyaṅgyasya padagatatvaṃ tadā	vAkya-sTa-eka-padasya-eva lAkzaNika-tvAt-tat-vyaFgyasya pada-gata-tvam tadA
   upakṛtaṃ bahvityatrāpi na vākyagatatvam /	upakRtam bahu-iti-atra-api na vAkya-gata-tvam /
        upakṛtaṃ bahu tatra kimucyate iti vākyasthasyopakṛtapadasya ekasyaiva	upakRtam bahu tatra kim-ucyate iti vAkya-sTasya-upakRta-padasya ekasya-eva
   lakṣaṇikatvāditi cenna /	lakzaNika-tvAt-iti ced-na /
        vākyagatapadadvayasya lābhaṇikatve tayoḥ padayorvākyatvena	vAkya-gata-pada-dvayasya lABaNika-tve tayoH padayoH-vAkya-tvena
   vākyagatatvāt /	vAkya-gata-tvAt /
        bhavati hi upakṛtamityatra upakṛtamityatra	Bavati hi upakRtam-iti-atra upakRtam-iti-atra
   upakṛtasujanatāpadayorvākyasthayorlākṣaṇikatvam /	upakRta-sujana-tApadayoH-vAkya-sTayoH-lAkzaNika-tvam /
        naca kimucyate ityantasya bhinnavākyatvāt kathaṃ tayorekavākyatvamiti	na-ca kim-ucyate iti-antasya Binna-vAkya-tvAt kaTam tayoH-eka-vAkya-tvam-iti
   vākyam, "kimucyate ataḥ sujanatā prathitā"ityevamekavākyatvāt /	vAkyam, "kim-ucyate atas su-janatA praTitA"-iti-evam-eka-vAkya-tvAt /
        Locanā:	LocanA:
        (lo, ī) tasmāt evamuktaprakāreṇa"upakṛtaṃ bahu tatra"ityatra	(lo, I) tasmAt evam-ukta-prakAreNa-"upakRtam bahu tatra"iti-atra
   bahupadaniṣṭatvābhiprāyeṇa vākyagatatvam /	bahu-pad-a-nizwa-tva-aBiprAyeNa vAkya-gata-tvam /
        evameva hi dhvaniguṇībhūtavyaṅgyadoṣaguṇālaṅkārāṇāṃ vākyaniṣṭatvam	evam-eva hi Dvani-guNIBUta-vyaFgya-doza-guNa-alaFkArANAm vAki-anizwa-tvam
   prācīnālaṅkāragranthaṣvapi prayaśo dṛśyate /	prAcIna-alaFkAra-granTazu-api prayaSaH dRSyate /
        tathāhi kāvyaprakāśakṛto hi nihatārthatve udāharaṇam /	taTA-hi kAvya-prakASa-kRtaH hi nihata-arTa-tve udAharaNam /
        "sāyakasahāyavāhormakaradhvajaniyamitakṣamādhipateḥ /	"sAyaka-sahAya-vAhoH-makara-Dvaja-niyamita-kzamA-aDipateH /
        abjarucibhāsvaraste bhātitarāmavanipaśloka." //	abja-ruci-BAsvaraH-te BAtitarAma-vanipa-Sloka." //
        iti /	iti /
        ********** END OF COMMENTARY **********	********** END OF SOMMENTa-aRY **********
   atha vyañjanā--	aTa vyaQjanA--
   viratāsvabhidhādyāsu yayār'tho bodhyate paraḥ // VisSd_2.12 //	viratAsu-aBiDA-AdyAsu yayAr-aTo boDyate paraH // VisSd-_2.12 //
   sā vṛttirvyañjanā nāma śabdasyārthādikasya ca /	sA vRttiH-vyaQjanAH nAma Sabdasya-arTa-Adikasya ca /
   "śabdabuddhikarmaṇāṃ viramya vyāpārābhāvaḥ" iti	"Sabda-budDi-karmaNAm viramya vyApAra-aBAvaH" iti
   nayenābhidhālakṣaṇātātparyākhyāsu tisṛṣu vṛttiṣu svaṃ svamarthaṃ	nayena-aBiDA-lakzaNa-AtAtparya-AKyAsu tisRzu vRttizu svam svam-arTam
   bodhayitvopakṣīṇāsu yathā aparo 'nyo 'nyor'tho bodhyate sā śabdasyārthasya	boDayitvA-upakzINAsu yaTA aparaH anyaH anyor-aTo boDyate sA Sabdasya-arTasya
   prakṛtipratyayādeśca	prakRti-pratyaya-AdeH-ca
   śaktirvyañjanadhvananagamanapratyāyanādivyapadeśaviṣayā vyañjanā nāma /	SaktiH-vyaQjana-Dvanana-gamana-pratyAyana-Adi-vyapadeSa-vizayA vyaQjanAH nAma /
        ************* COMMENTARY *************	************* SOMMENTa-aRY *************
        Vijñapriyā:	VijQa-priyA:
        (vi, ṭha) vyaṅgyo vyañjanayetyuktatvāt vyañjanālakṣaṇaṃ	(vi, Wa) vyaFgyaH vyaQjanayA-iti-ukta-tvAt vyaQjana-alakzaNam
   vaktumāha---atheti /	vaktum-Aha---aTa-iti /
        nayeneti /	nayena-iti /
        etannyāyāt śabdasyeva tanniṣṭhavṛtterapi viratiḥ siddhyati ityarthaḥ	etat-nyAyAt Sabdasya-iva tad-nizWa-vRtteH-api viratiH sidDi-ati iti-arTaH
        upakṣīṇāsviti /	upakzINAsu-iti /
        arthāntarabodhane kṣīṇasamarthyāsu /	arTa-antara-boDane kzINa-samarTyAsu /
        Locanā:	LocanA:
        (lo, u)--uddeśakamaprāptāṃ vyañjanāṃ nirūpayati--atheti /	(lo, u)--uddeSa-kama-prAptAm vyaQjanAm nirUpayati--aTa-iti /
        parobhidheyādivyatirikto vyaṅgyatvena nirūpayiṣyamāṇo	paroBiDeya-Adi-vyatiriktaH vyaFgya-tvena nirUpayizyamANaH-
   vastvalaṅkārarasalakṣaṇaḥ /	vastu-alaFkAra-rasa-lakzaNaH /
        tisṛṣviti---abhihitānvayavādimatamāśritya anvitābhidhānamate tu	tisRzu-iti----aBihita-anvaya-vAdi-matam-ASritya anvita-aBiDAna-mate tu
   dvayoḥ /	dvayoH /
        tatrāpi lakṣaṇāyā abhāve tu prathamamate tu dvayoḥ dvitīyamate	tatra-api lakzaNAyAH aBAve tu praTama-mate tu dvayoH dvitIya-mate
   tvekasyāḥ /	tu-ekasyAH /
        dhvananādayo vyañjanasya paryāyāntaraṇi /	Dvanana-AdayaH vyaQjanasya paryAya-antaraNi /
        ********** END OF COMMENTARY **********	********** END OF SOMMENTa-aRY **********
   tatra--	tatra--
   abhidhālakṣaṇāmūlā śabdasya vyañjanā dvidhā // VisSd_2.13 //	aBiDA-lakzaNA-mUlA Sabdasya vyaQjanAH dviDA // VisSd-_2.13 //
   abhidhāmūlāmāha--	aBiDA-mUlAm-Aha--
   anekārthasya śabdasya saṃyogādyairniyantrite /	aneka-arTasya Sabdasya saMyoga-AdyEH-niyantrite /
   ekatrārthe 'nyadhīheturvyañjanā sābhidhāśrayā // VisSd_2.14 //	ekatra-arTe anya-DIhetuH-vyaQjanA sa-aBiDa-ASrayAH // VisSd-_2.14 //
   ādiśabdādviprayogādayaḥ /	Adi-SabdAt-viprayoga-AdayaH /
        ************* COMMENTARY *************	************* SOMMENTa-aRY *************
        Vijñapriyā:	VijQa-priyA:
        (vi, ḍa) anekārthasyeti---saṃyogādīn vakṣyati, tairanekārthasya	(vi, xa) aneka-arTasya-iti----saMyoga-AdIn vakzyati, tEH-aneka-arTasya
   śabdasya ekārthe niyantrite arthāntarabodhaṃ pratirudhya bodhite sati	Sabdasya eka-arTe niyantrite arTa-antara-boDam pratiruDya boDite sati
   anyasya pratiruddhārthasya dhiyo heturyā vṛttiḥ sā vyañjanābhidhāśrayā	anyasya pratirudDa-arTasya DiyaH hetuH-yA vRttiH sA vyaQjana-aBiDA-ASrayA
   ityarthaḥ /	iti-arTaH /
        ādyaśabdāditi saṃyogādyairityādyaśabdādityarthaḥ /	Adya-SabdAt-iti saMyoga-AdyEH-iti-Adya-SabdAt-iti-arTaH /
        Locanā:	LocanA:
        (lo, ū) anekārthasya viṣṇusiṃhādyanekābhidheyaśabdasya haryyādeḥ	(lo, U) aneka-arTasya vizNu-siMha-Adi-aneka-aBiDeya-Sabdasya haryyAdeH
   ekārthe niyantrite ityanvayaḥ /	eka-arTe niyantrite iti-anvayaH /
        arthe vācyarūpe niyantrite arthāntaraniruddhaprasaratayā	arTe vAcya-rUpe niyantrite arTa-antara-nirudDa-prasara-tayA
   vyavasthāpite /	vyavasTApite /
        anyasya saṃyogādisācivyābhāvāt abhidhāyā aviṣayasya buddhihetuḥ	anyasya saMyoga-Adi-sAcivya-aBAvAt aBiDAyAH avizayasya budDi-hetuH
   vyañjanā /	vyaQjanAH /
        ********** END OF COMMENTARY **********	********** END OF SOMMENTa-aRY **********
   uktaṃ hi--	uktam hi--
   "saṃyogo viprayogaśca sāhacaryaṃ virodhitā /	"saMyogaH viprayogaH-ca sAhacaryam viroDitA /
   arthaḥ prakāraṇaṃ liṅgaṃśabdasyānyasya saṃnidhiḥ //	arTaH prakAraNam liFgaMSabdasya-anyasya saMniDiH //
   sāmarthyamaucitī deśaḥ kālo vyaktiḥ svarādayaḥ /	sAmarTyam-OcitI deSaH kAlaH vyaktiH svara-AdayaH /
   śabdārthasyānavacchede viśeṣasmṛtihetavaḥ" //	Sabda-arTasya-anavacCede viSeza-smRti-hetavaH" //
   iti /	iti /
        ************* COMMENTARY *************	************* SOMMENTa-aRY *************
        Vijñapriyā:	VijQa-priyA:
        (vi, ḍha) saṃyogaḥ, samabhivyāhṛtāparapadārthasya /	(vi, Xa) saMyogaH, samaBivyAhRta-apara-padArTasya /
        viprayogaḥ---tyāgaḥ, so 'pi tasyaiva /	viprayogaH---tyAgaH, saH api tasya-eva /
        sāhacaryyaṃ-samabhivyāhṛtapadārthena saha sarvadā sthitiḥ virodhitā	sAhacaryI-aM-sam-aBivyAhRta-padArTena saha sarvadA sTitiH viroDitA
   vairitā sāpi tādṛśāparapadārthena saha /	vEri-tA sA-api tAdRSa-apara-padArTena saha /
        arthaḥ prayojanaṃ tacca samabhivyāhṛtam /	arTaH prayojanam tat-ca samaBivyAhRtam /
        prakaraṇamupakramaḥ /	prakaraNam-upakramaH /
        liṅgaṃ cihnaṃ tadapi samabhivyāhṛtam /	liFgam cihnam tat-api samaBivyAhRtam /
        sāmarthyaṃ samabhivāyāhṛtapadārthajanane /	sAmarTyam samaBivAya-AhRta-padArTa-janane /
        aucitī tātparyyam /	OcitI tAtparyyam /
        teśakālāvapi samabhivyāhṛtau /	teSa-kAlO=-api samaBivyAhRtO /
        vyaktiḥ śabdasya puṃstvādiliṅgāni /	vyaktiH Sabdasya puMstva-Adi-liFgAni /
        svaraḥ udāttādiḥ /	svaraH udAtta-AdiH /
        anavacchede 'nekatve /	anavacCede aneka-tve /
        viśeṣasyaikasyaivārthasya smaraṇahetavaḥ saṃyogādaya ityarthaḥ /	viSezasya-ekasya-eva-arTasya smaraNa-hetavaH saMyoga-AdayaH iti-arTaH /
        naiyāyikamate sarveṣāmeva padārthanāṃ smaraṇamanvayabodhastvekameva	nEyAyika-mate sarvezAm-eva padArTanAm smaraNam-anvaya-boDaH-tu-ekam-eva
   padārthamādāya /	padArTam-AdAya /
        etanmate tu yasya padārthasyānvayabodhastasyaiva viśeṣasya	etat-mate tu yasya padArTasya-anvaya-boDaH-tasya-eva viSezasya
   smaraṇamiti /	smaraNam-iti /
        Locanā:	LocanA:
        (lo, ṛ) uktaṃ hi bhartṛhariṇā iti śeṣaḥ /	(lo, R) uktam hi BartR-hariNAH iti SezaH /
        saṃyoga iti /	saMyogaH iti /
        vilodho vadhyaghātakādiḥ /	viloDaH vaDya-GAtaka-AdiH /
        arthaḥ phalam, prakaraṇaṃ prastāvaḥ /	arTaH Palam, prakaraNam prastAvaH /
        liṅgam, viṣayavyāvṛtto dharmaḥ /	liFgam, vizaya-vyAvRttaH DarmaH /
        sannidhiḥ sāmānādhikaraṇyam /	sanniDiH sAmAnADikaraNyam /
        sāmarthyaṃ tat kāraṇaniyamaḥ /	sAmarTyam tat kAraNa-niyamaH /
        deśastad viśeṣaḥ /	deSaH-tat viSezaH /
        kālastadviśeṣaḥ /	kAlaH-tad-viSezaH /
        vyaktiḥ puṃstvādiḥ svarā udāttādayaḥ /	vyaktiH puMstva-AdiH svarAH udAtta-AdayaH /
        anavacchede ekavākyaniyame /	anavacCede eka-vAkya-niyame /
        viśeṣa ekavākyarūpaḥ /	viSezaH eka-vAkya-rUpaH /
        ********** END OF COMMENTARY **********	********** END OF SOMMENTa-aRY **********
   "saśaṅkhcakro hariḥ" iti śaṅkhcakrayogena hariśabdo viṣṇumevābhidhatte /	"sa-SaFKcakraH hariH" iti SaFKcakra-yogena hari-SabdaH vizNum-eva-aBiDatte /
   "aśaṅkhacakro hariḥ" iti tadviyogena tameva /	"a-SaFKa-cakraH hariH" iti tad-viyogena tam-eva /
   "bhīmārjunau" iti arjunaḥ pārthaḥ /	"BIma-arjunO" iti arjunaH pArTaH /
   "karṇārjunau" iti karṇaḥ sūtaputraḥ /	"karNa-arjunO" iti karNaH sUtaputraH /
   "sthāṇuṃ vande" iti sthāṇuḥ śivaḥ /	"sTANum vande" iti sTANuH SivaH /
   "sarvaṃ jānāti devaḥ" iti devo bhavān /	"sarvam jAnAti devaH" iti devaH BavAn /
   "kupito makaradhvajaḥ" iti makaradhvajaḥ kāmaḥ /	"kupitaH makaraDvajaH" iti makaraDvajaH kAmaH /
   "devaḥ purāriḥ" iti purāriḥ śivaḥ /	"devaH purAriH" iti purAriH SivaH /
   "madhunā mattaḥ pikaḥ" iti madhurvasantaḥ /	"maDunA mattaH pikaH" iti maDurvasantaH /
   "yātu vo dayitāmukham" iti mukhaṃ sāṃmukhyam /	"yAtu vaH dayitA-muKam" iti muKam sAMmuKyam /
   "vibhāti gagane candraḥ, iti candraḥ śaśī /	"viBAti gagane candraH, iti candraH SaSI /
   "niśi citrabhānuḥ" iti citrabhānurvāhniḥ /	"niSi citraBAnuH" iti citraBAnuH-vAhniH /
   "bhāti rathāṅgam" rathāṅgam" iti napuṃsakavyaktyā rathāṅgaṃ cakram /	"BAti raTAFgam" raTAFgam" iti napuMsaka-vyaktyA raTAFgam cakram /
   svarastu veda eva viśeṣapratītikṛnna kāvya iti tasya viṣayo nodāhṛtaḥ /	svaraH-tu vedaH eva viSeza-pratIti-kRt-na kAvyaH iti tasya vizayaH na-udAhRtaH /
        ************* COMMENTARY *************	************* SOMMENTa-aRY *************
        Vijñapriyā:	VijQa-priyA:
        (vi, ṇa) tadaviyogeneti---śaṅkhacakratyāgenetyarthaḥ /	(vi, Na) tad-aviyogena-iti----SaFKa-cakra-tyAgena-iti-arTaH /
        naño 'tra tyāgārthakatvāt /	naQaH atra tyAga-arTaka-tvAt /
        bhīmārjunāviti sāhacaryye /	BIma-arjunO=-iti sAhacaryye /
        atra arjunapadaṃ pārthakārttavīryyayoḥ /	atra arjuna-padam pArTakArtta-vIryyayoH /
        bhīmapadaṃ maheśapārthayoranekārtham /	BIma-padam maheSa-pArTayoH-aneka-arTam /
        karṇārjunāviti virodhitāyām /	karNa-arjunO=-iti viroDitAyAm /
        atra dvayamapi padamanekārtham /	atra dvayam-api padam-aneka-arTam /
        prayojane sthāṇumiti /	prayojane sTANum-iti /
        atra rājña upakramo vākyāntarāllabhyaḥ /	atra rAjQaH upakramaH vAkya-antarAt-laByaH /
        cihne-kupita iti kopasya kāmacihnatvāt /	cihne--kupitaH iti kopasya kAma-cihna-tvAt /
        samudro 'pi makaradhvajaḥ /	samudraH api makaraDvajaH /
        naca kāmadevasyāpi kopa iti vācyam, virahiṇyāṃ kupati ityarthāt /	na-ca kAmadevasya-api kopaH iti vAcyam, virahiNyAm kupati iti-arTAt /
        anyaśabdasannidhau sa deva iti--atra devaśabdo 'nekārthaḥ /	anya-Sabda-sanniDO sa devaH iti--atra deva-SabdaH aneka-arTaH /
        tulyavibhāktikapurārātiśabdasya sānnidhyam /	tulya-viBAktika-pura-arAti-Sabdasya sAnniDyam /
        sāmarthye madhuneti---atra madhurdaityaviśeṣe 'pi, kokilamādane	sAmarTye maDunA-iti---atra maDuH-dEtya-viSeze api, kokilam-Adane
   vasantasyaiva sāmarthyam /	vasantasya-eva sAmarTyam /
        aucityāṃ "pātu va'; iti--atra mukhapadaṃ prabhṛtyādāvanekārtham /	OcityAm "pAtu va-a; iti--atra muKa-padam praBRti-AdO=-aneka-arTam /
        māninyāḥ sāmmukhye vaktustātparyyam /	mAninyAH sAmmuKye vaktuH-tAtparyyam /
        deśe bhāvīti--atra candrapadaṃ karpūre 'pi /	deSe BAvi-iti---atra candra-padam karpUre api /
        deśogamanam /	deSaH-gamanam /
        kāle niśīti--citrabhānuḥ sūryyo 'pi /	kAle niSIti---citraBAnuH sUryyaH api /
        vyaktau--rathāṅgamiti, cakravākastu rathāṅgaḥ /	vyaktO--raTAFgam-iti, cakravAkaH-tu raTAFgaH /
        Locanā:	LocanA:
        (lo, ṝ) eṣāṃ niyantraṇasvarūpaṃ	(lo, L) ezAm niyantraNa-svarUpam
   kramādudāharaṇairdarśayati---saśaṅkhetyādi /	kramAt-udAharaNEH-darSayati---sa-SaFKa-ityAdi /
        viṣṇumevetyevakāreṇa śakasiṃhāśvādervyavacchedaḥ /	vizNum-eva-iti-evakAreNa Saka-siMha-aSva-AdeH-vyavacCedaH /
        tayoḥ śaṅvacakrayorviyoge 'bhāve 'pi tameva harimevābhidhatte	tayoH SaFva-cakrayoH-viyoge aBAve api tam-eva harim-eva-aBiDatte
   ityanuṣajyate, pratiṣedhasya prasaktipūrvakatvāt /	iti-anuzajyate, pratizeDasya prasakti-pUrvaka-tvAt /
        pārtho natu vṛkṣaviśeṣaḥ /	pArTaH na-tu vRkza-viSezaH /
        sūtapaputro natu śravaṇam /	sUtapa-putraH na-tu SravaNam /
        atra vadhyaghātako virodhaḥ, sahānavasthāne tu chāyātapāviti /	atra vaDya-GAtakaH viroDaH, saha-anavasTAne tu CAyA-AtapO=-iti /
        sthāṇuśabdasya śaṅkuvācakatve labdhacchedākhyaṃ na ghaṭate /	sTANu-Sabdasya SaFku-vAcaka-tve labDa=-Ceda-AKyam na Gawate /
        bhavān prakṛto rājā /	BavAn prakRtaH rAjA /
        kāmo na tu makarākāro dhvajaḥ, tasya koparūpadharmābhāvāt /	kAmaH na tu makara-AkAraH DvajaH, tasya kopa-rUpa-Darma-aBAvAt /
        śivo na muraripuḥ /	SivaH na muraripuH /
        vasanto na tu madyam /	vasantaH na tu madyam /
        sānnidhyaṃ na tu vadanaṃ, tasya kāmakātaratāyogyatvābhāvāt śaśī na tu	sAnniDyam na tu vadanan, tasya kAma-kAtara-tA-yogya-tva-aBAvAt SaSI na tu
   karpūram /	karpUram /
        vahnirna tu raviḥ /	vahniH-na tu raviH /
        cakaṃ na tu cakravākaḥ /	cakam na tu cakravAkaH /
        veda eva viśeṣapratītikṛt iti anekārthavācakaśabdasya	vedaH eva viSeza-pratIti-kRt iti aneka-arTa-vAcaka-Sabdasya
   ekārthavācakatve niyantraṇarūpaḥ, tatpratyayaṃ ca svaro vede eva karoti /	eka-arTa-vAcaka-tve niyantraNa-rUpaH, tad-pratyayam ca svaraH vede eva karoti /
        yathā indraśatrurityādau ṣaṣṭītatpuruṣe samāsāntodāttasūcite indrasya	yaTA indra-SatruH-iti-AdO zazwI-tatpuruze samAsa-anta-udAtta-sUcite indrasya
   śamīyatā vā daityo 'rirevābhidhīyate /	SamIyatA vA dEtyaH ariH-eva-aBiDIyate /
        bahuvrīhau tu pūrvapadāntodāttanirṇote indra eva śamayitā śātayitā	bahuvrIhO tu pUrva-pada-anta-udAtta-nirNote indraH eva SamayitA SAtayitA
   ceti /	ca-iti /
        idaṃ hi kāvyaprakāśakārasya udāharaṇam /	idam hi kAvya-prakASa-kArasya udAharaNam /
        ********** END OF COMMENTARY **********	********** END OF SOMMENTa-aRY **********
   idaṃ ca ke 'pyasahamānā āhuḥ--	idam ca ke api-asahamAnAH AhuH--
   svaro 'pi kākkādirūpaḥ kāvye viśeṣapratītikṛdeva /	svaraH api kAkka-Adi-rUpaH kAvye viSeza-pratIti-kRt-eva /
   udāttādirūpo 'pi muneḥ pāṭhoktadiśā śṛṅgārādirasaviśeṣapratītikṛdeva" iti	udAtta-Adi-rUpaH api muneH pAWA-ukta-diSA SRFgAra-Adi-rasa-viSeza-pratIti-kRt-eva" iti
   etadviṣaye udāharaṇamucitameva iti, tanna; tathāhi--	etat-vizaye udAharaNam-ucitam-eva iti, tat-na; taTA-hi--
   svarāḥ kākkādayaḥ udāttādayo vā vyaṅgyarūpameva viśeṣaṃ pratyāyanti, na	svarAH kAkka-AdayaH udAtta-AdayaH vA vyaFgya-rUpam-eva viSezam pratyAyanti, na
   khalu prakṛtoktamanekārthaśabdasyaikārthaniyantraṇarūpaṃ viśeṣam /	Kalu prakRta-uktam-aneka-arTa-Sabdasya-eka-arTa-niyantraNa-rUpam viSezam /
        ************* COMMENTARY *************	************* SOMMENTa-aRY *************
        Locanā:	LocanA:
        (lo, ḷ) ke 'pīti--śrīcaṇḍīdāsarāghavānandaprabhṛtayaḥ /	(lo, ?) ke api-iti---SrI-caNxI-dAsa-rAGava-Ananda-praBRtayaH /
        asahamānā iti /	asahamAnAH iti /
        śabdārthasyānavacchede viśeṣasmṛtihetava ityatra	Sabda-arTasya-anavacCede viSeza-smRti-hetavaH iti-atra
   viśeṣapadasyār'thānavabodhane iti śeṣaḥ /	viSeza-padasya-Ar-aTa-anavaboDane iti SezaH /
        āhuḥ--svaro 'pi ityādi ucitamevetyantam /	AhuH--svaraH api ityAdi ucitam-eva-iti-antam /
        tatra kāvyādīnāṃ viśeṣapratītikṛdeva niyantraṇarūpaḥ /	tatra kAvya-AdInAm viSeza-pratIti-kRt-eva niyantraNa-rUpaH /
        udāharaṇaṃ taireva darśitam /	udAharaNam tEH-eva darSitam /
        yathā "mathnāmītyanena kākuvacanena mathnāmyeva iti	yaTA "maTnAmi-iti-anena kAku-vacanena maTnAmi-eva iti
   viśeṣapratītikṛditi /	viSeza-pratIti-kRt-iti /
        muneḥ pāṭhaguṇoktamārgaśca taireva darśito yathā---"yathāha	muneH pAWa-guNa-ukta-mArgaH-ca tEH-eva darSitaH yaTA---"yaTA-Aha
   munirbharataḥ----"hasyaśṛṅgarayoḥ svarītodāttaṃ, vīraraudrādbhuteṣu	muniH-BarataH----"hasya-SRFgarayoH svarIta-udAttaM, vIra-rOdra-adButezu
   udāttakampitaṃ, karuṇabībhaṃtsabhayānakeṣu anudāttakampitam utpādayediti /	udAtta-kampitaM, karuNa-bIBaMtsa-BayAnakezu anudAtta-kampitam utpAdayet-iti /
        tanna, tat teṣāṃ vacanamayuktam, kathamityāha--tathāhīti /	tat-na, tat tezAm vacanam-ayuktam, kaTam-iti-Aha---taTA-ahi-iti /
        vyaṅgyarūpameva bhavaddarśitaṃ, mathnamyevetirūpaṃ śṛṅgārasarūpaṃ ca	vyaFgya-rUpam-eva Bavat-darSitaM, maTnamyeva-iti-rUpam SRFgArasa-rUpam ca
        prakṛtoktaṃ "saṃyogo viprayogaśca'; ityādinā bharttṛhariṇā uktaṃ	prakRta-uktam "saMyogaH viprayogaH-ca-a; ityAdinA BarttR-hariNA uktam
   darśitam /	darSitam /
        anekārthe ityādau arthaśabdo vācyaparaḥ, viśeṣa ityanantaraṃ	aneka-arTe ityAdO arTa-SabdaH vAcya-paraH, viSezaH iti-anantaram
   saṃyogādiprayogāditi śeṣaḥ /	saMyoga-Adi-prayogAt-iti SezaH /
        ********** END OF COMMENTARY **********	********** END OF SOMMENTa-aRY **********
   kiñca yadi yatra kvacidanekārthaśabdānāṃ	kiQca yadi yatra kvacid-aneka-arTa-SabdAnAm
   prakaraṇādiniyamābhāvādaniyantritayorapyarthayoranurūpasvaravaśenaikatra	prakaraNa-Adi-niyama-aBAvAt-aniyantritayoH-api-arTayoH-anurUpa-svara-vaSena-ekatra
   niyamanaṃ vācyaṃ, tadā tathāvidhasthale śleṣānaṅgīkāraprasaṅgaḥ;	niyamanam vAcyaM, tadA taTAviDa-sTale Sleza-anaFgIkAra-prasaFgaH;
        ************* COMMENTARY *************	************* SOMMENTa-aRY *************
        Vijñapriyā:	VijQa-priyA:
        (vi, ta) muneḥ pāṭhoktadiśeti--muninā vedasya svaraviśeṣeṇaiva	(vi, ta) muneH pAWA-ukta-diSA-iti---muninA vedasya svara-viSezeNa-eva
   paṭhanāt /	paWanAt /
        dvayorarthayoranurūpeti--dvayorrthayormadhye	dvayoH-arTayoH-anurUpA-iti---dvayorrTayoH-maDye
   ekasyānurūpasvaravaśenetyarthaḥ /	ekasya-anurUpa-svara-vaSena-iti-arTaH /
        ekoccāraṇe dvayoranurūpasvarāsambhavāt /	eka-uccAraNe dvayoH-anurUpa-svara-asamBavAt /
        tathātve ekatra niyamanāsambhavācca /	taTA-tve ekatra niyamanA-samBavAt-ca /
        tadā tathāvidhasthale śleṣānaṅgīkāraprasaṅga ityarthaḥ /	tadA taTAviDa-sTale Sleza-anaFgIkAra-prasaFgaH iti-arTaH /
        ekārthaniyamane 'nyārthasya vyaṅgyatvena tasyopamānatvāt	eka-arTa-niyamane anya-arTasya vyaFgya-tvena tasya-upamAna-tvAt-
   upamādhvanitvasyaiva prasakternatu śleṣasya /	upamA-aDvani-tvasya-eva prasakteH-na-tu Slezasya /
        yathā vakṣyamāṇe durgālaṅghitavigrahe ityādau	yaTA vakzyamANe durga-alaFGita-vigrahe iti-AdO
   prakaraṇādumāmahādevīvallabhabhānudevarājaniyamane pārvatīvallabhasya	prakaraNAt-umAmahAdevI-vallaBa-BAnu-deva-rAja-niyamane pArvatI-vallaBasya
   vyaṅgyatvena rājñaḥ tadupamādhvanireva /	vyaFgya-tvena rAjQaH tad-upamA-aDvaniH-eva /
        ********** END OF COMMENTARY **********	********** END OF SOMMENTa-aRY **********
   na ca tathā, ata evāhuḥ śleṣanirūpaṇaprastāve--	na ca taTA, atas eva-AhuH Sleza-nirUpaNa-prastAve--
   "kāvyamārge svaro na gaṇyate" itica nayaḥ, ityalamupajīvyānaṃ mānyānāṃ	"kAvya-mArge svaraH na gaNyate" iti-ca nayaH, iti-alam-upajIvyAnam mAnyAnAm
   vyākhyāneṣu kaṭākṣanikṣepeṇa /	vyAKyAnezu kawAkza-nikzepeNa /
   ādiśabdāt "etāvanmātrastanī" ityādau hastādiceṣṭādibhiḥ stanādīnāṃ	Adi-SabdAt "etAvat-mAtra-stanI" ityAdO hasta-Adi-cezwa-AdiBiH stana-AdInAm
   kamalakorakādyākāratvam /	kamala-koraka-Adi-AkAra-tvam /
        ************* COMMENTARY *************	************* SOMMENTa-aRY *************
        Locanā:	LocanA:
        (lo e) evaṃ pracīnoktaṃ dūṣayitvā svayameva pūrvapakṣamutpādya	(laH e) evam pracIna-uktam dUzayitvA svayam-eva pUrva-pakzam-utpAdya
   nirācaṣṭe-kiñceti /	nirAcazwe-kiQcA-iti /
        yatra kvacit---	yatra kvacit---
        "yena dhvastamanobhavena valijitkāyaḥ purā strīkṛto	"yena Dvasta-manoBavena valijit-kAyaH purA strI-kRtaH-
        yaścodvṛttabhujaṅgahāravalayogaṃgāṃ ca yo 'dhārayat /	yaH-ca-udvRtta-BujaFga-hAra-vala-yogaMgAm ca yaH aDArayat /
        yasyāhuḥ śaśimat śiro hara iti stutyaṃ ca nāmāmarāḥ	yasya-AhuH SaSimat SiraH haraH iti stutyam ca nAma-amarAH
        pāyāt sa svayamandhakakṣayakarastvāṃ sarvadomādhavaḥ" //	pAyAt sa svayam-anDaka-kzaya-karaH-tvAm sarva-domADavaH" //
        ityādau dvayorapyarthayorhariharastutiparayoranurūpaḥ svara	ityAdO dvayoH-api-arTayoH-hari-hara-stuti-parayoH-anurUpaH svara
   udāttādirekatra harau hare vā /	udAtta-AdiH-ekatra harO hare vA /
        naca tathā śleṣāṅgīkāraḥ /	na-ca taTA Sleza-aFgIkAraH /
        atrācāryyasammati darśayati--ata evetyādi /	atra-AcAryI-asammati darSayati--ataH eva-ityAdi /
        naye nītyāṃ lokaprasiddhāyām /	naye nItyAm loka-prasidDAyAm /
        teṣāmupajīvyatvaṃ-tadgranthaniṣṭayā svavyutpattyā viśeṣasampādanāt /	tezAm-upajIvya-tvan-tad-granTa-nizwayA sva-vyutpattyA viSeza-sampAdanAt /
        ādiśabdaḥ, kālo vyaktiḥ svaradaya ityatra /	Adi-SabdaH, kAlaH vyaktiH svara-dayaH iti-atra /
        ceṣṭādītyādiśabdena---"itaḥ sa daityaḥ prāptaśrīrneta evārhati	cezwA-Adi-ityAdi-Sabdena---"itaH sa dEtyaH prApta-SrIH-netaH eva-arhati
   kṣayam'; ityādau ātmanirddeśādayaḥ /	kzayam-a; ityAdO Atma-nirddeSa-AdayaH /
        ********** END OF COMMENTARY **********	********** END OF SOMMENTa-aRY **********
   evamekasminnarthe 'bhidhayā niyantrite yā śabdārthasyānyārthabuddhihetuḥ	evam-ekasmin=-arTe aBiDayA niyantrite yA Sabda-arTasya-anya-arTa-budDi-hetuH
   śaktiḥ sābhidhāmūlā vyañjanā /	SaktiH sa-aBiDA-mUlA vyaQjanAH /
        ************* COMMENTARY *************	************* SOMMENTa-aRY *************
        Vijñapriyā:	VijQa-priyA:
        (vi, tha) na ca tatheti--tathātve	(vi, Ta) na ca taTA-iti---taTA-tve
   pṛthukārttasvarapātramityādiśleṣālaṅkārocchedaprasaṅgāditi bhāvaḥ /	pRTuka-Artta-svara-pAtram-iti-Adi-Sleza-alaFkAra-ucCeda-prasaFgAt-iti BAvaH /
        ata evāhuriti kāvyaprakāśakārādaya āhurityarthaḥ /	atas eva-AhuH-iti kAvya-prakASa-kAra-AdayaH AhuH-iti-arTaH /
        upajñīvyānāmiti kāvyamārge 'pi svaragaṇayitṛṇāṃ	upajQIvyAnAm-iti kAvya-mArge api svara-gaNayitRNAm
   prācīnānāmuparītyarthaḥ /	prAcInAnAm-upari-iti-arTaH /
        ādiśabdāditi---svarādaya ityādiśabdādityarthaḥ /	Adi-Sabda-at-iti---svara-AdayaH ityAdi-SabdAt-iti-arTaH /
        hasteti---hastaceṣṭādibhiḥ stanādīnāṃ kamalakorakādyākāratvaṃ	hasta-iti----hasta-cezwA-AdiBiH stana-AdInAm kamala-koraka-Adi-AkAra-tvam
   smāryyata ityarthaḥ /	smAryyate iti-arTaH /
        "eddahamettathiṇiā eddahamettehi ācchivattehi /	"et-dahamet-taTiNiA eddaham-et-tehi AcCivat-tehi /
        eddamettāvatthā eddahamettehiṃ diṃa ehi" //	eddamet-tAvatTAH eddaham-et-tehim diMaH ehi" //
        ityādi prākṛtaślokasya hi--- "etāvanmātrastanikā	ityAdi prAkRta-Slokasya hi-- "etAvat-mAtra-stanikA
   etāvanmātrairakṣipattaiḥ /	etAvat-mAtrEH-akzipat-tEH /
        etāvanmātrāvasthā etāvanmātrairdivasaiḥ'; //	etAvat-mAtrA-avasTA etAvat-mAtrEH-divasEH-a; //
        iti saṃskṛtam /	iti saMskRtam /
        stanādīnāmiti---kamalakorakādityādipadadvayāt cakṣurādīnāṃ	stana-AdInAm-iti----kamala-korakAt-ityAdi-pada-dvayAt cakzuH-AdInAm
   padmapalāśādyākāraparigrahaḥ /	padma-palASa-Adi-AkAra-parigrahaH /
        atra etatpadaṃ nānākārabodhakatvenānekārtham /	atra etat-padam nAnA-AkAra-boDaka-tvena-aneka-arTam /
        ceṣṭāviśeṣastvākāraviśeṣasmārakaḥ /	cezwA-viSezaH-tu-AkAra-viSeza-smArakaH /
        śaktiḥ vṛttiḥ /	SaktiH vRttiH /
        ********** END OF COMMENTARY **********	********** END OF SOMMENTa-aRY **********
   yathā mama tātapādāna	yaTA mama tAta-pAdAna
   mahāpātracaturdaśabhāṣāvilāsinībhujaṅgamahākavīśvaraśrīcandraśekharasaṃdhivigrahikāṇām--	mahApAtra-caturdaSa-BAzA-vilAsinI-BujaFga-mahA-kavi-ISvara-SrI-candra-SeKara-saMDi-vigrahi-kANAm--
   "durgālaṅghitavigraho manasijaṃ saṃmīlayaṃstejasā prodyadrājakalo	"durga-alaFGita-vigrahaH manasijam saMmIlayan=-tejasA prodyat-rAja-kalo
   gṛhītagarimā viṣvagvṛto bhogibhiḥ /	gRhIta-garimA vizvak-vRtaH BogiBiH /
   nakṣatreśakṛ tekṣaṇo girigurau gāḍhāṃ ruciṃ dhārayan gāmākramya	nakzatreSakR tekzaNaH giri-gurO gAXAm rucim DArayan gAm-Akramya
   vibhūtibhūṣitatanū rājatyumāvallabhaḥ" //	viBUti-BUzita-tanuH rAjati-umAvallaBaH" //
   atra prakaraṇonābhidhayā	atra prakaraNa-UnA-aBiDayA
   umāvallabhaśabdasyomānāmnīmahādevīvallabhabhānudevanṛpatirūper'the	umA-vallaBa-Sabdasya-umA-nAmnI-mahAdevI-vallaBa-BAnu-deva-nRpati-rUper-aTe
   niyantrite vyañjanayaiva gaurīvallabharūpor'tho bodhyate /	niyantrite vyaQjanayA-eva gOrI-vallaBa-rUpor-aTo boDyate /
   evamanyat /	evam-anyat /
        ************* COMMENTARY *************	************* SOMMENTa-aRY *************
        Vijñapriyā:	VijQa-priyA:
        (vi, da) durgālaṅghiteti /	(vi, da) durga-alaFGitA-iti /
        atra umā nāma mahādevī tasyā vallabho bhānudevanṛpatiḥ /	atra umA nAma mahAdevI tasyAH vallaBaH BAnu-deva-nRpatiH /
        prākaraṇiko rājati /	prAkaraNikaH rAjati /
        kīdṛśaḥ śatrudurgeṇāvāritayuddhaḥ /	kIdRSaH Satru-durgeNa-avArita-yudDaH /
        tejasā dehakāntyā manasijaṃ sammīlayan sāndairyyagavārta saṅkocayan /	tejasA deha-kAntyA manasijam sammIlayan sAndEryya-gavArta saFkocayan /
        prodyantī rājakalā nṛpaticāturyyaṃ yasya tādṛśaḥ /	prodyantI rAja-kalA nRpati-cAturyyam yasya tAdRSaH /
        garimā, vapuḥ puṣṭiḥ, gṛhītatattvaḥ /	garimA, vapuH puzwiH, gRhIta-tattvaH /
        bhogibhirnāma bhogavadbhiḥ amātyairviṣvak sarvato vṛtaḥ /	BogiBiH-nAma BogavadBiH amAtyEH-vizvac sarvatas vRtaH /
        kṣatraiśeṣu kṣatriyeśvareṣu rājasu avajñayā na kṛtekṣaṇo	kzatra-ESezu kzatriya-ISvarezu rAjasu avajQayA na kRta-IkzaNaH-
   akṛtadṛkpātaḥ /	akRta-dRS-pAtaH /
        gurau mahatyāṃ giri vāci, gāḍhāṃ ruciṃ prītiṃ dhārayan gāmākramya	gurO mahatyAm giri vAci, gAXAm rucim prItim DArayan gAm-Akramya
   pṛthivīmadhikṛtya, vibhūtyā aiśvaryyeṇa bhūṣitatanuḥ /	pRTivIm-aDikRtya, viBUtyA ESvaryyeNa BUzita-tanuH /
        atra durgādipadānyanekārthāni prakaraṇavaśāddarśitārthe niyantrite	atra durga-Adi-padAni-aneka-arTAni prakaraNa-vaSAt-darSita-arTe niyantrite
   vācakāni (śabdāḥ) arthāntaraṃ tu vyañjanayā bodhayanti /	vAcakAni (SabdAH) arTa-antaram tu vyaQjanayA boDayanti /
        tathā hi--umāyāḥ pārvatyā vallabho maheśo rājati /	taTA hi--umAyAH pArvatyAH vallaBaH maheSaH rAjati /
        kīdṛśaḥ--durgayā, pārvatyā, laṅghitavigrahaḥ āśleṣeṇa ākrāntaśarīraḥ	kIdRSaH--durgayA, pArvatyA, laFGita-vigrahaH ASlezeNa AkrAnta-SarIraH
        tejasā netrajyotiṣā, manasijaṃ sammīlayan nighnan /	tejasA netra-jyotizA, manasijam sammIlayan niGnan /
        rājakalā candrakalā, śirasi pradyottatkaḥ gṛhītagarimā	rAjakalA candra-kalA, Sirasi pradya-uttatkaH gRhIta-garimA
   gṛhītajagadgurubhāraḥ /	gRhIta-jagadguru-BAraH /
        bhogibhiḥ sarpaiḥ sarvato vṛtaḥ /	BogiBiH sarpEH sarvatas vRtaH /
        kṣatreśena candreṇa ghaṭitalocanaḥ sūryyacandrāgnimayalocanatvāt /	kzatreSena candreNa Gawita-locanaH sUryya-candra-agni-maya-locana-tvAt /
        girīṇāṃ gurau himālaye gāḍhāṃ ruciṃ dhārayan śvaśuratvāt	girINAm gurO himAlaye gAXAm rucim DArayan SvaSura-tvAt-
   svīyataponilayatvācca /	svIya-tapaH-nilaya-tvAt-ca /
        gāṃ vṛṣam ākramyāruhya rājatītyanvayaḥ /	gAm vRzam Akramya-Aruhya rAjati-iti-anvayaH /
        vibhūtibhirbhasmabhirbhūṣitatanuśca /	viBUtiBiH-BasmaBiH-BUzita-tanuH-ca /
        itthamatrāprākaraṇike maheśe vyañjite prakṛte saṅgamanāya maheśa iva	itTam-atra-aprAkaraNike maheSe vyaQjite prakRte saFgamanAya maheSaH iva
   rājetyupamāvyañjanādupamādhvanirayam /	rAjA-iti-upamA-vyaQjanAt-upamA-aDvanirayam /
        Locanā:	LocanA:
        (lo, ai) durgālaṅghiteti---durgāṇi vanagirijalamayasthānāni durgā	(lo, E) durga-alaFGita-iti-----durgANi vana-giri-jala-maya-sTAnAni durgA
   pārvatī ca, alaṅghito laṅghitaśca, vigraho yuddhaṃ dehaśca, sammīlanaṃ	pArvatI ca, alaFGitaH laFGitaH-ca, vigrahaH yudDam dehaH-ca, sammIlanam
   tiraskāro dahanaṃ ca, tejaḥ kānti. nayanāgniśca /	tiraskAraH dahanam ca, tejaH kAnti. nayana-agniH-ca /
        rājā pārthivaścandraśca /	rAjA pArTivaH-candraH-ca /
        kalā kalanāṃ aṃśaśca, garimā mahimā aiśvaryyaviśeṣaśca /	kalA kalanAm aMSaH-ca, garimA mahimA ESvaryya-viSezaH-ca /
        bhoginaḥ strakcandanādibhogavantaḥ sarpāśca /	BoginaH strakcandana-Adi-BogavantaH sarpAH-ca /
        kṣatreśvareṣu akṛtadṛṣṭiḥ kṣatreśena candreṇa kṛtanayanaśca /	kzatreSvarezu akRta-dRzwiH kzatreSena candreNa kRta-nayanaH-ca /
        gurau mahatyām /	gurO mahatyAm /
        giri vāci /	giri vAci /
        girīṇāṃ gurau, śreṣṭe ca gāṃ pṛthivīṃ vṛṣabhaṃ ca /	girINAm gurO, Srezwe ca gAm pRTivIm vRzaBam ca /
        vibhūtiḥ sampat bhasma ca /	viBUtiH sampad Basma ca /
        umāvallabho bhānudeva īśvaraśca /	umA-vallaBaH BAnudevaH ISvaraH-ca /
        prakaraṇena varṇanīyatvāt /	prakaraNena varNanIya-tvAt /
        iha ca umāvallabhaśabdena yo 'yamaprakṛto maheśvarārthaḥ pratīyate	iha ca umA-vallaBa-Sabdena yaH ayam-aprakRtaH maheSvara-arTaH pratIyate
   tasyāsambaddhatvamāsīditi maheśvarabhānudevayorupamānopameyabhāvaḥ	tasya-asambadDa-tvam-AsIt-iti maheSvara-BAnu-devayoH-upamAna-upameya-BAvaH
   kalpyate /	kalpyate /
        tena umāvallabhaivetyupamādhvaniḥ vyañjanayaiva bodhyate /	tena umA-vallaBA-eva-iti-upamA-DvaniH vyaQjanayA-eva boDyate /
        ityatrai vakārasyāyamāśayaḥ-iha khalūmāvallabhaśabde yeyaṃ	iti-atrE vakArasya-ayam-ASayaH-iha KalUm-AvallaBa-Sabde yA-iyam
   dvitīyārthapratītiḥ tatrābhidhāyā prakṛtārthamātrabodhane viramāt	dvitIya-arTa-pratItiH tatra-aBiDAyA prakRta-arTa-mAtra-boDane viramAt-
   lakṣaṇāyāśca mukhyārthabodhahetukatvāt /	lakzaNAyAH-ca muKya-arTa-boDa-hetuka-tvAt /
        tātparyyasya śaktyabhihitalakṣitasaṃsargamātrabodhananaiyatyāt	tAtparyyasya Sakti-aBihita-lakzita-saMsarga-mAtra-boDana-nEyatyAt
   vyañjanākhyā turīyā vṛttirupāsyaiveti /	vyaQjana-AKyA turIyA vRttiH-upAsya-eva-iti /
        nanvatrāpyarthabhedena śabdabheda iti darśanāt śabdabhedadvayamasti /	nanu-atra-api-arTa-Bedena Sabda-BedaH iti darSanAt Sabda-Beda-dvayam-asti /
        tacca sājātyadaikyabhramahetuḥ /	tat-ca sAjAtya-dEkya-Brama-hetuH /
        ataśca prathamamumāvallabhādiśabdena rājārthabodhanād viratāyāṃ	atas-ca praTamam-umA-vallaBa-Adi-Sabdena rAja-arTa-boDanAt viratAyAm
   prathamābhidhāyāṃ dvitīyaḥ śabdaḥ tanniṣṭābhidhāśaktyā dvitīyārthaṃ	praTama-aBiDAyAm dvitIyaH SabdaH tad-nizwa-aBiDA-SaktyA dvitIya-arTam
   bodhayatu kiṃ vṛttyantarakalpanayā iti cenna /	boDayatu kim vRtti-antara-kalpanayAH iti ced-na /
        atra hi śabdadvayakalpane kathaṃ prakṛtārthasya prathamaṃ	atra hi Sabda-dvaya-kalpane kaTam prakRta-arTasya praTamam
   pratītiranubhūyate, dvayorabhidheyatvena pūrvapaścādbhāvanaiyatyāsambhavāt	pratItiH-anuBUyate, dvayoH-aBiDeya-tvena pUrva-paScAt-BAva-nEyati-a-asamBavAt-
        evaṃ"bhramimaratim"ityādāvapi viṣaśabdasya garalārthatve	evaM"Bramim-aratim-"iti-AdO=-api viza-Sabdasya garala-arTa-tve
   bhujaṅgādipadasācivyāt na panarabhidhāyā ujjīvanaṃ, kintu vyañjanaiva	BujaFga-Adi-padasAcivyAt na panaraBiDAyAH ujjIvanan, kintu vyaQjana-eva
   vyāpāraḥ /	vyApAraH /
        kintvatra dvitīyārthabodhe heturbhujaṅgādirūpaḥ śābdaḥ /	kintu-atra dvitIya-arTa-boDe hetuH-BujaFga-Adi-rUpaH SAbdaH /
        durgālaṅghitetyādāvārthaḥ /	durga-alaFGita-iti-AdA=-a-arTaH /
        "yena dhvastam" ityādau tu niyāmakābhāvāt anekārthaviṣayaḥ	"yena Dvastam" ityAdO tu niyAmaka-aBAvAt aneka-arTa-vizayaH
   sandehaḥ"vyathāṃ dvayeṣāmapi medinībhṛtām"ityādau cobhayābhidhānamapīti	sandehaH"vyaTAm dvayezAm-api medinIBRtAm-"ityAdO ca-uBaya-aBiDAnam-api-iti
   caṇḍīdāsapaṇḍitāḥ /	caNxI-dAsa-paNxitAH /
        etannirākariṣyāmahe śleṣālaṅkāravyākhyānāvasare /	etat-nirAkarizyAmahe Sleza-alaFkAra-vyAKyAna-avasare /
        durgālaṅghitetyādau ca dvitīyārthasyānubhavasiddhasyābhāvaṃ vadato	durga-alaFGita-ityAdO ca dvitIya-arTasya-anuBava-sidDasya-aBAvam vadataH-
   mahimācāryyasya gajanimīlikaiva durvyākhyātṛdurupadeśaparamparayaiva	mahima-AcAryI-asya gaja-nimIlikA-eva durvyAKyAtR-durupadeSa-paramparayA-eva
   dvitīyārthapratyākhyāne vyāsavālmīkiprabhṛtimahākavīnāṃ	dvitIya-arTa-pratyAKyAne vyAsa-vAlmIki-praBRti-mahAkavInAm
   tādṛśakāvyanibandhasya niṣphalatāprasaṅgaḥ /	tAdRSa-kAvya-nibanDasya nizPala-tA-prasaFgaH /
        arthadvayasyāpi pratīyamānatvaviśeṣād vyākhyāviśeṣanigamanāyāṃ	arTa-dvayasya-api pratIyamAna-tva-viSezAt vyAKyA-viSeza-nigamanAyAm
   prāmāṇyābhāvaśca /	prAmANya-aBAvaH-ca /
        kiñca dvitīyārthabodhane dharmikalpanāto varaṃ dharmakalpaneti	kiQca dvitIya-arTa-boDane Darmi-kalpanAtaH varam Darma-kalpanA-iti
   bhinnaśabdakalpanāt bhinnā eva vyañjanākhyā vṛttiraṅgīkarttumucitā ;	Binna-Sabda-kalpanAt BinnA eva vyaQjana-AKyA vRttiH-aFgIkarttum-ucitA ;
   tasyāstu yatra tatra prasare 'tiprasaṅgabhītyā sambandhatvena	tasyAH-tu yatra tatra prasare ati-prasaFga-BItyA sambanDa-tvena
   saivābhidhāśrīyata iti sarvamavadātam /	sA-eva-aBiDA-SrIyate iti sarvam-avadAtam /
        ********** END OF COMMENTARY **********	********** END OF SOMMENTa-aRY **********
   lakṣaṇāmūlāmāha--	lakzaNA-mUlAm-Aha--
   lakṣaṇopāsyate yasya kṛte tattu prayojanam /	lakzaNa-upAsyate yasya kRte tat-tu prayojanam /
   yayā pratyāyyate sā syādvyañjanā lakṣaṇāśrayā // VisSd_2.15 //	yayA pratyAyyate sA syAt-vyaQjanAH lakzaNa-ASrayAH // VisSd-_2.15 //
        ************* COMMENTARY *************	************* SOMMENTa-aRY *************
        Locanā:	LocanA:
        (lo, o) lakṣaṇāmūlāmuddeśakamaprāptāmiti śeṣaḥ /	(lo, o) lakzaNA-mUlAm-uddeSa-kama-prAptAm-iti SezaH /
        upāsyate ādriyate, yasya kṛte yannimittam yathā śabdaśaktyā /	upAsyate Adriyate, yasya kRte yad-nimittam yaTA Sabda-SaktyA /
        ********** END OF COMMENTARY **********	********** END OF SOMMENTa-aRY **********
   "gaṅgāyāṃ ghoṣaḥ" ityādau jalamayādyarthabodhanādabhidhāyāṃ	"gaFgAyAm GozaH" ityAdO jala-maya-Adi-arTa-boDanAt-aBiDAyAm
   taṭādyarthabodhanācca lakṣaṇāyāṃ viratāyāṃ yayā	tawa-Adi-arTa-boDanAt-ca lakzaNAyAm viratAyAm yayA
   śītatvapāvanatvādyatiśayādirbodhyate sā lakṣaṇāmūlā vyañjanā /	SIta-tva-pAvana-tva-Adi-atiSayAdiH-boDyate sA lakzaNA-mUlA vyaQjanAH /
   evaṃ śabdīṃ vyañjanāmu katvārthomāha--	evam SabdIm vyaQjanAmu katva-arTa-umAha--
   vaktṛboddhavyavākyānāmanyasaṃnidhivācyayoḥ /	vaktR-bA-udDavya-vAkyAnAm-anya-saMniDi-vAcyayoH /
   prastāvadeśakālānāṃ kākośceṣṭādikasya ca // VisSd_2.16 //	prastAva-deSa-kAlAnAm kAkoH-cezwA-Adikasya ca // VisSd-_2.16 //
   vyañjaneti sambadhyate /	vyaQjana-iti sambaDyate /
        ************* COMMENTARY *************	************* SOMMENTa-aRY *************
        Vijñapriyā:	VijQa-priyA:
        (vi, dha) yasya kṛte iti /	(vi, Da) yasya kRte iti /
        yatpratīternimittamityarthaḥ /	yat-pratIteH-nimittam-iti-arTaH /
        vaiśiṣṭyāt vailakṣaṇyāt /	vESizwyAt vElakzaNyAt /
        Locanā:	LocanA:
        (lo, au) prakaraṇasaṅgatimāha evamiti--bodhyate yaḥ sa boddhavyaḥ /	(lo, O) prakaraNa-saFgatim-Aha evam-iti--boDyate yaH sa bodDavyaH /
        śabdaprayogasya parārthatvāt, yatsamavetā pratītirupapadyate sa	Sabda-prayogasya para-arTa-tva-at, yat-samavetA pratItiH-upapadyate sa
   ityarthaḥ /	iti-arTaH /
        ucyate śabdena pratipādyate yaḥ sa vācyaḥ /	ucyate Sabdena pratipAdyate yaH sa vAcyaH /
        tena vācya-lakṣya-vyaṅgyātmanastrividhasyārthasya parigrahaḥ /	tena vAcya-lakzya--vyaFgya-AtmanaH-triviDasya-arTasya parigrahaH /
        prastāvaḥ prakaraṇaṃ, kākuḥ dhvanervikāraḥ, vaiśiṣṭyāt	prastAvaH prakaraNaM, kAkuH DvaneH-vikAraH, vESizwyAt-
   vailakṣaṇyāditi vaktrādiṣu pratyekamanvayaḥ /	vElakzaNyAt-iti vaktra-Adizu pratyekam-anvayaH /
        anyaṃ prācīnābhidheyādivailakṣaṇyam /	anyam prAcIna-aBiDeya-Adi-vElakzaNyam /
        ********** END OF COMMENTARY **********	********** END OF SOMMENTa-aRY **********
   tatra vaktṛvākyaprastāvadeśakālavaiśiṣṭye yathā mama--	tatra vaktR-vAkya-prastAva-deSa-kAla-vESizwye yaTA mama--
   "kālo madhuḥ kupita eṣa ca puṣpadhanvā dhīrā vahanti ratikhedaharāḥ	"kAlaH maDuH kupitaH eza ca puzpaDanvA DIrAH vahanti rati-Keda-harAH
   samīrāḥ /	samIrAH /
   kelīvanīyamapi vañjulakuñjamañjur- dūre patiḥ kathaya kiṃ karaṇīyamadya"	kelIvanIyam-api vaQjula-kuQja-maQjur dUre patiH kaTaya kim karaNIya-m-adya"
   atraitaṃ deśaṃ prati śīghraṃ pracchannakāmukastvayā preṣyatāmiti sakhīṃ	atra-etam deSam prati SIGram pracCanna-kAmukaH-tvayA prezya-tAm-iti saKIm
   prati kayācidvyajyate /	prati kayAcid-vyajyate /
        ************* COMMENTARY *************	************* SOMMENTa-aRY *************
        Vijñapriyā:	VijQa-priyA:
        (lo, a) kāla iti /	(lo, a) kAlaH iti /
        eṣa ityanena tatkālānubhūyamānoṃnmādakatvaṃ kāmasya sūcitam /	ezaH iti-anena tad-kAla-anuBUyamAnoMnmAdaka-tvam kAmasya sUcitam /
        patiriti--patirbharttā na tu priyaḥ /	patiH-iti--patiH-BarttA na tu priyaH /
        atra vaktryā madanavihvalatādinā vaiśiṣṭyam, vākyasya	atra vaktryA madana-vihvala-tA-AdinA vESizwyam, vAkyasya
   tathābhūtānubhūyamānavicchittiyuktatvena /	taTABUta-anuBUyamAna-vicCitti-yukta-tvena /
        prastāvasya patidūrasthityādinā; deśasya ca kīḍāvanarūpasya	prastAvasya pati-dUra-sTiti-AdinA; deSasya ca kIxA-vana-rUpasya
   vakulakuñjādinā; kālasya vasantavattvena; evameṣāṃ	vakula-kuQja-AdinA; kAlasya vasantavat-tvena; evam-ezAm
        vaiśiṣṭyena vakroktyā vyaṅgyārthaprakāśanaṃ sphuṭameva /	vESizwyena vakra-uktyA vyaFgya-arTa-prakASanam sPuwam-eva /
        (vi, na) kālo madhuriti--sakhīṃ prati proṣitabharttṛkāyā uktiriyam /	(vi, na) kAlaH maDuriti---saKIm prati prozita-BarttRkAyAH uktiH-iyam /
        spaṣṭor'thaḥ /	spazwoH-aTaH /
        atreti--etaṃ deśaṃ kelīvanīrūpam /	atra-iti--etam deSam kelIvanI-rUpam /
        īdṛśavyaṅgyabodhe kelīvanīrūpasya tatpradarśanena	IdRSa-vyaFgya-boDe kelI-vanI-rUpasya tad-pradarSanena
   karaṇīyājajñāsārthakavākyasya tat vaktryā	karaNIyAjajQA-sA-arTaka-vAkyasya tat vaktryA
   uddīpakapradarśanalabdhaśṛṅgāraprakaraṇasya madhurūpakālasya ca	uddIpaka-pradarSana-labDa-SRFgAra-prakaraNasya maDu-rUpa-kAlasya ca
   vailakṣaṇyaṃ hetuḥ /	vElakzaNyam hetuH /
        Locanā:	LocanA:
        ********** END OF COMMENTARY **********	********** END OF SOMMENTa-aRY **********
   boddhavyavaiśiṣṭye yathā--	bodDavya-vESizwye yaTA--
   "niḥ śeṣacyutacandanaṃ stanataṭaṃ nirmṛṣṭarāgo 'dharo netre dūramanañjane	"niH Seza-cyutacandanam stana-tawam nirmRzwa-rAgaH aDaraH netre dUram-anaQjane
   pulakitā tanvī taveyaṃ tanuḥ /	pulakitA tanvI tava-iyam tanuH /
   mithyāvādini ! dūti ! bāndhavajanasyājñātapīḍāgame vāpīṃ snātumito gatāsi	miTyA-vAdini ! dUti ! bAnDava-janasya-ajQAta-pIxA-game vApIm snAtum-itas gatA-asi
   na punastasyādhamasyāntikam" //	na punar-tasya-aDamasya-antikam" //
        ************* COMMENTARY *************	************* SOMMENTa-aRY *************
        Vijñapriyā:	VijQa-priyA:
        (vi, pa) niḥ śeṣeti--upanāyakamānetuṃ preṣitāṃ yuvatiṃ tenaiva	(vi, pa) niH Seza-iti--upanAyakam-Anetum prezitAm yuvatim tena-eva
   upabhuktāmāgatyāsau matprārthanayāpi nāyāta iti pratārayantīṃ dūtīṃ prati	upaBuktAm-Agatya-asO mad-prArTanayA-api na-AyAtaH iti pratArayantIm dUtIm prati
   nāyikāyāḥ solluṇṭhanoktiriyam /	nAyikAyAH sa-ulluNWana-uktiH-iyam /
        he matprārthanayāpi nāyāta iti mithyāvādini ! dūti ! bāndhavajanasya	he mad-prArTanayA-api na-AyAtaH iti miTyA-vAdini ! dUti ! bAnDava-janasya
   mama ajñātakāmapīḍāgame itaḥ strātuṃ vāpīṃ gatāsi na	mama ajQAta-kAma-pIxA-game itas strAtum vApIm gatA-asi na
   punastasyādhamasyāntikaṃ gatāsi /	punar-tasya-aDamasya-antikam gatA-asi /
        vāpīṃ strātumiti nānvayaḥ, strādhātorakarmakatvāt /	vApIm strAtum-iti na-anvayaH, stra-ADAtora-karmaka-tvAt /
        āpātataḥ strānakāryyāṇi darśayati---niḥ śeṣeti /	ApAtatas strAnakAryyANi darSayati---niH Seza-iti /
        yataste stanataṭaṃ stanapārśvabhāgo niḥ śeṣacyutacandanam /	yatas-te stana-tawam stana-pArSva-BAgaH niH Seza-cyutacandanam /
        adharaśca nirmṛṣṭarāgaḥ /	aDaraH-ca nirmRzwa-rAgaH /
        netre ca dūramatiśayaṃ yathā syāttathānañjane jāte iti śeṣaḥ /	netre ca dUram-atiSayam yaTA syAt-taTA-anaQjane jAte iti SezaH /
        tat kriyāviśeṣaṇaṃ ca dūramiti /	tat kriyA-viSezaNam ca dUram-iti /
        tathā iyaṃ tanvī kṛśā tava tanuḥ pulakitā; strānaśaityāt jātapulakā	taTA iyam tanvI kRSA tava tanuH pulakitA; strAnaSEtyAt jAta-pulakA
   ityarthaḥ /	iti-arTaH /
        tatheti viśeṣaṇasamuccaye /	taTA-iti viSezaNa-samuccaye /
        Locanā:	LocanA:
        ( lo, ā) niḥ śeṣeti--taṭaṃ samīpaṃ, sa ca samaprayo deśaḥ /	( lo, A) niH Seza-iti---tawam samIpaM, sa ca sama-prayaH deSaH /
        tatra candanaṃ niḥ śeṣacyutaṃ; cūcukādiṣu ca śeṣam; adharo	tatra candanam niH Seza-cyutaM; cUcuka-Adizu ca Sezam; aDaraH-
   nirmṛṣṭarāgaḥ; dūrabhanañjane nikaṭe tu sāñjane; añjanasya kvacit	nirmRzwa-rAgaH; dUraBanaQjane nikawe tu sa-aQjane; aQjanasya kvacid-
   kvacidavaśeṣaḥ sūcitaḥ /	kvacid-avaSezaH sUcitaH /
        iyaṃ tanuḥ cirakāle 'pi strāne idānīṃ pulakitā; tanvī kṣāmā ca /	iyam tanuH cira-kAle api strAne idAnIm pulakitA; tanvI kzAmA ca /
        adhamasya prāgapi lakṣitanikṛṣṭaparigrahasya /	aDamasya prAk-api lakzita-nikRzwa-parigrahasya /
        ********** END OF COMMENTARY **********	********** END OF SOMMENTa-aRY **********
   atra tadantikameva rantuṃ gatāsīti viparītalakṣaṇayā lakṣyam /	atra tad-antikam-eva rantum gatA-asi-iti viparIta-lakzaNayA lakzyam /
   tasya ca rantumiti vyaṅgyaṃ pratipādyaṃ dūtīvaiśiṣṭyādbodhyate /	tasya ca rantum-iti vyaFgyam pratipAdyam dUtI-vESizwyAt-boDyate /
        ************* COMMENTARY *************	************* SOMMENTa-aRY *************
        Vijñapriyā:	VijQa-priyA:
        (vi, pha) gatāsi iti lakṣyamiti /	(vi, Pa) gatAsi iti lakzyam-iti /
        candanacyavanādīnāṃ ratikāryyatvenaiva pratītyā tadīntake	candana-cyavana-AdInAm rati-kAryya-tvena-eva pratItyA tadIntake
   'gamanabodhāt, tadviparītaṃ gamanaṃ lakṣaṇayārthaḥ /	agamana-boDAt, tad-viparItam gamanam lakzaNayA-arTaH /
        teṣāṃ ratikāryyatvenaita	tezAm rati-kAryya-tvena-eta
   pratītirhi-candanādhararagayoścyutimārjanābhyāṃ, strāne tvanayoḥ	pratItiH-hi-candana-aDara-ragayoH-cyuti-mArjanAByAM, strAne tu-anayoH
   kṣālanamevoktaṃ syāt /	kzAlanam-eva-uktam syAt /
        tathā dūraṃ cumbanaspṛṣṭaṃ netraprāntabhāgaṃ prāpya anañjane strāne	taTA dUram cumbana-spRzwam netra-prAnta-BAgam prApya anaQjane strAne
   tu samastanetrasyaivānañjanatvamuktaṃ syāt /	tu samasta-netrasya-eva-anaQjana-tvam-uktam syAt /
        tathā candanacyutimahinmā grīṣmakālaprāptau pulakena ca tadānīṃ	taTA candana-cyuti-mahid-mA grIzma-kAla-prAptO pulakena ca tadAnIm
   snānena pulakābhāvāt /	snAnena pulaka-aBAvAt /
        tatā tadantikāgamane tasya doṣābhāvāt adhamatvoktyanaucityam,	tatA tad-antika-Agamane tasya doza-aBAvAt aDamatva-ukti-anOcityam,
   dūtirantṛtvenaivādhamatvopapatteśca /	dUti-H-antR-tvena-eva-aDamatva-upapatteH-ca /
        atra gamanaṃ lakṣaṇayeti yaduktaṃ tat kāvyaprakāśakārasyāsammatam /	atra gamanam lakzaNayA-iti yat-uktam tat kAvya-prakASa-kArasya-asammatam /
        rantuṃ tadantikagamanasyaiva tanmate vyaṅgyatvāt /	rantum tad-antika-gamanasya-eva tad-mate vyaFgya-tvAt /
        tathā hi na gatāsītyasya kāvyatvena tatra lakṣaṇāyā evābhāvāt /	taTA hi na gatA-asi-iti-asya kAvya-tvena tatra lakzaNAyAH eva-aBAvAt /
        taduktaṃ "vākye na śaktirnavā lakṣaṇeti'; padalakṣaṇā tu na	tat-uktam "vAkye na SaktiH-navA lakzaNa-iti-a; pada-lakzaNA tu na
   sambhavatyeva gamanasya gamadhātuvācyatvādeva /	samBavati-eva gamanasya gama-DAtu-vAcya-tvAt-eva /
        nañarthasya tu vāpīgamanānvayenaiva tadupapatteḥ /	naQarTasya tu vApI-gamana-anvayena-eva tad-upapatteH /
        yadi ca vākye 'pi lakṣaṇā svīkriyate tathāpi na lakṣaṇā /	yadi ca vAkye api lakzaNA svIkriyate taTA-api na lakzaNA /
        rantuṃ tadantikasyaiva tanmate prathamaṃ vyaṅgyatvādeva /	rantum tad-antikasya-eva tad-mate praTamam vyaFgya-tvAt-eva /
        tathā hi candanacyavanādīnāṃ prathamaṃ snānakāryyatvenaiva pratītyā	taTA hi candana-cyavana-AdInAm praTamam snAna-kAryya-tvena-eva pratItyE-
   bādhānavatārāt /	bADAnava-tArAt /
        pratisandhānaviśeṣaṇa uttarakālameva bādhāvatārāt /	pratisanDAna-viSezaNaH uttara-kAlam-eva bADa-avatArAt /
        atra ca vyañjanāyāḥ pravṛtternatu lakṣaṇāyā eva /	atra ca vyaQjanAyAH pravRtteH-na-tu lakzaNAyAH eva /
        prathamaṃ bādhāvatāra eva lakṣaṇāyāḥ pravṛtteḥ /	praTamam bADAvatAraH eva lakzaNAyAH pravRtteH /
        taduktam /	tat-uktam /
        "kvacit bādhyatayā khyatiḥ kvacit khyātasya bādhanam /	"kvacid bADya-tayA KyatiH kvacid KyAtasya bADanam /
        pūrvatra lakṣaṇaiva syāduttaratrābhidhaiva tu" //	pUrvatra lakzaNA-eva syAt-uttaratra-aBiDA-eva tu" //
        iti /	iti /
        pūrvatra prathamaṃ bādhyatayā khyātau pratītau abhidhaiva tvityanena	pUrvatra praTamam bADya-tayA KyAtO pratItO aBiDA-eva tu-iti-anena
   tatra lakṣaṇāyā abhāvāt /	tatra lakzaNAyAH aBAvAt /
        taduttaraṃ rantuṃ tadantikagamanaṃ vyañjanaivetyuktam /	tad-uttaram rantum tad-antika-gamanam vyaQjana-eva-iti-uktam /
        atra candanacyutādisattvaṃ boddhavyāyā dūtyā vailakṣaṇyam /	atra candana-cyuta-Adi-sattvam bodDavyAyAH dUtyA vElakzaNyam /
        Locanā:	LocanA:
        (lo, i) eṣāṃ ca padārthānāṃ vāpīsnānaviruddhānāmanusandhānādeva	(lo, i) ezAm ca padArTAnAm vApI-snAna-virudDAnAm-anusanDAnAt-eva
   vāpīsnānābhāvamātrasya prarohābhāvena tadantikaṃ na gatāsītyatra	vApI-snAna-aBAva-mAtrasya praroha-aBAvena tad-antikam na gatAsi-iti-atra
   viparītalakṣaṇayā gatāsīti lakṣyate ntumityataḥ pūrvaṃ tena saheti śeṣaḥ /	viparIta-lakzaNayA gatA-asi-iti lakzyate ntum-iti-atas pUrvam tena saha-iti SezaH /
        ********** END OF COMMENTARY **********	********** END OF SOMMENTa-aRY **********
   anyasaṃnidhivaiśiṣṭye yathā--	anya-saMniDi-vESizwye yaTA--
   "ua ṇiccala ṇippandā, bhisiṇīpattammi rehai balāā /	"ua Niccala NippandA, BisiNI-pattammi rehEH balAA /
   ṇimmalamaragaabhāaṇapariṭṭhiā (dā) saṅkhasutti vva" //	Nimmala-mara-gaa-BAaNa-pariwWiA (dA) saFKa-sutti vva" //
   atra balākāyā nispandatvena viśvastatvam, tenāsya deśasya vijanatvam, ataḥ	atra balAkAyAH nispanda-tvena viSvasta-tvam, tena-asya deSasya vijana-tvam, atas-
   saṃketasthānametaditi kayāpi saṃnihitaṃ pracchannakāmukaṃ pratyucyate /	saMketa-sTAnam-etat-iti kayA-api saMnihitam pracCanna-kAmukam pratyucyate /
   atraiva sthānanirjanatvarūpaṃ vyaṅgyārthavaiśiṣṭyaṃ prayojanam /	atra-eva sTAna-nirjana-tva-rUpam vyaFgya-arTa-vESizwyam prayojanam /
        ************* COMMENTARY *************	************* SOMMENTa-aRY *************
        Vijñapriyā:	VijQa-priyA:
        (vi, ba) saṅketasthānamupanāyake darśayantyā dūtyā uktiriyam--ua iti	(vi, ba) saFketa-sTAnam-upanAyake darSayantyAH dUtyA uktiH-iyam---uaH iti
        jānīhītyarthaḥ paśyeti yāvat /	jAnIhi-iti-arTaH paSya-iti yAvat /
        niścaleti sambodhanam /	niScala-iti samboDanam /
        athavā niścalaniṣpandetyekaṃ vā padam /	aTavA niScala-nizpandA-iti-ekam vA padam /
        tadā niścalādapi niṣpandetyarthaḥ /	tadA niScalAt-api nizpanda-iti-arTaH /
        śaṅkhaśuktiḥ śaccyakapālam /	SaFKa-SuktiH Saccya-kapAlam /
        ucyamānasya nāyakasya sānnidhyāt--saṅketasthalapradarśanaṃ	ucyamAnasya nAyakasya sAnniDyAt---saFketa-sTala-pradarSanam
   sāmājikairvyañjanayāvagamyate ityarthaḥ /	sAmAjikEH-vyaQjanayA-avagamyate iti-arTaH /
        tathā ca dyotyata ityatra dyotanaṃ sāmājikairvyañjanayā budhyata iti	taTA ca dyotyate iti-atra dyotanam sAmAjikEH-vyaQjanayA buDyate iti
   śeṣaḥ /	SezaH /
        nāyakena tu balākāpradarśanarūpāt vaktryā vailakṣaṇyāt saṅketasthalaṃ	nAyakena tu balAkA-pradarSana-rUpAt vaktryA vElakzaNyAt saFketa-sTalam
   vyañjanayā budhyate /	vyaQjanayA buDyate /
        Locanā:	LocanA:
        (lo, ī) usa ṇicceti---	(lo, I) usa Nit-ca-iti---
        paśya niścalaniṣpandā bisinīpatre rājate balākā /	paSya niScala-nizpandA bisinI-patre rAjate balAkAH /
        nirmalamarakatabhājanapratiṣṭitā śaṅkhasuktiriva //	nirmalamarakata-BAjana-pratizwitA SaFKa-suktiH-iva //
        niścaleti---nirudyameti viṭasambodhanam /	niScala-iti----nirudyamA-iti viwa-samboDanam /
        śaṅkhaśuktiḥ saṃkhapātrī /	SaFKa-SuktiH saMKapAtrI /
        ********** END OF COMMENTARY **********	********** END OF SOMMENTa-aRY **********
   bhinnakaṇṭhadhvanirdhoraiḥ kākurityabhidhīyate /	Binna-kaNWa-DvaniH-DorEH kAkuH-iti-aBiDIyate /
   ityuktaprakārāyāḥ kākorbhedā ākarebhyo jñātavyāḥ /	iti-ukta-prakArAyAH kAkoH-BedAH AkareByaH jQAtavyAH /
        ************* COMMENTARY *************	************* SOMMENTa-aRY *************
        Locanā:	LocanA:
        (lo, u) bhinneti--bhedāḥ tattatsahakāribhedāḥ svarūpabhedāntāḥ /	(lo, u) Binna-iti--BedAH tad-tad-sahakAri-BedAH svarUpa-Beda-antAH /
        ********** END OF COMMENTARY **********	********** END OF SOMMENTa-aRY **********
   etadvaiśiṣṭye yathā--	etad-vESizwye yaTA--
   "guruparatantratayā bata dūrataraṃ deśamudyato gantum /	"guru-paratantra-tayA bata dUrataram deSam-udyataH gantum /
   alikulakokilalalite naiṣyati sakhi ! surabhisamaye 'sau" //	ali-kula-kokila-lalite na-ezyati saKi ! suraBi-samaye asO" //
   atra naiṣyati, api tarhi eṣyatyeveti kākkā vyajyate--	atra na-ezyati, api tarhi ezyati-eva-iti kAkkA vyajyate--
        ************* COMMENTARY *************	************* SOMMENTa-aRY *************
        Vijñapriyā:	VijQa-priyA:
        (vi, bha) ākarebhya	(vi, Ba) AkareBya
   iti---bhinnakaṇṭhadhvanirityādikākuvivecakagrantha ākaraḥ /	iti---Binna-kaNWa-DvaniH-iti-AdikAku-vivecaka-granTaH AkaraH /
        svābhāvikakaṇṭhadhvanito bhinnaḥ kaṇṭhadhvanirityarthaḥ /	svABAvika-kaNWa-DvanitaH BinnaH kaNWa-DvaniH-iti-arTaH /
        guruparatantratayeti--dūrataradeśagataṃ patiṃ śocayantyā nāyikāyā	guru-paratantra-tayA-iti--dUratara-deSa-gatam patim SocayantyA nAyikAyAH-
   uktiḥ prathamārddham /	uktiH praTama-ardDam /
        tāmāśvāsayantyāḥ sakhyā uktiḥ parārddham /	tAm-ASvAsayantyAH saKyA uktiH parArdDam /
        naiṣyatīti---api tveṣyatyevetyarthaḥ kākkā vyajyate iti--kākkāḥ paraṃ	nEzyati-iti----api tu-ezyati-eva-iti-arTaH kAkkA vyajyate iti--kAkkAH param
   nañarthopasthāpanānna eṣyati eṣyatyevetyevaṃrūpaḥ /	naQarTa-upasTApanAt-naH ezyati ezyati-eva-iti-evaMrUpaH /
        atra śiraścālanasahotpannatvaṃ kākorvailakṣaṇyam /	atra SiraH-cAlana-saha-utpanna-tvam kAkoH-vElakzaNyam /
        ********** END OF COMMENTARY **********	********** END OF SOMMENTa-aRY **********
   ceṣṭāvaiśiṣṭye yathā--	cezwA-vESizwye yaTA--
   "saṃketakālamanasaṃ viṭaṃ jñātvā vidagdhayā /	"saMketa-kAla-manasam viwam jQAtvA vidagDayA /
   hasannetrārpitākūtaṃ līlāpaṅmaṃ nimīlitam" //	hasannetra-arpita-AkUtam lIlA-paFmam nimIlitam" //
        ************* COMMENTARY *************	************* SOMMENTa-aRY *************
        Locanā:	LocanA:
        (lo, ū) saṅketeti--hasatā vikaśatā netreṇa arpitamākūtamabhiprayoyena	(lo, U) saFketa-iti---hasatA vikaSatA netreNa arpitam-AkUtam-aBiprayoyena
   iti viṭaviśeṣaṇam /	iti viwa-viSezaNam /
        eṣāṃ coktodāharaṇānāṃ dhvaniguṇībhūta-vyaṅgyatve tānnirūpaṇe	ezAm ca-ukta-udAharaNAnAm Dvani-guNIBUta-vyaFgya-tve tAn-nirUpaNe
   agresphuṭībhaviṣyati, kintu vyañjanāyā ārthatvamātreṇodāharaṇam /	agresPuwI-Bavizyati, kintu vyaQjanAyAH ArTa-tva-mAtreNa-udAharaNam /
        ceṣṭādītyādiśabdena vararṇanīyanāyakādigatasāttvikādiparigrahaḥ /	cezwA-Adi-ityAdi-Sabdena vararNanIya-nAyaka-Adi-gata-sAttvika-Adi-parigrahaH /
        ********** END OF COMMENTARY **********	********** END OF SOMMENTa-aRY **********
   atra saṃdhyā saṃketakāla iti paṅmanimīlanādiceṣṭayā kayāciddyotyate /	atra saMDyA saMketa-kAle iti paFma-nimIlana-Adi-cezwayA kayAcid-dyotyate /
        ************* COMMENTARY *************	************* SOMMENTa-aRY *************
        Vijñapriyā:	VijQa-priyA:
        (vi, ma) saṃketakāleti---viṭaṃ dhūrttam upanāyakaṃ saṃketakālamanasaṃ	(vi, ma) saMketa-kAla-iti----viwam DUrttam upanAyakam saMketa-kAla-manasam
   tajjijñāsārthaṃ tanmanaskaṃ jñātvetyarthaḥ /	tad-jijQAsA-arTam tat-manaskam jQAtvA-iti-arTaH /
        hasatā netreṇārpitaṃ sthāpitam ākūtaṃ bhāvo yatra tādṛśaṃ yathā	hasatA netreNa-arpitam sTApitam AkUtam BAvaH yatra tAdRSam yaTA
   syāttathā līlāpadmaṃ nimīlitamityarthaḥ /	syAt-taTA lIlA-padmam nimIlitam-iti-arTaH /
        dyotyata iti viṭaṃ pratītyarthaḥ /	dyotyate iti viwam prati-iti-arTaH /
        sāmājikaistu taddyotanamapi budhyate iti bodhyam //	sAmAjikEH-tu tat-dyotanam-api buDyate iti boDyam //
        ********** END OF COMMENTARY **********	********** END OF SOMMENTa-aRY **********
   evaṃ vaktrādīnāṃ vyastasamastānāṃ vaiśiṣṭye boddhavyam /	evam vaktra-AdInAm vyasta-samastAnAm vESizwye bodDavyam /
   traividhyādiyamarthānāṃ pratyekaṃ trividhā matā // VisSd_2.17 //	trEviDyAdiyam-arTAnAm pratyekam triviDA matA // VisSd-_2.17 //
   "arthānāṃ vācyalakṣyavyaṅgyatvena trirūpatayā sarvā apyanantaroktā	"arTAnAm vAcya-lakzya-vyaFgya-tvena tri-rUpa-tayA sarvAH api-anantara-uktA
   vyañjanāstrividhāḥ /	vyaQjanAH-triviDAH /
   tatra vācyārthasya vyañjanā yathā-"kālo madhuḥ-" ityādi /	tatra vAcya-arTasya vyaQjanAH yaTA-"kAlaH maDuH-" ityAdi /
   lakṣyārthasya yathā--"niḥ śeṣacyutacandanam'--ityādi /	lakzya-arTasya yaTA--"niH Seza-cyutacandanam-a--ityAdi /
   vyaṅgyārthasya yathā--"ua ṇiccala-" ityādi /	vyaFgya-arTasya yaTA--"ua Niccala-" ityAdi /
   prakṛtipratyayādivyañjakatvaṃ tu prapañcayiṣyate /	prakRti-pratyaya-Adi-vyaQjaka-tvam tu prapaQcayizyate /
   śabdabodhyo vyanaktyarthaḥ śabdo 'pyarthāntarāśrayaḥ /	Sabda-boDyaH vyanakti-arTaH SabdaH api-arTa-antara-ASrayaH /
   ekasya vyañjakatve tadanyasya sahakāritā // VisSd_2.18 //	ekasya vyaQjaka-tve tad-anyasya saha-kAritAH // VisSd-_2.18 //
        ************* COMMENTARY *************	************* SOMMENTa-aRY *************
        Locanā:	LocanA:
        (lo, ṛ) śabdabodhya ityarthāntaramapekṣate,	(lo, R) Sabda-boDyaH iti-arTa-antaram-apekzate,
   natvekārthamātrapratipādako vyañjakaḥ yathā--durgālaṅghitetyādau /	na-tu-eka-arTa-mAtra-pratipAdakaH vyaQjakaH yaTA--durga-alaFGita-ityAdO /
        artho 'pi śabdamapekṣate yathā kālo madhurityādau /	arTaH api Sabdam-apekzate yaTA kAlaH maDuH-iti-AdO /
        ekasyetyāderayamarthaḥ /	ekasya-ityAdeH-ayam-arTaH /
        śabdārthayorekasya vyañjakatve taditaraḥ sahakārī satu	Sabda-arTayoH-ekasya vyaQjaka-tve tad-itaraH sahakArI satu
   avarjanīyasānnidhimātreṇāvasthitaḥ /	avarjanIyasAnniDi-mAtreNa-avasTitaH /
        kintu yatra yacchaktirutkaṭā tatra tanmūlo vyañjakatvavyapadeśaḥ /	kintu yatra yad-SaktiH-utkawA tatra tad-mUlaH vyaQjaka-tva-vyapadeSaH /
        ********** END OF COMMENTARY **********	********** END OF SOMMENTa-aRY **********
   yataḥ śabdo vyañjakatve 'pyarthāntaramapekṣate, artho 'pi śabdam,	yatas SabdaH vyaQjaka-tve api-arTa-antaram-apekzate, arTaH api Sabdam,
   tadekasya vyañjakatve 'nyasya sahakāritāvaśyamaṅgīkartavyā /	tat-ekasya vyaQjaka-tve anyasya saha-kArita-avaSyam-aFgIkartavyA /
   abhidhāditrayopādhivaiśiṣṭyātrtrividho mataḥ /	aBiDAdi-trayA-upADi-vESizwyAt-rtriviDaH mataH /
   śabdo 'pi vācakastadvallakṣako vyañjakastathā // VisSd_2.19 //	SabdaH api vAcakaH-tadvat-lakzakaH vyaQjakaH-taTA // VisSd-_2.19 //
        ************* COMMENTARY *************	************* SOMMENTa-aRY *************
        Vijñapriyā:	VijQa-priyA:
        (vi, ya) vaktṛboddhavyādidaśavaiśiṣṭyāt yār'tho vyañjanoktā, sā	(vi, ya) vaktR-bA-udDavyAdi-daSa-vESizwyAt yAr-aTo vyaQjana-uktA, sA
   vyañjakārthatrauvidhyāt trividhetyāha--arthānāṃ vyañjakārthānām /	vyaQjaka-arTa-trOviDyAt triviDA-iti-Aha--arTAnAm vyaQjaka-arTAnAm /
        iyaṃ daśavidhā vyañjanā /	iyam daSaviDAH vyaQjanAH /
        niḥ śeṣetyādau lakṣyārthasya vyañjakatvaṃ svamatābhiprāyeṇaivoktam /	niH Seza-ityAdO lakzya-arTasya vyaQjaka-tvam sva-mata-aBiprAyeNa-eva-uktam /
        uktaśabdārthavyañjakārthatraividhyasyaivoktatvāt idānīṃ	ukta-Sabda-arTa-vyaQjaka-arTa-trEviDyasya-eva-ukta-tvAt idAnIm
   vyañjakaśabdasyāpi traividhyamāha--abhidhāditrayeti /	vyaQjaka-Sabdasya-api trEviDyam-Aha--aBiDa-Adi-traya-iti /
        ********** END OF COMMENTARY **********	********** END OF SOMMENTa-aRY **********
   abhidhopādhiko vācakaḥ /	aBiDopa-aDikaH vAcakaH /
   lakṣaṇopādhiko lakṣakaḥ /	lakzaNa-upADikaH lakzakaH /
   vyañjanopādhiko vyayañjakaḥ /	vyaQjana-upADikaH vyayaQjakaH /
   kiñca--	kiQca--
   tātparyākhyāṃ vṛttimāhuḥ padārthānvayabodhane /	tAtparyAKyAm vRttim-AhuH padArTa-anvaya-boDane /
   tātparyārthaṃ tadarthaṃ ca vākyaṃ tadvodhakaṃ pare // VisSd_2.20 //	tAtparya-arTam tad-arTam ca vAkyam tat-voDakam pare // VisSd-_2.20 //
        ************* COMMENTARY *************	************* SOMMENTa-aRY *************
        Vijñapriyā:	VijQa-priyA:
        (vi, ra) na kevalaṃ vācyāditrividha eva śabdasyārtho 'pi tu	(vi, ra) na kevalam vAcyAdi-triviDaH eva Sabdasya-arTaH api tu
   vācyāditrayabhinnaḥ padārthasaṃsargo 'pi śabdārthastadbodhakaṃ ca	vAci-Adi-traya-BinnaH padArTa-saMsargaH api Sabda-arTaH-tat-boDakam ca
   vākyamityāha--kiṃ cetyādinā /	vAkyam-iti-Aha--kim ca-ityAdinA /
        padārthānvayabodhane tadanvayabodhanimittam /	padArTa-anvaya-boDane tad-anvaya-boDa-nimittam /
        pare naiyāyikāstātparyyākhyāṃ vṛttimāhuḥ /	pare nEyAyikAH-tAtparyyA-AKyAm vRttim-AhuH /
        tadarthaṃ tasyā vṛtterviṣayarūpamarthaṃ tātparyyārthaṃ saṃsargarūpaṃ	tad-arTam tasyAH vRtteH-vizaya-rUpam-arTam tAtparyya-arTam saMsarga-rUpam
   tadvodhakaṃ ca vākyamityāhuḥ /	tad-voDakam ca vAkyam-iti-AhuH /
        ********** END OF COMMENTARY **********	********** END OF SOMMENTa-aRY **********
   abhidhāyā ekaikapadārthabodhanavirāmādvākyārtharūpasya padārthānvayasya	aBiDAyE ekEka-padArTa-boDana-virAmAt-vAkya-arTa-rUpasya padArTa-anvayasya
   bodhikā tātpaya nāma vṛttiḥ /	boDikA tAtpaya nAma vRttiH /
   tadarthaśca tātparyārthaḥ /	tad-arTaH-ca tAtparya-arTaH /
   tadvodhakaṃ ca vākyamityabhihitānvayavādināṃ matam /	tad-voDakam ca vAkyam-iti-aBihita-anvaya-vAdinAm matam /
        ************* COMMENTARY *************	************* SOMMENTa-aRY *************
        Vijñapriyā:	VijQa-priyA:
        (vi, la) abhidhāyāḥ saṃsargabodhane 'sāmarthyaṃ darśayan	(vi, la) aBiDAyAH saMsarga-boDane asAmarTyam darSayan
   vyācaṣṭe--abhidhāyā iti /	vyAcazwe--aBiDAyAH iti /
        tadarthaśceti saṃsargarūpa ityarthaḥ /	tad-arTaH-ca-iti saMsarga-rUpaH iti-arTaH /
        abhihitānvayavādināṃ naiyāyikānāṃ padena padārthe 'bhihite smārite	aBihita-anvaya-va-AdinAm nEyAyikAnAm padena padArTe aBihite smArite
   tadanvayabodho vākyādeva //	tad-anvaya-boDaH vAkyAt-eva //
        iti /	iti /
        iti śrīsāhityadarpaṇaṭīkāyāṃ dvitīyaparicchedavivaraṇam	iti SrI-sAhitya-darpaNa-wIkAyAm dvitIya-paricCeda-vivaraNam
        ********** END OF COMMENTARY **********	********** END OF SOMMENTa-aRY **********
   ihi sāhityārpaṇo vākyasvarūpanirūpaṇo nāma dvitīyaḥ paricchedaḥ /	ihi sAhitya-arpaNaH vAkyasvarUpanirUpaNaH nAma dvitIyaH paricCedaH /
