   PADA MARKERS	PADAH MARKERS
   For a four-pada verse:	FoH a fouH--pada verse:
   For a six-pada verse:	FoH a six-pada verse:
   adhyāya 1	aDyAya 1
   athāto yamadharmasya $ prāyaścittaṃ vyākhyāsyāmaḥ &	aTa-atas yama-Darmasya $ prAyaScittam vyAKyAsyAmaH &
   caturṇām api varṇānāṃ % prāyaścittaṃ prakalpayet // YS182v_1.1 //	caturNAm api varNAnAm % prAyaScittam prakalpayet // YS182u-_1.1 //
   brāhmaṇas tu śunā daṣṭo $ jambūkena vṛkeṇa vā &	brAhmaNaH tu SunA dazwaH $ jambUkena vRkeNa vA &
   udite grahanakṣatre % dṛṣṭvā sadyaḥ śucir bhavet // YS182v_1.2 //	udite graha-nakzatre % dRzwvA sadyas SuciH Bavet // YS182u-_1.2 //
   jalāgnibandhanabhraṣṭāḥ $ pravrajyānāśakacyutāḥ &	jala-agni-banDana-BrazwAH $ pravrajyA-anASaka-cyutAH &
   viṣaprapannagātrāś ca % śastrāghātahatāś ca ye // YS182v_1.3 //	viza-prapanna-gAtrAH ca % Sastra-AGAta-hatAH ca ye // YS182u-_1.3 //
   navaite pratyavasitāḥ $ sarvadharmabahiṣkṛtāḥ &	navA-ete pratyavasitAH $ sarva-Darma-bahizkRtAH &
   cāndrāyaṇena śudhyanti % taptakṛcchradvayena ca // YS182v_1.4 //	cAndrAyaNena SuDyanti % taptakRcCra-dvayena ca // YS182u-_1.4 //
   ubhayāvasitāḥ pāpā $ ye śāmaśabalācyutāḥ &	uBaya-a=-asitAH pApAH $ ye SAmaSa-bala-acyutAH &
   indudvayena śudhyanti % dattvā dhenuṃ tathā vṛṣam // YS182v_1.5 //	indu-dvayena SuDyanti % dattvA Denum taTA vRzam // YS182u-_1.5 //
   gobrāhmaṇahataṃ dagdhaṃ $ mṛtam udbandhanena tu &	go-brAhmaNa-hatam dagDam $ mRtam udbanDanena tu &
   pāśaṃ chittvā tatas tasya % taptakṛcchradvayaṃ caret // YS182v_1.6 //	pASam CittvA tatas tasya % taptakRcCra-dvayam caret // YS182u-_1.6 //
   kṛmibhir brahmasaṃyuktaṃ $ makṣikaiś copaghātitam &	kRmiBiH brahma-saMyuktam $ makzikEH ca-upaGAtitam &
   kṛcchrārdhaṃ saṃprakurvīta % śaktyā dadyāt tu dakṣiṇām // YS182v_1.7 //	kRcCra-arDam saMprakurvIta % SaktyA dadyAt tu dakziNAm // YS182u-_1.7 //
   cāṇḍālabhāṇḍasaṃspṛṣṭaṃ $ pītvā bhūmigataṃ jalam &	cANxAla-BANxa-saMspRzwam $ pItvA BUmi-gatam jalam &
   gomūtrayāvakāhāraḥ % ṣaḍrātreṇa viśudhyati // YS182v_1.8 //	go-mUtra-yAvaka-AhAraH % zaz-rAtreNa viSuDyati // YS182u-_1.8 //
   cāṇḍālaghaṭabhāṇḍasthaṃ $ yas toyaṃ pibati dvijaḥ &	cANxAla-Gawa-BANxa-sTam $ yaH toyam pibati dvijaH &
   tatkṣanāt kṣipate yas tu % prājāpatyena śudhyati // YS182v_1.9 //	tad-kzanAt kzipate yaH tu % prAjApatyena SuDyati // YS182u-_1.9 //
   yadi na kṣipate toyaṃ $ śarīre yasya jīryati &	yadi na kzipate toyam $ SarIre yasya jIryati &
   prājāpatyaṃ na dātavyaṃ % kṛcchraṃ sāṃtapanādikam // YS182v_1.10 //	prAjApatyam na dAtavyam % kRcCram sAMtapana-Adikam // YS182u-_1.10 //
   caret sāṃtapanaṃ vipraḥ $ prājāpatyaṃ tu kṣattriyaḥ &	caret sAMtapanam vipraH $ prAjApatyam tu kzattriyaH &
   tadardhaṃ tu cared vaiśyaḥ % pādaṃ śūdrasya dāpayet // YS182v_1.11 //	tad-arDam tu caret vESyaH % pAdam SUdrasya dApayet // YS182u-_1.11 //
   cāṇḍālānnaṃ bhakṣayitvā $ tadvat salilam eva ca &	cANxAla-annam BakzayitvA $ tadvat salilam eva ca &
   māsaṃ kṛcchraṃ cared vipraś % cāndrāyaṇam athāpi vā // YS182v_1.12 //	mAsam kRcCram caret vipraH % cAndrAyaNam aTa-api vA // YS182u-_1.12 //
   gomūtraṃ gomayaṃ kṣīraṃ $ dadhi sarpiḥ kuśodakam &	go-mUtram gomayam kzIram $ daDi sarpiH kuSa-udakam &
   ekarātropavāsaś ca % kṛcchraṃ sāṃtapanaṃ smṛtam // YS182v_1.13 //	eka-rAtra-upavAsaH ca % kRcCram sAMtapanam smRtam // YS182u-_1.13 //
   cāṇḍālamūrtikā ye ca $ ye ca saṃkīrṇayonayaḥ &	cANxAla-mUrtikAH ye ca $ ye ca saMkIrNa-yonayaH &
   teṣāṃ dattvā ca bhuktvā ca % taptakṛcchraṃ samācaret // YS182v_1.14 //	tezAm dattvA ca BuktvA ca % taptakRcCram samAcaret // YS182u-_1.14 //
   cāṇḍālikāsu nārīṣu $ dvijo maithunakārakaḥ &	cANxAlikAsu nArIzu $ dvijaH mETuna-kArakaH &
   kṛtvā 'ghamarṣaṇaṃ pakṣaṃ % śudhyate ca payovratāt // YS182v_1.15 //	kRtvA aGamarzaNam pakzam % SuDyate ca payaH-vratAt // YS182u-_1.15 //
   iti śrīyāmye dharmaśāstre prathamo dhyāyaḥ ||	iti SrIyAmye Darma-SAstre praTamaH DyAyaH ||
   adhyāya 2	aDyAya 2
   naṭāṃ [ṭīṃ] śailūṣikāṃ caiva $ rajakīṃ veṇujīvinīm &	nawAm [wIM] SElUzikAm ca-eva $ rajakIm veNu-jIvinIm &
   gatvā cāndrāyaṇaṃ kuryāt % tathā carmopajīvinīm // YS182v_2.1 //	gatvA cAndrAyaNam kuryAt % taTA carma-upajIvinIm // YS182u-_2.1 //
   kāpālikānnabhoktṝṇāṃ $ tanayāgāmināṃ tathā &	kApAlika-anna-BoktLNAm $ tanaya-AgAminAm taTA &
   ajñānāt kṛcchram uddiṣṭaṃ % jñātvā caiva vratadvayam // YS182v_2.2 //	ajQAnAt kRcCram uddizwam % jQAtvA ca-eva vrata-dvayam // YS182u-_2.2 //
   surāyāḥ saṃprapānena $ gomāṃsabhakṣaṇe kṛte &	surAyAH saMprapAnena $ go-mAMsa-BakzaNe kRte &
   taptakṛcchraṃ cared vipro % mauñjīhomena śudhyati // YS182v_2.3 //	taptakRcCram caret vipraH % mOQjIhomena SuDyati // YS182u-_2.3 //
   gokṣattriyaṃ tathā vaiśyaṃ $ śūdraṃ cāpy anulomajam &	gokzattriyam taTA vESyam $ SUdram ca-api anuloma-jam &
   jñātvā viśeṣeṇa tataś % carec cāndrāyaṇaṃ vratam // YS182v_2.4 //	jQAtvA viSezeNa tatas % caret cAndrAyaNam vratam // YS182u-_2.4 //
   kukkuṭāṇḍakamātraṃ tu $ grāsaṃ ca parikalpayet &	kukkuwa-aNxaka-mAtram tu $ grAsam ca parikalpayet &
   anyathābhāvadoṣeṇa % navame 'ti ca śudhyahni // YS182v_2.5 //	anyaTA-BAva-dozeNa % navame ati ca SuDi-ahni // YS182u-_2.5 //
   ekaikaṃ vardhayed grāsaṃ $ śukle kṛṣṇe ca hrāsayet &	ekEkam varDayet grAsam $ Sukle kRzNe ca hrAsayet &
   amāyāṃ tu na bhuñjīta % eṣa cāndrāyaṇo vidhiḥ // YS182v_2.6 //	amAyAm tu na BuQjIta % eza cAndrAyaNaH viDiH // YS182u-_2.6 //
   prāyaścittam upakramya $ kartā yadi vipadyate &	prAyaScittam upakramya $ kartA yadi vipadyate &
   pūtas tad ahared vāpi % iha loke paratra ca // YS182v_2.7 //	pUtaH tat aharet vA-api % iha loke paratra ca // YS182u-_2.7 //
   yāvad ekaḥ pṛthag bhāvyaḥ $ prāyaścittaṃ na sevate &	yAvat ekaH pRTak BAvyaH $ prAyaScittam na sevate &
   apraśastā na te spṛśyās % te sarve 'pi vigarhitāḥ // YS182v_2.8 //	apraSastAH na te spRSyAH % te sarve api vigarhitAH // YS182u-_2.8 //
   abhojyāś cāpratigrāhyā $ asaṃpaṅktyāvivāhikāḥ &	aBojyAH ca-apratigrAhyA $ asaMpaFktyAvivAhikAH &
   pūyante tu vrate cīrṇe % sarve te rikthabhāginaḥ // YS182v_2.9 //	pUyante tu vrate cIrNe % sarve te rikTa-BAginaH // YS182u-_2.9 //
   iti śrīyāmye dharmaśāstre dvitīyo 'dhyāyaḥ ||	iti SrIyAmye DarmaSAstre dvitIyaH aDyAyaH ||
   adhyāya 3	aDyAya 3
   ūnaikādaśavarṣasya $ pañcavarṣāt parasya ca &	Una-ekAdaSa-varzasya $ paQca-varzAt parasya ca &
   prāyaścittaṃ cared bhrāta % pitā vā 'nyo 'pi bāndhavaḥ // YS182v_3.1 //	prAyaScittam caret BrAte % pitA vA anyaH api bAnDavaH // YS182u-_3.1 //
   ato bālatarasyāpi $ nāparādho na pātakam &	atas bAlatarasya-api $ na-aparADaH na pAtakam &
   rājadaṇḍo na tasyāsti % prāyaścittaṃ na vidyate // YS182v_3.2 //	rAja-daNxaH na tasya-asti % prAyaScittam na vidyate // YS182u-_3.2 //
   aśītyadhikavarṣāṇi $ bālo vā 'py ūnaṣoḍaśaḥ &	aSIti-aDika-varzANi $ bAlaH vA api Una-zoxaSaH &
   prāyaścittārdham arhanti % striyo vyādhita eva ca // YS182v_3.3 //	prAyaScitta-arDam arhanti % striyaH vyADitaH eva ca // YS182u-_3.3 //
   pitṛvyabhrātṛbhāryāṃ ca $ bhaginīṃ mātur eva ca &	pitRvya-BrAtR-BAryAm ca $ BaginIm mAtuH eva ca &
   śvaśrūṃ pitṛṣvasāraṃ ca % taptakṛcchraṃ samācaret // YS182v_3.4 //	SvaSrUm pitRzvasAram ca % taptakRcCram samAcaret // YS182u-_3.4 //
   rājñīm ācāryaśiṣyāṃ vā $ upādhyāyasya yoṣitaḥ &	rAjQIm AcArya-SizyAm vA $ upADyAyasya yozitaH &
   etā gatvā striyo mohāt % ṣaṇmāsaṃ kṛcchram ācaret // YS182v_3.5 //	etAH gatvA striyaH mohAt % zaz-mAsam kRcCram Acaret // YS182u-_3.5 //
   dvau māsau bhakṣya bhojyaṃ ca $ dvau māsau yāvakena tu &	dvO mAsO Bakzya Bojyam ca $ dvO mAsO yAvakena tu &
   dvau māsau pañcagavyena % ṣaṇmāsaṃ kṛcchram ācaret // YS182v_3.6 //	dvO mAsO paQcagavyena % zaz-mAsam kRcCram Acaret // YS182u-_3.6 //
   mātaraṃ gurupatnīṃ ca $ svasāraṃ duhitāṃ tathā &	mAtaram guru-patnIm ca $ svasAram duhitAm taTA &
   gatvā tu praviśed agniṃ % nānyā śuddhir vidhīyate // YS182v_3.7 //	gatvA tu praviSet agnim % na-anyA SudDiH viDIyate // YS182u-_3.7 //
   astaṃ gate yadā sūrye $ cāṇḍālam ṛtumatstriyaḥ &	astam gate yadA sUrye $ cANxAlam Rtumat-striyaH &
   saṃspṛśet tu yadā kaścit % prāyaścittaṃ kathaṃ bhavet // YS182v_3.8 //	saMspRSet tu yadA kaScid % prAyaScittam kaTam Bavet // YS182u-_3.8 //
   jātarūpyaṃ suvarṇaṃ tu $ divā ''hṛtaṃ ca yaj jalaṃ &	jAtarUpyam suvarNam tu $ divA aahRtam ca yat jalam &
   tena snātvā ca pītvā ca % gām ālabhya viśudhyati // YS182v_3.9 //	tena snAtvA ca pItvA ca % gAm AlaBya viSuDyati // YS182u-_3.9 //
   dāsanāpitagopāla- $ kulamitrārdhasīriṇaḥ &	dAsa-nApita-gopAla $ kula-mitra-arDa-sIriNaH &
   ete śūdrās tu bhojyānnā % yaś cā ''tmānaṃ nivedayet // YS182v_3.10 //	ete SUdrAH tu Bojya-annAH % yaH cA aatmAnam nivedayet // YS182u-_3.10 //
   asac chūdreṣu annādyaṃ $ ye bhuñjanty abudhā dvijāḥ &	asat SUdrezu annAdyam $ ye BuQjanti abuDAH dvijAH &
   prāyaścittaṃ tathā prāptaṃ % carec cāndrāyaṇavratam // YS182v_3.11 //	prAyaScittam taTA prAptam % caret cAndrAyaNa-vratam // YS182u-_3.11 //
   yaḥ karoty ekarātreṇa $ vṛṣalīsevanaṃ dvijaḥ &	yaH karoti eka-rAtreNa $ vRzalI-sevanam dvijaH &
   tadbhakṣaṇe japen nityaṃ % tribhir varṣair vyapohati // YS182v_3.12 //	tad-BakzaNe japet nityam % triBiH varzEH vyapohati // YS182u-_3.12 //
   vṛṣalīṃ yas tu gṛhṇāti $ brāhmaṇo madamohitaḥ &	vRzalIm yaH tu gRhNAti $ brAhmaNaH mada-mohitaH &
   sadā sūtakitā tasya % brahmahatyā dine dine // YS182v_3.13 //	sadA sUtakitA tasya % brahmahatyA dine dine // YS182u-_3.13 //
   vṛṣalīgamanaṃ caiva $ māsam ekaṃ nirantaram &	vRzalI-gamanam ca-eva $ mAsam ekam nirantaram &
   iha janmani śūdratvaṃ % punaḥ śvāno bhaviṣyati // YS182v_3.14 //	iha janmani SUdra-tvam % punar SvAnaH Bavizyati // YS182u-_3.14 //
   vṛṣalīphenapītasya $ niḥśvāsopagatasya ca &	vRzalI-Pena-pItasya $ niHSvAsa-upagatasya ca &
   tasyāṃ caiva prasūtasya % niṣkṛtir na vidhīyate // YS182v_3.15 //	tasyAm ca-eva prasUtasya % nizkRtiH na viDIyate // YS182u-_3.15 //
   agre māhiṣakaṃ dṛṣṭvā $ madhye ca vṛṣalīpatim &	agre mAhizakam dRzwvA $ maDye ca vRzalI-patim &
   ante vārdhuṣikaṃ dṛṣṭvā % nirāśāḥ pitaro gatāḥ // YS182v_3.16 //	ante vArDuzikam dRzwvA % nirASAH pitaraH gatAH // YS182u-_3.16 //
   mahiṣīty ucyate bhāryā $ sā caiva vyabhicāriṇī &	mahizI-iti ucyate BAryA $ sA ca-eva vyaBicAriNI &
   tān doṣān kṣamate yas tu % sa vai māhiṣakaḥ smṛtaḥ // YS182v_3.17 //	tAn dozAn kzamate yaH tu % sa vE mAhizakaH smRtaH // YS182u-_3.17 //
   pitur gehe tu yā kanyā $ paśyaty asaṃskṛtā rajaḥ &	pituH gehe tu yA kanyA $ paSyati asaMskRtAH rajaH &
   bhrūṇahatyā pitus tasyāḥ % kanyā sā vṛṣalī smṛtā // YS182v_3.18 //	BrUNahatyA pituH tasyAH % kanyA sA vRzalI smRtAH // YS182u-_3.18 //
   yas tāṃ vivāhayet kanyāṃ $ brāhmaṇo madamohitaḥ &	yaH tAm vivAhayet kanyAm $ brAhmaNaH mada-mohitaH &
   asaṃbhaṣyo hy apāṅkteyaḥ % sa vipro vṛṣalīpatiḥ // YS182v_3.19 //	asaMBazyaH hi apAFkteyaH % sa vipraH vRzalI-patiH // YS182u-_3.19 //
   prāpte dvādaśame varṣe $ kanyāṃ yo na prayacchati &	prApte dvAdaSame varze $ kanyAm yaH na prayacCati &
   māsi māsi rajas tasyāḥ % pitā pibati śoṇitam // YS182v_3.20 //	mAsi mAsi rajaH tasyAH % pitA pibati SoNitam // YS182u-_3.20 //
   aṣṭavarṣā bhaved gaurī $ navavarṣā ca rohiṇī &	azwa-varzA Bavet gOrI $ navavarzA ca rohiNI &
   daśavarṣā bhavet kanyā % ata ūrdhvaṃ rajasvalā // YS182v_3.21 //	daSa-varzA Bavet kanyA % atas UrDvam rajasvalAH // YS182u-_3.21 //
   mātā caiva pitā caiva $ jyeṣṭhabhrātā tathaiva ca &	mAtA ca-eva pitA ca-eva $ jyezWa-BrAtA taTA-eva ca &
   trayas te narakaṃ yānti % dṛṣṭvā kanyāṃ rajasvalām // YS182v_3.22 //	trayaH te narakam yAnti % dRzwvA kanyAm rajasvalAm // YS182u-_3.22 //
   samarghaṃ dhanam utsṛjya $ maha[hā]rghaṃ yaḥ prayacchati &	samarGam Danam utsRjya $ maha[-hA]rGam yaH prayacCati &
   sa vai vārdhuṣiko jñeyo % brahmavādiṣu garhitaḥ // YS182v_3.23 //	sa vE vArDuzikaH jQeyaH % brahma-vAdizu garhitaH // YS182u-_3.23 //
   śukrakṣayakarā vandhyā $ tyājyaiti parikīrtitā &	Sukra-kzaya-karAH vanDyA $ tyAjya-eti parikIrtitA &
   tasyās tu yo bhaved bhartā % taṃ tu vidyād ajāvikam // YS182v_3.24 //	tasyAH tu yaH Bavet BartA % tam tu vidyAt ajAvikam // YS182u-_3.24 //
   dūrāc chrāntaṃ bhayagrastaṃ $ brāhmaṇaṃ gṛham āgatam &	dUrAt SrAntam Baya-grastam $ brAhmaNam gRham Agatam &
   anarcayitvā yo bhuṅkte % tat kṣaṇe 'sau vidhīyate // YS182v_3.25 //	anarcayitvA yaH BuFkte % tat kzaNe asO viDIyate // YS182u-_3.25 //
   ajāviko māhiṣaś ca $ tathā ca vṛṣalīpatiḥ &	ajAvikaH mAhizaH ca $ taTA ca vRzalI-patiH &
   tṛṇāgreṇāpi saṃspṛṣṭvā % savāsā jalam āviśet // YS182v_3.26 //	tRNa-agreNa-api saMspRzwvA % sa-vAsAH jalam AviSet // YS182u-_3.26 //
   yāvad uṣṇaṃ bhaved annaṃ $ yāvad bhuñjanti vāgyatāḥ &	yAvat uzNam Bavet annam $ yAvat BuQjanti vAgyatAH &
   pitaras tāvad aśnanti % yāvan noktā havirguṇāḥ // YS182v_3.27 //	pitaraH tAvat aSnanti % yAvat na-uktAH haviH-guNAH // YS182u-_3.27 //
   havirguṇā na vaktavyāḥ $ pitaro yānty atarpitāḥ &	haviH-guNAH na vaktavyAH $ pitaraH yAnti atarpitAH &
   pitṛbhis tarpitaiḥ paścād % vaktavyaṃ śobhanaṃ haviḥ // YS182v_3.28 //	pitRBiH tarpitEH paScAt % vaktavyam SoBanam haviH // YS182u-_3.28 //
   yāvato grasate grāsān $ havyakavyeṣv amantritaḥ &	yAvataH grasate grAsAn $ havya-kavyezu amantritaH &
   tāvato grasate pretya % dīptān grāsān ayomayān // YS182v_3.29 //	tAvataH grasate pretya % dIptAn grAsAn ayaH-mayAn // YS182u-_3.29 //
   āsaneśv āsanaṃ dadyān $ na tu haste kadācana &	AsaneSu Asanam dadyAt $ na tu haste kadAcana &
   hasteśv āsanadāne ca % nirāśāḥ pitaro gatāḥ // YS182v_3.30 //	hasteSu Asana-dAne ca % nirASAH pitaraH gatAH // YS182u-_3.30 //
   āsane pādam ārūḍho $ vastrasyārdham adhaḥ kṛtam &	Asane pAdam ArUXaH $ vastrasya-arDam aDas kRtam &
   mukhena dhamitaṃ bhuṅkte % dvijaś cāndrāyaṇaṃ caret // YS182v_3.31 //	muKena Damitam BuFkte % dvijaH cAndrAyaNam caret // YS182u-_3.31 //
   aṅgulyāṃ yaḥ pavitrāṇi $ kṛtvā gandhān samarca[rpa]yet &	aFgulyAm yaH pavitrANi $ kRtvA ganDAn samarca-[rpa]yet &
   pitṝṇāṃ nopatiṣṭheta % rākṣasair vipralupyati // YS182v_3.32 //	pitLNAm na-upatizWeta % rAkzasEH vipralupyati // YS182u-_3.32 //
   hasangrāsaṃ ca yo bhuṅkte $ saśabdaṃ seṅgitaṃ tathā &	hasan-grAsam ca yaH BuFkte $ sa-Sabdam sa-iFgitam taTA &
   lehitaṃ vartitaṃ caiva % ṣaḍ ete paṅktidūṣakāḥ // YS182v_3.33 //	lehitam vartitam ca-eva % zaw ete paFkti-dUzakAH // YS182u-_3.33 //
   śvitrī kuṣṭḥī tathā śūlī $ kunakhī śyāvadantakaḥ &	SvitrI kuzwHI taTA SUlI $ kunaKI SyAva-dantakaH &
   rogī hīnātiriktāṅgaḥ % piśuno matsarī tathā // YS182v_3.34 //	rogI hIna-atirikta-aFgaH % piSunaH matsarI taTA // YS182u-_3.34 //
   durbhago hi tathā ṣaṇḍhaḥ $ pākhaṇḍī vedanindakaḥ &	durBagaH hi taTA zaNXaH $ pAKaNxI veda-nindakaH &
   haitukaḥ śūdrayājī ca % ayājyānāṃ ca yājakaḥ // YS182v_3.35 //	hEtukaH SUdra-yAjI ca % ayAjyAnAm ca yAjakaH // YS182u-_3.35 //
   nityaṃ pratigrahe lubdho $ yācako viṣayātmakaḥ &	nityam pratigrahe lubDaH $ yAcakaH vizaya-AtmakaH &
   śyāvadanto 'tha vaidyaś ca % asadālāpakas tathā // YS182v_3.36 //	SyAva-dantaH aTa vEdyaH ca % asat-AlApakaH taTA // YS182u-_3.36 //
   ete śrāddhe ca dāne ca $ varjanīyāḥ prayatnataḥ &	ete SrAdDe ca dAne ca $ varjanIyAH prayatnataH &
   tathā devalakaś caiva % bhṛtako vedavikrayī // YS182v_3.37 //	taTA devalakaH ca-eva % BRtakaH veda-vikrayI // YS182u-_3.37 //
   ete varjyāḥ prayatnena $ evam eva yamo 'bravīt &	ete varjyAH prayatnena $ evam eva yamaH abravIt &
   nirāśāḥ pitaras tasya % bhavanti ṛṇabhāginaḥ // YS182v_3.38 //	nirASAH pitaraH tasya % Bavanti RNa-BAginaH // YS182u-_3.38 //
   atha cen matra[ntra]vidyukto $ vaiṣṇavo jñānavān hi saḥ &	aTa ced matra-[ntra]-vidyuktaH $ vEzNavaH jQAnavAn hi saH &
   havyakavye niyoktavya % iti prāha svayaṃ yamaḥ // YS182v_3.39 //	havya-kavye niyoktavyaH % iti prAha svayam yamaH // YS182u-_3.39 //
   tasmāt sarvaprayatnena $ śrāddhe yajñe ca karmaṇi &	tasmAt sarva-prayatnena $ SrAdDe yajQe ca karmaNi &
   adūṣyaṃ caiva viprendraṃ % yojanīyaṃ[yettu] prayatnataḥ // YS182v_3.40 //	adUzyam ca-eva vipra-indram % yojanIyaM[yet-tu] prayatnataH // YS182u-_3.40 //
   tathaiva mantravidyuktaḥ $ śārīraiḥ paṅktidūṣanaiḥ &	taTA-eva mantra-vidyuktaH $ SArIrEH paFkti-dUzanEH &
   varjitaṃ ca yamaḥ prāha % paṅktipāvana eva saḥ // YS182v_3.41 //	varjitam ca yamaH prAha % paFkti-pAvanaH eva saH // YS182u-_3.41 //
   nirmatsaraḥ sadācāraḥ $ śrotriyo brahmavidyuvā &	nirmatsaraH sat-AcAraH $ SrotriyaH brahma-vid-yuvA &
   vidyāvinayasaṃpannaḥ % pātrabhūto dvijottamaḥ // YS182v_3.42 //	vidyA-vinaya-saMpannaH % pAtra-BUtaH dvijottamaH // YS182u-_3.42 //
   vedāntavijjyeṣṭhasāmā $ alubdho veda tat paraḥ &	vedAnta-vid-jyezWa-sAmA $ alubDaH veda tat paraH &
   yojanīyaḥ prayatnena % daive pitrye ca karmaṇi \	yojanIyaH prayatnena % dEve pitrye ca karmaNi \
   yad attaṃ ca hutaṃ tasmai hy # anantaṃ nātra saṃśayaḥ // YS182v_3.43 //	yat attam ca hutam tasmE hi # anantam na-atra saMSayaH // YS182u-_3.43 //
   ucchiṣṭocchiṣṭasaṃspṛṣṭaḥ $ śunā śūdreṇa vā dvijaḥ &	ucCizwa-ucCizwa-saMspRzwaH $ SunA SUdreNa vA dvijaH &
   upoṣya rajanīm ekāṃ % pañcagavyena śudhyati // YS182v_3.44 //	upozya rajanIm ekAm % paQcagavyena SuDyati // YS182u-_3.44 //
   ucchiṣṭabhājanaṃ yena $ vipreṇa cānnavarjitam &	ucCizwa-BAjanam yena $ vipreNa ca-anna-varjitam &
   spṛṣṭaṃ tena pramādāc ca % prājāpatyaṃ samācaret // YS182v_3.45 //	spRzwam tena pramAdAt ca % prAjApatyam samAcaret // YS182u-_3.45 //
   ucchiṣṭocchiṣṭasaṃspṛṣṭo $ brāhmaṇo brāhmaṇena hi &	ucCizwa-ucCizwa-saMspRzwaH $ brAhmaNaH brAhmaNena hi &
   daśarudrīṃ japet paścād % gāyatryā śodhanaṃ param // YS182v_3.46 //	daSarudrIm japet paScAt % gAyatryA SoDanam param // YS182u-_3.46 //
   ucchiṣṭocchiṣṭasaṃspṛṣṭaḥ $ kṣattriyo vaiśya eva ca &	ucCizwa-ucCizwa-saMspRzwaH $ kzattriyaH vESyaH eva ca &
   pramādocchiṣṭasaṃspṛṣṭaḥ % śūdreṇa tu yadā dvijaḥ // YS182v_3.47 //	pramAda-ucCizwa-saMspRzwaH % SUdreNa tu yadA dvijaH // YS182u-_3.47 //
   upoṣya rajanīm ekāṃ $ pañcagavyena śudhyati &	upozya rajanIm ekAm $ paQcagavyena SuDyati &
   śvānakukkuṭamārjārāḥ % kāko vā spṛśate yadi // YS182v_3.48 //	SvAna-kukkuwa-mArjArAH % kAkaH vA spRSate yadi // YS182u-_3.48 //
   ucchiṣṭaṃ taṃ dvijaṃ yas tu $ ahorātreṇa śudhyati &	ucCizwam tam dvijam yaH tu $ ahorAtreNa SuDyati &
   pañcagavyena śuddhiḥ syād % ity āha bhagavān yamaḥ // YS182v_3.49 //	paQcagavyena SudDiH syAt % iti Aha BagavAn yamaH // YS182u-_3.49 //
   rajasvalāṃ spṛśed yas tu $ trirātraṃ tatra kārayet &	rajasvalAm spRSet yaH tu $ tri-rAtram tatra kArayet &
   upoṣya dvijasaṃskāraṃ % pañcagavyena śudhyati // YS182v_3.50 //	upozya dvija-saMskAram % paQcagavyena SuDyati // YS182u-_3.50 //
   udakyā dṛṣṭipātena $ śrutaśabdena caiva hi &	udakyA dRzwi-pAtena $ Sruta-Sabdena ca-eva hi &
   snānaṃ devārcanaṃ dānaṃ % havanaṃ ca praṇaśyati // YS182v_3.51 //	snAnam deva-arcanam dAnam % havanam ca praNaSyati // YS182u-_3.51 //
   raktavastrasya vikretā $ lākṣārajakameva ca &	rakta-vastrasya vikretA $ lAkzA-rajakam-eva ca &
   veṇujīvanakaivarta- % takṣacarmopajīvinaḥ // YS182v_3.52 //	veNu-jIvana-kEvarta % takza-carma-upajIvinaH // YS182u-_3.52 //
   eteṣāṃ sparśanāt pāpaṃ $ tathā caiva tu mohitaḥ &	etezAm sparSanAt pApam $ taTA ca-eva tu mohitaH &
   pratigrahāc ca vipro vai % narakaṃ pratigacchati // YS182v_3.53 //	pratigrahAt ca vipraH vE % narakam pratigacCati // YS182u-_3.53 //
   udakyāḥ sparśane caiva $ brāhmaṇo vai pramādataḥ &	udakyAH sparSane ca-eva $ brAhmaNaH vE pramAdataH &
   ṣaḍrātropoṣitaḥ snātvā % pañcagavyena śudhyati // YS182v_3.54 //	zaz-rAtra-upozitaH snAtvA % paQcagavyena SuDyati // YS182u-_3.54 //
   sūtake vartamāne 'pi $ dāsavargasya kā kriyā &	sUtake vartamAne api $ dAsa-vargasya kA kriyA &
   svāmitulyaṃ bhavet tasya % sūtakaṃ tu praśasyate // YS182v_3.55 //	svAmi-tulyam Bavet tasya % sUtakam tu praSasyate // YS182u-_3.55 //
   yan na kārayate tat tan $ nānyaṃ pratyabravīd yamaḥ &	yat na kArayate tat tat $ na-anyam pratyabravIt yamaH &
   vivāhotsavayajñeṣu % kārye caivam upasthite // YS182v_3.56 //	vivAha-utsava-yajQezu % kArye ca-evam upasTite // YS182u-_3.56 //
   rajaḥ paśyati yā nārī $ tasya kālasya kā kriyā &	rajaH paSyati yA nArI $ tasya kAlasya kA kriyA &
   vipule ca jale snātvā % śuklavāsās tv alaṅkṛtā // YS182v_3.57 //	vipule ca jale snAtvA % Sukla-vAsAH tu alaFkRtAH // YS182u-_3.57 //
   āpo hiṣṭḥety ṛgabhiṣiktā $ ''yaṃ gauriti vā ṛcaḥ[cā] &	ApaH hizwHA-iti Rc-aBiziktA $ aayam gOH-iti vE RcaH[cA] &
   pūjānte homayet paścād % ghṛtāhutyā śatāṣṭakaṃ // YS182v_3.58 //	pUjA-ante homayet paScAt % GRta-AhutyA Sata-azwakam // YS182u-_3.58 //
   gāyatryā vyāhṛtibhiś ca $ tataḥ karma samācaret &	gAyatryA vyAhRtiBiH ca $ tatas karma samAcaret &
   yāvad dvijā na cārcyante % annadānahiraṇyakaiḥ // YS182v_3.59 //	yAvat dvijAH na ca-arcyante % anna-dAna-hiraNyakEH // YS182u-_3.59 //
   tāvaccīrṇavratasyāpi $ tat pāpaṃ na praṇaśyati // YS182v_3.60 //	tAvat-cIrNa-vratasya-api $ tat pApam na praNaSyati // YS182u-_3.60 //
   yad dehakaṃ kākabalākacillām- $ edhyena liptaṃ tu bhavet kadācit &	yat dehakam kAka-balA-kacillAm $ eDyena liptam tu Bavet kadAcid &
   śrotre mukhe vā parimastake vā % jñā[snā]nena lepopahatasya śuddhiḥ //	Srotre muKe vA parimastake vA % jQA[snA]nena lepa-upahatasya SudDiH //
   YS182v_3.61 //	YS182u-_3.61 //
   abhakṣyāṇām apeyānām $ alehyānāṃ ca bhakṣaṇe &	aBakzyANAm apeyAnAm $ alehyAnAm ca BakzaNe &
   retomūtrapurīṣāṇāṃ % prāyaścittaṃ kathaṃ bhavet // YS182v_3.62 //	retaH-mUtra-purIzANAm % prAyaScittam kaTam Bavet // YS182u-_3.62 //
   padmodumbarabilvānāṃ $ kuśāśvatthapalāśayoḥ &	padma-udumbara-bilvAnAm $ kuSa-aSvatTa-palASayoH &
   eteṣām udakaṃ pītvā % pañcagavyena śudhyati // YS182v_3.63 //	etezAm udakam pItvA % paQcagavyena SuDyati // YS182u-_3.63 //
   strīṇāṃ rajasvalānāṃ ca $ sparśaś caiva bhaved yadi &	strINAm rajasvalAnAm ca $ sparSaH ca-eva Bavet yadi &
   caturṇām api varṇanāṃ % prāyaścittaṃ kathaṃ bhavet // YS182v_3.64 //	caturNAm api varNanAm % prAyaScittam kaTam Bavet // YS182u-_3.64 //
   spṛṣṭvā rajasvalā 'nyonyaṃ $ sagotrā cānyagotrakā &	spRzwvA rajasvalA anyonyam $ sagotrA ca-anya-gotrakAH &
   kāmād akāmato vā 'pi % trirātrāc cuddhir iṣyate // YS182v_3.65 //	kAmAt akAmatas vA api % tri-rAtrAt cudDiH izyate // YS182u-_3.65 //
   spṛṣṭvā rajasvalā 'nyonyaṃ $ brāhmaṇī kṣattriyā tathā &	spRzwvA rajasvalA anyonyam $ brAhmaNI kzattriyA taTA &
   ardhakṛcchraṃ caret pūrvā % pādakṛcchraṃ tathottarā // YS182v_3.66 //	arDa-kRcCram caret pUrvA % pAda-kRcCram taTA-uttarAH // YS182u-_3.66 //
   spṛṣṭvā rajasvalā 'nyonyaṃ $ brāhmaṇī vaiśyinī tathā &	spRzwvA rajasvalA anyonyam $ brAhmaNI vESyinI taTA &
   pādahīnaṃ caret pūrvā % pādam ekaṃ tathottarā // YS182v_3.67 //	pAda-hInam caret pUrvA % pAdam ekam taTA-uttarAH // YS182u-_3.67 //
   spṛṣṭvā rajasvalā 'nyonyaṃ $ brāhmaṇī śūdriṇī tathā &	spRzwvA rajasvalA anyonyam $ brAhmaNI SUdriNI taTA &
   kṛcchreṇa śudhyate śūdrī % brāhmī dānena śudhyati // YS182v_3.68 //	kRcCreNa SuDyate SUdrI % brAhmI dAnena SuDyati // YS182u-_3.68 //
   vipraḥ spṛṣṭo niśāyāṃ tū- $ dakyayā patitena vā &	vipraH spRzwaH niSAyAm tU $ dakyayA patitena vA &
   divā ''nītena toyena % snāpayed agnisaṃnidhau // YS182v_3.69 //	divA aanItena toyena % snApayet agni-saMniDO // YS182u-_3.69 //
   divā caivārkasaṃspṛṣṭaṃ $ rātrau nakṣatradarśanāt &	divA ca-eva-arka-saMspRzwam $ rAtrO nakzatra-darSanAt &
   saṃdhyayor ubhayor vā 'pi % pavitraṃ sarvadā jalam // YS182v_3.70 //	saMDyayoH uBayoH vA api % pavitram sarvadA jalam // YS182u-_3.70 //
   iti śrīyāmye dharmaśāstre tṛtīyo 'dhyāyaḥ ||	iti SrIyAmye DarmaSAstre tRtIyaH aDyAyaH ||
   adhyāya 4	aDyAya 4
   khātaṃ vāpī tathā kūpa- $ pāṣāṇe śastraghātite &	KAtam vApI taTA kUpa $ pAzANe Sastra-GAtite &
   yaṣṭyā tu ghātite caiva % mṛtpiṇḍānyeva sādhayet // YS182v_4.1 //	yazwyA tu GAtite ca-eva % mRd-piNxAni-eva sADayet // YS182u-_4.1 //
   govadhe caiva yat pāpaṃ $ balīvardasya caiva hi &	go-vaDe ca-eva yat pApam $ balIvardasya ca-eva hi &
   prāyaścittaṃ bhavet tatra % striyā vā puruṣasya vā // YS182v_4.2 //	prAyaScittam Bavet tatra % striyAH vA puruzasya vA // YS182u-_4.2 //
   khāte ca patitā yā gauḥ $ kūpe vā cāvaṭe 'pi vā &	KAte ca patitA yA gOH $ kUpe vA ca-avawe api vA &
   āśā[śai]vālakuḍe[ṇḍe] vā 'pi % śastraghātena caiva hi // YS182v_4.3 //	ASA[-SE]vAla-kuxe[Nxe] vA api % Sastra-GAtena ca-eva hi // YS182u-_4.3 //
   yaṣṭyā tu patitā yā gaur $ balīvardo mṛto 'pi vā &	yazwyA tu patitA yA gOH $ balIvardaH mRtaH api vA &
   vatso vatsataro vā 'pi % prāyaścittī bhaven naraḥ // YS182v_4.4 //	vatsaH vatsataraH vA api % prAyaScittI Bavet naraH // YS182u-_4.4 //
   nārī vā 'pi kumāro vā $ prāyaścittād viśudhyati &	nArI vA api kumAraH vA $ prAyaScittAt viSuDyati &
   pāpī prakhyāpayet pāpaṃ % dattvā dhenuṃ tathā vṛṣam // YS182v_4.5 //	pApI praKyApayet pApam % dattvA Denum taTA vRzam // YS182u-_4.5 //
   pracchannapāpino ye syuḥ $ kṛtaghnā duṣṭacāriṇaḥ &	pracCanna-pApinaH ye syuH $ kRtaGnAH duzwa-cAriNaH &
   narakeṣu ca pacyante % yāvad ābhūtasaṃplavam // YS182v_4.6 //	narakezu ca pacyante % yAvat ABUtasaMplavam // YS182u-_4.6 //
   tasmāc ca pāpinā grāhyaṃ $ prāyaścittaṃ yathā tathā &	tasmAt ca pApinA grAhyam $ prAyaScittam yaTA taTA &
   pramādāc ca hatā yena % kapilā vā tathetarā // YS182v_4.7 //	pramAdAt ca hatAH yena % kapilA vA taTA-itarAH // YS182u-_4.7 //
   yathā brahmavadhe pāpaṃ $ kapilāyā vadhe tathā &	yaTA brahma-vaDe pApam $ kapilAyAH vaDe taTA &
   balīvarde 'pi ca tathā % prāyaścittaṃ samaṃ smṛtam // YS182v_4.8 //	balIvarde api ca taTA % prAyaScittam samam smRtam // YS182u-_4.8 //
   rodhane bandhane caiva $ mṛtpiṇḍanavagomaye &	roDane banDane ca-eva $ mRd-piNxa-nava-gomaye &
   utkṛṣṭenāpi gohantā % prāyaścittena śudhyati // YS182v_4.9 //	utkRzwena-api go-hantA % prAyaScittena SuDyati // YS182u-_4.9 //
   muṣṭyā vā nihatā yā gauḥ $ śakaṭe dhā[vā]ripaṅkayoḥ &	muzwyA vA nihatAH yA gOH $ Sakawe DA[va-a]ri-paFkayoH &
   govartapatitā gāvaḥ % śvanadyām uttare 'pi vā // YS182v_4.10 //	govarta-patitAH gAvaH % Sva-nadyAm uttare api vA // YS182u-_4.10 //
   etat te kathitaṃ sarvaṃ $ gavāṃ ca [vi]ghātam uttamam &	etat te kaTitam sarvam $ gavAm ca [vi]GAtam uttamam &
   yatra yatra mriyed gauś ca % prāyaścittaṃ pṛthak pṛthak // YS182v_4.11 //	yatra yatra mriyet gOH ca % prAyaScittam pRTak pRTak // YS182u-_4.11 //
   vane ca patitā yā gauḥ $ pāmaratrāṭa [sa]śaṅktitā &	vane ca patitA yA gOH $ pAmara-trAwaH [sa]SaFkti-tA &
   mṛtā caiva yadā sā gauḥ % prāyaścittī bhavec ca saḥ // YS182v_4.12 //	mRtA ca-eva yadA sA gOH % prAyaScittI Bavet ca saH // YS182u-_4.12 //
   preṣitaḥ puruṣo vā 'pi $ prāyaścittaṃ ca yat smṛtam &	prezitaH puruzaH vA api $ prAyaScittam ca yat smRtam &
   ābdikaṃ caiva śūdrasya % vaiśyasya dviguṇaṃ bhavet // YS182v_4.13 //	Abdikam ca-eva SUdrasya % vESyasya dviguNam Bavet // YS182u-_4.13 //
   triguṇaṃ kṣattriyasyaiva $ viprasyaiva caturguṇam &	triguNam kzattriyasya-eva $ viprasya-eva caturguNam &
   goṣṭhe nivasanaṃ kāryaṃ % goghno 'ham iti vācayet // YS182v_4.14 //	gozWe nivasanam kAryam % go-GnaH aham iti vAcayet // YS182u-_4.14 //
   kaṣṭena vartamāno 'pi $ kālenaiva śucir bhavet &	kazwena vartamAnaH api $ kAlena-eva SuciH Bavet &
   gavāṃ madhye vased rātrau % divā gā vai(?) hy anuvrajet // YS182v_4.15 //	gavAm maDye vaset rAtrO % divA gAH vE(?) hi anuvrajet // YS182u-_4.15 //
   na strīṇāṃ vapanaṃ kuryān $ na ca govrajanaṃ smṛtam &	na strINAm vapanam kuryAt $ na ca go-vrajanam smRtam &
   na ca goṣṭhe vased rātrau % na kuryād vaidikīṃ śrutim // YS182v_4.16 //	na ca gozWe vaset rAtrO % na kuryAt vEdikIm Srutim // YS182u-_4.16 //
   sarvān keśān samucchritya $ cchedayed aṅguladvayam &	sarvAn keSAn samucCritya $ cCedayet aFgula-dvayam &
   eṣa e[vame]va tu nārīṇāṃ % śiromuṇḍāpanaṃ smṛtam // YS182v_4.17 //	ezaH e[vam-e]va tu nArINAm % SiromuNxApanam smRtam // YS182u-_4.17 //
   sūtake mṛtake caiva $ vidhiṃ prabrūhi no yama &	sUtake mRtake ca-eva $ viDim prabrUhi naH yamaH &
   jātake vartamāne 'pi % mṛtakaṃ ca yadā bhavet // YS182v_4.18 //	jAtake vartamAne api % mRtakam ca yadA Bavet // YS182u-_4.18 //
   ko vidhiḥ sa vinirdiṣṭaḥ $ kathayasva yathā tatham &	kaH viDiH sa vinirdizwaH $ kaTayasva yaTA taTam &
   evam ukto hi bhagavān % yamaḥ prāha yathā tatham // YS182v_4.19 //	evam uktaH hi BagavAn % yamaH prAha yaTA taTam // YS182u-_4.19 //
   jātake naiva mṛtakaṃ $ kṣayaṃ yāti na saṃśayaḥ &	jAtake na-eva mRtakam $ kzayam yAti na saMSayaH &
   pūrvavratam anirdiṣṭaṃ % mayā ca sūtakaṃ bhavet // YS182v_4.20 //	pUrva-vratam anirdizwam % mayA ca sUtakam Bavet // YS182u-_4.20 //
   sūtakena na lipyeta $ iti prāha svayaṃ yamaḥ &	sUtakena na lipyeta $ iti prAha svayam yamaH &
   sūtakena na lipyeta % vrataṃ saṃpūrṇatāṃ vrajet // YS182v_4.21 //	sUtakena na lipyeta % vratam saMpUrNa-tAm vrajet // YS182u-_4.21 //
   śrāddhaṃ dānaṃ tapo yajño $ devatārādhanaṃ tathā &	SrAdDam dAnam tapaH yajQaH $ devatA-ArADanam taTA &
   brahmahā ca surāpaś ca % svarṇasteyī gurudruhaḥ // YS182v_4.22 //	brahma-hA ca surApaH ca % svarNa-steyI guru-druhaH // YS182u-_4.22 //
   saṃsargī pañcamo jñeyas $ tatsamo nātra saṃśayaḥ &	saMsargI paQcamaH jQeyaH $ tad-samaH na-atra saMSayaH &
   eteṣu dvādaśābdaṃ ca % prāyaścittaṃ vidhīyate // YS182v_4.23 //	etezu dvAdaSa-abdam ca % prAyaScittam viDIyate // YS182u-_4.23 //
   tathā pātakināṃ caiva $ ṣaḍabdaṃ caiva saṃsmṛtam &	taTA pAtakinAm ca-eva $ zaxabdam ca-eva saMsmRtam &
   upapātakināṃ caiva % tripañcābdaṃ vidhīyate // YS182v_4.24 //	upapAtakinAm ca-eva % tri-paQca-abdam viDIyate // YS182u-_4.24 //
   prājāpatyais tribhiḥ kṛcchraṃ $ kṛcchraṃ vai dvādaśābdikam &	prAjApatyEH triBiH kRcCram $ kRcCram vE dvAdaSa-Abdikam &
   ekabhaktaṃ tathā naktam % upavāsam athāpi vā // YS182v_4.25 //	eka-Baktam taTA naktam % upavAsam aTa-api vA // YS182u-_4.25 //
   etad dinacatuṣkeṇa $ pādakṛcchraś ca jāyate &	etat dina-catuzkeNa $ pAdakRcCraH ca jAyate &
   tripādakṛcchro vijñeyaḥ % pāpakśayakaraḥ smṛtaḥ // YS182v_4.26 //	tri-pAda-kRcCraH vijQeyaH % pApakSaya-karaH smRtaH // YS182u-_4.26 //
   dharmaśāstrānusāreṇa $ prāyaścittaṃ manīṣibhiḥ &	Darma-SAstra-anusAreNa $ prAyaScittam manIziBiH &
   dātavyaṃ pāpamuktyarthaṃ % prāṇināṃ pāpakāriṇām // YS182v_4.27 //	dAtavyam pApa-mukti-arTam % prANinAm pApa-kAriNAm // YS182u-_4.27 //
   anutāpādya[po ya]dā puṃsāṃ[so] $ bhaved vai pāpinaḥ kila &	anutApa-Adi-a[paH ya]dA puMsAM[so] $ Bavet vE pApinaH kila &
   prāyaścittaṃ tadā deyam % ity āha bhagavān yamaḥ // YS182v_4.28 //	prAyaScittam tadA deyam % iti Aha BagavAn yamaH // YS182u-_4.28 //
   ajñātvā dharmaśāstrāṇi $ prāyaścittaṃ dadāti yaḥ &	ajQAtvA Darma-SAstrANi $ prAyaScittam dadAti yaH &
   prāyaścittī bhavet pūtas % tat pāpaṃ parṣadaṃ vrajet // YS182v_4.29 //	prAyaScittI Bavet pUtaH % tat pApam parzadam vrajet // YS182u-_4.29 //
   tasmāc chāstrānusāreṇa $ prāyaścittaṃ vidhīyate &	tasmAt SAstra-anusAreNa $ prAyaScittam viDIyate &
   aṣṭaśālyāṃ mṛtā ye ca % ye ca strīsūtake mṛtāḥ // YS182v_4.30 //	azwa-SAlyAm mRtAH ye ca % ye ca strI-sUtake mRtAH // YS182u-_4.30 //
   draṃṣṭrābhir bhakṣitā ye ca $ ye ca ātmahano janāḥ &	draMzwrABiH BakzitAH ye ca $ ye ca Atma-hanaH janAH &
   aṣṭaśālyāṃ mṛto vipraḥ % prāyaścittaṃ tu bandhubhiḥ // YS182v_4.31 //	azwa-SAlyAm mRtaH vipraH % prAyaScittam tu banDuBiH // YS182u-_4.31 //
   kāryaṃ tu ābdikaṃ caiva $ tathā strīṇāṃ ca dāpayet &	kAryam tu Abdikam ca-eva $ taTA strINAm ca dApayet &
   śuddhyarthaṃ nānyathā bhāvyam % ity āha bhagavān yamaḥ // YS182v_4.32 //	SudDi-arTam na-anyaTA BAvyam % iti Aha BagavAn yamaH // YS182u-_4.32 //
   durmṛtyumaraṇaṃ prāptā $ ye 'py adhogatim āgatāḥ &	durmRtyu-maraNam prAptAH $ ye api aDogatim AgatAH &
   teṣāṃ śuddhyartham evātra % dvitryabdaṃ hi viśiṣyate // YS182v_4.33 //	tezAm SudDi-arTam eva-atra % dvi-tri-abdam hi viSizyate // YS182u-_4.33 //
   brāhmaṇakṣattriyaviśāṃ $ śūdrānāṃ cāntyajātinām &	brAhmaNa-kzattriya-viSAm $ SUdrAnAm ca-antya-jAtinAm &
   tāratam yena dātavyam % iti prāha svayaṃ yamaḥ // YS182v_4.34 //	tAratam yena dAtavyam % iti prAha svayam yamaH // YS182u-_4.34 //
   patitānāṃ ca viprāṇāṃ $ tathā strīṇāṃ vigarhitam &	patitAnAm ca viprANAm $ taTA strINAm vigarhitam &
   kathaṃ śuddhir bhavet tāsāṃ % teṣāṃ caiva viśeṣataḥ // YS182v_4.35 //	kaTam SudDiH Bavet tAsAm % tezAm ca-eva viSezataH // YS182u-_4.35 //
   vyabhicārād ṛtau śuddhiḥ $ strīṇāṃ caiva na saṃśayaḥ &	vyaBicArAt RtO SudDiH $ strINAm ca-eva na saMSayaH &
   garbhe jāte parityāgo % nānyathā mama bhāṣitam // YS182v_4.36 //	garBe jAte parityAgaH % na-anyaTA mama BAzitam // YS182u-_4.36 //
   duṣṭastrīdarśanenaiva $ pitaro yānty adhogatim &	duzwa-strI-darSanena-eva $ pitaraH yAnti aDogatim &
   ghṛtaṃ yonyāṃ kṣiped ghoraṃ % parapuṃsagatā hi yā // YS182v_4.37 //	GRtam yonyAm kzipet Goram % parapuMsa-gatAH hi yAH // YS182u-_4.37 //
   havanaṃ ca prayatnena $ gāyatryā cāyutatrayam &	havanam ca prayatnena $ gAyatryA ca-ayuta-trayam &
   brāhmaṇān bhojayet paścāc % chatam aṣṭottareṇa hi // YS182v_4.38 //	brAhmaNAn Bojayet paScAt % Catam azwa-uttareNa hi // YS182u-_4.38 //
   vidhavā caiva yā nārī $ puṃsopagatasevinī &	viDavA ca-eva yA nArI $ puMsA-upagata-sevinI &
   tyājyā sā bandhubhiś caiva % nānyathā yamabhāṣitam // YS182v_4.39 //	tyAjyA sA banDuBiH ca-eva % na-anyaTA yama-BAzitam // YS182u-_4.39 //
   patitasya ca viprasya $ anutāparatasya ca &	patitasya ca viprasya $ anutApa-ratasya ca &
   pāpāc caiva nivṛttasya % prāyaścittī bhavet tadā // YS182v_4.40 //	pApAt ca-eva nivRttasya % prAyaScittI Bavet tadA // YS182u-_4.40 //
   tāratam yena dātavyaṃ $ prāyaścittaṃ yathā vidhi &	tAratam yena dAtavyam $ prAyaScittam yaTA viDi &
   sakāmo hi yadā vipraḥ % pāpācāraparo bhavet // YS182v_4.41 //	sa-kAmaH hi yadA vipraH % pApa-AcAra-paraH Bavet // YS182u-_4.41 //
   dṛṣṭvā[diṣṭyā] nivṛttapāpaughaḥ $ prāyaścittī tadārhati &	dRzwvA-a[dizwyA] nivRtta-pApa-oGaH $ prAyaScittI tadA-arhati &
   tathā kṣattriyavaiśyau vā % śūdro vā 'pi yathā kramāt // YS182v_4.42 //	taTA kzattriya-vESyO vA % SUdraH vA api yaTA kramAt // YS182u-_4.42 //
   vidhav āgamane pāpaṃ $ sakṛc caiva tu yad bhavet &	viDau Agamane pApam $ sakRt ca-eva tu yat Bavet &
   asakṛc ca yadā jñātvā % prāyaścittaṃ pravartate // YS182v_4.43 //	asakRt ca yadA jQAtvA % prAyaScittam pravartate // YS182u-_4.43 //
   asakṛd gamanāc caiva $ carec cāndrāyaṇadvayam &	asakRt gamanAt ca-eva $ caret cAndrAyaNa-dvayam &
   sakṛd gamane yat pāpaṃ % prājāpatyadvayena hi // YS182v_4.44 //	sakRt gamane yat pApam % prAjApatya-dvayena hi // YS182u-_4.44 //
   punarbhūr vikṛtā yena $ kṛtā vipreṇa caiva hi &	punarBUH vikRtAH yena $ kRtA vipreNa ca-eva hi &
   vinā śākhāprabhedena % punarbhūr bhaṇyate hi sā // YS182v_4.45 //	vinA SAKA-praBedena % punarBUH BaNyate hi sA // YS182u-_4.45 //
   savarṇaś ca savarṇāyām $ abhiṣikto yadā bhavet &	savarNaH ca savarNAyAm $ aBiziktaH yadA Bavet &
   brāhmaṇaḥ kāmalubdho 'pi % śrāddhe yajñe ca garhitaḥ // YS182v_4.46 //	brAhmaNaH kAma-lubDaH api % SrAdDe yajQe ca garhitaH // YS182u-_4.46 //
   kṣattriyo brāhmaṇīsaktaḥ $ kṣattriṇyāṃ viśa eva vā &	kzattriyaH brAhmaNI-saktaH $ kzattriNyAm viSaH eva vA &
   vaiśyāyā gamane śūdraḥ % patitāyā bhavān yathā // YS182v_4.47 //	vESyAyAH gamane SUdraH % patitAyAH BavAn yaTA // YS182u-_4.47 //
   prātilomye mahatpāpaṃ $ pravadanti manīṣiṇaḥ &	prAtilomye mahat-pApam $ pravadanti manIziNaH &
   prāyaścittaṃ cā ''nulomye % na bhavaty eva cānyathā // YS182v_4.48 //	prAyaScittam cA aanulomye % na Bavati eva ca-anyaTA // YS182u-_4.48 //
   mānasaṃ vācikaṃ caiva $ kāyikaṃ pātakaṃ smṛtam &	mAnasam vAcikam ca-eva $ kAyikam pAtakam smRtam &
   tasmāt pāpād viśuddhyarthaṃ % prāyaścittaṃ dine dine // YS182v_4.49 //	tasmAt pApAt viSudDi-arTam % prAyaScittam dine dine // YS182u-_4.49 //
   prātah saṃdhyāṃ sanakṣatrām $ upāsyām e[sītai]va yatnataḥ &	prAtam saMDyAm sa-nakzatrAm $ upAsyAm e[sItE]va yatnatas &
   madhyāhne ca tathā raudrīṃ % sāyaṃ caiva tu vaiṣṇavīm // YS182v_4.50 //	maDyAhne ca taTA rOdrIm % sAyam ca-eva tu vEzNavIm // YS182u-_4.50 //
   trividhaṃ pāpaśuddhyarthaṃ $ saṃdhyopāsanam eva ca &	triviDam pApa-SudDi-arTam $ saMDyA-upAsanam eva ca &
   saṃdhyāhīno hi yo vipraḥ % snānahīnas tathaiva ca // YS182v_4.51 //	saMDyA-hInaH hi yaH vipraH % snAna-hInaH taTA-eva ca // YS182u-_4.51 //
   snānahīno malāśī syāt $ saṃdhyāhīno hi bhrūṇahā &	snAna-hInaH mala-ASI syAt $ saMDyA-hInaH hi BrUNa-hA &
   naiśaṃ pā([naśyetpā])paṃ hi yāṃ dhyātvā % u([turu])pāsanaparo hi saḥ //	nESam pA([naSyet-pA])pam hi yAm DyAtvA % u([turu])pAsana-paraH hi saH //
   YS182v_4.52 //	YS182u-_4.52 //
   brahmalokaṃ vrajaty eva $ nānyathā yamabhāṣitam &	brahma-lokam vrajati eva $ na-anyaTA yama-BAzitam &
   vidyāt apobhyāṃ saṃyuktaḥ % śāntaḥ śucir alampaṭaḥ // YS182v_4.53 //	vidyAt apoByAm saMyuktaH % SAntaH SuciH alampawaH // YS182u-_4.53 //
   alubhdāhlādaniṣpāpā $ bhūdevā nātra saṃśayaḥ &	aluBda-AhlAda-nizpApAH $ BUdevAH na-atra saMSayaH &
   pātrībhūtāś ca vijñeyā % viprās te nātra saṃśayaḥ // YS182v_4.54 //	pAtrI-BUtAH ca vijQeyAH % viprAH te na-atra saMSayaH // YS182u-_4.54 //
   tebhyo dattam anantaṃ hi $ ity āha bhagavān yamaḥ &	teByaH dattam anantam hi $ iti Aha BagavAn yamaH &
   kukarmasthās tu ye viprā % lolupā vedavarjitāḥ // YS182v_4.55 //	kukarma-sTAH tu ye viprAH % lolupAH veda-varjitAH // YS182u-_4.55 //
   saṃdhyāhīnā vratabhraṣṭāḥ $ piśunā viṣayātmakāḥ &	saMDyA-hInAH vrata-BrazwAH $ piSunAH vizaya-AtmakAH &
   tebhyo dattaṃ niṣphalaṃ syān % nātra kāryāvicāraṇā // YS182v_4.56 //	teByaH dattam nizPalam syAt % na-atra kArya-avicAraNAH // YS182u-_4.56 //
   pratigrahe saṃkucitā yadānyātaiyavidhṛtā |	pratigrahe saMkucitA yadA-anyAtEya-viDRtA |
   bhūmidarśanāt pāpamocakā kṛtatretādvāpare kalau nauvarvīroṣitaḥ ||	BUmi-darSanAt pApa-mocakA kRta-tretA-dvApare kalO nOvarvIra-uzitaH ||
   YS182v_4.57 ||	YS182u-_4.57 ||
   rājapratigrahāt sarvaṃ $ brahmavarcasam eva ca &	rAja-pratigrahAt sarvam $ brahmavarcasam eva ca &
   naśyatīti na saṃdeha % ity āha bhagavān yamaḥ // YS182v_4.58 //	naSyati-iti na saMdehaH % iti Aha BagavAn yamaH // YS182u-_4.58 //
   rājñāṃ pratigrahas tyājyo $ lokatrayajigīṣubhiḥ &	rAjQAm pratigrahaH tyAjyaH $ lokatraya-jigIzuBiH &
   rājñaḥ pratigrahāc caiva % brāhmaṇyaṃ hi vilupyate // YS182v_4.59 //	rAjQaH pratigrahAt ca-eva % brAhmaNyam hi vilupyate // YS182u-_4.59 //
   gāvo dūrapracāreṇa $ hiraṇyaṃ lobhalipsayā &	gAvaH dUra-pracAreNa $ hiraNyam loBa-lipsayA &
   strī vinaśyati garve[bhe]ṇa % brāhmaṇo rājasevayā // YS182v_4.60 //	strI vinaSyati garve[-Be]Na % brAhmaNaH rAja-sevayA // YS182u-_4.60 //
   sevakāś cāpi viprāṇāṃ $ rājñāṃ sukṛtanāmabhiḥ &	sevakAH ca-api viprANAm $ rAjQAm su-kRta-nAmaBiH &
   kumbhīpākeṣu pacyante % yāvad ābhūtasaṃplavam // YS182v_4.61 //	kumBIpAkezu pacyante % yAvat ABUtasaMplavam // YS182u-_4.61 //
   asevyāsevino viprā $ ayājyānāṃ ca yājakāḥ &	asevya-AsevinaH viprAH $ ayAjyAnAm ca yAjakAH &
   apāṅktās te ca vijñeyāḥ % sarvadharmabahiṣkatāḥ // YS182v_4.62 //	apAFktAH te ca vijQeyAH % sarva-Darma-bahizkatAH // YS182u-_4.62 //
   iti śrīyāmye dharmaśāstre caturtho 'dhyāyaḥ ||	iti SrIyAmye DarmaSAstre caturTaH aDyAyaH ||
   adhyāya 5	aDyAya 5
   ataḥ paraṃ pravakṣyāmi $ śṛṇudhvaṃ munipuṅgavāḥ &	atas param pravakzyAmi $ SRNuDvam muni-puFgavAH &
   sarveṣām antyajātīnāṃ % varṇādīnāṃ yathā kramam // YS182v_5.1 //	sarvezAm antya-jAtInAm % varNa-AdInAm yaTA kramam // YS182u-_5.1 //
   strīsaṃparkādikaṃ sarvaṃ $ jātam antyajasaṃjñakam &	strI-saMparka-Adikam sarvam $ jAtam antyaja-saMjQakam &
   yonisaṃkarajaṃ sarvaṃ % varṇataś cāpi sarvaśaḥ // YS182v_5.2 //	yoni-saMkara-jam sarvam % varNataH ca-api sarvaSas // YS182u-_5.2 //
   viprakṣattriyaviṭśūdrā- $ varṇijātyeṣv anukramāt &	vipra-kzattriya-viS-SUdrA $ varNi-jAtyezu anukramAt &
   ete brāhmaṇakutsāḥ syus % tasmād brāhmaṇa([ṇya])m uttamam // YS182v_5.3 //	ete brAhmaNa-kutsAH syuH % tasmAt brAhmaNa-([Nya])m uttamam // YS182u-_5.3 //
   vedācārarato vipro $ vedavedāṅgapāragaḥ &	veda-AcAra-rataH vipraH $ veda-vedAFga-pAragaH &
   tair apy anuṣṭhito dharma % uktaś caiva viśeṣataḥ // YS182v_5.4 //	tEH api anuzWitaH DarmaH % uktaH ca-eva viSezataH // YS182u-_5.4 //
   kārye caiva viśeṣeṇa $ tribhir varnair atandritaḥ &	kArye ca-eva viSezeNa $ triBiH varnEH atandritaH &
   balād dāsī kṛtā ye ca % mlecchacāṇḍāladasyubhiḥ // YS182v_5.5 //	balAt dAsI kRtAH ye ca % mlecCa-cANxAla-dasyuBiH // YS182u-_5.5 //
   aśubhaṃ kāritāḥ karma $ gavādiprāṇihiṃsanam &	aSuBam kAritAH karma $ gavA-Adi-prANi-hiMsanam &
   prāyaścittaṃ ca dātavyaṃ % tāratam yena vā dvijaiḥ // YS182v_5.6 //	prAyaScittam ca dAtavyam % tAratam yena vA dvijEH // YS182u-_5.6 //
   śrāddhakāle yadā jātā $ patnī yasya rajasvalā &	SrAdDa-kAle yadA jAtA $ patnI yasya rajasvalA &
   prasūtā vā na kārya ca % daivikaṃ paitṛkaṃ tathā // YS182v_5.7 //	prasUtAH vA na kArya ca % dEvikam pEtRkam taTA // YS182u-_5.7 //
   brāhmaṇā mantritāś caiva $ kṣaṇitā vā prayatnataḥ &	brAhmaNAH mantritAH ca-eva $ kzaNitAH vA prayatnataH &
   uddiśya pitṛpākaṃ ca % kāryaṃ paitṛkam eva tat // YS182v_5.8 //	uddiSya pitR-pAkam ca % kAryam pEtRkam eva tat // YS182u-_5.8 //
   āśaucaṃ na bhavaty eva $ nātra kāryā vicāraṇā &	ASOcam na Bavati eva $ na-atra kAryA vicAraNA &
   prasthāne vā pitā tasya % pañcatvaṃ ca gato bhavet // YS182v_5.9 //	prasTAne vA pitA tasya % paQcatvam ca gataH Bavet // YS182u-_5.9 //
   śrāddhādikām tu putreṇa $ ajñātena kṛtaṃ yadā &	SrAdDa-AdikAm tu putreNa $ ajQAtena kRtam yadA &
   kanyā pradānasamaye % śrutaṃ ca pi([tavānpi])taraṃ mṛtam // YS182v_5.10 //	kanyA pradAna-samaye % Srutam ca pi([tavAn-pi])taram mRtam // YS182u-_5.10 //
   kanyādānaṃ ca tat kāryaṃ $ vacanād bhavate[ti] kṣamaḥ &	kanyA-dAnam ca tat kAryam $ vacanAt BavatA-i[ti] kzamaH &
   pituḥ pātrādikaṃ karma % paścāt sarvaṃ yathā vidhi // YS182v_5.11 //	pituH pAtra-Adikam karma % paScAt sarvam yaTA viDi // YS182u-_5.11 //
   ajñānāc ca kṛtaṃ sarvaṃ $ daivikaṃ paitṛkaṃ ca yat &	ajQAnAt ca kRtam sarvam $ dEvikam pEtRkam ca yat &
   jātake sū([mṛ])take vā 'pi % tat sarvaṃ saphalaṃ bhavet // YS182v_5.12 //	jAtake sU([mR])take vA api % tat sarvam saPalam Bavet // YS182u-_5.12 //
   vyāsenoktasmṛtau svakīye ajñānāt pitari mṛte yadā jñātu sadaiva kāryaṃ	vyAsena-ukta-smRtO svakIye ajQAnAt pitari mRte yadA jQAtu sadA-eva kAryam
   pitṛkam eva vā || YS182v_5.13 ||	pitRkam eva vA || YS182u-_5.13 ||
   aneke yasya ye putrāḥ $ saṃsṛṣṭā hi bhavanti ca &	aneke yasya ye putrAH $ saMsRzwAH hi Bavanti ca &
   jyeṣṭhena hi kṛtaṃ sarvaṃ % saphalaṃ paitṛkaṃ bhavet // YS182v_5.14 //	jyezWena hi kRtam sarvam % saPalam pEtRkam Bavet // YS182u-_5.14 //
   vaidikaṃ ca tathā sarvaṃ $ bhavaty eva na saṃśayaḥ &	vEdikam ca taTA sarvam $ Bavati eva na saMSayaH &
   pṛthak piṇḍaṃ pṛthak śrāddhaṃ % vaiśvadevādikaṃ ca yat // YS182v_5.15 //	pRTak piNxam pRTak SrAdDam % vESvadeva-Adikam ca yat // YS182u-_5.15 //
   bhrātaraś ca pṛthak kuryur $ nāvibhaktāḥ kadācana &	BrAtaraH ca pRTak kuryuH $ na-aviBaktAH kadAcana &
   aputrasya ca putrāḥ syuḥ % kartāraḥ sāṃparāyaṇāḥ // YS182v_5.16 //	aputrasya ca putrAH syuH % kartAraH sAMparAyaNAH // YS182u-_5.16 //
   saphalaṃ jāyate sarvām $ iti śātātapo 'bravīt &	saPalam jAyate sarvAm $ iti SAtAtapaH abravIt &
   na ca datto 'pyahīno 'ti- % snehena ca tathā 'paraḥ // YS182v_5.17 //	na ca dattaH api-ahInaH ati % snehena ca taTA aparaH // YS182u-_5.17 //
   balād gṛhīto baddhaś ca $ bandhubhir datta eva ca &	balAt gRhItaH badDaH ca $ banDuBiH dattaH eva ca &
   bhrātuḥ putro mitraputraḥ % śiṣyaś caiva tathaurasaḥ // YS182v_5.18 //	BrAtuH putraH mitra-putraH % SizyaH ca-eva taTA-OrasaH // YS182u-_5.18 //
   aputrasya ca vijñeyā $ dāyādā nātra saṃśayaḥ &	aputrasya ca vijQeyA $ dAyAdAH na-atra saMSayaH &
   navaite putravatpālyāḥ % paralokapradā hy amī // YS182v_5.19 //	navA-ete putra-vat-pAlyAH % para-loka-pradA hi amI // YS182u-_5.19 //
   aurasena samā jñeyā $ vacasoddālakasya ca &	Orasena samAH jQeyA $ vacasA-uddAlakasya ca &
   idānīṃ bhāganirṇayam % ṛṣiḥ śātātapo 'bravīt // YS182v_5.20 //	idAnIm BAga-nirNayam % RziH SAtAtapaH abravIt // YS182u-_5.20 //
   jyeṣṭhena vā kaniṣṭhena $ vibhāgasya vinirṇayaḥ &	jyezWena vA kanizWena $ viBAgasya vinirNayaH &
   samabhāgapradātā ca % aputrebhyo na saṃśayaḥ // YS182v_5.21 //	sama-BAga-pradAtA ca % aputreByaH na saMSayaH // YS182u-_5.21 //
   samabhāgo grahītavyaḥ $ putramatyā sadaiva hi &	sama-BAgaH grahItavyaH $ putra-matyA sadA-eva hi &
   pitṛbhyo bhrātṛputrebhyo % dāyādebhyo yathā kramāt // YS182v_5.22 //	pitRByaH BrAtR-putreByaH % dAyAdeByaH yaTA kramAt // YS182u-_5.22 //
   adhikasya ca bhāgau dvau $ itarebhyaḥ(?) samāsataḥ &	aDikasya ca BAgO dvO $ itareByaH(?) samAsatas &
   ādhau pratigrahe krānte % pūrvā tu balavattarā // YS182v_5.23 //	ADO pratigrahe krAnte % pUrvA tu balavattarAH // YS182u-_5.23 //
   sarvesv eva vivādeṣu $ balavaty uttarā kriyā &	sarvesu eva vivAdezu $ balavatI uttarA kriyA &
   samavidyottaraṃ caiva % pratyavaskandanaṃ tathā // YS182v_5.24 //	samavidyA-uttaram ca-eva % pratyavaskandanam taTA // YS182u-_5.24 //
   pūrvaṃ nyāsavidhiś caiva $ uttaraḥ syāc caturvidhaḥ &	pUrvam nyAsa-viDiH ca-eva $ uttaraH syAt caturviDaH &
   sākṣiṣūbhayataḥ satsu % sākṣiṇaḥ pūrvavādinaḥ // YS182v_5.25 //	sAkzizu-uBayatas satsu % sAkziNaH pUrvavAdinaH // YS182u-_5.25 //
   pūrvapakṣe 'dharībhūte $ bhavanty uttaravādinaḥ &	pUrva-pakze aDarIBUte $ Bavanti uttara-vAdinaH &
   asākṣivyavahāreṣu % divyaṃ deyaṃ yathā vidhi // YS182v_5.26 //	asAkzi-vyavahArezu % divyam deyam yaTA viDi // YS182u-_5.26 //
   iti śrīyāmye dharmaśāstre pañcamo 'dhyāyaḥ |	iti SrIyAmye Darma-SAstre paQcamaH aDyAyaH |
   samāpteyaṃ bṛhadyamasmṛtiḥ ||	samAptA-iyam bRhadyama-smRtiH ||
