abhiprvu.htm.txt	Abhinavagupta: Isvarapratyabhijnavimarsini, Adhikaras 1-4
abhisamu.htm.txt	Maitreyanatha: Abhisamayalamkaranamaprajnaparamitopadesasastram
abhisdhu.htm.txt	A Digital edition of the Abhisamacarika-Dharma
   of the Mahasamghika-Lokottaravadins
abhmal1u.htm.txt	Abhinavagupta: Malinislokavarttika
abhmal2u.htm.txt	Abhinavagupta: Malinislokavarttika
abhnispu.htm.txt	Abhayakaragupta: Nispannayogavali, chapter 1
abhsubhu.htm.txt	Abhidharmasamuccayabhasya
abhtantu.htm.txt	Abhinavagupta: Tantrasara
acatstvu.htm.txt	Amrtakara: Catuhstavasamasartha
adbhutdu.htm.txt	Adbhutadharmaparyaya
adhsatpu.htm.txt	Adhyardhasatika Prajnaparamita
adsp55-u.htm.txt	Astadasasahasrika Prajnaparamita
adsp70-u.htm.txt	Astadasasahasrika Prajnaparamita
adyappau.htm.txt	Adyanatha: Anuttaraprakasapancasika
adyappiu.htm.txt	Adyanatha: Anuttaraprakasapancasika
adyapppu.htm.txt	Adyanatha: Anuttaraprakasapancasika
aghatkvu.htm.txt	Ghatakarparakavya, with Abhinavagupta's Ghatakarparavivrti
agp_bi_u.htm.txt	Agni-Purana
agsas_1u.htm.txt	Agamasastra 1) Agamaprakarana (including Mandukya-Upanisad)
agsas_2u.htm.txt	Agamasastra 2) Vaitathyaprakarana
agsas_3u.htm.txt	Agamasastra 3) Advaitaprakarana
agsas_4u.htm.txt	Agamasastra 4) Alatasantiprakarana
ahovcs_u.htm.txt	Ahoratravratacaityasevanusamsavadana
ahovk1_u.htm.txt	Ahoratravratakatha
ahovk2_u.htm.txt	Ahoratravratakatha (Prose version)
aitupsbu.htm.txt	Aitareya-Upanisad (Aitareyopanisad) [RV]
aitup__u.htm.txt	Aitareya-Upanisad (Aitareyopanisad) [RV] Mula
ajitsvyu.htm.txt	Ajitasenavyakarana
ajm_u.htm.txt		Aryasura: Jatakamala 1-15
akadambu.htm.txt	Abhinanda: Kadambarikathasara
amark1hu.htm.txt	Amarasimha: Namalinganusasana [Amarakosa]
amark1pu.htm.txt	Amarasimha: Namalinganusasana [Amarakosa]
amark2_u.htm.txt	Amarasimha: Namalinganusasana [Amarakosa]
amark3_u.htm.txt	Amarasimha: Namalinganusasana [Amarakosa]
amaru_u.htm.txt	Amaru: Amarusataka
amoghapu.htm.txt	Amoghapasahrdayasutra
anandk_u.htm.txt	Anandakanda
andhvc1u.htm.txt	Anandavardhana: Dhvanyaloka
andhvc2u.htm.txt	Anandavardhana: Dhvanyaloka
andhvc3u.htm.txt	Anandavardhana: Dhvanyaloka
andhvc4u.htm.txt	Anandavardhana: Dhvanyaloka
andhvy_u.htm.txt	Anandavardhana: Dhvanyaloka[*1]
angirsau.htm.txt	Angirasasmrti
angirsiu.htm.txt	Angirasasmrti
angirspu.htm.txt	Angirasasmrti
anitysuu.htm.txt	Anityatasutra
antarkau.htm.txt	Annambhatta: Tarkasamgraha
antarkpu.htm.txt	Annambhatta: Tarkasamgraha (2)
antarkxu.htm.txt	Annambhatta: Tarkasamgraha (3)
antsdi_u.htm.txt	Annambhatta: Tarkasamgraha, with Dipika,  Nilakanta's Dipikaprakasika and Balapriya
anuttaru.htm.txt	Abhinavagupta: Anuttarastika
anvallcu.htm.txt	Anandabhatta: Vallalacarita
aparmyou.htm.txt	Abhinavagupta: Paramarthasara, with Yogaraja's Paramarthasarasamgrahavivrti
apastd_u.htm.txt	AAPASTAMBA DHARMASUUTRA
apastgcu.htm.txt	Apastamba-Grhyasutra, with Haradatta's Anakula
appvairu.htm.txt	Appayadiksita: Vairagyasataka
apsulbcu.htm.txt	Apastama-Sulbasutra with the commentaries of Kapardi, Karavinda and Sundararaja
apsulb_u.htm.txt	Apastama-Sulbasutra
arhebt2u.htm.txt	Arcata: Hetubindutika 
arhebt_u.htm.txt	Arcata: Hetubindutika
aryabhcu.htm.txt	Aryabhata: Aryabhatiya with the Commentary of Bhaskara
aryabh_u.htm.txt	Aryabhatiya
asabhs_u.htm.txt	Asanga: Abhidharmasamuccaya
asmahsbu.htm.txt	Asanga: Mahayanasutralamkara, with Vasubandhu's commentary
asmahsuu.htm.txt	Asanga: Mahayanasutralankara
astavgau.htm.txt	Astavakragita
astavgiu.htm.txt	Astavakragita
astavgpu.htm.txt	Astavakragita
asvbc_1u.htm.txt	ASVAGHOSA: BUDDHACARITA
asvbc_2u.htm.txt	ASVAGHOSA: BUDDHACARITA
asvbc_3u.htm.txt	ASVAGHOSA: BUDDHACARITA
asvbuc2u.htm.txt	Asvaghosa: Buddhacarita
asvgs_u.htm.txt	Asvalayana-Grhyasutra
asvsau2u.htm.txt	Asvaghosa: Saundarananda
asvsaunu.htm.txt	Asvaghosa: Saundarananda
asvss_u.htm.txt	Asvalayana-Srautasutra
asycsaru.htm.txt	Asanga: Sarirarthagatha of the Cintamayibhumi
atrisatu.htm.txt	Asanga: Trisatikayah prajnaparamitayah karikasaptatih
avpari_u.htm.txt	Atharvavedaparisistas
avpray_u.htm.txt	Atharvavedaprayascittani
avs_acu.htm.txt	Atharvaveda-Samhita, Saunaka recension
avsata_u.htm.txt	Avadanasataka
avs___u.htm.txt	Atharvaveda-Samhita, Saunaka recension (1)
ayuhparu.htm.txt	Ayuhparyantasutra
bahcar1u.htm.txt	Bana: Harsacarita
bahcar2u.htm.txt	Bana: Harsacarita
bahcar3u.htm.txt	Bana: Harsacarita
bahcar4u.htm.txt	Bana: Harsacarita
bahcar5_au.htm.txt	Bana: Harsacarita
bahcar5_pu.htm.txt	Bana: Harsacarita
bahcar6u.htm.txt	Bana: Harsacarita
bahcar7u.htm.txt	Bana: Harsacarita
bahcar8u.htm.txt	Bana: Harsacarita
bahcarpu.htm.txt	Bana: Harsacarita
bankad1u.htm.txt	Bana: Kadambari, Purvabhaga: Varnana 84-122 (end); with variant readings.
baudhd_u.htm.txt	BAUDHAYANA-DHARMASUTRA
bbdip11u.htm.txt	Badarayana: Brahmsutra, with the Bhasya by Madhva (Anandatirtha), and Jagannatha Tirtha's Dipika
bbdip12u.htm.txt	Badarayana: Brahmsutra, with the Bhasya by Madhva (Anandatirtha), and Jagannatha Tirtha's Dipika 
bbdip13u.htm.txt	Badarayana: Brahmsutra, with the Bhasya by Madhva (Anandatirtha), and Jagannatha Tirtha's Dipika 
bghsic_u.htm.txt	Buddhaghosa: Siddharthacaritrakavya
bhagvg_u.htm.txt	Bhagavadgita
bhairstu.htm.txt	Abhinavagupta: Bhairavastava
bhakavau.htm.txt	Bhamaha: Kavyalamkara
bhakaviu.htm.txt	Bhamaha: Kavyalamkara (1)
bhakavpu.htm.txt	Bhamaha: Kavyalamkara (2)
bhakirau.htm.txt	Bharavi: Kiratarjuniya
bhakiriu.htm.txt	Bharavi: Kiratarjuniya (1)
bhakirpu.htm.txt	Bharavi: Kiratarjuniya (2)
bhakirxu.htm.txt	Bharavi: Kiratarjuniya (3)
bhall_au.htm.txt	Bhallata: Bhallatasataka
bhall_iu.htm.txt	Bhallata: Bhallatasataka (1)
bhall_pu.htm.txt	Bhallata: Bhallatasataka (2)
bhall_xu.htm.txt	Bhallata: Bhallatasataka (3)
bharnatu.htm.txt	Bharata: Natyasastra
bharst_u.htm.txt	Bhartrhari: Satakatraya
bhasdutu.htm.txt	Bhasa: Dutavakya
bhassv_u.htm.txt	Bhasa: Svapnavasavadatta
bhattiku.htm.txt	Bhatti: Ravanavadha (Bhattikavya)
bhavpr_u.htm.txt	Bhavamisra: Bhavaprakasa (three chapters)
bhbhg_cu.htm.txt	Bhaskara: Bhagavadasayanusaranabhasya on the Bhagavadgita, Adhyayas 1-9
bhg4c01u.htm.txt	Bhagavadgita with the commentaries of Sridhara, Madhusudana, Visvanatha and Baladeva
bhg4c02u.htm.txt	Bhagavadgita with the commentaries of Sridhara, Madhusudana, Visvanatha and Baladeva
bhg4c03u.htm.txt	Bhagavadgita with the commentaries of Sridhara, Madhusudana, Visvanatha and Baladeva
bhg4c04u.htm.txt	Bhagavadgita with the commentaries of Sridhara, Madhusudana, Visvanatha and Baladeva
bhg4c05u.htm.txt	Bhagavadgita with the commentaries of Sridhara, Madhusudana, Visvanatha and Baladeva
bhg4c06u.htm.txt	Bhagavadgita with the commentaries of Sridhara, Madhusudana, Visvanatha and Baladeva
bhg4c07u.htm.txt	Bhagavadgita with the commentaries of Sridhara, Madhusudana, Visvanatha and Baladeva
bhg4c08u.htm.txt	Bhagavadgita with the commentaries of Sridhara, Madhusudana, Visvanatha and Baladeva
bhg4c09u.htm.txt	Bhagavadgita with the commentaries of Sridhara, Madhusudana, Visvanatha and Baladeva
bhg4c10u.htm.txt	Bhagavadgita with the commentaries of Sridhara, Madhusudana, Visvanatha and Baladeva
bhg4c11u.htm.txt	Bhagavadgita with the commentaries of Sridhara, Madhusudana, Visvanatha and Baladeva
bhg4c12u.htm.txt	Bhagavadgita with the commentaries of Sridhara, Madhusudana, Visvanatha and Baladeva
bhg4c13u.htm.txt	Bhagavadgita with the commentaries of Sridhara, Madhusudana, Visvanatha and Baladeva
bhg4c14u.htm.txt	Bhagavadgita with the commentaries of Sridhara, Madhusudana, Visvanatha and Baladeva
bhg4c15u.htm.txt	Bhagavadgita with the commentaries of Sridhara, Madhusudana, Visvanatha and Baladeva
bhg4c16u.htm.txt	Bhagavadgita with the commentaries of Sridhara, Madhusudana, Visvanatha and Baladeva
bhg4c17u.htm.txt	Bhagavadgita with the commentaries of Sridhara, Madhusudana, Visvanatha and Baladeva
bhg4c18u.htm.txt	Bhagavadgita with the commentaries of Sridhara, Madhusudana, Visvanatha and Baladeva
bhg4c__u.htm.txt	Bhagavadgita with the commentaries of Sridhara, Madhusudana, Visvanatha and Baladeva
bhgank_u.htm.txt	Bhasarvajna: Ganakarika, 1
bhgce__u.htm.txt	Bhagavadgita (Text based on the BORI edition of the Mahabharata)
bhgsbh_u.htm.txt	Bhagavadgita with the commentary ascribed to Samkara (Adhyayas 1-17)
bhikavau.htm.txt	Bhiksuni-Karmavacana (= BhīKaVā)
bhivin_u.htm.txt	Bhiksunivinaya
bhnstcau.htm.txt	Bhatta Narayana: Stavacintamani
bhnstcbu.htm.txt	Bhatta Narayana: Stavacintamani
bhnstciu.htm.txt	Bhatta Narayana: Stavacintamani
bhnstcpu.htm.txt	Bhatta Narayana: Stavacintamani
bhnstcxu.htm.txt	Bhatta Narayana: Stavacintamani
bhp_01u.htm.txt	Bhagavata-Purana 
bhp_02u.htm.txt	Bhagavata-Purana 
bhp_03u.htm.txt	Bhagavata-Purana 
bhp_04u.htm.txt	Bhagavata-Purana 
bhp_05u.htm.txt	Bhagavata-Purana 
bhp_06u.htm.txt	Bhagavata-Purana 
bhp_07u.htm.txt	Bhagavata-Purana 
bhp_08u.htm.txt	Bhagavata-Purana 
bhp_09u.htm.txt	Bhagavata-Purana 
bhp_10u.htm.txt	Bhagavata-Purana 
bhp1-12u.htm.txt	Bhagavata-Puranam (Skandhas 1 - 12)
bhp_11u.htm.txt	Bhagavata-Purana 
bhp_12u.htm.txt	Bhagavata-Purana 
bhpc101u.htm.txt	Bhagavata-Purana 10,29 - 33 with Sridhara's commentary (Bhavarthadipika).
bhrgus_u.htm.txt	Bhrgu-Samhita
bhutisbs_u.htm.txt	Bhuti(raja): Svabodhasiddhi
bhveni_u.htm.txt	Bhattanarayana: Venisamhara
bicaupau.htm.txt	Bilhana: Caurapancasika
bicaupiu.htm.txt	Bilhana: Caurapancasika
bicauppu.htm.txt	Bilhana: Caurapancasika
bicaupxu.htm.txt	Bilhana: Caurapancasika
bijaganu.htm.txt	Bhaskara: Bijaganita
bijnighu.htm.txt	Bijanighantu
bodhpanu.htm.txt	Abhinavagupta: Bodhapancadasika
bowermsu.htm.txt	Bower Manuscript.
brahmpau.htm.txt	Brahma-Purana, Adhyayas 1 - 246
brahmpiu.htm.txt	Brahma-Purana, Adhyayas 1 - 246 (2)
brahmppu.htm.txt	Brahma-Purana, Adhyayas 1 - 246 (3)
brahms2u.htm.txt	Badarayana: Brahmasutra
   Sutra text extracted from Samkara's Sarirakamimamsabhasya commentary
brahmsuu.htm.txt	Badarayana: Brahmasutra
brbiuppu.htm.txt	Brahmabindu-Upanisad
brhajj_u.htm.txt	Varahamihira: Brhajjataka
brhaspau.htm.txt	Brhaspatismrti: Vyavaharakanda
brhaspiu.htm.txt	Brhaspatismrti: Vyavaharakanda
brhasppu.htm.txt	Brhaspatismrti: Vyavaharakanda
brhasp_u.htm.txt	Brhaspatismrti
   Input by Yasuke Ikari and Akihiko Akamatsu
brhats_u.htm.txt	Varahamihira: Brhatsamhita
   (Version 4.3, May 8, 1998)
brhms5cu.htm.txt	Brahma-Samhita: Adhyaya 5
   with Jiva Gosvami's commentary Digdarsanatika
brkas_au.htm.txt	Buddhasvamin: Brhatkathaslokasamgraha
brkas_pu.htm.txt	Buddhasvamin: Brhatkathaslokasamgraha (2)
brkas_su.htm.txt	Buddhasvamin: Brhatkathaslokasamgraha (3)
brndp1_u.htm.txt	Brahmanda-Purana
   Part 1 (38 Adhyayas)
brndp2_u.htm.txt	Brahmanda-Purana
   Part 2 (74 Adhyayas)
brndp3_u.htm.txt	Brahmanda-Purana
   Part 3 (44 Adhyayas)
brsgor1u.htm.txt	Badarayana: Brahmasutra
   with Govindananda's Ratnaprabhavyakhya, 
brsgor2u.htm.txt	Badarayana: Brahmasutra
   with Govindananda's Ratnaprabhavyakhya, 
brsgor3u.htm.txt	Badarayana: Brahmasutra
   with Govindananda's Ratnaprabhavyakhya, 
brsgor4u.htm.txt	Badarayana: Brahmasutra
   with Govindananda's Ratnaprabhavyakhya, 
brsphutu.htm.txt	Brahmagupta: Brahmasphutasiddhanta
brssbh1u.htm.txt	Badarayana: Brahmasutra (1)
   with Samkara's Sarirakamimamsabhasya
brssbh2u.htm.txt	Badarayana: Brahmasutra (1)
   with Samkara's Sarirakamimamsabhasya
brssbh3u.htm.txt	Badarayana: Brahmasutra (1)
   with Samkara's Sarirakamimamsabhasya
brssbh4u.htm.txt	Badarayana: Brahmasutra (1)
   with Samkara's Sarirakamimamsabhasya
brssgo1u.htm.txt	Badarayana: Brahmasutra (2)
   with:
brssgo2u.htm.txt	Badarayana: Brahmasutra (2)
   with:
brssgo3u.htm.txt	Badarayana: Brahmasutra (2)
   with:
brssgo4u.htm.txt	Badarayana: Brahmasutra (2)
   with:
brsvbh1u.htm.txt	Badarayana: Brahmasutra (3)
   with Vacaspati's Bhamati (a subcommentary on Samkara's Brahmasutrabhasya)
brsvbh2u.htm.txt	Badarayana: Brahmasutra (3)
brsvbh3u.htm.txt	Badarayana: Brahmasutra (3)
   with Vacaspati's Bhamati (a subcommentary on Samkara's Brahmasutrabhasya)
brsvbh4u.htm.txt	Badarayana: Brahmasutra (3)
   with Vacaspati's Bhamati (a subcommentary on Samkara's Brahmasutrabhasya)
brupsb1u.htm.txt	Brhadaranyaka-Upanisad (Brhadaranyakopanisad), Kanva recension
   with the commentary ascribed to Samkara
brupsb2u.htm.txt	Brhadaranyaka-Upanisad (Brhadaranyakopanisad), Kanva recension
   with the commentary ascribed to Samkara
brupsb3u.htm.txt	Brhadaranyaka-Upanisad (Brhadaranyakopanisad), Kanva recension
   with the commentary ascribed to Samkara
brupsb4u.htm.txt	Brhadaranyaka-Upanisad (Brhadaranyakopanisad), Kanva recension
   with the commentary ascribed to Samkara
brupsb5u.htm.txt	Brhadaranyaka-Upanisad (Brhadaranyakopanisad), Kanva recension
   with the commentary ascribed to Samkara
brupsb6u.htm.txt	Brhadaranyaka-Upanisad (Brhadaranyakopanisad), Kanva recension
   with the commentary ascribed to Samkara
brupsb_u.htm.txt	Brhadaranyaka-Upanisad (Brhadaranyakopanisad), Kanva recension
   with the commentary ascribed to Samkara
brup___u.htm.txt	Brhadaranyaka-Upanisad (Brhadaranyakopanisad), Kanva recension
   with the commentary ascribed to Samkara
bsa001_u.htm.txt	Alambanapariksa
bsa002_u.htm.txt	Alambanapariksa with Alambanapariksavrtti
bsa003_u.htm.txt	Santideva: Bodhicaryavatara
bsa004_u.htm.txt	Bodhipathapradipa
bsa005_u.htm.txt	Dipamkara (Dipankara): Caryasamgrahapradipa
bsa006_u.htm.txt	Aryadeva: Cittavisuddhiprakarana
bsa007_u.htm.txt	Nagarjuna: Dharmasamgraha (Dharmasangraha)
bsa008_u.htm.txt	Garbhasamgraha
bsa009_u.htm.txt	Hastavalaprakaranavrtti
bsa010_u.htm.txt	Maitreya (attrib.): Madhyantavibhagakarika
bsa011_u.htm.txt	Dignaga: Prajnaparamitapindartha
bsa012_u.htm.txt	Nagarjuna: Pratityasamutpadahrdayakarika
bsa013_u.htm.txt	Nagarjuna: Pratityasamutpadahrdayavyakhyana
bsa014_u.htm.txt	Siksasamuccayakarika
bsa015_u.htm.txt	Nagarjuna: Suhrllekha
bsa016_u.htm.txt	Nagarjuna: Sunyatasaptati
bsa017_u.htm.txt	Tattvaratnavaloka
bsa018_u.htm.txt	Vasubandhu: Trimsikavijnaptikarika
bsa019_u.htm.txt	Vasubandhu: Trisvabhavanirdesa
bsa020_u.htm.txt	Asvaghosa (attrib.): Vajrasuci
bsa021_u.htm.txt	Nagarjuna: Vigrahavyavartini
bsa022_u.htm.txt	Vimsikavrtti
bsa023_u.htm.txt	Vimsatikakarika
bsa024_u.htm.txt	Dipamkara [=Dipankara]: Satyadvayavataranama
bsa025_u.htm.txt	Nagarjuna: Ratnavali (1-2.46, and 4; Sanskrit text of 2.47-95 and 3 lost!)
bsa026_u.htm.txt	Abhisamayalamkara
bsa027_u.htm.txt	Nagarjuna: Madhyamakasastra (Karika only!)
bsa028_u.htm.txt	Aryadeva: Catuhsatika
bsa030_u.htm.txt	Mahayanasutralamkara
bsa031_u.htm.txt	Abhisamayalankaravrttih sphutartha
bsa032_u.htm.txt	Aryasura: Jatakamala
bsa033_u.htm.txt	Abhisamayalankarantah patinam
bsa034_u.htm.txt	Bodhisattvabhumi
bsa035_u.htm.txt	Dipankarasrijnana 
bsa036_u.htm.txt	Dipankarasrijnana 
bsa037_u.htm.txt	Dipankarasrijnana 
bsa038_u.htm.txt	Dipankarasrijnana 
bsa039_u.htm.txt	Dipankarasrijnana 
bsa040_u.htm.txt	Dipankarasrijnana 
bsa041_u.htm.txt	Dipankarasrijnana 
bsa042_u.htm.txt	Dipankarasrijnana 
bsa043_u.htm.txt	Dipankarasrijnana 
bsa044_u.htm.txt	Nagarjuna: Kriyasamgrahakarika
bsa045_u.htm.txt	Asvaghosa: Gurupancasika
bsa046_u.htm.txt	Dignaga: Yogavatara
bsa047_u.htm.txt	Kamalasila: Bhavanakrama 
bsa048_u.htm.txt	Aryadeva: Caryamelavanapradipa
bsa050_u.htm.txt	Aryasura: Paramitasamasa
bsa051_u.htm.txt	Ratnakarasanti: Saratama
bsa052_u.htm.txt	Dharmasamuccaya
bsa053_u.htm.txt	Madhyamakavatara [Chapter 6 not available at present!]
bsa054_u.htm.txt	Prajnakaramati: Bodhicaryavatarapanjika
bsa0551u.htm.txt	Apohasiddhi
bsa0552u.htm.txt	Ksanabhangasiddhi
bsa0553u.htm.txt	Ksanabhangasiddih vyatirekatmika
bsa0554u.htm.txt	Panditasoka: Avayavinirakarana
bsa0555u.htm.txt	Panditasoka: Samanyadusanadikprasarita
bsa0556u.htm.txt	Antarvyaptisamarthana
bsa056_u.htm.txt	Asokavadana
bsa057_u.htm.txt	Dharmakirti: Nyayabindu Prakaranakarika.
bsa058_u.htm.txt	Maitreyanatha: Bhavasankrantitika
bsa059_u.htm.txt	Dharmakirti: Samtanantarasiddhi.
bsa060_u.htm.txt	Vararuci: Satagatha
bsa061_u.htm.txt	Vinitadeva: Samtanantarasiddhitika (with mula text; reconstructed)
bsa062_u.htm.txt	Nagarjuna: Salistambakakarika.
bsa063_u.htm.txt	Dharmakirti: Sambandhapariksa, with Prabhacandra's commentary
bsa064_u.htm.txt	Dharmakirti: Vadanyaya (Vn)
bsa065_u.htm.txt	Vasubandhu: Pancaskandhaprakarana
bsa066_u.htm.txt	Haribhadrasuri: Nyayapravesapravrtti
bsa067_u.htm.txt	Nagarjuna: Bhavasamkrantiparikatha (reconstructed text)
bsa068_u.htm.txt	Bhiksukarmavakya
bsa069_u.htm.txt	Tarkasastra (reconstructed text) (Tś)
bsa070_u.htm.txt	Upayahrdaya (reconstructed text)
bsa071_u.htm.txt	Dharmakirti: Hetubindu
bsa072_u.htm.txt	Tarkabhasa
bsa073_u.htm.txt	Ratnagotravibhaga
bsa075_u.htm.txt	Ratnakirti: Nibandhavali
bst-108u.htm.txt	108 Buddhist stotras
bsu001_u.htm.txt	Aryanityatasutra
bsu002_u.htm.txt	Amoghapasahrdaya nama mahayanasutram
bsu003_u.htm.txt	Aparimitayuhsutra
bsu004_u.htm.txt	Sarvatathagatosnisasitatpatra-nama-aparitamahapratyangiravidyarajni (Sitatapatra)
bsu005_u.htm.txt	Arthaviniscayasutra
bsu006_u.htm.txt	Ajitasenavyakarana
bsu007_u.htm.txt	Srimahadevivyakaranam
bsu008_u.htm.txt	Buddhabaladhanapratiharyavikurvananirdesanama Mahayanasutram
bsu009_u.htm.txt	Maitreyavyakaranam
bsu010_u.htm.txt	Bhavasankrantisutra
bsu011_u.htm.txt	Bodhisattvapratimoksasutra
bsu012_u.htm.txt	Bhaisajyaguruvaiduryaprabharajasutra
bsu013_u.htm.txt	Aryacaturdharmanirdesasutra
bsu014_u.htm.txt	Dasabhumikasutram
bsu015_u.htm.txt	Ekadasamukham
bsu016_u.htm.txt	Gandavyuhasutra
bsu017_u.htm.txt	Hayagrivavidya
bsu018_u.htm.txt	Karunapundarikasutra
bsu019_u.htm.txt	Karandavyuha
bsu020_u.htm.txt	Kasyapaparivartasutra
bsu021_u.htm.txt	Saddharmalankavatarasutra 
bsu022_u.htm.txt	Lalitavistara
bsu023_u.htm.txt	Madhyamakasalistambasutra
bsu024_u.htm.txt	Mahasannipataratnaketudharanisutra (Ratnaketuparivarta) (Parivartas 1-6,    10-11)
bsu025_u.htm.txt	Nairatmyapariprcchamahayanasutra
bsu026_u.htm.txt	Pratityasamutpadamahayanasutra
bsu027_u.htm.txt	Pratityasamutpadadivibhanganirdesasutra
bsu028au.htm.txt	Ratnagunasamcayagatha
bsu028iu.htm.txt	Ratnagunasamcayagatha
bsu028pu.htm.txt	Ratnagunasamcayagatha
bsu029_u.htm.txt	Rastrapalapariprccha 
bsu030_u.htm.txt	Suvikrantavikramipariprccha
bsu031_u.htm.txt	Salistambasutra
bsu032_u.htm.txt	Sukhavativyuha, Samksiptamatrka 
bsu033_u.htm.txt	Sukhavativyuha, Vistaramatrika 
bsu034_u.htm.txt	Samadhirajasutra
bsu035_u.htm.txt	Suvarnaprabhasasutra (Suvarnabhasottamasutra)
bsu036_u.htm.txt	Saddharmapundarikasutra
bsu037_u.htm.txt	Sarvatathagatadhisthanavyuhasutra
bsu038_u.htm.txt	Sagaranagarajapariprccha 
bsu039_u.htm.txt	Triskandhasutra
bsu040_u.htm.txt	Vinayaviniscaya upalipariprccha
bsu041_u.htm.txt	Manjusrimulakalpa
bsu045_u.htm.txt	Samghatasutra
bsu046_u.htm.txt	Mahasamghikanam pratimoksasutram
bsu049_u.htm.txt	Astasahasrika Prajnaparamita
bsu050_u.htm.txt	Svalpaksara prajnaparamita
bsu051_u.htm.txt	Vajracchedika Prajnaparamita
bsu052_u.htm.txt	Saptasatika prajnaparamita
bsu053_u.htm.txt	Prajnaparamitahrdayasutra [vistaramatrka]
bsu054_u.htm.txt	Prajnaparamitahrdayasutra [samksiptamatrka]
bsu055_u.htm.txt	Kausikaprajnaparamitasutra
bsu056_u.htm.txt	Adhyardhasatika prajnaparamita
bsu057_u.htm.txt	Advayasatika Prajnaparamitasutra
bsu058_u.htm.txt	Vinayasutram, 1: Pravrajyavastu
bsu059_u.htm.txt	Samyaksambuddhabhasitam Pratimalaksanam
bsu060_u.htm.txt	Karmavibhangopadesa
bsu061_u.htm.txt	Vimalakirtinirdesa
bsu062_u.htm.txt	Gunakarandavyuhasutra
bsu078_u.htm.txt	Ksemendra: Avadanakalpalata
   based on the edition by P.L. Vaidya. Avadāna-kalpalatā, 2 vols.
busto1_u.htm.txt	BUDDHIST STOTRAS
byogalbu.htm.txt	"Buddhist Yoga manual"
caitcanu.htm.txt	Prabodhananda Sarasvati Gosvami: Caitanyacandramrta
cakbh_au.htm.txt	Cakrapaninatha: Bhavopaharastotra
   (mula text extracted from the commented version)
cakbhavu.htm.txt	Cakrapaninatha: Bhavopaharastotra
   with Vivarana commentary by Ramyadeva Bhatta
cakbh_iu.htm.txt	Cakrapaninatha: Bhavopaharastotra
   (mula text extracted from the commented version)
cakbh_pu.htm.txt	Cakrapaninatha: Bhavopaharastotra
   (mula text extracted from the commented version)
canprasu.htm.txt	Candrakirti: Prasannapada 
cansisyu.htm.txt	Candragomin: Sisyalekha
caraka_u.htm.txt	Agnivesa: Carakasamhita
   with the Ayurvedadipika
chandovu.htm.txt	Chandoviciti
chupsb_u.htm.txt	Chandogya-Upanisad (Chandogyopanisad)
   with the commentary ascribed to Samkara
chup___u.htm.txt	Chandogya-Upanisad (Chandogyopanisad)
   Mula text extracted from the commented version.
damkuttu.htm.txt	Damodaragupta: Kuttanimata
danddk1u.htm.txt	DANDIN: DASAKUMARACARITA
   Ucchvasas 3, 5 & 6
danddk2u.htm.txt	DANDIN: DASAKUMARACARITA
   Ucchvasas 3, 5 & 6
dandkc_u.htm.txt	Dandin: Dasakumaracarita
dantyovu.htm.txt	Dantyosthavidhi
davyasou.htm.txt	Davuldena Jnanesvara Mahasthavira: Yasodharacarita
dbhp_dgu.htm.txt	Devigita (=Devibhagavata-Purana 7,31 - 40)
dbsu1-4u.htm.txt	DASABALASUTRA 1-4
devikaau.htm.txt	Devikalottara-Agama (Devikalottaragama; mula text only!)
devikaiu.htm.txt	Devikalottara-Agama (Devikalottaragama; mula text only!)
devikapu.htm.txt	Devikalottara-Agama (Devikalottaragama; mula text only!)
dhandasu.htm.txt	Dhananjaya: Dasarupaka, Paricchedas 1-4 (without Dhanika's exposition "Avaloka")
dhebta_u.htm.txt	Durveka Misra: Hetubindutikaloka
   (subcommentary on Arcata's Hetubindutika on Dharmakirti's Hetubindu)
dhkhetuu.htm.txt	DHARMAKIRTI: HETUBINDU
dhknyayu.htm.txt	DHARMAKIRTI: NYAYABINDU
   Input by Motoi Ono
dhkprviu.htm.txt	Dharmakirti: Pramanaviniscaya (fragment)
dhkprvku.htm.txt	DHARMAKIRTI: PRAMANAVARTTIKAKARIKA, CHAPTERS 2-4
   (without the Svarthanumana-chapter)
dhkpvsvu.htm.txt	DHARMAKIRTI: PRAMANAVARTTIKASVAVRTTI
   Input by Motoi Ono
dhksparu.htm.txt	DHARMAKIRTI: SAMBANDHAPARIKSA, VERSES 1-25
   Input by Motoi Ono
dhkvadnu.htm.txt	DHARMAKIRTI: VADANYAYA
dhnyabpu.htm.txt	Dharmakirti: Nyayabinduprakarana,  with Vinitadeva's Nyayabindutikasisyahita and Dharmottara's
dhoypavu.htm.txt	Dhoyi: Pavanaduta
dhppat_u.htm.txt	Patna Dharmapada
dhrasciu.htm.txt	Dhundhukanatha: Rasendracintamani
dhrmsk_u.htm.txt	Dharmaskandha
dhvajkdu.htm.txt	Dhvajagrakeyura-Dharani [alternative version]
dhvajkeu.htm.txt	Dhvajagrakeyura-Dharani
   Source unknown.
dhyggs_u.htm.txt	Dhyanacandra Gosvami: Gauragovindarcanasmaranapaddhati
dhyrkk_u.htm.txt	Dhyanacandra Gosvami: Radhakrsnastakaliyalilasmaranakramapaddhati
dipguhsu.htm.txt	Dipamkarabhadra: Guhyasamajamandalavidhi
divav29u.htm.txt	Asokavadana
divav33u.htm.txt	Sardulakarnavadana 
divyav_u.htm.txt	Divyavadana
dkavy12u.htm.txt	Dandin: Kavyadarsa, Paricchedas 1 and 2
dkavy1au.htm.txt	DANDIN: KAVYADARSA, Pariccheda 1
   based on the edition by S.K. Belvalkar, Poona 1924.
dkavy1pu.htm.txt	DANDIN: KAVYADARSA, Pariccheda 1 (2)
   based on the edition by S.K. Belvalkar, Poona 1924.
dkavy2au.htm.txt	DANDIN: KAVYADARSA, Pariccheda 2 (incomplete!): Verses 2.1-144, 310-368
   based on the edition by S.K. Belvalkar, Poona 1924.
dkavy2pu.htm.txt	DANDIN: KAVYADARSA, Pariccheda 2 (incomplete!): Verses 2.1-144, 310-368 (2)
   based on the edition by S.K. Belvalkar, Poona 1924.
dkavy3_u.htm.txt	Dandin: Kavyadarsa, Pariccheda 3
dramfrag_pu.htm.txt	Dramatic Fragments (buddhist)
dramfrag_tu.htm.txt	Dramatic Fragments (buddhist) (1)
dsp1-2_u.htm.txt	Dasasahasrika Prajnaparamita, chapter 1 and 2 translated from the Tibetan
durdhpru.htm.txt	Durvekamisra (c. 1100): Dharmottarapradipa 
dvavims_pu.htm.txt	Dvavimsatyavadanakatha
        I. punyaprotsahanakatha
dvavims_tu.htm.txt	Dvavimsatyavadanakatha
        I. punyaprotsahanakatha
dvtasutu.htm.txt	Devatasutra (GBM 1542.5 - 1545.3)
   Alpadevatasutra (GBM 1545.3 - 1545.8)
ekmuhr_u.htm.txt	Ekadasamukhahrdayam
   based on Nalinaksha Dutt: Giglit Manuscripts, Vol. 1, pp. 35--40
ekottaru.htm.txt	Ekottaragama (fragments).
gangtciu.htm.txt	Gangesa: Tattvacintamani, Sabdakhanda
   from Sabdapramanyavada to Jatisaktivada (incomplete)
ganphrdu.htm.txt	Ganapatihrdaya-Dharani
garbhupu.htm.txt	Garbha-Upanisad (Garbhopanisad)
garup1_u.htm.txt	Garuda-Purana
   Part 1
garup2_u.htm.txt	Garuda-Purana
   Part 2
garup3_u.htm.txt	Garuda-Purana
   Part 3
gaukarau.htm.txt	Gaudapada: Agamasastra (=Gaudapadakarika, Gaudapadiyakarika)
gaukarpu.htm.txt	Gaudapada: Agamasastra (=Gaudapadakarika, Gaudapadiyakarika) (1)
gaukarsu.htm.txt	Gaudapada: Agamasastra (=Gaudapadakarika, Gaudapadiyakarika) (2)
gaunys_u.htm.txt	Gautama: Nyayasutra
gautdhcu.htm.txt	Gautama: Dharmasutra, Adhyayas 1-3,    with Maskari's commentary (Gautamasmṛtibhāṣya)
gautdh_u.htm.txt	Gautama-Dharmasutra
ghatgu_u.htm.txt	Kusalamisra: Gudharthadipika
   on
ghers_au.htm.txt	Gheranda-Samhita
   Electronic text based on the edition:
ghers_bu.htm.txt	Gheranda-Samhita (1)
   Electronic text based on the edition:
ghers_pu.htm.txt	Gheranda-Samhita (2)
   Electronic text based on the edition:
ghers__u.htm.txt	Gheranda-Samhita (3)
   Electronic text based on the edition:
gmandk_u.htm.txt	Gaudapada: Mandukya-Upanisadkarika (Mandukyopanisadkarika,    also known as Gaudapadakarika, Mandukyakarika or Agamasastra)
gopbra_u.htm.txt	Gopathabrahmana
gopjatmu.htm.txt	Gopadatta: Jatakamala
gopthbru.htm.txt	Gopatha-Brahmana 1,1.1 - 1,3.6
goramaru.htm.txt	Goraksanatha: Amaraughasasana (with commentary)
gorst1au.htm.txt	Goraksanatha (=Gorakhnath): Goraksasataka
gorst1pu.htm.txt	Goraksanatha (=Gorakhnath): Goraksasataka (1)
gorst2au.htm.txt	Goraksanatha [= Gorakhnath]: Goraksasataka
gorst2pu.htm.txt	Goraksanatha [= Gorakhnath]: Goraksasataka (1)
gorst_iu.htm.txt	Goraksanatha (=Gorakhnath): Goraksasataka
govass_u.htm.txt	Govardhana (c. 12th cent.): Aryasaptasati
gp01-11u.htm.txt	Jiva Gosvamin: Gopalacampu, Purvacampu
gp12-22u.htm.txt	Jiva Gosvamin: Gopalacampu, Purvacampu
gp23-33u.htm.txt	Jiva Gosvamin: Gopalacampu, Purvacampu
grahmdhu.htm.txt	Grahamatrkanamadharani
grasht_u.htm.txt	Govindbhagavatpada: Rasahrdayatantra
   with Caturbhuja Misra's Mugdhavabodhini (comm.)
gu01-03u.htm.txt	Jiva Gosvami: Gopalacampu - Uttaracampu
gu05-06u.htm.txt	Jiva Gosvami: Gopalacampu - Uttaracampu
gu29___u.htm.txt	Jiva Gosvami: Gopalacampu - Uttaracampu
harinc_u.htm.txt	Datta, Kedaranatha (=Bhaktivinoda, 1838-1914): Harinamacintamani
harnagau.htm.txt	Harsadeva: Naganandanataka
hathyopu.htm.txt	Svatmarama: Hathayogapradipika
hbhvil_u.htm.txt	Gopalabhatta: Haribhaktivilasa, 1-11
hdratn_u.htm.txt	Harsadeva: Ratnavalinatika
hitop_u.htm.txt	Narayana: Hitopadesa
   (version 1.1)
hjatm_au.htm.txt	Haribhatta: Jatakamala, Jatakas 1-8, 11-12, 19-20, 22, 24, 26, 32, 35.
   - Jataka 1 based on the ed. by Michael Hahn: "How it all began: I.
hjatm_iu.htm.txt	Haribhatta: Jatakamala, Jatakas 1-8, 11-12, 19-20, 22, 24, 26, 32, 35. (1)
   - Jataka 1 based on the ed. by Michael Hahn: "How it all began: I.
hjatm_pu.htm.txt	Haribhatta: Jatakamala, Jatakas 1-8, 11-12, 19-20, 22, 24, 26, 32, 35. (2)
   - Jataka 1 based on the ed. by Michael Hahn: "How it all began: I.
hpriydau.htm.txt	Harsadeva: Priyadarsika
hpriydpu.htm.txt	Harsadeva: Priyadarsika (1)
hsasvrau.htm.txt	Haribhadrasuri: Sastravartasamuccaya
hsasvriu.htm.txt	Haribhadrasuri: Sastravartasamuccaya (1)
hsasvrpu.htm.txt	Haribhadrasuri: Sastravartasamuccaya (2)
hv_appau.htm.txt	Harivamsa, Appendix I.
hv_appiu.htm.txt	Harivamsa, Appendix I. (1)
hv_apppu.htm.txt	Harivamsa, Appendix I. (2)
hv_conau.htm.txt	Harivamsa, constituted text with star passages
hv_coniu.htm.txt	Harivamsa, constituted text with star passages (1)
hv_conpu.htm.txt	Harivamsa, constituted text with star passages (2)
hv_cumiu.htm.txt	Harivamsa (complete)
hvsatssu.htm.txt	Harivarman: Satyasiddhisastra
iskamatu.htm.txt	Isvarakrsna: Samkhyakarika (Samkhyasaptati), with Mathara's commentary
   Matharavrtti
iskar_u.htm.txt	Isvarakrsna: Samkhyakarika (Samkhyasaptati). (Mula)
   Mula text extracted from the version with Mathara's commentary
iskgaudu.htm.txt	Isvarakrsna: Samkhyakarika, with Gaudapada's Bhasya (commentary)
isupsb_u.htm.txt	Isa-Upanisad (Isopanisad or Isavasyopanisad), Kanva recension
   with the commentary ascribed to Samkara
isup___u.htm.txt	Isa-Upanisad (Isopanisad or Isavasyopanisad), Kanva recension (Mula)
   Mula text extracted from the commented version.
isvskaru.htm.txt	Isvarakrsna: Samkhyakarika
   Input by Ferenc Ruzsa
jagpranu.htm.txt	Jagannatha: Pranabharana, with auto-commentary
jagsudhu.htm.txt	Jagannatha: Sudhalahari
jaimigsu.htm.txt	Jaimini-Grhyasutra
   [no source given; cf. the ed. by Willem Caland: The Jaiminigṛhyasūtra
jaimsutu.htm.txt	Jaimini: Mimamsasutra
jalmugau.htm.txt	Jalhana: Mugdhopadesa
jalmugiu.htm.txt	Jalhana: Mugdhopadesa (1)
jalmugpu.htm.txt	Jalhana: Mugdhopadesa (2)
jalmugxu.htm.txt	Jalhana: Mugdhopadesa (3)
jatkstau.htm.txt	Jnanayasas: Jatakastava
jatkstiu.htm.txt	Jnanayasas: Jatakastava (1)
jatkstpu.htm.txt	Jnanayasas: Jatakastava (2)
jaycndau.htm.txt	Jayadeva (alias Piyusavarsa): Candraloka
jaycndiu.htm.txt	Jayadeva (alias Piyusavarsa): Candraloka (1)
jaycndpu.htm.txt	Jayadeva (alias Piyusavarsa): Candraloka (2)
jaygit1u.htm.txt	Jayadeva: Gitagovinda
jaygit2u.htm.txt	Jayadeva: Gitagovinda
jaymangu.htm.txt	Isvarakrsna: Samkhyakarika, with Samkara arya's Jayamangala commentary
jaytupau.htm.txt	Jayarasi: Tattvopaplavasimha
jaytuppu.htm.txt	Jayarasi: Tattvopaplavasimha (1)
jgrasg1u.htm.txt	Jagannatha Panditaraja: Rasagangadhara, Anana 1
   This etext is based upon the following four editions:
jithettu.htm.txt	Jitari: Hetutattvopadesa (= Htu)
jithetuu.htm.txt	Jitari: Hetutattvopadesa (2)
jivrkadu.htm.txt	Jiva Gosvamin: Radhakrsnarcanadipika
jivskd_u.htm.txt	Jiva Gosvamin: Samkalpakalpadruma
jnalokau.htm.txt	Jnanalokalamkara [Sarvabuddhaviṣayāvatārajñānālokālaṃkāra nāma
   mahāyānasūtra]
jnass01u.htm.txt	Jnanamrtasara-Samhita (also called "Narada-Pancaratra")
jonart_au.htm.txt	Jonaraja and Pseudo-Jonaraja: Rajatarangini
jonart_pu.htm.txt	Jonaraja and Pseudo-Jonaraja: Rajatarangini (1)
jsbh1-1u.htm.txt	Khandadeva: Bhattadipika, a commentary on Jaimini's Mimamsasutra
jsbh1-2u.htm.txt	Khandadeva: Bhattadipika, a commentary on Jaimini's Mimamsasutra
jsbh1-3u.htm.txt	Khandadeva: Bhattadipika, a commentary on Jaimini's Mimamsasutra
jsbh1-4u.htm.txt	Khandadeva: Bhattadipika, a commentary on Jaimini's Mimamsasutra
jsbh2-1u.htm.txt	Khandadeva: Bhattadipika, a commentary on Jaimini's Mimamsasutra
jsbh2-2u.htm.txt	Khandadeva: Bhattadipika, a commentary on Jaimini's Mimamsasutra
jsbh2-3u.htm.txt	Khandadeva: Bhattadipika, a commentary on Jaimini's Mimamsasutra
jsbh2-4u.htm.txt	Khandadeva: Bhattadipika, a commentary on Jaimini's Mimamsasutra
jsbh3-1u.htm.txt	Khandadeva: Bhattadipika, a commentary on Jaimini's Mimamsasutra
jsbh3-2u.htm.txt	Khandadeva: Bhattadipika, a commentary on Jaimini's Mimamsasutra
jsbh3-3u.htm.txt	Khandadeva: Bhattadipika, a commentary on Jaimini's Mimamsasutra
jsphustu.htm.txt	Jayaraksita: Sphutartha Srighanacarasamgrahatika
jssivpau.htm.txt	Jnanasambhu (c. 12th cent.): Sivapujastava
jssivpiu.htm.txt	Jnanasambhu (c. 12th cent.): Sivapujastava (1)
jssivppu.htm.txt	Jnanasambhu (c. 12th cent.): Sivapujastava (2)
jssivpxu.htm.txt	Jnanasambhu (c. 12th cent.): Sivapujastava (3)
jvkasipu.htm.txt	Jayaditya & Vamana: Kasikavrtti
jvkasixu.htm.txt	Jayaditya & Vamana: Kasikavrtti (1)
jvrtmsau.htm.txt	Jnanasrimitra: Vrttamalastuti
jvrtmsiu.htm.txt	Jnanasrimitra: Vrttamalastuti (1)
jvrtmspu.htm.txt	Jnanasrimitra: Vrttamalastuti (2)
jyopancu.htm.txt	Jyotirisvara Kavisekhara: Pancasayaka
   (source unknown)
kaivup_u.htm.txt	Kaivalya-Upanisad
kakumsau.htm.txt	Kalidasa: Kumarasambhava
kakumsiu.htm.txt	Kalidasa: Kumarasambhava (1)
kakumspu.htm.txt	Kalidasa: Kumarasambhava (2)
kalhans_u.htm.txt	Kalhana: Ardhanarisvarastotra
kalrs_au.htm.txt	Kalidasa: Rtusamhara
kalrs_iu.htm.txt	Kalidasa: Rtusamhara (1)
kalrs_pu.htm.txt	Kalidasa: Rtusamhara (2)
kamasufu.htm.txt	VATSYAYANA: KAMASUTRA (with notes)
   input by Jean Fezas
kamasutu.htm.txt	Vatsyayana, Kamasutram
   digitalized by Mizue Sugita
kamvchtu.htm.txt	Kamalasila: Vajracchedikatika (= Vajrṭ)
karatoau.htm.txt	Karatoyamahatmya
karatoiu.htm.txt	Karatoyamahatmya (1)
karatopu.htm.txt	Karatoyamahatmya (2)
kasyparu.htm.txt	Kasyapaparivartasutra
kathinau.htm.txt	Kathinavadana
kathop_u.htm.txt	Katha-Upanisad
katy1__u.htm.txt	Katyayanasmrti
katy2a_u.htm.txt	Katyayanasmrti
katy2piu.htm.txt	Katyayanasmrti
katy2p_u.htm.txt	Katyayanasmrti
kaulpradsam_u.htm.txt	Govind Kaul: Pradesasamgraha
        1.  Kaśmīrā Maṇḍalam
kausibru.htm.txt	Kausitaki-Brahmana (or Sankhayana-Brahmana)
   Input by Muneo Tokunaga, March-April, 1995
kaussu_u.htm.txt	Kausikasutra
kauthgsu.htm.txt	Kauthuma-Grhyasutra
   [no source given; cf. the ed. by Suryakanta: Kauthuma-Gṛhya, ed. with
kautil_u.htm.txt	Kautilya: Arthasastra
kavsttvu.htm.txt	Kavirajayati (=Kavirajagiri): Samkhyatattvapradipa
kbavk10u.htm.txt	Ksemendra: Garbhavakrantyavadana
kbavk64u.htm.txt	Sudhanakinnaryavadana
   from: Ksemendra: Avadanakalpalata (Avadana 64)
kbavk75u.htm.txt	Pratityasamutpadavadana
   from: Ksemendra: Bodhisattvavadanakalpalata (Avadana 75)
kbavk93u.htm.txt	Ksemendra: Bodhisattvavadanakalpalata, no. 93: Sumagadhavadana
   based on the edition by P.L. Vaidya, Ksemendra's Avadanakalpalata, vol.
kbss_1-u.htm.txt	Krsnadasa: Bhavanasarasamgraha, Lila's 1 & 2
kedvratu.htm.txt	Kedarabhatta (12th c.): Vrttaratnakara (sutra verses only)
keskaupu.htm.txt	Kesava: Kausikapaddhati
kestprau.htm.txt	Kesava: Samkhyatattvapradipika (or Samkhyarthatattvapradipika; according
   to colophon), 
khasrpsu.htm.txt	Khasarpanasadhana (= Khs)
kirtc_au.htm.txt	Kiranatantra, chapters 1-6
   with the commentary of Rāmakaṇṭha
kirtc_pu.htm.txt	Kiranatantra, chapters 1-6 (1)
   with the commentary of Rāmakaṇṭha
kirtm_au.htm.txt	Kiranatantra, chapters 1-6 (2)
   Mula text only (extracted from the commented version)
kirtm_iu.htm.txt	Kiranatantra, chapters 1-6 (3)
   Mula text (extracted from the commented version)
kirtm_pu.htm.txt	Kiranatantra, chapters 1-6 (4)
   Mula text only (extracted from the commented version)
klpdraiu.htm.txt	Kalpadrumavadanamala
klpdrapu.htm.txt	Kalpadrumavadanamala (1)
kmeghdau.htm.txt	Kalidasa: Meghaduta
kmeghdiu.htm.txt	Kalidasa: Meghaduta (1)
kmeghdpu.htm.txt	Kalidasa: Meghaduta (2)
kmeghvau.htm.txt	Kalidasa: Meghaduta, according to Vallabhadeva's commentary
kmeghviu.htm.txt	Kalidasa: Meghaduta, according to Vallabhadeva's commentary (2)
kmeghvpu.htm.txt	Kalidasa: Meghaduta, according to Vallabhadeva's commentary (3)
knavslou.htm.txt	Kambalapada: Navasloki (= Nś)
kragh_au.htm.txt	Kalidasa: Raghuvamsa
kragh_iu.htm.txt	Kalidasa: Raghuvamsa (1)
kragh_pu.htm.txt	Kalidasa: Raghuvamsa (2)
kramstou.htm.txt	Abhinavagupta: Kramastotra
krdipc_u.htm.txt	Kesava Kasmiri: Kramadipika
   With the commentary by Govinda Bhattacarya
ksakunau.htm.txt	Kalidasa: Abhijnanasakuntalam
ksakunpu.htm.txt	Kalidasa: Abhijnanasakuntalam (1)
ksakunxu.htm.txt	Kalidasa: Abhijnanasakuntalam (2)
ksbhm06u.htm.txt	Ksemendra: Bharatamanjari
   6. Bhismaparvan
ksbhm07u.htm.txt	Ksemendra: Bharatamanjari
   7. Dronaparvan
ksbhm08u.htm.txt	Ksemendra: Bharatamanjari
   8. Karnaparvan
ksbhm09u.htm.txt	Ksemendra: Bharatamanjari
   9. Salyaparvan
ksbhm10u.htm.txt	Ksemendra: Bharatamanjari
   10. Gadaparvan
ksbhm11u.htm.txt	Ksemendra: Bharatamanjari
   11. Sauptikaparvan
ksbhm12u.htm.txt	Ksemendra: Bharatamanjari
   12. Striparvan
ksbhm13u.htm.txt	Ksemendra: Bharatamanjari
   13. Santiparvan
ksbhm14u.htm.txt	Ksemendra: Bharatamanjari
   14. Asvamedhikaparvan
ksbhm15u.htm.txt	Ksemendra: Bharatamanjari
   15. Asramavasikaparvan
ksbhm16u.htm.txt	Ksemendra: Bharatamanjari
   16. Mausalaparvan
ksbhm17u.htm.txt	Ksemendra: Bharatamanjari
   17. Mahaprasthanikaparvan
ksbhm18u.htm.txt	Ksemendra: Bharatamanjari
   18. Svargaparvan
ksbhm19u.htm.txt	Ksemendra: Bharatamanjari
   19. Harivamsa
ksdarpau.htm.txt	Ksemendra: Darpadalana
ksdarpiu.htm.txt	Ksemendra: Darpadalana (1)
ksdarppu.htm.txt	Ksemendra: Darpadalana (2)
ksembodhv_u.htm.txt	Ksemaraja: Bodhavilasa
kskala_u.htm.txt	Ksemendra: Kalavilasa
   based on the ed. by Pandita Durgaprasada and Kasinatha Panduranga Paraba
ksmadhlu.htm.txt	Kamalasila: Madhyamakaloka
   (source unknown)
ksnarm_u.htm.txt	Ksemendra: Narmamala
ksyadndu.htm.txt	Kalidasa: Syamaladandaka
ktv_2-1u.htm.txt	Kumarila: Tantravarttika ad 2.1.1-4 (bhavarthadhikarana)
kubjt_au.htm.txt	Kubjikamatatantra
kubjt_iu.htm.txt	Kubjikamatatantra (2)
kubjt_pu.htm.txt	Kubjikamatatantra (3)
kukalpmu.htm.txt	Kumaralata: Kalpanamanditika
kulmukuu.htm.txt	Kulasekhara: Mukundamala
kumukumu.htm.txt	Kulasekhara: Mukundamala (1)
kunvjivu.htm.txt	Kuntaka: Vakroktijivita
   with Kuntaka's own commentary
kurmp1_u.htm.txt	Kurma-Purana
kurmp2_u.htm.txt	Kurma-Purana
kvrtrsuu.htm.txt	Kedarabhatta: Vrttaratnakara, with Sulhana's Sukavihrdayanandini (comm.)
laghbh_u.htm.txt	Rupa Gosvami: Laghubhagavatamrta
lagrvvju.htm.txt	Lagadha: Rgvedavedangajyotisa
lilavatu.htm.txt	Bhaskara: Lilavati
lip_1_au.htm.txt	Linga-Purana
lip_1_iu.htm.txt	Linga-Purana, Part 1 (Adhy. 1-108) (1)
lip_1_pu.htm.txt	Linga-Purana, Part 1 (Adhy. 1-108) (2)
lip_2__u.htm.txt	Linga-Purana 
lnksivsu.htm.txt	Lankesvara: Sivastuti
mabhedtu.htm.txt	Matrkabhedatantra
madhanuu.htm.txt	Madhva Anandatirtha: Anuvyakhyana,    a Dvaita verse commentary on Badarayana's Brahmasutra
madhsiddhb_u.htm.txt	Madhusudanasarasvati: Siddhantabindu
maghspvu.htm.txt	Magha: Sisupalavadha
mahama_u.htm.txt	Mahamantranusarini
mahpratu.htm.txt	Mahapratisaramahavidyarajni
maitrs_au.htm.txt	Maitrayani-Samhita
maitrs_pu.htm.txt	Maitrayani-Samhita (2)
maivy_au.htm.txt	Maitreyavyakarana (3) 
maivy_iu.htm.txt	Maitreyavyakarana (4)
maivy_pu.htm.txt	Maitreyavyakarana (5)
malinivu.htm.txt	Malinivijayottaratantra
   Adhikaras 1-4, 7, 11-17 based on the critical edition by Somadeva
mamkavpu.htm.txt	Mammata: Kavyaprakasa
mamkpbiu.htm.txt	Mammata: Kavyaprakasa
   With Vamanacarya Ramabhatta Jhalakikar's Balabodhini commentary.
mamkpb_u.htm.txt	Mammata: Kavyaprakasa
   With Vamanacarya Ramabhatta Jhalakikar's Balabodhini commentary.
mamkprku.htm.txt	Mammata: Kavyaprakasa (Karikavali)
manavgsu.htm.txt	Manava-Grhyasutra (=Maitrayaniyamanava-Grhyasutra)
mand_upu.htm.txt	MANDUKYA-UPANISAD
mandup_u.htm.txt	Mandukya-Upanisad (Mandukyopanisad)
   Mula text extracted from the commented version (see Agamasastra, 1)
manivdhu.htm.txt	Mahamanivipulavimanavisvasupratisthitaguhyaparamarahasyakalparaja-Dharani
manjn1au.htm.txt	Manjusrinamasamgiti
   Text based on: Davidson, Ronald M.: "The Litany of Names of Manjusri.
manjn1iu.htm.txt	Manjusrinamasamgiti
   Text based on: Davidson, Ronald M.: "The Litany of Names of Manjusri.
manjn1pu.htm.txt	Manjusrinamasamgiti
   Text based on: Davidson, Ronald M.: "The Litany of Names of Manjusri.
manjnsau.htm.txt	Manjusrinamasamgiti
manjnsiu.htm.txt	Manjusrinamasamgiti
manjnspu.htm.txt	Manjusrinamasamgiti
manu1__u.htm.txt	Manusmrti
   Typed, analyzed and proofread by M.YANO and Y.IKARI
manu2a_u.htm.txt	Manusmrti
   Typed, analyzed and proofread by M.YANO and Y.IKARI
manu2piu.htm.txt	Manusmrti
   Typed, analyzed and proofread by M.YANO and Y.IKARI
manu2p_u.htm.txt	Manusmrti
   Typed, analyzed and proofread by M.YANO and Y.IKARI
maricdhu.htm.txt	Maricinamadharani
matpra_u.htm.txt	Matrceta: Prasadapratibhodhava (= Satapancasatka)
mavadsuu.htm.txt	Mahavadanasutra
mbh_01_u.htm.txt	% Mahabharata: Adiparvan
   % Electronic text (C) Bhandarkar Oriental Research Institute, 
mbh_02_u.htm.txt	% Mahabharata: Sabhaparvan
   % Electronic text (C) Bhandarkar Oriental Research Institute, 
mbh_03_u.htm.txt	% Mahabharata: Aranyakaparvan
   % Electronic text (C) Bhandarkar Oriental Research Institute, 
mbh_04_u.htm.txt	% Mahabharata: Virataparvan
   % Electronic text (C) Bhandarkar Oriental Research Institute, 
mbh_05_u.htm.txt	% Mahabharata: Udyogaparvan
   % Electronic text (C) Bhandarkar Oriental Research Institute, 
mbh_06_u.htm.txt	% Mahabharata: Bhismaparvan
   % Electronic text (C) Bhandarkar Oriental Research Institute, 
mbh_07_u.htm.txt	% Mahabharata: Dronaparvan
   % Electronic text (C) Bhandarkar Oriental Research Institute, 
mbh_08_u.htm.txt	% Mahabharata: Karnaparvan
   % Electronic text (C) Bhandarkar Oriental Research Institute, 
mbh_09_u.htm.txt	% Mahabharata: Salyaparvan
   % Electronic text (C) Bhandarkar Oriental Research Institute, 
mbh_10_u.htm.txt	% Mahabharata: Sauptikaparvan
   % Electronic text (C) Bhandarkar Oriental Research Institute, 
mbh1-18u.htm.txt	% Mahabharata, Parvans 1 - 18
   % Electronic text (C) Bhandarkar Oriental Research Institute, 
mbh_11_u.htm.txt	% Mahabharata: Striparvan
   % Electronic text (C) Bhandarkar Oriental Research Institute, 
mbh_12_u.htm.txt	% Mahabharata: Santiparvan
   % Electronic text (C) Bhandarkar Oriental Research Institute, 
mbh_13_u.htm.txt	% Mahabharata: Anusasanaparvan
   % Electronic text (C) Bhandarkar Oriental Research Institute, 
mbh_14_u.htm.txt	% Mahabharata: Asvamedhikaparvan
   % Electronic text (C) Bhandarkar Oriental Research Institute, 
mbh_15_u.htm.txt	% Mahabharata: Asramavasikaparvan
   % Electronic text (C) Bhandarkar Oriental Research Institute, 
mbh_16_u.htm.txt	% Mahabharata: Mausalaparvan
   % Electronic text (C) Bhandarkar Oriental Research Institute, 
mbh_17_u.htm.txt	% Mahabharata: Mahaprasthanikaparvan
   % Electronic text (C) Bhandarkar Oriental Research Institute, 
mbh_18_u.htm.txt	% Mahabharata: Svargarohanaparvan
   % Electronic text (C) Bhandarkar Oriental Research Institute, 
mbrahsiu.htm.txt	Mandana Misra [Mandanamisra]: Brahmasiddhi
mdhvkmou.htm.txt	Madhva (Anandatirtha): Krsnamrtamaharnava
meghdksu.htm.txt	Kalidasa: Meghaduta
meghdk_u.htm.txt	Kalidasa: Meghaduta (1)
mekhdh_u.htm.txt	Mekhala-Dharani
mhvastuu.htm.txt	Mahavastu-Avadana
mimslovu.htm.txt	Kumarila Bhatta: Mimamsaslokavarttika
mimsvtku.htm.txt	Sucaritamisra: Mimamsaslokavarttikakasika
minsmaru.htm.txt	Minanatha: Smaradipika
mjnya01u.htm.txt	Madhava: Jaiminiyanyayamalavistara
mjnya02u.htm.txt	Madhava: Jaiminiyanyayamalavistara
mjnya03u.htm.txt	Madhava: Jaiminiyanyayamalavistara
mjnya04u.htm.txt	Madhava: Jaiminiyanyayamalavistara
mkarmviu.htm.txt	Mahakarmavibhanga (= MKV)
mkp1-93u.htm.txt	Markandeya-Purana, Adhyayas 1-93
   (Adhy. 94ff. not available at present)
mmatvipu.htm.txt	Mahendravarman I: Mattavilasaprahasana
mmayuvru.htm.txt	Mahamayurividyarajni (Mmvr)
m_mbhtnu.htm.txt	Madhva (Anandatirtha): Mahabharatatatparyanirnaya
mndvivau.htm.txt	Mandanamisra: Vibhramaviveka
mndviviu.htm.txt	Mandanamisra: Vibhramaviveka (2)
mndvivpu.htm.txt	Mandanamisra: Vibhramaviveka (2)
motik_1u.htm.txt	Moksopaya (also known as "Yogavasistha")
   with Bhaskarakantha's Tika
motik_2u.htm.txt	Moksopaya (also known as "Yogavasistha")
   with Bhaskarakantha's Tika
motik_3u.htm.txt	Moksopaya (also known as "Yogavasistha")
   with Bhaskarakantha's Tika
motik_4u.htm.txt	Moksopaya, 4. Sthitiprakarana
motik_au.htm.txt	Moksopaya (also known as "Yogavasistha")
   with Bhaskarakantha's Tika
motik_xu.htm.txt	Moksopaya (also known as "Yogavasistha")
   with Bhaskarakantha's Tika
mpratpru.htm.txt	Mahapratisara vidyarajni (= Mp)
mprsvdhu.htm.txt	Mahapratisaravidyadharani
mpsu_w_u.htm.txt	Mahaparinirvanasutra
mpvv_u.htm.txt	Mahapratisaravidyavidhi
mrgt14iu.htm.txt	Mrgendragama (=Mrgendra-Tantra)
   (Mula text only!)
mrgt14pu.htm.txt	Mrgendragama (=Mrgendra-Tantra)
   (Mula text only!)
mrgt1chu.htm.txt	Mrgendragama (=Mrgendratantra)
   1. Vidyapada 1 - 7.23, with Narayanakantha's Vrtti
mrgt1mau.htm.txt	Mrgendragama (=Mrgendratantra),    1. Vidyapada (Mula text only.)
mrgt1mpu.htm.txt	Mrgendragama (=Mrgendratantra),    1. Vidyapada (Mula text only.)
mrgt3cau.htm.txt	Mrgendragama (=Mrgendratantra)
   3. Caryapada, with Narayanakantha's Vrtti
mrgt3cpu.htm.txt	Mrgendragama (=Mrgendratantra)
   3. Caryapada, with Narayanakantha's Vrtti
mrgt3mau.htm.txt	Mrgendragama (=Mrgendratantra)
   3. Caryapada (mula text only!).
mrgt3miu.htm.txt	Mrgendragama (=Mrgendratantra)
   3. Caryapada (mula text only!)
mrgt3mpu.htm.txt	Mrgendragama (=Mrgendratantra)
   3. Caryapada (mula text only!).
mrgt4mau.htm.txt	Mrgendragama (=Mrgendratantra),    4. Yogapada
mrgt4mpu.htm.txt	Mrgendragama (=Mrgendratantra),    4. Yogapada
mrtvstsu.htm.txt	Mrtyuvancanasitatarasadhana (Mvsts) / SM 103
mrtvts_u.htm.txt	Mrtyuvancanatarasadhana (Mvts) / SM 102
mrtvutsu.htm.txt	Mrtyuvancanopadesatarasadhana (Mvupts) / SM 112
msabdvvu.htm.txt	Mammata: Sabdavyaparavicara
msbh1-7u.htm.txt	Jaimini: Mimamsasutra,    with Sabara's Bhasya, Adhyayas 1-7 (to be continued)
msitvatu.htm.txt	Mahasitavati vidyarajni
mspram_u.htm.txt	Mahasahasrapramardani
msubhs_u.htm.txt	Mahasubhashitasangraha, verses 1-9979
msudarsu.htm.txt	Mahasudarsanavadana (= MSuAv)
mtp176au.htm.txt	Matsyapurana, Adhyayas 1-176
mtp176iu.htm.txt	Matsyapurana, Adhyayas 1-176
mtp176pu.htm.txt	Matsyapurana, Adhyayas 1-176
muktacau.htm.txt	Raghunathadasa Gosvami: Muktacarita
mvir_sau.htm.txt	Mitramisra: Viramitrodaya, Samayaprakasa
nabodhsu.htm.txt	Narahari: Bodhasara
nagast_u.htm.txt	Nagarjuna: Acintyastava
nagbhc_u.htm.txt	Nagarjuna: Bodhicittavivarana (fragments)
nagcitau.htm.txt	Nagnajit: Citralaksana (= NCit)
nagcitiu.htm.txt	Nagnajit: Citralaksana (= NCit)
nagcitpu.htm.txt	Nagnajit: Citralaksana (= NCit)
nagdhdbu.htm.txt	Nagarjuna: Dharmadhatugarbhavivarana
naglok_u.htm.txt	Nagarjuna: Lokatitastava
nagmmk_u.htm.txt	Nagarjuna: Mulamadhyamakakarika
nagmyv_u.htm.txt	Nagarjuna: Mahayanavimsika
nagpancu.htm.txt	Nagarjuna: Pancakrama (= Pk)
nagpindu.htm.txt	Nagarjuna: Pindikrama (transmitted as the first krama of Nagarjuna's
   Pancakrama)
nagsaliu.htm.txt	Nagarjuna: Salistambakamahayanasutratika
nagsu_pu.htm.txt	Nagaropamasutra
nagsu_tu.htm.txt	Nagaropamasutra
nagvigvu.htm.txt	Nagarjuna: Vigrahavyavartani
nagvvy_u.htm.txt	Nagarjuna: Vigrahavyavartanikarika
nagysk_u.htm.txt	Nagarjuna: Yuktisastikakarika (fragments)
nagyuksu.htm.txt	Nagarjuna: Yuktisastikarika (= Yukti)
   Sanskrit reconstruction
namekvsu.htm.txt	Namaskaraikavimsatistotra
   [Tib. Namastāre-ekaviṃśatistotraguṇasahita (Tārā-ekaviṃśatistotra)]
narads_u.htm.txt	Naradasmrti
naray_bu.htm.txt	Narayaniya (Mahabharata 12.321-339)
   Input by Peter Schreiner
narayniu.htm.txt	Narayanabhatta: Narayaniya
narayriu.htm.txt	Narayaniya (Mahabharata 12.321-339)
   Input by Peter Schreiner
naray__u.htm.txt	Narayaniya (Mahabharata 12.321-339)
   Input by Peter Schreiner
nardp1_u.htm.txt	Narada-Purana (or Naradiya-Purana), Part 1
nardp2_u.htm.txt	Narada-Purana (or Naradiya-Purana), Part 2
nars2_au.htm.txt	Naradasmrti
nars2_iu.htm.txt	Naradasmrti
nars2_pu.htm.txt	Naradasmrti
narsekou.htm.txt	Naropa: Sekoddesa
narsipau.htm.txt	Narasimha-Purana
narsipiu.htm.txt	Narasimha-Purana
narsippu.htm.txt	Narasimha-Purana
ndbiuppu.htm.txt	Nadabindu-Upanisad
nidansyu.htm.txt	Nidanasamyukta (= NidSa)
niruktau.htm.txt	Yaska: Nirukta
nitkarpu.htm.txt	Nityakarmapujavidhi
nitrrk_u.htm.txt	Nityanathasiddha [alias Nemanatha]: Rasaratnakara
nkalivau.htm.txt	Nilakantha Diksita: Kalividambana
nkaliviu.htm.txt	Nilakantha Diksita: Kalividambana
nkalivpu.htm.txt	Nilakantha Diksita: Kalividambana
nkalivxu.htm.txt	Nilakantha Diksita: Kalividambana
nrat_1_u.htm.txt	Nagarjuna: Ratnavali, 1
nrat_2_u.htm.txt	Nagarjuna: Ratnavali, 2
nrat_4_u.htm.txt	Nagarjuna: Ratnavali, 3
nvtp1_1u.htm.txt	Udayana: Nyayavarttikatatparyaparisuddhi, Adhyaya 1,1
nvtp1_2u.htm.txt	Udayana: Nyayavarttikatatparyaparisuddhi, Adhyaya 1,2
nystik_u.htm.txt	Gautama: Nyayasutra
   with Vacaspatimisra's Nyayavarttikatatparyatika
nysu__1u.htm.txt	Jayatirtha: Nyayasudha,    a subcommentary on Madhva's Anuvyakhana, a commentary on Badarayana's
nysu__2u.htm.txt	Jayatirtha: Nyayasudha,    a subcommentary on Madhva's Anuvyakhyana, a commentary on Badarayana's
nysu__3u.htm.txt	Jayatirtha: Nyayasudha,    a subcommentary on Madhva's Anuvyakhana, a commentary on Badarayana's
nysu__4u.htm.txt	Jayatirtha: Nyayasudha,    a subcommentary on Madhva's Anuvyakhana, a commentary on Badarayana's
nysu51au.htm.txt	Gautama: Nyayasutra 5.1,    with Nyayasutrabhasya by Vatsyayana
nysu51pu.htm.txt	Gautama: Nyayasutra 5.1,    with Nyayasutrabhasya by Vatsyayana
nysu51xu.htm.txt	Gautama: Nyayasutra 5.1,    with Nyayasutrabhasya by Vatsyayana
nysvbh1u.htm.txt	Gautama: Nyayasutra
   with Vatsyayana's Nyayabhasya
nysvbh_u.htm.txt	Gautama: Nyayasutra
   with Vatsyayana's Nyayasutrabhasya
paddhs_u.htm.txt	Prasastapada: Padarthadharmasamgraha (commentary on Kanada's
   Vaisesikasutra)
padnscau.htm.txt	Padmagupta (alias Parimala): Navasahasankacarita
padnscpu.htm.txt	Padmagupta (alias Parimala): Navasahasankacarita
padnscsu.htm.txt	Padmagupta (alias Parimala): Navasahasankacarita
padnscxu.htm.txt	Padmagupta (alias Parimala): Navasahasankacarita
padyavlu.htm.txt	Rupa Gosvami (comp.): Padyavali
pamsuavu.htm.txt	Pamsupradana-Avadana
   Translitaeration based on facsimiles in: Gilgit Buddhist Manuscripts
paniniiu.htm.txt	Panini: Astadhyayi
paninipu.htm.txt	Panini: Astadhyayi
panini_u.htm.txt	Panini: Astadhyayi
paninixu.htm.txt	Panini: Astadhyayi
paraksau.htm.txt	Parasurama-Kalpasutra
   (a digest of Srividya, as system of worship of the Divine Mother)
parakspu.htm.txt	Parasurama-Kalpasutra
   (a digest of Srividya, as system of worship of the Divine Mother)
paratriu.htm.txt	Paratrimsika
paribhsu.htm.txt	Nagesa [=Nagojibhatta]: Paribhasendusekhara
parmartu.htm.txt	Abhinavagupta: Paramarthasara
pars1__u.htm.txt	Parasarasmrti
pars2_au.htm.txt	Parasaradharmasamhita (=Parasarasmrti): Kandas 1 & 2
   1) Acarakanda (Adhyayas 1-11)
pars2_iu.htm.txt	Parasaradharmasamhita (=Parasarasmrti): Kandas 1 & 2
   1) Acarakanda (Adhyayas 1-11)
pars2_pu.htm.txt	Parasaradharmasamhita (=Parasarasmrti): Kandas 1 & 2
   1) Acarakanda (Adhyayas 1-11)
partr_au.htm.txt	Paratrimsika
   (text extracted from the version
partr_iu.htm.txt	Paratrimsika
   (text extracted from the version
partr_pu.htm.txt	Paratrimsika
   (text extracted from the version
partrvau.htm.txt	Abhinavagupta: Paratrimsikavivarana
   (lacks the Apabhramsa passages)
partrvpu.htm.txt	Abhinavagupta: Paratrimsikavivarana
   (lacks the Apabhramsa passages)
parypanu.htm.txt	Abhinavagupta: Paryantapancasika
pasupbhu.htm.txt	Pasupatasutra
   with Kaundinya's Pancarthabhasya
pasupsau.htm.txt	Pasupatasutra
   text based on the edition by Krishnanda Sagar, Varanasi 1987
pasupspu.htm.txt	Pasupatasutra
   text based on the edition by Krishnanda Sagar, Varanasi 1987
patyogbu.htm.txt	Patanjali: Yogasutra with Bhasya (=Pātañjalayogaśāstra)
patyog_u.htm.txt	Patanjali: Yogasutra
pmbh_1su.htm.txt	Patanjali: Vyakaranamahabhasya (Mahabhasya)
pmbhassu.htm.txt	Patanjali: Vyakaranamahabhasya (Mahabhasya)
pmbhasuu.htm.txt	Patanjali: Vyakaranamahabhasya (Mahabhasya)
pncvbr1u.htm.txt	Pancavimsabrahmana
pncvbr2u.htm.txt	Pancavimsabrahmana
ppfrag_u.htm.txt	Fragments of Prajnaparamita texts (from 16 sources)
pplg1__u.htm.txt	Larger Prajnaparamita
pplg202u.htm.txt	Larger Prajnaparamita
   Gilgit manuscript, fol. 202r5-205r12 (GBM 571.5-577.12)
prajnhsu.htm.txt	Prajnaparamitahrdayasutra
prakassu.htm.txt	Prakasa-Samhita (a Pancaratra Samhita)
prakp01u.htm.txt	Salikanathamisra: Prakaranapancika,    with Jayapuri Narayanabhatta's Nyayasiddhi:
prakp02u.htm.txt	Salikanathamisra: Prakaranapancika,    with Jayapuri Narayanabhatta's Nyayasiddhi:
prakp03u.htm.txt	Salikanathamisra: Prakaranapancika,    with Jayapuri Narayanabhatta's Nyayasiddhi:
prakp04u.htm.txt	Salikanathamisra: Prakaranapancika,    with Jayapuri Narayanabhatta's Nyayasiddhi:
prakp05u.htm.txt	Salikanathamisra: Prakaranapancika,    with Jayapuri Narayanabhatta's Nyayasiddhi:
prakp06u.htm.txt	Salikanathamisra: Prakaranapancika,    with Jayapuri Narayanabhatta's Nyayasiddhi:
prakp07u.htm.txt	Salikanathamisra: Prakaranapancika,    with Jayapuri Narayanabhatta's Nyayasiddhi:
prakp08u.htm.txt	Salikanathamisra: Prakaranapancika,    with Jayapuri Narayanabhatta's Nyayasiddhi:
prakp09u.htm.txt	Salikanathamisra: Prakaranapancika,    with Jayapuri Narayanabhatta's Nyayasiddhi:
prakp10u.htm.txt	Salikanathamisra: Prakaranapancika,    with Jayapuri Narayanabhatta's Nyayasiddhi:
prakp11u.htm.txt	Salikanathamisra: Prakaranapancika,    with Jayapuri Narayanabhatta's Nyayasiddhi:
prakp12u.htm.txt	Salikanathamisra: Prakaranapancika,    with Jayapuri Narayanabhatta's Nyayasiddhi:
prakp13u.htm.txt	Salikanathamisra: Prakaranapancika,    with Jayapuri Narayanabhatta's Nyayasiddhi:
prakp14u.htm.txt	Salikanathamisra: Prakaranapancika,    with Jayapuri Narayanabhatta's Nyayasiddhi:
pramanvu.htm.txt	Pramanavartika
   (source unknown)
prasupbu.htm.txt	Prasna-Upanisad (Prasnopanisad)
   with the commentary ascribed to Samkara
prasup_u.htm.txt	Prasna-Upanisad (Prasnopanisad)
   Mula text extracted from commented version
pratyabu.htm.txt	Ksemaraja: Pratyabhijnahrdaya
prmosubu.htm.txt	Pratimoksasutra of the Mulasarvastivadins.
prmosufu.htm.txt	Pratimoksasutra (fragments)
prmosulu.htm.txt	Pratimoksasutram of the Lokottaravadimahasanghika
prmosu_u.htm.txt	Pratimoksasutra
ps27-43u.htm.txt	Pauskara-Samhita
psarkdhu.htm.txt	Pratisarakalpadharani
   Bsed on the edition "Pratisarākalpadhāraṇī". Dhīḥ Journal 28 (1999), eds.
psp_1u.htm.txt	Pañcaviṃśatisāhasrikā Prajñāpāramitā I
psp_2-3u.htm.txt	Pancavimsatisahasrika Prajnaparamita, II-III
psp_4u.htm.txt	Pancavimsatisahasrika Prajnaparamita, IV
psp_5u.htm.txt	Pancavimsatisahasrika Prajnaparamita, V
psp_6-8u.htm.txt	Pancavimsatisahasrika Prajnaparamita, VI-VIII
pspdut2u.htm.txt	Pancavimsatisahasrika Prajnaparamita
pspduttu.htm.txt	Pancavimsatisahasrika Prajnaparamita
purekaku.htm.txt	Purusottamadeva: Ekaksarakosa
purukadu.htm.txt	Pururavas: Kadambarisvikaranasutramanjari
pvspl_u.htm.txt	Pancavimsatisahasrika Prajnaparamita
rabhramu.htm.txt	Ratnakarasanti: Bhramaharanama Hevajrasadhana
raggancu.htm.txt	Raghavacaitanya: Mahaganapatistotra, with a commentary "by his disciple"
ragh1-6u.htm.txt	Kalidasa: Raghuvamsa (Kashmirian text, as read by Vallabhadeva)
rahppsau.htm.txt	Rahulabhadra: Prajnaparamitastotra
rahppsiu.htm.txt	Rahulabhadra: Prajnaparamitastotra
rahppspu.htm.txt	Rahulabhadra: Prajnaparamitastotra
rajkmimu.htm.txt	Rajasekhara: Kavyamimamsa,    Adhikarana 1 (the only part known so far)
rajnighu.htm.txt	Narahari Pandita [alias Nrsimha]: Rajanighantu [also called Nighanturaja, or Abhidhanacudamani], 
ram_01_u.htm.txt	Valmiki: Ramayana, 1. Balakanda
ram_02au.htm.txt	Valmiki (trad.): Ramayana: 2. Ayodhyakanda
ram_02pu.htm.txt	Valmiki (trad.): Ramayana: 2. Ayodhyakanda
ram_02su.htm.txt	Valmiki (trad.): Ramayana: 2. Ayodhyakanda
ram_02_u.htm.txt	Valmiki: Ramayana, 2. Ayodhyakanda
ram_03au.htm.txt	Valmiki (trad.): Ramayana: 3. Aranyakanda
ram_03pu.htm.txt	Valmiki (trad.): Ramayana: 3. Aranyakanda
ram_03_u.htm.txt	Valmiki: Ramayana, 3. Aranyakanda
ram_04_u.htm.txt	Valmiki: Ramayana, 4. Kiskindhakanda
ram_05_u.htm.txt	Valmiki: Ramayana, 5. Sundarakanda
ram_06_u.htm.txt	Valmiki: Ramayana, 6. Yuddhakanda
ram_07_u.htm.txt	Valmiki: Ramayana, 7. Uttarakanda
ram_1-7u.htm.txt	Valmiki: Ramayana, Kandas 1-7
ram2-3iu.htm.txt	Valmiki (trad.): Ramayana: Khandas 2-3
ramgbhau.htm.txt	Ramanuja: Bhagavadgitabhasya
ramgbhpu.htm.txt	Ramanuja: Bhagavadgitabhasya
ramodtau.htm.txt	Ramodanta
ramodtiu.htm.txt	Ramodanta
ramodtpu.htm.txt	Ramodanta
rams11au.htm.txt	Ramanuja: Sribhsya 1,1.3
rams11pu.htm.txt	Ramanuja: Sribhsya 1,1.3
ramvasau.htm.txt	Ramanuja: Vedarthasamgraha
ramvaspu.htm.txt	Ramanuja: Vedarthasamgraha
rasadhau.htm.txt	Rasadhyaya (with Tika), verses 1-302
rasadhiu.htm.txt	Rasadhyaya (with Tika), verses 1-302
rasadhpu.htm.txt	Rasadhyaya (with Tika), verses 1-302
rasadh_u.htm.txt	Rasadhyaya, with Rasadhyayatika (comm.), Adhyaya 1.
rasarnau.htm.txt	Rasarnava, Patalas 1-12
rasarniu.htm.txt	Rasarnava, Patalas 1-12
rasarnpu.htm.txt	Rasarnava, Patalas 1-12
rascum_u.htm.txt	Somadeva: Rasendracudamani, chapters 3-5, 7-16
rassanku.htm.txt	Camunda (Kayastha [= Kayasthacamunda], or Canda; around 1490 CE): Rasasamketakalika [=Rasasanketakalika]
ratksanu.htm.txt	Ratnakirti: Ksanabhangasiddhir Vyatirekatmika
ratnakeu.htm.txt	Mahasannipataratnaketudharanisutra, or Ratnaketuparivarta (=RKP)
ratnml_u.htm.txt	Ratnamālāvadāna
rgvidh_u.htm.txt	Rgvidhana
rmc1-3au.htm.txt	Abhinanda: Ramacaritamahakavya, 1-3 (to be continued)
rmc1-3pu.htm.txt	Abhinanda: Ramacaritamahakavya, 1-3 (to be continued)
rmc1-3xu.htm.txt	Abhinanda: Ramacaritamahakavya, 1-3 (to be continued)
rnatc__u.htm.txt	Rupa Gosvami: Natakacandrika (RNc)
ruphamdu.htm.txt	Rupa Gosvami: Hamsaduta
ruphbr_u.htm.txt	Rupa Gosvamin: Haribhaktirasamrtasindhu
ruyalscu.htm.txt	Ruyyaka: Alamkarasarvasva (Sutras only!)
   with Vidyacakravartin's commentary "Samjivani", 
ruyalssu.htm.txt	Ruyyaka: Alamkarasarvasva
   Sutras 1 - 34 (incomplete; remainder of 34 upto 87 not available).
ruyalsvu.htm.txt	Ruyyaka: Alamkarasarvasva
   with Jayaratha's commentary "Vimarsini", 
ruysahlu.htm.txt	Ruyyaka: Sahrdayalila
rv_01_u.htm.txt	RGVEDA 1
rv_02_u.htm.txt	RGVEDA 2
rv_03_u.htm.txt	RGVEDA 3
rv_04_u.htm.txt	RGVEDA 4
rv_05_u.htm.txt	RGVEDA 5
rv_06_u.htm.txt	RGVEDA 6
rv_07_u.htm.txt	RGVEDA 7
rv_08_u.htm.txt	RGVEDA 8
rv_09_u.htm.txt	RGVEDA 9
rv_10_u.htm.txt	RGVEDA 10
rvadrahu.htm.txt	Ratnakirti (?): Vadarahasya, also known as Udayananirakarana
rvh1-10u.htm.txt	Rgveda
rv_hn01u.htm.txt	Rgveda, Mandala 1
rv_hn02u.htm.txt	Rgveda, Mandala 2
rv_hn03u.htm.txt	Rgveda, Mandala 3
rv_hn04u.htm.txt	Rgveda, Mandala 4
rv_hn05u.htm.txt	Rgveda, Mandala 5
rv_hn06u.htm.txt	Rgveda, Mandala 6
rv_hn07u.htm.txt	Rgveda, Mandala 7
rv_hn08u.htm.txt	Rgveda, Mandala 8
rv_hn09u.htm.txt	Rgveda, Mandala 9
rv_hn10u.htm.txt	Rgveda, Mandala 10
rvkhilau.htm.txt	The Khila Verses of the Rgveda
rvpp_01u.htm.txt	Rgveda-Samhita: Padapatha text
   Mandala 1
rvpp_02u.htm.txt	Rgveda-Samhita: Padapatha text
   Mandala 2
rvpp_03u.htm.txt	Rgveda-Samhita: Padapatha text
   Mandala 3
rvpp_04u.htm.txt	Rgveda-Samhita: Padapatha text
   Mandala 4
rvpp_05u.htm.txt	Rgveda-Samhita: Padapatha text
   Mandala 5
rvpp_06u.htm.txt	Rgveda-Samhita: Padapatha text
   Mandala 6
rvpp_07u.htm.txt	Rgveda-Samhita: Padapatha text
   Mandala 7
rvpp_08u.htm.txt	Rgveda-Samhita: Padapatha text
   Mandala 8
rvpp_09u.htm.txt	Rgveda-Samhita: Padapatha text
   Mandala 9
rvpp_10u.htm.txt	Rgveda-Samhita: Padapatha text
   Mandala 10
sabbha1u.htm.txt	Sabara: Mimamsasutrabhasya ad Jaimini's Mimamsasutra 1,1.1-5
sabhivpu.htm.txt	Sabhikasaugatasasanapravrajyavratacaranaparivarta
sadhdipu.htm.txt	Radhakrsnadasa Gosvami: Sadhanadipika
saivjvbu.htm.txt	CUMULATIVE PADA INDEX of metric Sanskrit portions
   of Javano-Balinese Saiva texts
saivrliu.htm.txt	CUMULATIVE PADA INDEX OF METRIC SAIVA TEXTS
salrasmu.htm.txt	Salinatha: Rasamanjari
samanv_u.htm.txt	Kuḍaka's Samanvayadiś (SD)
samapviu.htm.txt	Susena: Ayurvedamahodadhau Annapanavidhi
samavedu.htm.txt	Samaveda-Samhita
samghscu.htm.txt	Samghatasutra (alternative version).
samkaubh_u.htm.txt	Samkara (attrib.): Kathopanisadbhasya
samkhsuu.htm.txt	Kapila (trad. author): Samkhyasutra,    [including the Tattvasamasa, an abstract of Sāṃkhya philosophy (appended
samkupad_u.htm.txt	Samkara: Upadesasahasri
samyu_wu.htm.txt	Samyuktagama (966-972 according to the Chinese canon)
sankharu.htm.txt	Sankhayana-Aranyaka
sankhgsu.htm.txt	Sankhayana-Grhyasutra
   On the basis of the edition by Hermann Oldenberg, 
sankhssu.htm.txt	Sankhayana-Srautasutra
sanss01u.htm.txt	Santideva: Siksasamuccaya
   1. Danaparamita
sanss02u.htm.txt	Santideva: Siksasamuccaya
   2. Saddharmaparigraha
sanss03u.htm.txt	Santideva: Siksasamuccaya
   3. Dharmabhanakadiraksa
sanss04u.htm.txt	Santideva: Siksasamuccaya, 4
sanss05u.htm.txt	Santideva: Siksasamuccaya
   5. Anarthavivarjana
sanss06u.htm.txt	Santideva: Siksasamuccaya
   6. Atmabhavaraksa
sanss07u.htm.txt	Santideva: Siksasamuccaya
   7. Bhogapunyaraksa
sanss08u.htm.txt	Santideva: Siksasamuccaya
   8. Papasodhana
sanss09u.htm.txt	Santideva: Siksasamuccaya
   9. Ksantiparamita
sanss10u.htm.txt	Santideva: Siksasamuccaya
   10. Viryaparamita
sanss11u.htm.txt	Santideva: Siksasamuccaya
   11. Aranyasamvarnana
sanss12u.htm.txt	Santideva: Siksasamuccaya
   12. Cittaparikarma
sanss13u.htm.txt	Santideva: Siksasamuccaya
   13. Smrtyupasthanaparicchedah
sanss14u.htm.txt	Santideva: Siksasamuccaya
   14. Atmabhavaparisuddhi
sanss15u.htm.txt	Santideva: Siksasamuccaya
   15. Bhogapunasuddhi
sanss16u.htm.txt	Santideva: Siksasamuccaya
   16. Bhadracaryavidhi
sanss17u.htm.txt	Santideva: Siksasamuccaya
   17. Vadananusamsa
sanss18u.htm.txt	Santideva: Siksasamuccaya
   18. Ratnatrayanusmrti
sanss19u.htm.txt	Santideva: Siksasamuccaya
   19. (Punyavrddhi)
sanssr_au.htm.txt	Santideva: Siksasamuccaya
        I. danaparamita
sanssr_pu.htm.txt	Santideva: Siksasamuccaya
        I. danaparamita
santbcau.htm.txt	Santideva: Bodhicaryavatara
santbciu.htm.txt	Santideva: Bodhicaryavatara
santbcpu.htm.txt	Santideva: Bodhicaryavatara
santts_u.htm.txt	Santaraksita: Tattvasamgraha
sarvmtsu.htm.txt	Sarvamatasamgraha
sarvttsu.htm.txt	Sarvatathagatatattvasamgraha
sastrdiu.htm.txt	Parthasarathi Misra: Sastradipika
   (Jaimini's Mimamsasutra 1,1.1-23)
satvtanu.htm.txt	Satvatatantra
saulahau.htm.txt	Samkara (attrib.): Saundaryalahari
saulahiu.htm.txt	Samkara (attrib.): Saundaryalahari
saulahpu.htm.txt	Samkara (attrib.): Saundaryalahari
sb_01_u.htm.txt	SATAPATHA-BRAHMANA 1
sb_02_u.htm.txt	SATAPATHA-BRAHMANA 2
sb_03_u.htm.txt	SATAPATHA-BRAHMANA 3
sb_04_u.htm.txt	SATAPATHA-BRAHMANA 4
sb_05_u.htm.txt	SATAPATHA-BRAHMANA 5
sb_06_u.htm.txt	SATAPATHA-BRAHMANA 6
sb_07_u.htm.txt	SATAPATHA-BRAHMANA 7
sb_08_u.htm.txt	SATAPATHA-BRAHMANA 8
sb_09_u.htm.txt	SATAPATHA-BRAHMANA 9
sb_10_u.htm.txt	SATAPATHA-BRAHMANA 10
sb_11_u.htm.txt	SATAPATHA-BRAHMANA 11
sb_13_u.htm.txt	SATAPATHA-BRAHMANA 13
sb_14_u.htm.txt	SATAPATHA-BRAHMANA 14
sbhami_u.htm.txt	Samantabhadra: Aptamimamsa
sbpramvu.htm.txt	Sakyabuddhi: Pramanavarttikatika
sdahennu.htm.txt	Srinivasamakhi Vedantadesika: Dasavidhahetunirupana (part of the
   Vaikhanasasutratatparyacintamani)
sdahen_u.htm.txt	Srinivasamakhi Vedantadesika: Dasavidhahetunirupana (part of the
   Vaikhanasasutratatparyacintamani)
sdurst_u.htm.txt	Sarvadurgatiparisodhana Tantra
sghancsu.htm.txt	Srighanacarasamgraha (=Śghs)
   reconstructed by Sanghasena Singh from Jayaraksita's
simhrsku.htm.txt	Simhabhupala: Rasarnavasudhakara (only karikas)
simhrs_u.htm.txt	Simhabhupala: Rasarnavasudhakara
sirup_u.htm.txt	Sira-Upanisad (= Atharvasira-Upanisad)
sivap1_u.htm.txt	Siva-Purana, Book 1 (Vidyesvara-Samhita)
sivap7_u.htm.txt	Siva-Purana, Book 7 (Vayaviya-Samhita), parts 1 and 2
sivmstau.htm.txt	Sivamahimnastava
sivmstpu.htm.txt	Sivamahimnastava
sivmstxu.htm.txt	Sivamahimnastava
sivsutru.htm.txt	Sivasutra (with Vartika)
sivup_au.htm.txt	Siva-Upanisad
sivup_pu.htm.txt	Siva-Upanisad
sivup_su.htm.txt	Siva-Upanisad - PADA-INDEX
sjdh_u.htm.txt	Sarvajnatakaradharani
skp031au.htm.txt	Skandapurana (Adhyayas 1 - 31.14; to be continued)
skp031iu.htm.txt	Skandapurana (Adhyayas 1 - 31.14; to be continued)
skp031pu.htm.txt	Skandapurana (Adhyayas 1 - 31.14; to be continued)
skprevku.htm.txt	Skanda-Purana: Revakhanda (RKS)
snyayvau.htm.txt	Siddhasena Mahamati: Nyayavatara,    with the Nyayavataravivrti commentary by Siddharsi-ganin
snyayvpu.htm.txt	Siddhasena Mahamati: Nyayavatara,    with the Nyayavataravivrti commentary by Siddharsi-ganin
sokss_mu.htm.txt	Somadeva: Kathasaritsagara
sokss_pu.htm.txt	Somadeva: Kathasaritsagara
soksvpau.htm.txt	Somadeva: Kathasaritsagara, Vetalapancavimsatika (= SoKs_12,8.21 - 32.41)
soksvppu.htm.txt	Somadeva: Kathasaritsagara, Vetalapancavimsatika (= SoKss_12,8.21 - 32.41)
somsv_u.htm.txt	Somananda: Saktavijnana
spandkau.htm.txt	  ----------------------------------------------------------------------
sparibhu.htm.txt	Samkhyaparibhasa
srabhusu.htm.txt	Asanga: Sravakabhumi
srabhu_u.htm.txt	Sravakabhumi
srajsgiu.htm.txt	Samadhirajasutra (transliteration of Gilgit ms.)
   Chapters 1-11, 13, 15-22
sratrpau.htm.txt	Srikantha: Ratnatrayapariksa
sratrpiu.htm.txt	Srikantha: Ratnatrayapariksa
sratrppu.htm.txt	Srikantha: Ratnatrayapariksa
srngt_pu.htm.txt	Rudrabhatta: Srngaratilaka
srngt_su.htm.txt	Rudrabhatta: Srngaratilaka
srngt_vu.htm.txt	Rudrabhatta: Srngaratilaka
ss1_tatu.htm.txt	Jiva Gosvami: Satsamdarbha, part 1: Tattvasamdarbha
ss2_bhgu.htm.txt	Jiva Gosvami: Satsamdarbha, part 2: Bhagavatsamdarbha
ss3_paru.htm.txt	Jiva Gosvami: Satsamdarbha, part 3: Paramatmasamdarbha
ss4_krsu.htm.txt	Jiva Gosvami: Satsamdarbha, part 4: Krsnasamdarbha
ss5_bhku.htm.txt	Jiva Gosvami: Satsamdarbha, part 5: Bhaktisamdarbha
ss6_priu.htm.txt	Jiva Gosvami: Satsamdarbha, part 6: Pritisamdarbha
sspp2_1u.htm.txt	Satasahasrika Prajnaparamita II-1
sspp2_2u.htm.txt	Satasahasrika Prajnaparamita, II-2
sspp2_3u.htm.txt	Satasahasrika Prajnaparamita II-3
sspp2_4u.htm.txt	Satasahasrika Prajnaparamita II-4
sthtvbhu.htm.txt	Trimsikavijnaptibhasya
stkal_au.htm.txt	Sardhatrisatikalottaragama
stkal_iu.htm.txt	Sardhatrisatikalottaragama
stkal_pu.htm.txt	Sardhatrisatikalottaragama
stuplaku.htm.txt	Stupalaksanakarikavivecanam
subhrk_u.htm.txt	Subhasitaratnakarandakatha
sukhvylu.htm.txt	SUKHAVATIVYUHA
sukhvysu.htm.txt	THE SMALLER SUKHAVATIVYUHA
suksaptu.htm.txt	Sukasaptati
sumagavu.htm.txt	Sumagadhavadana
   based on the edition by Yutaka Iwamoto: Sumagadhavadana.
sunytjsu.htm.txt	Sunyasamadhipada: Tattvajnanasamsiddhi
surysidu.htm.txt	Suryasiddhanta
suvasavu.htm.txt	Subandhu: Vasavadatta
suvrnavu.htm.txt	Suvarnavarnavadana (sutra)
svabhupu.htm.txt	Svayambhupurana (= SvayambhuP)
svact_au.htm.txt	Svacchandatantra [or Svacchandabhairavatantra]
   (Mula text only)
svact_iu.htm.txt	Svacchandatantra [or Svacchandabhairavatantra]
   (Mula text only)
svact_pu.htm.txt	Svacchandatantra [or Svacchandabhairavatantra]
   (Mula text only)
svetu_au.htm.txt	Svetasvatara-Upanisad (Svetasvataropanisad)
svetugau.htm.txt	Svetasvatara-Upanisad (Svetasvataropanisad)
svetugiu.htm.txt	Svetasvatara-Upanisad (Svetasvataropanisad)
svetugpu.htm.txt	Svetasvatara-Upanisad (Svetasvataropanisad)
svetu_iu.htm.txt	Svetasvatara-Upanisad (Svetasvataropanisad)
svetu_pu.htm.txt	Svetasvatara-Upanisad (Svetasvataropanisad)
sypadatu.htm.txt	Udicya Syamilaka: Padataditaka
tantralu.htm.txt	Abhinavagupta: Tantraloka
tarasdhu.htm.txt	Tarasragdharastotra
tarb108u.htm.txt	Tarabhattarikanamastottarasatakastotra
tarkrplu.htm.txt	Pratyaksalaksana text of Tarkarahasya
tarkrsau.htm.txt	Tarkarahasya
tatsuvru.htm.txt	Tattvasamasasutravrtti, or Kramadipika (cf. final verse),    a commentary on the Tattvasamāsa, an abstract of Sāṃkhya philosophy in
tattvmiu.htm.txt	Tattvamimamsa
tbimbk_u.htm.txt	Tathagatabimbakarapanasutra
tikaniku.htm.txt	Varahamihira: Tikanikayatra
timudghu.htm.txt	Timirodghāṭana (plus short Nirvāṇakārikā at the end)
todaltau.htm.txt	Todalatantra
todaltiu.htm.txt	Todalatantra
todaltpu.htm.txt	Todalatantra
tsc_bhau.htm.txt	Bhavaganesa [or Ganesadiksita]: Tattvayatharthyadipana,    a commentary on the Tattvasamāsa, an abstract of Sāṃkhya philosophy in
tsc_simu.htm.txt	Simanandadiksita [= Ksemananda/Ksemendra (?)]: Samkhyatattvavivecana,    a commentary on the Tattvasamāsa, an abstract of Sāṃkhya philosophy in
tsc_vivu.htm.txt	Samkhyasutravivarana,    a commentary on the Tattvasamāsa, an abstract of Sāṃkhya philosophy in
ttrkhy1u.htm.txt	Tantrākhyāyika 1
ttrkhy2u.htm.txt	Tantrākhyāyika 2
ttssarvu.htm.txt	Sarvopakarani,    a commentary on the Tattvasamasa, an abstract of Sāṃkhya philosophy in 22
tttvsamu.htm.txt	Tattvasamasa, an abstract of Sāṃkhya philosophy in (23-) 25 sūtras,    IN FOUR ALTERNATIVE VERSION.
udanav_u.htm.txt	Udanavarga
uddamt_u.htm.txt	Uddamaresvaratantra
uddkokau.htm.txt	Uddanda: Kokilasamdesa
uddkokiu.htm.txt	Uddanda: Kokilasamdesa
uddkokpu.htm.txt	Uddanda: Kokilasamdesa
udkassku.htm.txt	Udbhata: Kavyalamkarasarasamgraha,    Karikas (extracted from the commented version)
udkass_u.htm.txt	Udbhata: Kavyalamkarasarasamgraha,    with Induraja's Laghuvrtti commentary.
udnyku1u.htm.txt	Udayana: Nyayakusumanjali, Stavaka 1
udnyku2u.htm.txt	Udayana: Nyayakusumanjali, Stavaka 2
udnyku3u.htm.txt	Udayana: Nyayakusumanjali, Stavaka 3
udnyku4u.htm.txt	Udayana: Nyayakusumanjali, Stavaka 4
udnyku5u.htm.txt	Udayana: Nyayakusumanjali, Stavaka 5
ujjvni_u.htm.txt	Rupa Gosvamin: Ujjvalanilamani
upsmpjnu.htm.txt	Upasampadajnapti (= Uj)
utajp_au.htm.txt	Utpaladeva: Ajadapramatrsiddhi
utajp_iu.htm.txt	Utpaladeva: Ajadapramatrsiddhi
utajp_pu.htm.txt	Utpaladeva: Ajadapramatrsiddhi
utipk_au.htm.txt	Utpaladeva: Isvarapratyabhijnakarika with vrtti.
utipk_iu.htm.txt	Utpaladeva: Isvarapratyabhijnakarika with vrtti.
utipk_pu.htm.txt	Utpaladeva: Isvarapratyabhijnakarika with vrtti.
utsivsau.htm.txt	Utpaladeva: Sivastotravali
vabhdicu.htm.txt	Vimalamitra(?): Abhidharmadipa (= Abhidh-d), with auto(?)-commentary
   Vibhasaprabhavrtti
vabhdiku.htm.txt	Vimalamitra(?): Abhidharmadipa, Karikas only!
vabhdilu.htm.txt	Vimalamitra(?): Abhidharmadipa, Karikas: 1-383 only!
vacbhamu.htm.txt	Vacaspati: Bhamati
   (a commentary on Samkara's Brahmasutrabhasya)
vadhdhdu.htm.txt	Vasudharadharani (=Vasudharadharanisutra)
vadhdhgu.htm.txt	Vasudharadharani or Sucandragrhapatipariprccha or Sucandravadana
   (identification by Paul Harrison)
vadhdhju.htm.txt	Vasudharadharani (= Vasudharadharanisutra)
vagaah_u.htm.txt	Vagbhata: Astangahrdayasutra
vaikhd_u.htm.txt	Vaikhaanasa Dharmasuutra \VKHDHS)1-3
vaimp_cu.htm.txt	Vaikhanasamantraprasna, Prasnas 5 - 8
vaimp__u.htm.txt	Vaikhanasamantraprasna, Prasnas 5 - 8
vaisessu.htm.txt	Kanada: Vaisesikasutra
vaissu1u.htm.txt	Kanada: Vaisesikasutra
vaitss_u.htm.txt	Vaitana-Srautasutra [=Vaitanasutra]
vajvidhu.htm.txt	Vajravidarani-Dharani
vakobhau.htm.txt	Vasubandhu: Abhidharmakosa-bhasya
vakobhku.htm.txt	Vasubandhu: Abhidharmakosa, Karikas only
   Source unknown; cf. the edition by P. Pradhan. Vasubandhu, 
vakyp1au.htm.txt	Bhartrhari: Vakyapadiya
vakyp1iu.htm.txt	Bhartrhari: Vakyapadiya
vakyp1pu.htm.txt	Bhartrhari: Vakyapadiya
vakyp_au.htm.txt	Bhartrhari: Vakyapadiya
   1.1-3.7 (sadhanasamuddesa)
vakyp_pu.htm.txt	Bhartrhari: Vakyapadiya
   1.1-3.7 (sadhanasamuddesa)
vakyp_su.htm.txt	  ----------------------------------------------------------------------
valsubhu.htm.txt	Vallabhadeva: Subhasitavali
   Verses 1-1040
vamjanmu.htm.txt	Vamadeva: Janmamaranavicara
vamkalsu.htm.txt	Vamana: Kavyalamkara (sutras without commentary)
vamkalvu.htm.txt	Vamana: Kavyalamkarasutra, with Vṛtti
vampsm_u.htm.txt	Vamana-Purana, Saromahatmya (inserted after Adhy. 23)
vamp__u.htm.txt	Vamana-Purana, Adhyayas 1-69
   [For Saromahatmya (inserted after Adhy. 23) see separate file!]
vamsbum_u.htm.txt	Vamanadatta: Svabodhodayamanjari
vamvupau.htm.txt	Vagisvarakirti: Mrtyuvancanopadesa
vamvupiu.htm.txt	Vagisvarakirti: Mrtyuvancanopadesa
vamvuppu.htm.txt	Vagisvarakirti: Mrtyuvancanopadesa
vanighau.htm.txt	Vahata: Astanganighantu
vanighiu.htm.txt	Vahata: Astanganighantu
vanighpu.htm.txt	Vahata: Astanganighantu
vargs_u.htm.txt	Varahagrhyasutra
varlghku.htm.txt	Varadaraja: Laghusiddhantakaumudi (= Laghukaumudi)
vasbocpu.htm.txt	Vasubandhu: Bodhicittotpadasutrasastra
vasist_u.htm.txt	Vasistadharmasutra
vasspacu.htm.txt	Vasugupta [or Kallata Bhatta?]: Spandakrika
   With the commentary by Ksemaraja
vasvvmsu.htm.txt	Vasubandhu: Vimsatika vijnaptimatratasiddhi (= Vvs)
vatnsuau.htm.txt	Vatulanatha: Vatulanathasutra with the Vrtti of Anantasaktipada.
vatnsupu.htm.txt	Vatulanatha: Vatulanathasutra with the Vrtti of Anantasaktipada.
vatnsuxu.htm.txt	Vatulanatha: Vatulanathasutra with the Vrtti of Anantasaktipada.
vcamkc_u.htm.txt	Visvesvara Kavicandra: Camatkaracandrika
vchedpgu.htm.txt	Vajracchedika Prajnaparamita
vchedppu.htm.txt	Vajracchedika Prajnaparamita
vd2127_u.htm.txt	Visnudharmottara-Purana, Adhy. 2,127: Atharvavidhikathana
   (=Atharvavidhana)
vd3343au.htm.txt	Visnudharmottara-Purana, Adhy. 3,343-353
vd3343pu.htm.txt	Visnudharmottara-Purana, Adhy. 3,343-353
vdhapadu.htm.txt	Visnudharmah
vdhasrtu.htm.txt	Visnudharmah
vidsrgau.htm.txt	Vidyakara: Subhasitaratnakosa
vidsrgiu.htm.txt	Vidyakara: Subhasitaratnakosa
vidsrgpu.htm.txt	Vidyakara: Subhasitaratnakosa
vidsriau.htm.txt	Vidyakara: Subhasitaratnakosa
vidsriiu.htm.txt	Vidyakara: Subhasitaratnakosa
vidsrimu.htm.txt	Vidyakara: Subhasitaratnakosa
vidsripu.htm.txt	Vidyakara: Subhasitaratnakosa
vidsrixu.htm.txt	Vidyakara: Subhasitaratnakosa
vijnbhau.htm.txt	Vijnanabhairava
vijsamsu.htm.txt	Vijnanabhiksu: Samkhyasara
   [source unknown]
vimkn_u.htm.txt	Vimalakirtinirdesa
vinst_au.htm.txt	Vinasikhatantra
vinst_pu.htm.txt	Vinasikhatantra
vinst_su.htm.txt	Vinasikhatantra
vinsutru.htm.txt	Vinayasutra
   Preliminary transliteration of the ms. found in Tibet by Rahula
vinv01_u.htm.txt	Pravrajyavastu of the Vinayavstvagama of the Mulasarvastivadin (Vastu 1 im
   Vinayavastu)
vinv02_u.htm.txt	Posadhavastu of the Vinayavstvagama of the Mulasarvastivadin (Vastu 2 im
   Vinayavastu)
vinv03_u.htm.txt	Pravaranavastu of the Vinayavastvagama of the Mulasarvastivadin (Vastu 3
   im Vinayavastu)
vinv04_u.htm.txt	Varsavastu of the Vinayavastvagama of the Mulasarvastivadin (Vastu 4 of
   Vinayavastu)
vinv05_u.htm.txt	Carmavastu of the Vinayavstvagama of the Mulasarvastivadin (= Vastu 5 of
   the Vinayavastu)
vinv_06u.htm.txt	Bhaisajyavastu of the Vinayavastvagama of the Mulasarvastivadin [Vastu 6]
vinv07_u.htm.txt	Civaravastu of the Vinayavastvagama of the Mulasarvastivadin (= Vastu 7 of
   the Vinayavastu)
vinv08_u.htm.txt	Kathinavastu of the Vinayavastvagama of the Mulasarvastivadin (= Vastu 8
   of the Vinayavastu)
vinv09_u.htm.txt	Kosambakavastu of the Vinayavastvagama of the Mulasarvastivadin (= Vastu 9
   of the Vinayavastu)
vinv10_u.htm.txt	Karmavastu of the Vinayavastvagama of the Mulasarvastivadin (= Vastu 10 of
   the Vinayavastu)
vinv11_u.htm.txt	Pandulohitakavastu (Vastu 11 of Vinayavastu)
vinv12_u.htm.txt	Pudgalavastu of the Vinayavastvagama of the Mulasarvastivadin (= Vastu 12
   of the Vinayavastu)
vinv13_u.htm.txt	Parivasikavastu of the Vinayavastvagama of the Mulasarvastivadin (= Vastu
   13 of the Vinayavastu)
vinv14_u.htm.txt	Posadhasthapanavastu of the Vinayavastvagama of the Mulasarvastivadin (=
   Vastu 14 of the Vinayavastu)
vinv15_u.htm.txt	Vinayavastu, 15: Sayanasanavastu.
vinv16_u.htm.txt	Vinayavastu, 16: Adhikaranavastu
vinv171u.htm.txt	Sanghabhedavastu
vinv172u.htm.txt	Sanghabhedavastu
   ed. R. Gnoli with the assistance of T. Venkatacharya:
vipce_au.htm.txt	Visnu-Purana
vipce_iu.htm.txt	Visnu-Purana
vipce_pu.htm.txt	Visnu-Purana
viprud_u.htm.txt	Vidyanatha: Prataparudriya, or Prataparudrayasobhusana,    with Kumarasvamin's Ratnapana commentary
visa01cu.htm.txt	Visvanatha (kaviraja): Sahityadarpana, with the author's autocommentary Vasudhakara, 
visa02cu.htm.txt	Visvanatha (kaviraja): Sahityadarpana, with the author's autocommentary Vasudhakara, 
visa03cu.htm.txt	Visvanatha (kaviraja): Sahityadarpana, with the author's autocommentary Vasudhakara, 
visa04cu.htm.txt	Visvanatha (kaviraja): Sahityadarpana, with the author's autocommentary Vasudhakara, 
visa05cu.htm.txt	Visvanatha (kaviraja): Sahityadarpana, with the author's autocommentary Vasudhakara, 
visa06cu.htm.txt	Visvanatha (kaviraja): Sahityadarpana, with the author's autocommentary Vasudhakara, 
visa07cu.htm.txt	Visvanatha (kaviraja): Sahityadarpana, with the author's autocommentary Vasudhakara, 
visa08cu.htm.txt	Visvanatha (kaviraja): Sahityadarpana, with the author's autocommentary Vasudhakara, 
visa09cu.htm.txt	Visvanatha (kaviraja): Sahityadarpana, with the author's autocommentary Vasudhakara, 
visa10cu.htm.txt	Visvanatha (kaviraja): Sahityadarpana, with the author's autocommentary Vasudhakara, 
visah_cu.htm.txt	Visvanatha (kaviraja): Sahityadarpana, with the author's autocommentary Vasudhakara, 
visah__u.htm.txt	Visvanatha (kaviraja): Sahityadarpana
visnu_au.htm.txt	Visnusmrti
visnu_iu.htm.txt	Visnusmrti
visnu_pu.htm.txt	Visnusmrti
visnup_u.htm.txt	Visnu-Purana
visnus_u.htm.txt	Visnusmrti
vispancu.htm.txt	Visnusarma: Pancatantra
   (Version 1.01)
visvaksu.htm.txt	Visvaksenasamhita
visvantu.htm.txt	Visvantaravadana
visvsdpu.htm.txt	Visvanatha (kaviraja): Sahityadarpana
vivahapu.htm.txt	Varahamihira: Vivahapatalam
vivcud_u.htm.txt	Samkara (attrib.): Vivekacudamani
vjviddhu.htm.txt	Vajravidarana-Dharani
vmvkbh_u.htm.txt	Vasubandhu: Madhyantavibhagabhasya
vnyps00u.htm.txt	Venkatanatha [Vedantadesika]: Nyayaparisuddhi, bhumika
vnyps11u.htm.txt	Venkatanatha [Vedantadesika]: Nyayaparisuddhi, Adhyaya 1,1
vnyps12u.htm.txt	Venkatanatha [Vedantadesika]: Nyayaparisuddhi, Adhyaya 1,2
vnyps31u.htm.txt	Venkatanatha [Vedantadesika]: Nyayaparisuddhi, Adhyaya 3,1
vnyps32u.htm.txt	Venkatanatha [Vedantadesika]: Nyayaparisuddhi, Adhyaya 3,2
vnyps41u.htm.txt	Venkatanatha [Vedantadesika]: Nyayaparisuddhi, Adhyaya 4,1
vnyps42u.htm.txt	Venkatanatha [Vedantadesika]: Nyayaparisuddhi, Adhyaya 4,2
vnyps51u.htm.txt	Venkatanatha [Vedantadesika]: Nyayaparisuddhi, Adhyaya 5,1
vnyps52u.htm.txt	Venkatanatha [Vedantadesika]: Nyayaparisuddhi, Adhyaya 5,2
vprevk_u.htm.txt	Revakhanda of the Vayupurana (RKV)
vrasrscu.htm.txt	Vagbhata: Rasaratnasamuccaya, Adhyayas 1-18.29ab.
   With commentaries:
vrasrs_u.htm.txt	Vagbhata: Rasaratnasamuccaya.
vtrksopu.htm.txt	Vidyakarasanti: Tarkasopana (= Ts)
vvmanmhu.htm.txt	Vadivagisvara: Manamanohara
vytrkt1u.htm.txt	Vyasatirtha: Tarkatandava
   with Raghavendra's Nyayadipa (comm.), 
vytrkt2u.htm.txt	Vyasatirtha: Tarkatandava
   with Raghavendra's Nyayadipa (comm.), 
vytrkt3u.htm.txt	Vyasatirtha: Tarkatandava
   with Raghavendra's Nyayadipa (comm.), 
yaatsi_u.htm.txt	Yamuna: Siddhitraya,    Part 1: Atmasiddhi
yabhkvyu.htm.txt	Yasomitra: Sphutartha Abhidharmakosavyakhya
yaissi_u.htm.txt	Yamuna: Siddhitraya,    Part 2: Isvarasiddhi
yajn1_u.htm.txt	Yajnavalkya-Smrti
yajn2_au.htm.txt	Yajnavalkya-Smrti
yajn2piu.htm.txt	Yajnavalkyasmrti
yajn2_pu.htm.txt	Yajnavalkyasmrti
yamcatau.htm.txt	Yamuna: Catuhsloki
yamcatpu.htm.txt	Yamuna: Catuhsloki
yamgasau.htm.txt	Yamuna: Gitarthasangraha
yamgaspu.htm.txt	Yamuna: Gitarthasangraha
yamis_au.htm.txt	Yamuna: Isvarasiddhi
yamis_pu.htm.txt	Yamuna: Isvarasiddhi
yamsr_au.htm.txt	Yamuna: Stotraratna
yamsr_pu.htm.txt	Yamuna: Stotraratna
yamss_au.htm.txt	Yamuna: Samvitsiddhi
yamss_iu.htm.txt	Yamuna: Samvitsiddhi
yamss_pu.htm.txt	Yamuna: Samvitsiddhi
yamsvsau.htm.txt	Yamunacarya: Samvitsiddhi
yamsvsiu.htm.txt	Yamunacarya: Samvitsiddhi
yamsvspu.htm.txt	Yamunacarya: Samvitsiddhi
yasasi_u.htm.txt	Yamuna: Siddhitraya,    Part 3: Samvitsiddhi
yogasatu.htm.txt	Yogasataka
yogasutu.htm.txt	Patanjali: Yogasutra
yogay1_u.htm.txt	Varahamihira: Yogayatra
yogay2_u.htm.txt	Varahamihira: Yogayatra
yogsubhu.htm.txt	Patanjali: Yogasutra (with Bhasya)
yrasprau.htm.txt	Yasodhara: Rasaprakasasudhakara
yraspriu.htm.txt	Yasodhara: Rasaprakasasudhakara
yrasprpu.htm.txt	Yasodhara: Rasaprakasasudhakara
ys182_au.htm.txt	Brhadyamasmrti
ys182_iu.htm.txt	Brhadyamasmrti
ys182_pu.htm.txt	Brhadyamasmrti
ys-78_au.htm.txt	Yamasmrti
ys-78_iu.htm.txt	Yamasmrti
ys-78_pu.htm.txt	Yamasmrti
ys-99_au.htm.txt	Laghuyamasmrti (AAL)
ys-99_iu.htm.txt	Laghuyamasmrti (AAL)
ys-99_pu.htm.txt	Laghuyamasmrti (AAL)
ysall_iu.htm.txt	YAMASMRTI: CUMULATIVE PADA INDEX OF FOUR VERSIONS (78 / 99 / 182 verses,    and South Indian recension)
yssoutau.htm.txt	Yamasmrti, South Indian recension
yssoutiu.htm.txt	Yamasmrti, South Indian recension
yssoutpu.htm.txt	Yamasmrti, South Indian recension
yuktdipu.htm.txt	Yuktidipika, a commentary on Īśvarakṛṣṇa's Sāṃkhyakārikā
